"yy","week","monitor_id","monitor","latitude","longitude","avg_windspeed","avg_temperature","avg_precip","avg_humidity","avg_pm10","avg_no2","tot_events","dw_events","dw_fatals","uw_events","uw_fatals","tot_fatals","nw_events","nw_fatals"
2017,1,1,"Catalan",37.0687,35.2704,18.7,9.42857142857143,5.01514285714286,77.7571428571429,9.91857142857143,1.54285714285714,563,66,79,50,112,847,497,768
2017,2,1,"Catalan",37.0687,35.2704,17.8142857142857,8.25714285714286,2.164,66.3142857142857,10.09,2.16428571428571,757,25,16,64,72,1214,732,1198
2017,3,1,"Catalan",37.0687,35.2704,15.4571428571429,9.5,0,57.3285714285714,17.6928571428571,1.87714285714286,762,0,0,92,432,1449,762,1449
2017,4,1,"Catalan",37.0687,35.2704,22.1428571428571,8.12857142857143,0.008,44.0142857142857,12.65,1.92571428571429,639,0,0,91,113,889,639,889
2017,5,1,"Catalan",37.0687,35.2704,20.2142857142857,6.15714285714286,0,45.4,18.7242857142857,3.96428571428571,588,0,0,133,321,1163,588,1163
2017,6,1,"Catalan",37.0687,35.2704,19.2428571428571,13.1714285714286,0.0511428571428571,54.9,33.1585714285714,2.70714285714286,736,0,0,77,216,1519,736,1519
2017,7,1,"Catalan",37.0687,35.2704,23.9,8.35714285714286,0,35.3285714285714,13.2757142857143,2.40142857142857,492,0,0,114,259,717,492,717
2017,8,1,"Catalan",37.0687,35.2704,16.3714285714286,11.8428571428571,0,61.6,31.8328571428571,5.04285714285714,739,280,715,75,155,1747,459,1032
2017,9,1,"Catalan",37.0687,35.2704,20.0142857142857,15.0714285714286,3.99857142857143,55.2857142857143,30.8142857142857,2.31857142857143,574,0,0,134,173,866,574,866
2017,10,1,"Catalan",37.0687,35.2704,19.8285714285714,15.3285714285714,4.66385714285714,65.5,41.5442857142857,2.96571428571429,712,33,97,10,25,1043,679,946
2017,11,1,"Catalan",37.0687,35.2704,22.7714285714286,12.7714285714286,1.81328571428571,62.4571428571429,14.4371428571429,1.84428571428571,525,117,133,45,66,725,408,592
2017,12,1,"Catalan",37.0687,35.2704,18.8285714285714,15.7714285714286,0.00414285714285714,65.9142857142857,21.1028571428571,4.42285714285714,589,238,530,140,259,1077,351,547
2017,13,1,"Catalan",37.0687,35.2704,20.0285714285714,16.4428571428571,0.378857142857143,68.2142857142857,19.2585714285714,3.71714285714286,574,121,199,51,55,887,453,688
2017,14,1,"Catalan",37.0687,35.2704,23.5428571428571,17.9142857142857,1.12528571428571,64.6571428571429,21.6457142857143,4.41,639,187,438,0,0,1336,452,898
2017,15,1,"Catalan",37.0687,35.2704,21.9,16.6571428571429,6.08385714285714,65.3571428571429,15.5642857142857,3.76714285714286,587,80,76,14,155,1187,507,1111
2017,16,1,"Catalan",37.0687,35.2704,21.1714285714286,18.5714285714286,0,69.8714285714286,28.1942857142857,3.86428571428571,717,128,279,34,86,920,589,641
2017,17,1,"Catalan",37.0687,35.2704,16.2714285714286,20.5,0,47.4285714285714,37.6571428571429,4.20142857142857,731,25,21,40,110,1478,706,1457
2017,18,1,"Catalan",37.0687,35.2704,23.2142857142857,20.5428571428571,0.803,72.9571428571429,42.2971428571429,4.15428571428571,506,132,440,6,11,923,374,483
2017,19,1,"Catalan",37.0687,35.2704,19.6,22.4142857142857,0.00814285714285714,68.8428571428571,33.9842857142857,4.87571428571429,471,145,316,2,2,966,326,650
2017,20,1,"Catalan",37.0687,35.2704,19.4285714285714,21.6714285714286,2.00542857142857,65.9,24.7414285714286,5.26285714285714,472,146,465,68,107,1205,326,740
2017,21,1,"Catalan",37.0687,35.2704,21.2714285714286,20.4857142857143,2.885,73.5857142857143,22.3471428571429,2.05714285714286,448,124,292,1,2,849,324,557
2017,22,1,"Catalan",37.0687,35.2704,22.0428571428571,22.8142857142857,0.902714285714286,70.9,25.2214285714286,NA,522,122,252,15,30,1015,400,763
2017,23,1,"Catalan",37.0687,35.2704,19.9142857142857,25.6,0.0187142857142857,71.4,40.0371428571429,NA,578,188,438,0,0,1388,390,950
2017,24,1,"Catalan",37.0687,35.2704,21.0285714285714,25.2142857142857,4.07771428571429,73.2571428571429,33.6857142857143,NA,552,249,540,0,0,1139,303,599
2017,25,1,"Catalan",37.0687,35.2704,24.0571428571429,25.6285714285714,0.000428571428571429,68.3428571428571,29.8542857142857,9.674,584,184,312,0,0,1041,400,729
2017,26,1,"Catalan",37.0687,35.2704,20.5285714285714,29.5,0,65.8571428571429,37.1171428571429,7.08142857142857,564,125,294,36,37,971,439,677
2017,27,1,"Catalan",37.0687,35.2704,22.4,29.4,0,67.1857142857143,41.8514285714286,6.78428571428571,511,187,344,4,16,642,324,298
2017,28,1,"Catalan",37.0687,35.2704,21.1714285714286,29.4,0,71.2714285714286,36.3857142857143,6.31428571428571,481,159,418,0,0,864,322,446
2017,29,1,"Catalan",37.0687,35.2704,22.8428571428571,29.3285714285714,0,70.2857142857143,37.7971428571429,5.98857142857143,532,191,562,0,0,1272,341,710
2017,30,1,"Catalan",37.0687,35.2704,22.7,29.7857142857143,0,68.1285714285714,36.4557142857143,5.85142857142857,531,264,557,0,0,928,267,371
2017,31,1,"Catalan",37.0687,35.2704,22.7571428571429,29.4428571428571,0.0161428571428571,70.6857142857143,37.265,5.95714285714286,559,181,576,0,0,1047,378,471
2017,32,1,"Catalan",37.0687,35.2704,20.5714285714286,30.0285714285714,0,69.4428571428572,NA,6.01285714285714,567,182,553,0,0,1092,385,539
2017,33,1,"Catalan",37.0687,35.2704,22.2285714285714,29.2857142857143,0,71.0428571428571,33.79,6.44166666666667,596,193,718,0,0,1199,403,481
2017,34,1,"Catalan",37.0687,35.2704,22.9142857142857,29.0142857142857,0,68.7714285714286,41.49,9.40857142857143,601,187,583,0,0,1280,414,697
2017,35,1,"Catalan",37.0687,35.2704,23.0857142857143,28.6285714285714,0,69.8714285714286,34.3328571428571,7.47857142857143,493,158,453,0,0,1014,335,561
2017,36,1,"Catalan",37.0687,35.2704,22.3285714285714,27.4714285714286,0.263,59.8714285714286,36.3728571428571,9.66142857142857,507,171,732,8,15,1321,336,589
2017,37,1,"Catalan",37.0687,35.2704,20.0571428571429,28.0857142857143,0,71.9714285714286,44.4614285714286,9.54,589,157,548,0,0,1138,432,590
2017,38,1,"Catalan",37.0687,35.2704,23,27.3714285714286,0.00414285714285714,68.9857142857143,40.6242857142857,8.00714285714286,671,198,622,0,0,1312,473,690
2017,39,1,"Catalan",37.0687,35.2704,23.3,25.1285714285714,0.485571428571429,67.3714285714286,27.8114285714286,7.90857142857143,782,350,917,0,0,1630,432,713
2017,40,1,"Catalan",37.0687,35.2704,17.5285714285714,23.2142857142857,0.000428571428571429,44.9571428571429,19.7728571428571,9.50428571428571,543,32,58,11,85,1137,511,1079
2017,41,1,"Catalan",37.0687,35.2704,19.2142857142857,21.9,0.169714285714286,51.1285714285714,19.24,7.78666666666667,487,111,112,34,87,843,376,731
2017,42,1,"Catalan",37.0687,35.2704,19.3142857142857,22.1285714285714,0,44.7,21.25,7.84,530,149,199,17,42,815,381,616
2017,43,1,"Catalan",37.0687,35.2704,17.7714285714286,20.9571428571429,3.16114285714286,66.5,28.3971428571429,7.98571428571429,506,190,458,17,27,919,316,461
2017,44,1,"Catalan",37.0687,35.2704,16.8285714285714,17.3,6.97671428571429,64.2,13.6714285714286,5.44833333333333,561,42,63,100,272,1102,519,1039
2017,45,1,"Catalan",37.0687,35.2704,14.0714285714286,16.7285714285714,0.884857142857143,67.7428571428571,17.1957142857143,NA,577,0,0,103,173,829,577,829
2017,46,1,"Catalan",37.0687,35.2704,19.0285714285714,18.4714285714286,1.72671428571429,57.2428571428571,36.4171428571429,NA,587,0,0,20,28,1085,587,1085
2017,47,1,"Catalan",37.0687,35.2704,20.4428571428571,12.6,2.90028571428571,60.3142857142857,24.55,NA,418,0,0,26,25,804,418,804
2017,48,1,"Catalan",37.0687,35.2704,12.7857142857143,13.5571428571429,4.93157142857143,76.5428571428571,18.9214285714286,NA,386,0,0,4,6,619,386,619
2017,49,1,"Catalan",37.0687,35.2704,16.8,10.5428571428571,1.52528571428571,63.9285714285714,9.90333333333333,NA,407,0,0,47,87,645,407,645
2017,50,1,"Catalan",37.0687,35.2704,11.3571428571429,12.7857142857143,0.00871428571428571,70.9,15.8385714285714,NA,346,0,0,21,16,442,346,442
2017,51,1,"Catalan",37.0687,35.2704,17.1142857142857,14.5571428571429,1.3,72.1714285714286,53.5914285714286,NA,386,25,24,29,56,349,361,325
2017,52,1,"Catalan",37.0687,35.2704,15.5875,11.475,4.41125,70.1125,13.83375,4.07666666666667,528,0,0,77,73,507,528,507
2018,1,1,"Catalan",37.0687,35.2704,16.1375,10.875,18.042625,74.4875,6.82833333333333,4.57142857142857,618,0,0,102,152,914,618,914
2018,2,1,"Catalan",37.0687,35.2704,14.4285714285714,11.3142857142857,1.06457142857143,70.2571428571429,26.5033333333333,4.79857142857143,624,0,0,39,32,1309,624,1309
2018,3,1,"Catalan",37.0687,35.2704,16.8428571428571,9.97142857142857,6.52771428571429,70.8571428571429,8.98666666666667,4.50142857142857,639,10,3,142,96,655,629,652
2018,4,1,"Catalan",37.0687,35.2704,21.1428571428571,9.55714285714286,16.4227142857143,75.2714285714286,19.09,4.49714285714286,604,0,0,246,367,764,604,764
2018,5,1,"Catalan",37.0687,35.2704,11.3,10.2,0.00414285714285714,69.6428571428571,13.7785714285714,4.80142857142857,670,0,0,111,65,819,670,819
2018,6,1,"Catalan",37.0687,35.2704,12.8142857142857,14.0571428571429,0,65.7,32.6271428571429,4.92,704,0,0,47,35,1022,704,1022
2018,7,1,"Catalan",37.0687,35.2704,23.9142857142857,14.3142857142857,0.646285714285714,66.8142857142857,14.21,4.61285714285714,478,85,89,40,61,557,393,468
2018,8,1,"Catalan",37.0687,35.2704,16.9857142857143,13.8285714285714,2.28342857142857,69.5428571428571,12.2685714285714,4.8,711,173,312,43,28,1321,538,1009
2018,9,1,"Catalan",37.0687,35.2704,17.7714285714286,13.6142857142857,4.75214285714286,78.7428571428571,11.58,4.71571428571429,621,111,153,67,143,956,510,803
2018,10,1,"Catalan",37.0687,35.2704,18.0857142857143,16.3714285714286,0.182857142857143,74.1285714285714,36.1457142857143,4.78571428571429,556,245,497,39,56,1330,311,833
2018,11,1,"Catalan",37.0687,35.2704,19.2,16.1142857142857,0.0807142857142857,74.1714285714286,16.0328571428571,4.77714285714286,551,225,696,0,0,1426,326,730
2018,12,1,"Catalan",37.0687,35.2704,23.9,18.2,0,64.5714285714286,34.0428571428571,4.72714285714286,425,132,369,4,6,1187,293,818
2018,13,1,"Catalan",37.0687,35.2704,20.8428571428571,17.6142857142857,2.63814285714286,64.0714285714286,33.9128571428571,5.04857142857143,356,37,69,48,65,428,319,359
2018,14,1,"Catalan",37.0687,35.2704,20.8857142857143,18.7857142857143,0.000285714285714286,51.4285714285714,15.5485714285714,5.31857142857143,407,14,34,45,13,486,393,452
2018,15,1,"Catalan",37.0687,35.2704,20.0428571428571,18.1571428571429,3.78771428571429,79.1142857142857,20.0857142857143,5.11428571428571,374,21,43,20,25,450,353,407
2018,16,1,"Catalan",37.0687,35.2704,20.5571428571429,19.5714285714286,0.0335714285714286,53.5285714285714,18.0514285714286,5.12,411,93,186,84,100,648,318,462
2018,17,1,"Catalan",37.0687,35.2704,19.0428571428571,21.9571428571429,0.293142857142857,61.2142857142857,25.3571428571429,5.07142857142857,419,136,298,13,57,652,283,354
2018,18,1,"Catalan",37.0687,35.2704,19.9571428571429,25.0857142857143,0.629857142857143,53.2857142857143,39.6957142857143,5.25142857142857,303,25,26,4,5,474,278,448
2018,19,1,"Catalan",37.0687,35.2704,19.6428571428571,19.8285714285714,5.44085714285714,75.0714285714286,23.355,5.00142857142857,275,97,114,20,28,467,178,353
2018,20,1,"Catalan",37.0687,35.2704,18.1428571428571,25.4571428571429,0.0917142857142857,56.9428571428571,26.116,5.92714285714286,204,62,63,2,0,306,142,243
2018,21,1,"Catalan",37.0687,35.2704,17.9714285714286,25.8428571428571,0.0355714285714286,65.4857142857143,48.054,5.60714285714286,252,127,204,0,0,281,125,77
2018,22,1,"Catalan",37.0687,35.2704,20.3285714285714,24.2571428571429,4.21542857142857,70.3571428571429,24.28,3.90714285714286,249,128,221,0,0,427,121,206
2018,23,1,"Catalan",37.0687,35.2704,18.7857142857143,27.3428571428571,0,68.2714285714286,27.52,4.61142857142857,267,89,321,4,34,812,178,491
2018,24,1,"Catalan",37.0687,35.2704,23.4714285714286,25.6857142857143,2.20128571428571,73.9285714285714,24.626,3.72714285714286,267,67,257,5,11,448,200,191
2018,25,1,"Catalan",37.0687,35.2704,22.2285714285714,25.5142857142857,2.10171428571429,73.8857142857143,26.39,2.99142857142857,358,136,258,0,0,518,222,260
2018,26,1,"Catalan",37.0687,35.2704,20.5571428571429,26.5428571428571,0,71.4428571428571,25.2857142857143,2.32428571428571,355,87,131,0,0,587,268,456
2018,27,1,"Catalan",37.0687,35.2704,20.7142857142857,28.1714285714286,0,72.1857142857143,29.3433333333333,2.31428571428571,342,98,197,0,0,418,244,221
2018,28,1,"Catalan",37.0687,35.2704,21.0714285714286,28.5857142857143,0,72.4428571428571,31.74,2.27666666666667,286,88,247,0,0,585,198,338
2018,29,1,"Catalan",37.0687,35.2704,24.6571428571429,29.1,0,70.2428571428571,33.0642857142857,2.23142857142857,260,81,156,0,0,756,179,600
2018,30,1,"Catalan",37.0687,35.2704,23.6142857142857,28.8285714285714,0,71.5857142857143,38.9828571428571,2.23,265,91,148,0,0,822,174,674
2018,31,1,"Catalan",37.0687,35.2704,24.1857142857143,29.1428571428571,0.000857142857142857,73.1285714285714,39.8414285714286,2.23571428571429,267,81,116,0,0,499,186,383
2018,32,1,"Catalan",37.0687,35.2704,24.4,29.6428571428571,0,66.0285714285714,43.24,2.19428571428571,297,90,146,0,0,403,207,257
2018,33,1,"Catalan",37.0687,35.2704,22.7428571428571,28.9142857142857,0,69.3,44.84,6.00857142857143,216,85,142,0,0,332,131,190
2018,34,1,"Catalan",37.0687,35.2704,22.2857142857143,29.0714285714286,0,72.2428571428571,48.2257142857143,5.74571428571429,144,52,98,0,0,227,92,129
2018,35,1,"Catalan",37.0687,35.2704,21.6428571428571,28.8571428571429,0,69.2857142857143,38.4371428571429,1.74,201,66,129,0,0,314,135,185
2018,36,1,"Catalan",37.0687,35.2704,23.4142857142857,27.9,0.429,69.2857142857143,33.17,1.34714285714286,341,159,238,0,0,370,182,132
2018,37,1,"Catalan",37.0687,35.2704,19.3714285714286,26.9428571428571,0.000285714285714286,59.1,26.37,1.39857142857143,241,73,107,1,1,419,168,312
2018,38,1,"Catalan",37.0687,35.2704,19.4,28.0428571428571,0,62.0714285714286,26.3571428571429,1.41428571428571,189,98,212,18,30,344,91,132
2018,39,1,"Catalan",37.0687,35.2704,19.1,26.3714285714286,0.0212857142857143,66.3714285714286,30.6928571428571,1.39857142857143,180,88,153,12,47,353,92,200
2018,40,1,"Catalan",37.0687,35.2704,19.2428571428571,24.8857142857143,0.084,54.4,21,1.54714285714286,191,77,142,13,32,341,114,199
2018,41,1,"Catalan",37.0687,35.2704,15.8142857142857,23.4285714285714,0.415571428571429,62.7428571428571,57.34,3.16571428571429,187,51,135,28,113,422,136,287
2018,42,1,"Catalan",37.0687,35.2704,17.8428571428571,23.9428571428571,1.19714285714286,59.8,74.7685714285714,2.49,168,2,10,30,40,381,166,371
2018,43,1,"Catalan",37.0687,35.2704,20.1714285714286,19.5285714285714,7.93685714285714,59.1428571428571,25.4133333333333,2.49857142857143,187,0,0,79,266,402,187,402
2018,44,1,"Catalan",37.0687,35.2704,13.9,19.7571428571429,0.01,51.2,99.5485714285714,2.51428571428571,196,2,1,18,16,264,194,263
2018,45,1,"Catalan",37.0687,35.2704,14.5714285714286,18.4285714285714,0.614142857142857,65.5571428571429,26.9642857142857,2.48571428571429,231,30,61,7,4,473,201,412
2018,46,1,"Catalan",37.0687,35.2704,20.8857142857143,14.8571428571429,1.10342857142857,53.0428571428571,13.86,2.50571428571429,230,0,0,42,129,465,230,465
2018,47,1,"Catalan",37.0687,35.2704,14.2,15.5285714285714,0.718714285714286,69.3,17.8428571428571,2.49428571428571,270,0,0,69,262,499,270,499
2018,48,1,"Catalan",37.0687,35.2704,16.5285714285714,15.1571428571429,3.94457142857143,77.1571428571429,14.68,2.48142857142857,245,0,0,30,58,201,245,201
2018,49,1,"Catalan",37.0687,35.2704,17.4857142857143,13.9571428571429,9.54142857142857,75.7,9.48142857142857,49.3628571428571,257,0,0,58,214,420,257,420
2018,50,1,"Catalan",37.0687,35.2704,22.3571428571429,12.9285714285714,5.77142857142857,69.5,12.0514285714286,110.661428571429,256,2,1,6,5,305,254,304
2018,51,1,"Catalan",37.0687,35.2704,16.3714285714286,11.9428571428571,12.069,81.4428571428572,10.4428571428571,83.94,250,0,0,49,33,248,250,248
2018,52,1,"Catalan",37.0687,35.2704,17.8714285714286,9.8,7.556,67.5714285714286,10.64,50.28,244,0,0,47,116,273,244,273
2019,1,1,"Catalan",37.0687,35.2704,20.325,10.325,20.2075,84.675,8.225,4.165,343,52,124,30,36,784,291,660
2019,2,1,"Catalan",37.0687,35.2704,18.4571428571429,7.78571428571429,2.35085714285714,64.9571428571429,13.45,35.8166666666667,255,0,0,22,62,208,255,208
2019,3,1,"Catalan",37.0687,35.2704,22.6571428571429,8.7,11.6631428571429,64.1571428571429,12.8585714285714,29.3428571428571,192,26,12,42,60,198,166,186
2019,4,1,"Catalan",37.0687,35.2704,19.4142857142857,11.6142857142857,0.889714285714286,63.8,40.3914285714286,31.8942857142857,308,0,0,3,7,314,308,314
2019,5,1,"Catalan",37.0687,35.2704,15.6428571428571,11.4428571428571,2.73857142857143,73.5428571428571,29.35,27.7828571428571,253,0,0,22,20,143,253,143
2019,6,1,"Catalan",37.0687,35.2704,23.7857142857143,11.3,7.85557142857143,71.8,9.30428571428571,21.1385714285714,276,0,0,34,35,127,276,127
2019,7,1,"Catalan",37.0687,35.2704,18.3,11.6142857142857,0.622428571428571,74.2428571428571,11.3542857142857,22.6585714285714,325,43,98,1,0,234,282,136
2019,8,1,"Catalan",37.0687,35.2704,15.1285714285714,12.4428571428571,0.384714285714286,73.9428571428572,13.1628571428571,21.7271428571429,305,45,18,7,2,219,260,201
2019,9,1,"Catalan",37.0687,35.2704,21.4857142857143,11.3857142857143,0.852142857142857,65.3714285714286,9.55714285714286,19.7171428571429,331,62,31,40,108,310,269,279
2019,10,1,"Catalan",37.0687,35.2704,18.5428571428571,12.8428571428571,1.96385714285714,69.8857142857143,10.8257142857143,18.1785714285714,359,44,28,79,49,252,315,224
2019,11,1,"Catalan",37.0687,35.2704,18.4714285714286,13.9,6.61071428571429,78.3857142857143,12.2171428571429,18.13,373,186,134,29,31,400,187,266
2019,12,1,"Catalan",37.0687,35.2704,20.2571428571429,15.6428571428571,0,59.0857142857143,13.0714285714286,21.1685714285714,343,40,33,86,38,416,303,383
2019,13,1,"Catalan",37.0687,35.2704,22.4571428571429,13.6428571428571,4.94571428571429,73.1142857142857,11.0271428571429,21.7057142857143,256,89,27,70,49,194,167,167
2019,14,1,"Catalan",37.0687,35.2704,16.4714285714286,15.3428571428571,2.94471428571429,75.8428571428571,9.11857142857143,24.7742857142857,365,35,19,89,36,208,330,189
2019,15,1,"Catalan",37.0687,35.2704,20.5428571428571,17.8714285714286,0.108,69.8285714285714,23.14,22.5757142857143,359,132,71,2,0,183,227,112
2019,16,1,"Catalan",37.0687,35.2704,22.1857142857143,14,5.84728571428571,75.5571428571429,8.79428571428571,14.7642857142857,318,64,70,36,11,208,254,138
2019,17,1,"Catalan",37.0687,35.2704,18.5857142857143,18.2571428571429,0.000285714285714286,54.0857142857143,16.6442857142857,18.3942857142857,412,0,0,227,163,313,412,313
2019,18,1,"Catalan",37.0687,35.2704,20.4857142857143,20.9,0.0624285714285714,64.9571428571429,25.95,20.9771428571429,523,140,69,66,33,353,383,284
2019,19,1,"Catalan",37.0687,35.2704,22.8285714285714,20.0571428571429,0.0128571428571429,61.8285714285714,17.5725,12.87,452,44,51,88,59,386,408,335
2019,20,1,"Catalan",37.0687,35.2704,18.5142857142857,25.7285714285714,0,52.5142857142857,22.51,15.5157142857143,454,94,73,32,41,389,360,316
2019,21,1,"Catalan",37.0687,35.2704,17.7428571428571,24.5428571428571,0.0201428571428571,66.1,20.515,17.25,457,80,48,39,15,413,377,365
2019,22,1,"Catalan",37.0687,35.2704,18.5142857142857,27.1857142857143,0,58.7714285714286,29.7233333333333,19.21,453,34,91,3,14,323,419,232
2019,23,1,"Catalan",37.0687,35.2704,18.6,26.2857142857143,0.0222857142857143,65.4142857142857,44,18.4957142857143,378,229,218,7,1,532,149,314
2019,24,1,"Catalan",37.0687,35.2704,22.3285714285714,25.5142857142857,2.38171428571429,73.0142857142857,20.92,16.0328571428571,378,39,35,0,0,244,339,209
2019,25,1,"Catalan",37.0687,35.2704,21.8285714285714,25.8714285714286,3.03157142857143,76.8142857142857,23.54,10.6485714285714,306,83,173,0,0,325,223,152
2019,26,1,"Catalan",37.0687,35.2704,19.8571428571429,28.8285714285714,0,73.2857142857143,32.4142857142857,17.76,377,95,101,52,27,342,282,241
2019,27,1,"Catalan",37.0687,35.2704,20.5,27.8142857142857,0,66.3285714285714,33.3385714285714,11.5757142857143,456,155,97,4,2,222,301,125
2019,28,1,"Catalan",37.0687,35.2704,22.0571428571429,27.9285714285714,0.352285714285714,74.6142857142857,33.1266666666667,12.6414285714286,398,205,139,0,0,421,193,282
2019,29,1,"Catalan",37.0687,35.2704,21.4857142857143,27.1714285714286,3.38814285714286,73.5285714285714,20.7542857142857,13.3471428571429,453,153,77,0,0,203,300,126
2019,30,1,"Catalan",37.0687,35.2704,21.9714285714286,28.7857142857143,0,72.3714285714286,21.9014285714286,9.57285714285714,456,156,122,0,0,335,300,213
2019,31,1,"Catalan",37.0687,35.2704,20.9571428571429,28.8571428571429,0,74.9714285714286,31.38,14.5985714285714,334,104,120,0,0,375,230,255
2019,32,1,"Catalan",37.0687,35.2704,23.1285714285714,29.1428571428571,0.0158571428571429,70.1142857142857,26.9671428571429,16.5842857142857,346,53,77,0,0,395,293,318
2019,33,1,"Catalan",37.0687,35.2704,22.2,29.1285714285714,0.0408571428571428,74.2714285714286,29.755,19.5271428571429,337,44,47,0,0,531,293,484
2019,34,1,"Catalan",37.0687,35.2704,20.9714285714286,28.9571428571429,0,64.3428571428571,22.5885714285714,7.97571428571429,299,149,188,39,42,345,150,157
2019,35,1,"Catalan",37.0687,35.2704,20.8428571428571,29.5142857142857,0,73.1428571428571,32.9385714285714,12.3814285714286,307,116,177,0,0,415,191,238
2019,36,1,"Catalan",37.0687,35.2704,23.7571428571429,28.3285714285714,1.49585714285714,70.8857142857143,32.5585714285714,11.4371428571429,171,76,47,0,0,67,95,20
2019,37,1,"Catalan",37.0687,35.2704,23.5428571428571,27.7428571428571,0.0444285714285714,64.4285714285714,22.3414285714286,9.36,218,25,9,3,12,55,193,46
2019,38,1,"Catalan",37.0687,35.2704,22.3571428571429,26.0428571428571,0,55.3142857142857,17.62,7.72428571428571,266,58,19,11,4,91,208,72
2019,39,1,"Catalan",37.0687,35.2704,19.3428571428571,25.0714285714286,0,64.9428571428572,17.2971428571429,5.45428571428571,237,61,32,4,3,79,176,47
2019,40,1,"Catalan",37.0687,35.2704,21.7,25,0,71.8428571428571,20.2785714285714,6.38857142857143,241,63,71,0,0,111,178,40
2019,41,1,"Catalan",37.0687,35.2704,16.9,24.6142857142857,1.26257142857143,60.8142857142857,15.8057142857143,9.04571428571429,416,89,54,114,186,448,327,394
2019,42,1,"Catalan",37.0687,35.2704,19.3857142857143,25.4428571428571,1.02128571428571,56.8428571428571,23.8057142857143,6.83142857142857,356,79,88,70,114,408,277,320
2019,43,1,"Catalan",37.0687,35.2704,20.2428571428571,22.9571428571429,0.0105714285714286,53.4,15.2414285714286,4.20571428571429,306,3,11,43,62,300,303,289
2019,44,1,"Catalan",37.0687,35.2704,17.7,19.0142857142857,1.90528571428571,70.7,10.33,3.91285714285714,350,56,57,96,81,250,294,193
2019,45,1,"Catalan",37.0687,35.2704,15.2142857142857,20.2857142857143,0,48,18.1525,3.29857142857143,417,0,0,102,156,328,417,328
2019,46,1,"Catalan",37.0687,35.2704,15.3857142857143,20.1428571428571,0.406285714285714,46.5428571428571,23.2714285714286,3.94142857142857,401,0,0,35,80,337,401,337
2019,47,1,"Catalan",37.0687,35.2704,12.5142857142857,14.8285714285714,0,51.6857142857143,22.8385714285714,5.17142857142857,391,0,0,59,77,339,391,339
2019,48,1,"Catalan",37.0687,35.2704,17.1714285714286,15.3857142857143,2.621,71.6285714285714,20.26,4.58571428571429,320,0,0,35,48,251,320,251
2019,49,1,"Catalan",37.0687,35.2704,15,12.7142857142857,0.521714285714286,61.0142857142857,10.8857142857143,4.08142857142857,393,0,0,27,31,274,393,274
2019,50,1,"Catalan",37.0687,35.2704,21.0714285714286,12.3714285714286,11.0822857142857,78.9428571428571,9.87571428571429,3.21142857142857,218,0,0,31,8,119,218,119
2019,51,1,"Catalan",37.0687,35.2704,9.31428571428571,11.7571428571429,0,82.9571428571429,19.1057142857143,9.92571428571429,361,0,0,79,51,488,361,488
2019,52,1,"Catalan",37.0687,35.2704,19.5,10.6714285714286,38.1568571428571,85.9714285714286,9.67714285714286,4.72,279,0,0,60,49,281,279,281
2020,1,1,"Catalan",37.0687,35.2704,15.02,9.74,5.6432,78.06,8.732,4.792,160,0,0,13,6,126,160,126
2020,2,1,"Catalan",37.0687,35.2704,18.0571428571429,9.5,15.9802857142857,74.6428571428571,8.57571428571429,4.98714285714286,240,0,0,106,113,173,240,173
2020,3,1,"Catalan",37.0687,35.2704,17.3,9.77142857142857,0.535714285714286,65.5857142857143,11.3742857142857,6.75571428571429,270,0,0,61,39,382,270,382
2020,4,1,"Catalan",37.0687,35.2704,22.4428571428571,8.77142857142857,0,44,9.00285714285714,5.67571428571429,358,0,0,168,159,295,358,295
2020,5,1,"Catalan",37.0687,35.2704,13.7857142857143,10.2,3.23242857142857,71.2142857142857,15.6857142857143,7.29428571428571,331,3,3,49,63,272,328,269
2020,6,1,"Catalan",37.0687,35.2704,21.8714285714286,9.91428571428571,3.58385714285714,71.4857142857143,12.11,7.27428571428571,343,57,43,42,8,267,286,224
2020,7,1,"Catalan",37.0687,35.2704,25.5714285714286,6.64285714285714,0.186571428571429,51.6,9.73428571428571,6.42714285714286,341,0,0,20,8,338,341,338
2020,8,1,"Catalan",37.0687,35.2704,19.0142857142857,12.3428571428571,9.70528571428571,71.1,13.388,7.77,283,31,56,57,21,187,252,131
2020,9,1,"Catalan",37.0687,35.2704,14.8285714285714,13.0857142857143,6.19285714285714,74.6285714285714,11.6357142857143,6.10857142857143,393,45,15,43,52,528,348,513
2020,10,1,"Catalan",37.0687,35.2704,16.7571428571429,15.6714285714286,0,68.9714285714286,16.5542857142857,7.49857142857143,205,19,14,24,20,210,186,196
2020,11,1,"Catalan",37.0687,35.2704,22.0142857142857,17.7428571428571,2.90571428571429,65.5857142857143,24.2271428571429,7.26,115,16,1,25,40,94,99,93
2020,12,1,"Catalan",37.0687,35.2704,20.2714285714286,11.5285714285714,3.86428571428571,69.9,8.73,4.70285714285714,117,16,11,56,43,118,101,107
2020,13,1,"Catalan",37.0687,35.2704,23.4285714285714,16.2,0.469714285714286,70.4285714285714,15.4342857142857,6.53428571428571,136,12,6,22,11,92,124,86
2020,14,1,"Catalan",37.0687,35.2704,27.0714285714286,16.1714285714286,1.167,68.7857142857143,11.67,5.81857142857143,155,46,50,27,24,121,109,71
2020,15,1,"Catalan",37.0687,35.2704,19.5,16.5857142857143,0.527571428571428,79.6,19.6942857142857,7.96714285714286,133,61,29,2,0,118,72,89
2020,16,1,"Catalan",37.0687,35.2704,17.2142857142857,18.9571428571429,0.00142857142857143,64.3857142857143,18.2657142857143,13.3085714285714,141,27,26,40,36,106,114,80
2020,17,1,"Catalan",37.0687,35.2704,19.7,18.2428571428571,0.429714285714286,70.8,15.4528571428571,23.0257142857143,137,42,23,4,21,123,95,100
2020,18,1,"Catalan",37.0687,35.2704,19.6857142857143,18.5857142857143,7.16528571428571,81.9285714285714,15.1142857142857,23.8557142857143,146,57,37,1,1,164,89,127
2020,19,1,"Catalan",37.0687,35.2704,21.5,19.9142857142857,3.31014285714286,75.5714285714286,12.4614285714286,34.0671428571429,137,54,35,3,1,157,83,122
2020,20,1,"Catalan",37.0687,35.2704,18.1285714285714,25.9714285714286,0,57.8,NA,NA,164,32,37,20,11,164,132,127
2020,21,1,"Catalan",37.0687,35.2704,23.9285714285714,27.2428571428571,0.128285714285714,43.2142857142857,NA,NA,146,33,19,64,60,96,113,77
2020,22,1,"Catalan",37.0687,35.2704,22.0714285714286,22.1142857142857,0,57.2,NA,NA,118,45,45,15,4,100,73,55
2020,23,1,"Catalan",37.0687,35.2704,20.0428571428571,23.9571428571429,0,60.2428571428571,23.476,13.998,112,40,18,1,1,70,72,52
2020,24,1,"Catalan",37.0687,35.2704,22.2571428571429,24.0285714285714,2.59671428571429,73.5142857142857,21.3557142857143,13.14,140,40,24,0,0,150,100,126
2020,25,1,"Catalan",37.0687,35.2704,21.5142857142857,24.6,0.706285714285714,77.2714285714286,18.7014285714286,12.7128571428571,137,63,58,0,0,108,74,50
2020,26,1,"Catalan",37.0687,35.2704,21.1285714285714,26.2571428571429,0,75.1714285714286,20.9828571428571,14.2428571428571,173,67,69,0,0,133,106,64
2020,27,1,"Catalan",37.0687,35.2704,20.5428571428571,28.3,0,74.9,24.3542857142857,17.8742857142857,113,34,16,0,0,113,79,97
2020,28,1,"Catalan",37.0687,35.2704,20.4285714285714,28.4428571428571,0,76.8857142857143,23.4528571428571,24.8085714285714,164,59,50,0,0,122,105,72
2020,29,1,"Catalan",37.0687,35.2704,20.8857142857143,29,0,76.8428571428571,24.5385714285714,20.1242857142857,186,38,24,0,0,111,148,87
2020,30,1,"Catalan",37.0687,35.2704,19.3428571428571,29.6428571428571,0,75.5142857142857,26.89,23.18,190,72,65,0,0,142,118,77
2020,31,1,"Catalan",37.0687,35.2704,20.4285714285714,30.2,0,77.0714285714286,32.8,28.8614285714286,150,51,58,0,0,127,99,69
2020,32,1,"Catalan",37.0687,35.2704,23.7571428571429,29.7142857142857,0,75.0142857142857,27.508,27.4585714285714,146,63,53,0,0,107,83,54
2020,33,1,"Catalan",37.0687,35.2704,25.9857142857143,29.1142857142857,0.0997142857142857,67.8142857142857,26.8816666666667,13.1914285714286,183,44,28,0,0,83,139,55
2020,34,1,"Catalan",37.0687,35.2704,21.3571428571429,29.1857142857143,0.00457142857142857,64.3142857142857,27.3228571428571,13.0083333333333,197,61,49,27,7,97,136,48
2020,35,1,"Catalan",37.0687,35.2704,19.4714285714286,29.3714285714286,0,65.6428571428571,35.0728571428571,12.7183333333333,164,49,61,0,0,157,115,96
2020,36,1,"Catalan",37.0687,35.2704,17.7142857142857,30.9571428571429,0,69,42.88,18.954,179,81,58,0,0,112,98,54
2020,37,1,"Catalan",37.0687,35.2704,18.7,30.1428571428571,0,60.4428571428571,27.0916666666667,13.01,193,34,35,29,9,91,159,56
2020,38,1,"Catalan",37.0687,35.2704,18.5,28.8714285714286,0,76.6285714285714,31.7014285714286,14.2257142857143,235,129,114,0,0,157,106,43
2020,39,1,"Catalan",37.0687,35.2704,19.1428571428571,27.3285714285714,0.0408571428571428,72.9,27.02,5.11428571428571,220,158,102,0,0,129,62,27
2020,40,1,"Catalan",37.0687,35.2704,22.2285714285714,26.2428571428571,0,68.6428571428571,31.05,5.248,187,54,32,28,3,154,133,122
2020,41,1,"Catalan",37.0687,35.2704,18.9142857142857,26.6571428571429,0,48.5285714285714,34.5157142857143,19.6716666666667,182,18,7,23,14,127,164,120
2020,42,1,"Catalan",37.0687,35.2704,17.6285714285714,24.4857142857143,0,74.6857142857143,33.7242857142857,15.2271428571429,177,41,24,0,0,111,136,87
2020,43,1,"Catalan",37.0687,35.2704,14.6285714285714,24.9571428571429,0,54.8142857142857,28.2771428571429,11.6971428571429,194,3,5,36,37,161,191,156
2020,44,1,"Catalan",37.0687,35.2704,13.9857142857143,23.0142857142857,0,57.9714285714286,31.2385714285714,16.9375,255,77,42,0,0,233,178,191
2020,45,1,"Catalan",37.0687,35.2704,20.5285714285714,19.4857142857143,6.10657142857143,62.1285714285714,8.62142857142857,5.59428571428571,156,6,3,24,21,103,150,100
2020,46,1,"Catalan",37.0687,35.2704,12.6285714285714,17.8714285714286,0,54.3857142857143,17.13,7.27285714285714,208,0,0,53,24,109,208,109
2020,47,1,"Catalan",37.0687,35.2704,15.3571428571429,15.6571428571429,0.342714285714286,58.6571428571429,14.4128571428571,19.7642857142857,173,0,0,28,7,83,173,83
2020,48,1,"Catalan",37.0687,35.2704,15.4571428571429,13.1285714285714,0.160285714285714,54.6857142857143,12.5542857142857,18.4,199,0,0,44,35,262,199,262
2020,49,1,"Catalan",37.0687,35.2704,15.2857142857143,13.7571428571429,0.967,65.6,14.2785714285714,12.3483333333333,207,0,0,43,18,116,207,116
2020,50,1,"Catalan",37.0687,35.2704,17.6285714285714,14.0428571428571,1.29071428571429,68.1714285714286,14.5585714285714,13.2042857142857,181,0,0,32,22,98,181,98
2020,51,1,"Catalan",37.0687,35.2704,18.4428571428571,13.8428571428571,1.49342857142857,65.1714285714286,11.515,12.1914285714286,171,0,0,41,31,90,171,90
2020,52,1,"Catalan",37.0687,35.2704,15.9571428571429,11,0.0997142857142857,52.2714285714286,10.6457142857143,15.2714285714286,203,0,0,49,38,113,203,113
2020,53,1,"Catalan",37.0687,35.2704,11.875,11.6,0,51.975,10.68,52.26,122,0,0,10,12,111,122,111
2017,1,2,"Dogankent",36.8415,35.3705,18.7857142857143,9.4,5.42157142857143,77.6428571428571,12.99,24.0828571428571,563,66,79,76,156,847,497,768
2017,2,2,"Dogankent",36.8415,35.3705,17.8857142857143,8.2,2.22971428571429,66.0714285714286,14.6814285714286,22.5571428571429,757,25,16,101,193,1214,732,1198
2017,3,2,"Dogankent",36.8415,35.3705,15.4714285714286,9.51428571428571,0,56.4857142857143,25.3542857142857,30.3028571428571,762,0,0,173,569,1449,762,1449
2017,4,2,"Dogankent",36.8415,35.3705,22.3714285714286,8.02857142857143,0.123285714285714,43.8428571428571,17.7614285714286,31.15,639,0,0,109,150,889,639,889
2017,5,2,"Dogankent",36.8415,35.3705,20.1285714285714,6.05714285714286,0,45.0285714285714,30.1928571428571,NA,588,0,0,149,345,1163,588,1163
2017,6,2,"Dogankent",36.8415,35.3705,19.3428571428571,13.1285714285714,0.0474285714285714,54.7285714285714,27.1642857142857,NA,736,0,0,140,383,1519,736,1519
2017,7,2,"Dogankent",36.8415,35.3705,23.7857142857143,8.28571428571428,0,34.9285714285714,15.4728571428571,NA,492,0,0,144,297,717,492,717
2017,8,2,"Dogankent",36.8415,35.3705,16.0428571428571,11.7571428571429,0.0192857142857143,61.1571428571429,31.1514285714286,NA,739,229,635,112,209,1747,510,1112
2017,9,2,"Dogankent",36.8415,35.3705,20.2857142857143,15.0285714285714,4.05271428571429,55.1,21.378,10.43,574,0,0,172,207,866,574,866
2017,10,2,"Dogankent",36.8415,35.3705,19.9,15.2571428571429,5.37642857142857,65.3857142857143,29.9385714285714,16.78,712,29,87,69,114,1043,683,956
2017,11,2,"Dogankent",36.8415,35.3705,22.6,12.6714285714286,1.82528571428571,63.1,10.8371428571429,7.92,525,109,128,82,143,725,416,597
2017,12,2,"Dogankent",36.8415,35.3705,18.2857142857143,15.6571428571429,0.0168571428571429,66.2571428571429,16.1614285714286,8.75714285714286,589,242,532,110,183,1077,347,545
2017,13,2,"Dogankent",36.8415,35.3705,19.2571428571429,16.3571428571429,0.520714285714286,68.3571428571429,16.78,9.12857142857143,574,115,181,83,104,887,459,706
2017,14,2,"Dogankent",36.8415,35.3705,23.2,17.8142857142857,1.37757142857143,64.9428571428571,15.7742857142857,6.37285714285714,639,175,378,2,1,1336,464,958
2017,15,2,"Dogankent",36.8415,35.3705,22.3857142857143,16.5142857142857,5.81657142857143,65.8142857142857,11.6385714285714,6.97285714285714,587,70,77,21,175,1187,517,1110
2017,16,2,"Dogankent",36.8415,35.3705,20.8714285714286,18.4285714285714,0,70.0285714285714,18.5242857142857,8.15,717,149,302,59,91,920,568,618
2017,17,2,"Dogankent",36.8415,35.3705,15.7428571428571,20.3,0,47.5571428571429,24.9,9.65571428571429,731,26,21,75,225,1478,705,1457
2017,18,2,"Dogankent",36.8415,35.3705,22.9285714285714,20.4857142857143,1.21714285714286,73.0714285714286,37.0085714285714,4.97428571428571,506,138,439,13,16,923,368,484
2017,19,2,"Dogankent",36.8415,35.3705,19.5428571428571,22.3,0.013,68.9142857142857,46.2385714285714,6.77,471,167,353,2,2,966,304,613
2017,20,2,"Dogankent",36.8415,35.3705,19.3428571428571,21.6428571428571,2.47557142857143,65.2285714285714,36.2414285714286,9.42571428571429,472,118,324,96,143,1205,354,881
2017,21,2,"Dogankent",36.8415,35.3705,21.8285714285714,20.4,4.38142857142857,73.6428571428571,27.7871428571429,6.86,448,129,352,63,68,849,319,497
2017,22,2,"Dogankent",36.8415,35.3705,21.9285714285714,22.7714285714286,0.821571428571429,70.7571428571429,40.2328571428571,7.52428571428571,522,123,219,12,29,1015,399,796
2017,23,2,"Dogankent",36.8415,35.3705,20,25.5714285714286,0.0405714285714286,70.9571428571429,59.5714285714286,7.21,578,193,440,0,0,1388,385,948
2017,24,2,"Dogankent",36.8415,35.3705,21.1428571428571,25.1714285714286,3.894,72.9285714285714,40.2828571428571,7.05714285714286,552,270,610,0,0,1139,282,529
2017,25,2,"Dogankent",36.8415,35.3705,23.9571428571429,25.6,0.0682857142857143,67.6285714285714,40.8457142857143,5.95857142857143,584,188,339,0,0,1041,396,702
2017,26,2,"Dogankent",36.8415,35.3705,21.0285714285714,29.5285714285714,0,64.9285714285714,56.7566666666667,7.08285714285714,564,127,285,44,50,971,437,686
2017,27,2,"Dogankent",36.8415,35.3705,22.7857142857143,29.4,0,66.0285714285714,63.335,7.69857142857143,511,203,366,7,16,642,308,276
2017,28,2,"Dogankent",36.8415,35.3705,21.4428571428571,29.3571428571429,0,70.7571428571429,57.6757142857143,8.34714285714286,481,175,440,0,0,864,306,424
2017,29,2,"Dogankent",36.8415,35.3705,23.2285714285714,29.3428571428571,0,69.5571428571428,42.4485714285714,7.07857142857143,532,205,579,0,0,1272,327,693
2017,30,2,"Dogankent",36.8415,35.3705,24.4285714285714,29.7285714285714,0,67.4857142857143,64.3985714285714,6.51,531,301,633,0,0,928,230,295
2017,31,2,"Dogankent",36.8415,35.3705,24.1142857142857,29.4571428571429,0.035,69.9,36.1342857142857,6.11142857142857,559,221,609,0,0,1047,338,438
2017,32,2,"Dogankent",36.8415,35.3705,20.7571428571429,30.0142857142857,0,68.7571428571429,41.8985714285714,2.28857142857143,567,184,534,0,0,1092,383,558
2017,33,2,"Dogankent",36.8415,35.3705,22.1571428571429,29.3142857142857,0,70.2571428571429,47.1657142857143,1.74571428571429,596,209,746,0,0,1199,387,453
2017,34,2,"Dogankent",36.8415,35.3705,22.7428571428571,28.9857142857143,0,68.2428571428571,55.5257142857143,2.35428571428571,601,210,807,0,0,1280,391,473
2017,35,2,"Dogankent",36.8415,35.3705,23,28.5571428571429,0,69.3285714285714,43.3766666666667,1.81,493,172,505,0,0,1014,321,509
2017,36,2,"Dogankent",36.8415,35.3705,22.2142857142857,27.3714285714286,0.259428571428571,59.3571428571429,73.0366666666667,5.39333333333333,507,203,746,22,80,1321,304,575
2017,37,2,"Dogankent",36.8415,35.3705,19.8571428571429,28.0428571428571,0,71.6428571428571,57.1371428571429,4.06142857142857,589,189,615,0,0,1138,400,523
2017,38,2,"Dogankent",36.8415,35.3705,22.7714285714286,27.3428571428571,0.014,68.5,54.6042857142857,3.85142857142857,671,228,691,0,0,1312,443,621
2017,39,2,"Dogankent",36.8415,35.3705,23.1142857142857,25.0571428571429,0.439571428571429,66.9428571428572,49.6114285714286,4.90142857142857,782,395,932,1,10,1630,387,698
2017,40,2,"Dogankent",36.8415,35.3705,17.4428571428571,23.1285714285714,0.001,44.5714285714286,55.2185714285714,8.38142857142857,543,32,58,41,253,1137,511,1079
2017,41,2,"Dogankent",36.8415,35.3705,19.1428571428571,21.8,0.295571428571429,50.6285714285714,40.8728571428571,12.8357142857143,487,100,109,46,142,843,387,734
2017,42,2,"Dogankent",36.8415,35.3705,19.2571428571429,22.1142857142857,0,43.8714285714286,61.37,12.57,530,136,184,42,74,815,394,631
2017,43,2,"Dogankent",36.8415,35.3705,17.5285714285714,20.9,3.35414285714286,66.2571428571429,56.7871428571429,11.3171428571429,506,159,429,25,33,919,347,490
2017,44,2,"Dogankent",36.8415,35.3705,16.9714285714286,17.2571428571429,7.189,64.0857142857143,36.7285714285714,12.6942857142857,561,58,96,117,392,1102,503,1006
2017,45,2,"Dogankent",36.8415,35.3705,13.8142857142857,16.6571428571429,0.875142857142857,67.3,45.3871428571429,13.9814285714286,577,0,0,134,223,829,577,829
2017,46,2,"Dogankent",36.8415,35.3705,19.1714285714286,18.4571428571429,1.36442857142857,56.5428571428571,94.2914285714286,13.6814285714286,587,0,0,41,80,1085,587,1085
2017,47,2,"Dogankent",36.8415,35.3705,20.8142857142857,12.5142857142857,3.23885714285714,60.0857142857143,59.08,11.3528571428571,418,0,0,33,30,804,418,804
2017,48,2,"Dogankent",36.8415,35.3705,12.7571428571429,13.4857142857143,6.018,76.2857142857143,62.9071428571429,15.9728571428571,386,0,0,9,11,619,386,619
2017,49,2,"Dogankent",36.8415,35.3705,17.1285714285714,10.4714285714286,1.45471428571429,63.5857142857143,56.1542857142857,14.6885714285714,407,0,0,77,101,645,407,645
2017,50,2,"Dogankent",36.8415,35.3705,11.0285714285714,12.7571428571429,0.014,70.6714285714286,73.9342857142857,17.0828571428571,346,0,0,58,120,442,346,442
2017,51,2,"Dogankent",36.8415,35.3705,17.2714285714286,14.5571428571429,1.84857142857143,71.7571428571429,140.242857142857,12.9314285714286,386,21,21,41,63,349,365,328
2017,52,2,"Dogankent",36.8415,35.3705,15.85,11.4375,4.923,69.925,51.5825,15.04,528,0,0,94,80,507,528,507
2018,1,2,"Dogankent",36.8415,35.3705,16.6875,10.8375,18.081,74.05,39.5514285714286,11.8471428571429,618,0,0,85,108,914,618,914
2018,2,2,"Dogankent",36.8415,35.3705,14.8571428571429,11.2571428571429,0.781428571428571,69.7571428571429,66.8942857142857,14.29,624,0,0,67,80,1309,624,1309
2018,3,2,"Dogankent",36.8415,35.3705,17.1428571428571,9.88571428571429,6.23242857142857,70.5571428571428,42.6028571428571,12.3242857142857,639,16,4,195,175,655,623,651
2018,4,2,"Dogankent",36.8415,35.3705,21.1428571428571,9.48571428571429,15.971,75.0142857142857,51.73,12.4271428571429,604,0,0,290,413,764,604,764
2018,5,2,"Dogankent",36.8415,35.3705,11.3285714285714,10.0428571428571,0.00657142857142857,70.0285714285714,62.6871428571429,15.6671428571429,670,0,0,154,145,819,670,819
2018,6,2,"Dogankent",36.8415,35.3705,13.5,13.9285714285714,0,65.9,100.212857142857,16.7557142857143,704,0,0,106,106,1022,704,1022
2018,7,2,"Dogankent",36.8415,35.3705,23.5857142857143,14.2285714285714,0.779285714285714,67.0285714285714,33.0742857142857,12.1814285714286,478,102,99,64,102,557,376,458
2018,8,2,"Dogankent",36.8415,35.3705,16.5428571428571,13.8142857142857,2.81328571428571,69.5285714285714,44.6871428571429,14.0542857142857,711,159,363,58,37,1321,552,958
2018,9,2,"Dogankent",36.8415,35.3705,17.9285714285714,13.5285714285714,4.87542857142857,78.7857142857143,32.4128571428571,14.35,621,97,149,83,153,956,524,807
2018,10,2,"Dogankent",36.8415,35.3705,17.8857142857143,16.3,0.227428571428571,74.1857142857143,68.7971428571429,13.7285714285714,556,232,495,58,125,1330,324,835
2018,11,2,"Dogankent",36.8415,35.3705,19.3428571428571,16.0714285714286,0.146,74.2428571428571,34.2214285714286,12.2214285714286,551,210,699,5,6,1426,341,727
2018,12,2,"Dogankent",36.8415,35.3705,24.0571428571429,18.1142857142857,0.00114285714285714,64.6857142857143,84.5914285714286,14.12,425,139,372,7,7,1187,286,815
2018,13,2,"Dogankent",36.8415,35.3705,21,17.4857142857143,2.63885714285714,64.2285714285714,75.1642857142857,16.0642857142857,356,29,60,50,101,428,327,368
2018,14,2,"Dogankent",36.8415,35.3705,20.7285714285714,18.6428571428571,0.000428571428571429,51.4857142857143,49.6785714285714,19.3028571428571,407,17,35,60,40,486,390,451
2018,15,2,"Dogankent",36.8415,35.3705,20.0714285714286,18.1,3.79771428571429,79.1857142857143,30.4142857142857,20.7314285714286,374,21,43,22,29,450,353,407
2018,16,2,"Dogankent",36.8415,35.3705,20.8714285714286,19.3571428571429,0.123857142857143,53.6571428571429,44.1571428571429,24.2614285714286,411,92,181,88,100,648,319,467
2018,17,2,"Dogankent",36.8415,35.3705,18.8857142857143,21.8142857142857,0.293285714285714,61.3,77.3085714285714,26.1225,419,133,143,48,77,652,286,509
2018,18,2,"Dogankent",36.8415,35.3705,20.3285714285714,24.9857142857143,0.707,53.4,99.9114285714286,24.615,303,21,26,53,39,474,282,448
2018,19,2,"Dogankent",36.8415,35.3705,20.3857142857143,19.7571428571429,6.62771428571429,75.2571428571429,83.8814285714286,12.9314285714286,275,54,97,26,45,467,221,370
2018,20,2,"Dogankent",36.8415,35.3705,17.6428571428571,25.2571428571429,0.137142857142857,57.1571428571429,82.3514285714286,14.6185714285714,204,66,76,10,15,306,138,230
2018,21,2,"Dogankent",36.8415,35.3705,18.2,25.8,0.077,65.0428571428571,82.64,10.3,252,144,222,0,0,281,108,59
2018,22,2,"Dogankent",36.8415,35.3705,20.7428571428571,24.2,4.44928571428571,70.0285714285714,85.41,7.83428571428571,249,117,232,0,0,427,132,195
2018,23,2,"Dogankent",36.8415,35.3705,18.6857142857143,27.3142857142857,0,67.9428571428572,115.035714285714,5.96285714285714,267,100,371,13,90,812,167,441
2018,24,2,"Dogankent",36.8415,35.3705,23.4857142857143,25.6571428571429,2.43242857142857,73.3428571428571,151.34,3.79571428571429,267,92,311,7,12,448,175,137
2018,25,2,"Dogankent",36.8415,35.3705,22.5428571428571,25.5142857142857,1.81728571428571,73.1428571428571,NA,3.30428571428571,358,143,259,0,0,518,215,259
2018,26,2,"Dogankent",36.8415,35.3705,20.7428571428571,26.5857142857143,0.00328571428571429,70.7,NA,3.27428571428571,355,98,140,0,0,587,257,447
2018,27,2,"Dogankent",36.8415,35.3705,21.1571428571429,28.2,0,71.5428571428571,NA,3.78142857142857,342,114,230,0,0,418,228,188
2018,28,2,"Dogankent",36.8415,35.3705,21.4,28.6,0,71.7,31.998,17.9157142857143,286,101,273,0,0,585,185,312
2018,29,2,"Dogankent",36.8415,35.3705,24.7428571428571,29.0857142857143,0.0221428571428571,69.5285714285714,33.9142857142857,25.78,260,92,162,0,0,756,168,594
2018,30,2,"Dogankent",36.8415,35.3705,23.8428571428571,28.8142857142857,0.0681428571428571,70.8714285714286,35.0528571428571,27.2214285714286,265,100,149,0,0,822,165,673
2018,31,2,"Dogankent",36.8415,35.3705,24.2,29.1571428571429,0.0901428571428571,72.3428571428571,41.5833333333333,71.2585714285714,267,88,120,0,0,499,179,379
2018,32,2,"Dogankent",36.8415,35.3705,24.2714285714286,29.6285714285714,0.0215714285714286,65.1571428571429,51.574,91.195,297,96,179,0,0,403,201,224
2018,33,2,"Dogankent",36.8415,35.3705,22.8428571428571,28.8428571428571,0,68.6714285714286,38.7983333333333,NA,216,117,171,0,0,332,99,161
2018,34,2,"Dogankent",36.8415,35.3705,22.1,29.0428571428571,0,71.5,28.6571428571429,NA,144,65,114,0,0,227,79,113
2018,35,2,"Dogankent",36.8415,35.3705,21.5428571428571,28.8285714285714,0.0408571428571429,68.7571428571429,42.8371428571429,136.51,201,72,131,0,0,314,129,183
2018,36,2,"Dogankent",36.8415,35.3705,23.9,27.8428571428571,0.656714285714286,68.9285714285714,39.89,129.468333333333,341,147,226,0,0,370,194,144
2018,37,2,"Dogankent",36.8415,35.3705,19.4857142857143,26.8285714285714,0.0301428571428571,58.6285714285714,31.7785714285714,102.39,241,79,107,5,2,419,162,312
2018,38,2,"Dogankent",36.8415,35.3705,19.3571428571429,27.9857142857143,0,61.6857142857143,28.8957142857143,0.128,189,104,217,20,30,344,85,127
2018,39,2,"Dogankent",36.8415,35.3705,18.9714285714286,26.2428571428571,0.029,65.9857142857143,20.5842857142857,0.128571428571429,180,90,156,28,73,353,90,197
2018,40,2,"Dogankent",36.8415,35.3705,20.8,24.8285714285714,0.135142857142857,53.6428571428571,24.5657142857143,5.1,191,51,70,15,32,341,140,271
2018,41,2,"Dogankent",36.8415,35.3705,15.7857142857143,23.3428571428571,0.383285714285714,62.2571428571429,33.2342857142857,10.0942857142857,187,22,52,49,125,422,165,370
2018,42,2,"Dogankent",36.8415,35.3705,18.3,23.8857142857143,1.235,59.2714285714286,34.47,10.0585714285714,168,0,0,42,54,381,168,381
2018,43,2,"Dogankent",36.8415,35.3705,19.8285714285714,19.4714285714286,6.667,58.8857142857143,28.6628571428571,10.0157142857143,187,0,0,65,205,402,187,402
2018,44,2,"Dogankent",36.8415,35.3705,14.0428571428571,19.7,0.00685714285714286,50.4142857142857,25.6642857142857,8.85714285714286,196,0,0,29,29,264,196,264
2018,45,2,"Dogankent",36.8415,35.3705,14.3285714285714,18.4285714285714,0.663428571428571,65.4142857142857,23.5,6.95285714285714,231,29,57,8,4,473,202,416
2018,46,2,"Dogankent",36.8415,35.3705,21.4571428571429,14.8142857142857,1.06757142857143,52.8571428571429,27.14,6.96285714285714,230,0,0,63,196,465,230,465
2018,47,2,"Dogankent",36.8415,35.3705,14.5285714285714,15.5,0.975714285714286,68.8285714285714,27.8171428571429,6.98571428571429,270,0,0,84,301,499,270,499
2018,48,2,"Dogankent",36.8415,35.3705,16.9,15.1428571428571,3.83714285714286,76.8285714285714,24.1457142857143,6.98428571428571,245,0,0,50,90,201,245,201
2018,49,2,"Dogankent",36.8415,35.3705,17.5142857142857,13.9,10.0245714285714,75.3857142857143,20.0342857142857,7.00857142857143,257,0,0,72,225,420,257,420
2018,50,2,"Dogankent",36.8415,35.3705,22.3,12.8714285714286,6.20128571428571,69.1285714285714,15.7914285714286,6.95,256,20,53,15,13,305,236,252
2018,51,2,"Dogankent",36.8415,35.3705,16.4857142857143,11.9285714285714,11.9715714285714,80.9,15.1528571428571,6.98714285714286,250,0,0,56,47,248,250,248
2018,52,2,"Dogankent",36.8415,35.3705,17.7571428571429,9.77142857142857,7.76057142857143,67.2142857142857,13.2475,6.9725,244,0,0,68,148,273,244,273
2019,1,2,"Dogankent",36.8415,35.3705,20.325,10.3,20.538625,84.1,10.84,NA,343,52,124,53,88,784,291,660
2019,2,2,"Dogankent",36.8415,35.3705,18.7142857142857,7.68571428571429,2.50671428571429,64.8285714285714,14.875,6.99666666666667,255,0,0,36,81,208,255,208
2019,3,2,"Dogankent",36.8415,35.3705,22.3571428571429,8.58571428571429,12.4998571428571,64.3285714285714,15.3057142857143,7.01,192,20,12,46,76,198,172,186
2019,4,2,"Dogankent",36.8415,35.3705,19.4857142857143,11.5285714285714,1.073,64.1,16.0114285714286,NA,308,0,0,13,9,314,308,314
2019,5,2,"Dogankent",36.8415,35.3705,15.7142857142857,11.3571428571429,2.80214285714286,73.7857142857143,16.16,NA,253,0,0,42,32,143,253,143
2019,6,2,"Dogankent",36.8415,35.3705,23.8142857142857,11.2571428571429,7.93842857142857,71.9,15.2342857142857,NA,276,0,0,44,42,127,276,127
2019,7,2,"Dogankent",36.8415,35.3705,18.1571428571429,11.5,0.730142857142857,74.6,25.5628571428571,NA,325,14,7,7,2,234,311,227
2019,8,2,"Dogankent",36.8415,35.3705,15.1142857142857,12.3285714285714,0.706,74.3571428571429,26.3128571428571,NA,305,3,3,14,20,219,302,216
2019,9,2,"Dogankent",36.8415,35.3705,21.4285714285714,11.2857142857143,1.28542857142857,65.8714285714286,27.5414285714286,NA,331,1,0,85,138,310,330,310
2019,10,2,"Dogankent",36.8415,35.3705,18.5714285714286,12.8,1.618,70.2428571428571,14.58,NA,359,40,38,120,56,252,319,214
2019,11,2,"Dogankent",36.8415,35.3705,17.8285714285714,13.8571428571429,7.13628571428571,78.8,6.88,NA,373,150,98,36,43,400,223,302
2019,12,2,"Dogankent",36.8415,35.3705,19.9428571428571,15.5428571428571,0,59.1142857142857,7.65714285714286,NA,343,0,0,90,312,416,343,416
2019,13,2,"Dogankent",36.8415,35.3705,22.1571428571429,13.5571428571429,5.362,73.6571428571429,6.36857142857143,NA,256,61,25,78,55,194,195,169
2019,14,2,"Dogankent",36.8415,35.3705,16.3714285714286,15.2857142857143,2.655,76.2285714285714,5.86714285714286,NA,365,27,18,120,58,208,338,190
2019,15,2,"Dogankent",36.8415,35.3705,20.1,17.7428571428571,0.154857142857143,70.4285714285714,8.75714285714286,NA,359,96,63,18,10,183,263,120
2019,16,2,"Dogankent",36.8415,35.3705,21.8714285714286,13.9285714285714,4.95928571428571,75.9571428571429,5.97857142857143,NA,318,66,71,51,57,208,252,137
2019,17,2,"Dogankent",36.8415,35.3705,18.0571428571429,18.1142857142857,0.000428571428571429,54.8142857142857,9.84571428571429,NA,412,0,0,281,203,313,412,313
2019,18,2,"Dogankent",36.8415,35.3705,20.3714285714286,20.7714285714286,0.0824285714285714,65.5142857142857,11.7657142857143,NA,523,140,70,51,32,353,383,283
2019,19,2,"Dogankent",36.8415,35.3705,23.1,19.9714285714286,0.0267142857142857,61.9714285714286,9.27571428571428,NA,452,71,64,91,60,386,381,322
2019,20,2,"Dogankent",36.8415,35.3705,18.2714285714286,25.6142857142857,0,52.3428571428571,12.6971428571429,NA,454,103,78,41,41,389,351,311
2019,21,2,"Dogankent",36.8415,35.3705,17.5714285714286,24.4714285714286,0.0142857142857143,65.9714285714286,9.995,NA,457,167,114,10,4,413,290,299
2019,22,2,"Dogankent",36.8415,35.3705,18.0714285714286,27.0714285714286,0,58.3428571428571,10.7033333333333,NA,453,35,95,122,69,323,418,228
2019,23,2,"Dogankent",36.8415,35.3705,18.2571428571429,26.2285714285714,0.046,65.2,8.15142857142857,NA,378,222,206,62,133,532,156,326
2019,24,2,"Dogankent",36.8415,35.3705,22.2857142857143,25.4714285714286,1.89414285714286,72.6714285714286,7.04,NA,378,44,36,0,0,244,334,208
2019,25,2,"Dogankent",36.8415,35.3705,21.7428571428571,25.8285714285714,2.90585714285714,76.5285714285714,6.48428571428571,NA,306,99,179,0,0,325,207,146
2019,26,2,"Dogankent",36.8415,35.3705,19.9428571428571,28.8571428571429,0,72.6285714285714,7.74142857142857,NA,377,113,118,20,15,342,264,224
2019,27,2,"Dogankent",36.8415,35.3705,21.0142857142857,27.8428571428571,0,65.6428571428571,9.52714285714286,NA,456,197,123,4,2,222,259,99
2019,28,2,"Dogankent",36.8415,35.3705,22.0714285714286,27.8857142857143,0.349142857142857,73.9285714285714,12.5657142857143,NA,398,192,123,0,0,421,206,298
2019,29,2,"Dogankent",36.8415,35.3705,21.6285714285714,27.1285714285714,3.989,73.1428571428571,8.84,NA,453,66,68,0,0,203,387,135
2019,30,2,"Dogankent",36.8415,35.3705,21.9857142857143,28.7714285714286,0,71.8857142857143,9.45428571428571,NA,456,185,133,0,0,335,271,202
2019,31,2,"Dogankent",36.8415,35.3705,21.1,28.8428571428571,0,74.3428571428571,9.38571428571429,NA,334,139,156,0,0,375,195,219
2019,32,2,"Dogankent",36.8415,35.3705,23.1,29.0857142857143,0.0377142857142857,69.5285714285714,9.58714285714286,NA,346,61,83,0,0,395,285,312
2019,33,2,"Dogankent",36.8415,35.3705,22.1571428571429,29.0714285714286,0.0725714285714286,73.7857142857143,17.3714285714286,NA,337,51,53,0,0,531,286,478
2019,34,2,"Dogankent",36.8415,35.3705,20.9,28.8857142857143,0.017,63.8428571428571,27.9942857142857,NA,299,153,190,39,42,345,146,155
2019,35,2,"Dogankent",36.8415,35.3705,21.0285714285714,29.4285714285714,0.00742857142857143,72.7571428571429,37.5,NA,307,127,188,0,0,415,180,227
2019,36,2,"Dogankent",36.8415,35.3705,23.6428571428571,28.3,1.04528571428571,69.9714285714286,18.7671428571429,NA,171,82,47,0,0,67,89,20
2019,37,2,"Dogankent",36.8415,35.3705,23.4285714285714,27.6571428571429,0.150571428571429,63.8142857142857,18.7514285714286,NA,218,21,9,6,16,55,197,46
2019,38,2,"Dogankent",36.8415,35.3705,22.3,25.9428571428571,0.04,54.8285714285714,18.6971428571429,NA,266,24,7,41,11,91,242,84
2019,39,2,"Dogankent",36.8415,35.3705,19.4142857142857,25,0.00214285714285714,64.2571428571429,19.3014285714286,NA,237,66,30,4,3,79,171,49
2019,40,2,"Dogankent",36.8415,35.3705,21.8,24.9142857142857,0.0125714285714286,71.4571428571429,20.2885714285714,NA,241,64,71,0,0,111,177,40
2019,41,2,"Dogankent",36.8415,35.3705,16.6714285714286,24.5142857142857,1.707,60.5428571428571,14.1614285714286,NA,416,61,48,134,200,448,355,400
2019,42,2,"Dogankent",36.8415,35.3705,19.1857142857143,25.3142857142857,0.842714285714286,56.7285714285714,20.3442857142857,NA,356,69,76,98,159,408,287,332
2019,43,2,"Dogankent",36.8415,35.3705,19.8857142857143,22.9285714285714,0.0485714285714286,53.0857142857143,12.0357142857143,NA,306,1,10,88,155,300,305,290
2019,44,2,"Dogankent",36.8415,35.3705,18.0142857142857,18.9714285714286,1.96414285714286,70.4857142857143,6.92285714285714,NA,350,57,57,109,87,250,293,193
2019,45,2,"Dogankent",36.8415,35.3705,16.7857142857143,20.1571428571429,0,47.7714285714286,19.2514285714286,NA,417,0,0,141,210,328,417,328
2019,46,2,"Dogankent",36.8415,35.3705,15.4285714285714,20.0571428571429,0.478857142857143,46.0571428571429,23.0857142857143,NA,401,0,0,96,123,337,401,337
2019,47,2,"Dogankent",36.8415,35.3705,13.0714285714286,14.7142857142857,0,50.9142857142857,22.7257142857143,NA,391,0,0,101,124,339,391,339
2019,48,2,"Dogankent",36.8415,35.3705,17.4285714285714,15.3428571428571,2.64671428571429,71.4714285714286,14.2957142857143,NA,320,0,0,62,59,251,320,251
2019,49,2,"Dogankent",36.8415,35.3705,15.2571428571429,12.6,0.702714285714286,61,6.57571428571429,NA,393,0,0,41,40,274,393,274
2019,50,2,"Dogankent",36.8415,35.3705,20.9571428571429,12.2857142857143,10.7965714285714,79,6.01714285714286,NA,218,0,0,38,8,119,218,119
2019,51,2,"Dogankent",36.8415,35.3705,9.24285714285714,11.6857142857143,0,82.6285714285714,10.1757142857143,NA,361,0,0,100,71,488,361,488
2019,52,2,"Dogankent",36.8415,35.3705,19.6571428571429,10.6428571428571,40.1665714285714,85.7285714285714,9.70285714285714,NA,279,0,0,77,51,281,279,281
2020,1,2,"Dogankent",36.8415,35.3705,14.82,9.7,5.284,78.34,6.784,NA,160,0,0,21,12,126,160,126
2020,2,2,"Dogankent",36.8415,35.3705,17.8571428571429,9.42857142857143,15.4445714285714,75.0285714285714,9.88571428571429,NA,240,0,0,135,123,173,240,173
2020,3,2,"Dogankent",36.8415,35.3705,17.0714285714286,9.7,0.506714285714286,65.8142857142857,13.8514285714286,NA,270,0,0,75,58,382,270,382
2020,4,2,"Dogankent",36.8415,35.3705,22.4428571428571,8.61428571428571,0.00228571428571429,44.2142857142857,4.33714285714286,NA,358,0,0,198,179,295,358,295
2020,5,2,"Dogankent",36.8415,35.3705,13.7714285714286,10.1,3.24857142857143,71.9714285714286,3.51571428571429,NA,331,0,0,69,77,272,331,272
2020,6,2,"Dogankent",36.8415,35.3705,21.4714285714286,9.84285714285714,3.42371428571429,72.3428571428571,9.07714285714286,NA,343,58,43,48,8,267,285,224
2020,7,2,"Dogankent",36.8415,35.3705,25.5571428571429,6.55714285714286,0.228714285714286,51.7285714285714,14.0614285714286,NA,341,0,0,36,10,338,341,338
2020,8,2,"Dogankent",36.8415,35.3705,19.1571428571429,12.2428571428571,9.66414285714286,71.7142857142857,9.79285714285714,28.17,283,17,12,76,31,187,266,175
2020,9,2,"Dogankent",36.8415,35.3705,14.8285714285714,13,6.37985714285714,75.1428571428571,11.6642857142857,18.92,393,1,0,54,65,528,392,528
2020,10,2,"Dogankent",36.8415,35.3705,16.9285714285714,15.5428571428571,0.00671428571428571,69.4571428571429,12.2142857142857,9.90142857142857,205,12,12,31,21,210,193,198
2020,11,2,"Dogankent",36.8415,35.3705,21.8428571428571,17.7142857142857,3.04442857142857,65.9285714285714,16.6228571428571,7.20571428571429,115,14,1,32,50,94,101,93
2020,12,2,"Dogankent",36.8415,35.3705,19.8714285714286,11.4714285714286,3.63328571428571,70.8714285714286,5.57142857142857,7.18,117,16,11,59,43,118,101,107
2020,13,2,"Dogankent",36.8415,35.3705,23.1857142857143,16.1428571428571,0.911571428571429,70.9857142857143,NA,NA,136,15,9,32,12,92,121,83
2020,14,2,"Dogankent",36.8415,35.3705,26.8714285714286,16.1428571428571,1.15985714285714,69.5428571428571,NA,NA,155,46,50,32,28,121,109,71
2020,15,2,"Dogankent",36.8415,35.3705,19.5142857142857,16.5285714285714,0.736428571428571,80.1428571428571,NA,NA,133,61,21,6,0,118,72,97
2020,16,2,"Dogankent",36.8415,35.3705,16.7285714285714,18.8857142857143,0.006,64.9142857142857,NA,NA,141,28,16,52,39,106,113,90
2020,17,2,"Dogankent",36.8415,35.3705,19.2857142857143,18.1857142857143,0.847,71.3285714285714,NA,NA,137,46,35,6,22,123,91,88
2020,18,2,"Dogankent",36.8415,35.3705,20.0428571428571,18.5428571428571,7.54385714285714,82.5714285714286,6.05333333333333,7.18,146,58,39,13,18,164,88,125
2020,19,2,"Dogankent",36.8415,35.3705,21.1714285714286,19.8714285714286,3.20571428571429,75.8857142857143,6.46142857142857,7.17857142857143,137,62,51,6,2,157,75,106
2020,20,2,"Dogankent",36.8415,35.3705,18.3571428571429,25.8857142857143,0,57.8285714285714,10.92,7.39285714285714,164,34,38,45,48,164,130,126
2020,21,2,"Dogankent",36.8415,35.3705,23.7571428571429,27.1714285714286,0.191714285714286,43.1857142857143,15.5571428571429,6.30571428571429,146,12,9,64,48,96,134,87
2020,22,2,"Dogankent",36.8415,35.3705,22.0142857142857,22.0571428571429,0.00142857142857143,57.1571428571429,7.79142857142857,5.98142857142857,118,47,45,16,4,100,71,55
2020,23,2,"Dogankent",36.8415,35.3705,19.6428571428571,24,0.000714285714285714,59.9285714285714,11.44,7.34428571428571,112,38,19,3,2,70,74,51
2020,24,2,"Dogankent",36.8415,35.3705,21.5857142857143,24.0714285714286,1.94042857142857,73,9.70285714285714,4.94142857142857,140,49,32,2,3,150,91,118
2020,25,2,"Dogankent",36.8415,35.3705,21.6571428571429,24.6857142857143,0.789857142857143,76.6714285714286,8.96571428571429,5.33571428571429,137,65,65,0,0,108,72,43
2020,26,2,"Dogankent",36.8415,35.3705,21.1,26.3428571428571,0,74.6428571428571,10.9228571428571,5.79142857142857,173,75,75,0,0,133,98,58
2020,27,2,"Dogankent",36.8415,35.3705,20.3142857142857,28.4285714285714,0,74.1428571428571,12.3971428571429,6.98142857142857,113,38,19,0,0,113,75,94
2020,28,2,"Dogankent",36.8415,35.3705,20.4285714285714,28.5142857142857,0,76.2571428571429,13.7471428571429,10.8242857142857,164,69,92,0,0,122,95,30
2020,29,2,"Dogankent",36.8415,35.3705,20.9,29.1285714285714,0.000714285714285714,76.0285714285714,12.2666666666667,17.0333333333333,186,55,29,0,0,111,131,82
2020,30,2,"Dogankent",36.8415,35.3705,19.4285714285714,29.7428571428571,0,74.6,NA,NA,190,98,69,0,0,142,92,73
2020,31,2,"Dogankent",36.8415,35.3705,20.3142857142857,30.2714285714286,0,76.3714285714286,NA,NA,150,57,76,0,0,127,93,51
2020,32,2,"Dogankent",36.8415,35.3705,23.8714285714286,29.7571428571429,0.0537142857142857,74.3571428571429,NA,NA,146,67,56,0,0,107,79,51
2020,33,2,"Dogankent",36.8415,35.3705,27.1142857142857,29.1857142857143,0.0805714285714286,66.8,36.075,7.44833333333333,183,52,41,0,0,83,131,42
2020,34,2,"Dogankent",36.8415,35.3705,21.5571428571429,29.2285714285714,0.00985714285714286,63.6285714285714,32.3842857142857,5.41142857142857,197,65,49,27,7,97,132,48
2020,35,2,"Dogankent",36.8415,35.3705,19.5714285714286,29.4142857142857,0,64.7285714285714,44.248,7.04142857142857,164,61,69,2,2,157,103,88
2020,36,2,"Dogankent",36.8415,35.3705,17.6,30.9714285714286,0.000714285714285714,68.2142857142857,9.93,8.07571428571429,179,83,56,0,0,112,96,56
2020,37,2,"Dogankent",36.8415,35.3705,18.5571428571429,30.1857142857143,0,59.6571428571429,5.81333333333333,15.88,193,41,36,36,9,91,152,55
2020,38,2,"Dogankent",36.8415,35.3705,18.5714285714286,28.9142857142857,0,76,3.694,9.94,235,148,135,0,0,157,87,22
2020,39,2,"Dogankent",36.8415,35.3705,19.0428571428571,27.2857142857143,0.107285714285714,72.4428571428572,5.44333333333333,12.1557142857143,220,153,102,0,0,129,67,27
2020,40,2,"Dogankent",36.8415,35.3705,22.1,26.2142857142857,0,68.1142857142857,4.17833333333333,7.02714285714286,187,39,26,21,4,154,148,128
2020,41,2,"Dogankent",36.8415,35.3705,18.7571428571429,26.5571428571429,0,47.8285714285714,4.092,2.424,182,7,4,37,24,127,175,123
2020,42,2,"Dogankent",36.8415,35.3705,17.5285714285714,24.4428571428571,0,74.3285714285714,2.64857142857143,4.31857142857143,177,51,23,2,2,111,126,88
2020,43,2,"Dogankent",36.8415,35.3705,14.3571428571429,24.9428571428571,0,54.0857142857143,2.85285714285714,5.44714285714286,194,1,2,64,51,161,193,159
2020,44,2,"Dogankent",36.8415,35.3705,13.9857142857143,22.9714285714286,0,57.4142857142857,3.03714285714286,10.7771428571429,255,39,17,9,18,233,216,216
2020,45,2,"Dogankent",36.8415,35.3705,20.6714285714286,19.4,6.19842857142857,62.3428571428571,2.24285714285714,9.80285714285714,156,2,1,33,25,103,154,102
2020,46,2,"Dogankent",36.8415,35.3705,12.4,17.7714285714286,0,53.9714285714286,2.09142857142857,10.7566666666667,208,0,0,78,40,109,208,109
2020,47,2,"Dogankent",36.8415,35.3705,15.3142857142857,15.5285714285714,0.39,58.3714285714286,2.37571428571429,15.38,173,0,0,50,11,83,173,83
2020,48,2,"Dogankent",36.8415,35.3705,15.7571428571429,13.0857142857143,0.140857142857143,53.6714285714286,3.32428571428571,22.6366666666667,199,0,0,83,83,262,199,262
2020,49,2,"Dogankent",36.8415,35.3705,15.7,13.7285714285714,1.20985714285714,65.2285714285714,1.91857142857143,19.3442857142857,207,0,0,74,37,116,207,116
2020,50,2,"Dogankent",36.8415,35.3705,18.3714285714286,13.9714285714286,1.18342857142857,68,1.77428571428571,17.12,181,0,0,46,28,98,181,98
2020,51,2,"Dogankent",36.8415,35.3705,18.8714285714286,13.7285714285714,1.74642857142857,65.5142857142857,1.60142857142857,12.2525,171,0,0,63,38,90,171,90
2020,52,2,"Dogankent",36.8415,35.3705,16.5285714285714,10.9285714285714,0.099,51.8142857142857,1.64857142857143,12.9257142857143,203,0,0,85,41,113,203,113
2020,53,2,"Dogankent",36.8415,35.3705,11.8,11.55,0,51.175,1.9225,16.8875,122,0,0,32,27,111,122,111
2017,1,3,"Meteoroloji",37.0042,35.3499,19.3428571428571,9.34285714285714,5.33828571428571,77.9857142857143,61.6228571428571,19.3671428571429,563,68,79,54,114,847,495,768
2017,2,3,"Meteoroloji",37.0042,35.3499,18.3857142857143,8.12857142857143,2.03614285714286,66.2428571428571,50.6671428571429,21.4128571428571,757,25,16,76,100,1214,732,1198
2017,3,3,"Meteoroloji",37.0042,35.3499,16.0142857142857,9.45714285714286,0,56.1285714285714,100.917142857143,29.0842857142857,762,0,0,97,312,1449,762,1449
2017,4,3,"Meteoroloji",37.0042,35.3499,23.2571428571429,7.94285714285714,0.00214285714285714,43.7571428571429,73.8128571428571,18.5566666666667,639,0,0,91,114,889,639,889
2017,5,3,"Meteoroloji",37.0042,35.3499,20.5714285714286,5.95714285714286,0,44.8857142857143,103.151428571429,26.5616666666667,588,0,0,143,335,1163,588,1163
2017,6,3,"Meteoroloji",37.0042,35.3499,19.9285714285714,13.0714285714286,0.0421428571428571,54.7857142857143,96.962,21.9985714285714,736,0,0,110,313,1519,736,1519
2017,7,3,"Meteoroloji",37.0042,35.3499,24.6714285714286,8.21428571428571,0,34.6857142857143,55.5716666666667,18.04,492,0,0,129,270,717,492,717
2017,8,3,"Meteoroloji",37.0042,35.3499,16.3571428571429,11.6714285714286,0,61.1142857142857,27.4885714285714,21.66,739,199,598,91,187,1747,540,1149
2017,9,3,"Meteoroloji",37.0042,35.3499,20.9571428571429,14.9714285714286,3.75628571428571,55.1142857142857,99.8485714285714,20.1528571428571,574,0,0,150,189,866,574,866
2017,10,3,"Meteoroloji",37.0042,35.3499,20.6142857142857,15.2142857142857,5.674,65.6142857142857,97.85,18.0642857142857,712,31,97,28,42,1043,681,946
2017,11,3,"Meteoroloji",37.0042,35.3499,23.0714285714286,12.5857142857143,1.85757142857143,63.6571428571429,54.2485714285714,14.3742857142857,525,114,132,70,88,725,411,593
2017,12,3,"Meteoroloji",37.0042,35.3499,18.5142857142857,15.6,0.00785714285714286,66.6571428571429,69.4,23.17,589,240,530,66,131,1077,349,547
2017,13,3,"Meteoroloji",37.0042,35.3499,19.3285714285714,16.3285714285714,0.399285714285714,68.5285714285714,60.65,21.6614285714286,574,131,217,84,106,887,443,670
2017,14,3,"Meteoroloji",37.0042,35.3499,23.8285714285714,17.7714285714286,1.51414285714286,65.2714285714286,71.3814285714286,16.5885714285714,639,173,378,2,1,1336,466,958
2017,15,3,"Meteoroloji",37.0042,35.3499,23.2,16.4571428571429,5.61885714285714,66.3428571428571,61.9671428571429,24.4914285714286,587,93,110,14,155,1187,494,1077
2017,16,3,"Meteoroloji",37.0042,35.3499,21.1857142857143,18.3428571428571,0,70.3285714285714,102.157142857143,16.0328571428571,717,145,284,45,88,920,572,636
2017,17,3,"Meteoroloji",37.0042,35.3499,16.4285714285714,20.2285714285714,0,47.6285714285714,103.642857142857,13.7728571428571,731,27,21,48,131,1478,704,1457
2017,18,3,"Meteoroloji",37.0042,35.3499,23.3,20.4571428571429,1.41514285714286,73.2285714285714,105.788571428571,13.5771428571429,506,171,472,10,16,923,335,451
2017,19,3,"Meteoroloji",37.0042,35.3499,20.0571428571429,22.2571428571429,0.0157142857142857,69.0285714285714,88.7985714285714,11.8028571428571,471,152,336,2,2,966,319,630
2017,20,3,"Meteoroloji",37.0042,35.3499,19.6714285714286,21.6,2.514,64.9857142857143,67.3985714285714,17.68,472,117,332,106,145,1205,355,873
2017,21,3,"Meteoroloji",37.0042,35.3499,22.5571428571429,20.3285714285714,5.19028571428571,74,70.8828571428571,23.92,448,151,471,1,2,849,297,378
2017,22,3,"Meteoroloji",37.0042,35.3499,22.2571428571429,22.7,0.838571428571429,70.7857142857143,74.3957142857143,20.6728571428571,522,112,164,11,29,1015,410,851
2017,23,3,"Meteoroloji",37.0042,35.3499,20.4428571428571,25.5857142857143,0.005,70.6285714285714,88.0171428571429,16.4385714285714,578,190,449,4,2,1388,388,939
2017,24,3,"Meteoroloji",37.0042,35.3499,21.7,25.1428571428571,4.12528571428571,72.9142857142857,73.2228571428571,15.7328571428571,552,296,683,0,0,1139,256,456
2017,25,3,"Meteoroloji",37.0042,35.3499,24.4428571428571,25.5857142857143,0.000142857142857143,67.3714285714286,67.96,19.9233333333333,584,182,316,0,0,1041,402,725
2017,26,3,"Meteoroloji",37.0042,35.3499,21.9,29.5857142857143,0,64.4,82.3285714285714,18.1728571428571,564,146,323,39,37,971,418,648
2017,27,3,"Meteoroloji",37.0042,35.3499,23.4142857142857,29.4428571428571,0,65.4142857142857,85.9,15.78,511,198,360,7,16,642,313,282
2017,28,3,"Meteoroloji",37.0042,35.3499,22.1,29.3571428571429,0,70.5428571428571,77.7585714285714,14.23,481,175,467,0,0,864,306,397
2017,29,3,"Meteoroloji",37.0042,35.3499,23.9714285714286,29.3428571428571,0,69.2428571428571,84.2414285714286,14.2142857142857,532,192,549,0,0,1272,340,723
2017,30,3,"Meteoroloji",37.0042,35.3499,25.8714285714286,29.7285714285714,0,67.2285714285714,81.0314285714286,13.62,531,315,638,0,0,928,216,290
2017,31,3,"Meteoroloji",37.0042,35.3499,25.2285714285714,29.4571428571429,0.00428571428571429,69.6142857142857,75.3057142857143,13.9714285714286,559,218,601,0,0,1047,341,446
2017,32,3,"Meteoroloji",37.0042,35.3499,21.2571428571429,30.0285714285714,0,68.4285714285714,88.25,15.2185714285714,567,194,577,0,0,1092,373,515
2017,33,3,"Meteoroloji",37.0042,35.3499,22.6142857142857,29.3142857142857,0,69.9857142857143,94.8128571428571,11.4414285714286,596,201,734,0,0,1199,395,465
2017,34,3,"Meteoroloji",37.0042,35.3499,23.2571428571429,28.9571428571429,0,68.0571428571429,114.93,15.0014285714286,601,203,795,0,0,1280,398,485
2017,35,3,"Meteoroloji",37.0042,35.3499,23.4714285714286,28.5428571428571,0,69.2142857142857,90.5942857142857,10.8414285714286,493,163,488,0,0,1014,330,526
2017,36,3,"Meteoroloji",37.0042,35.3499,22.7285714285714,27.3285714285714,0.212,59.2142857142857,103.69,19.11,507,226,776,18,54,1321,281,545
2017,37,3,"Meteoroloji",37.0042,35.3499,20.2857142857143,28,0,71.6,NA,16.8628571428571,589,188,608,0,0,1138,401,530
2017,38,3,"Meteoroloji",37.0042,35.3499,23.1285714285714,27.3142857142857,0.00785714285714286,68.3428571428571,88.65,17.2871428571429,671,232,689,0,0,1312,439,623
2017,39,3,"Meteoroloji",37.0042,35.3499,23.5285714285714,24.9857142857143,0.307571428571429,66.9428571428571,87.9785714285714,22.0328571428571,782,412,954,0,0,1630,370,676
2017,40,3,"Meteoroloji",37.0042,35.3499,17.9571428571429,23.0285714285714,0.000142857142857143,44.4428571428571,74.6728571428571,28.1614285714286,543,38,81,37,216,1137,505,1056
2017,41,3,"Meteoroloji",37.0042,35.3499,19.7857142857143,21.7,0.223857142857143,50.6142857142857,71.2171428571429,29.5014285714286,487,115,114,29,86,843,372,729
2017,42,3,"Meteoroloji",37.0042,35.3499,19.9714285714286,22.1,0,43.6142857142857,89.3071428571429,31.9728571428571,530,138,184,46,94,815,392,631
2017,43,3,"Meteoroloji",37.0042,35.3499,17.8857142857143,20.8714285714286,3.58514285714286,66.3714285714286,101.258571428571,30.7628571428571,506,191,468,22,33,919,315,451
2017,44,3,"Meteoroloji",37.0042,35.3499,17.5285714285714,17.2142857142857,7.42514285714286,64.3142857142857,71.4685714285714,34.5314285714286,561,58,96,95,350,1102,503,1006
2017,45,3,"Meteoroloji",37.0042,35.3499,14.1571428571429,16.6,0.932142857142857,67.4142857142857,92.0328571428571,36.18,577,0,0,120,211,829,577,829
2017,46,3,"Meteoroloji",37.0042,35.3499,19.7857142857143,18.3857142857143,1.12842857142857,56.6142857142857,142.765714285714,35.2357142857143,587,0,0,22,42,1085,587,1085
2017,47,3,"Meteoroloji",37.0042,35.3499,21.6428571428571,12.4285714285714,3.40571428571429,60.3142857142857,150.213333333333,34.1257142857143,418,0,0,28,25,804,418,804
2017,48,3,"Meteoroloji",37.0042,35.3499,13.0285714285714,13.4,6.50414285714286,76.6,126.147142857143,30.9728571428571,386,0,0,6,7,619,386,619
2017,49,3,"Meteoroloji",37.0042,35.3499,17.7285714285714,10.3857142857143,1.406,63.8571428571429,113.831428571429,38.36,407,0,0,59,90,645,407,645
2017,50,3,"Meteoroloji",37.0042,35.3499,11.1142857142857,12.6571428571429,0.0157142857142857,71.0571428571429,128.022857142857,37.7057142857143,346,0,0,53,119,442,346,442
2017,51,3,"Meteoroloji",37.0042,35.3499,17.7857142857143,14.4857142857143,1.949,72.1285714285714,204.885714285714,27.82,386,16,21,37,59,349,370,328
2017,52,3,"Meteoroloji",37.0042,35.3499,16.475,11.325,5.08425,70.3875,117.05875,32.03375,528,0,0,88,57,507,528,507
2018,1,3,"Meteoroloji",37.0042,35.3499,17.3875,10.7625,18.743625,74.0375,115.39625,34.13875,618,0,0,73,81,914,618,914
2018,2,3,"Meteoroloji",37.0042,35.3499,15.2142857142857,11.1714285714286,0.689857142857143,69.9,144.355714285714,33.24,624,0,0,32,34,1309,624,1309
2018,3,3,"Meteoroloji",37.0042,35.3499,17.7,9.8,6.24457142857143,70.6285714285714,101.972857142857,27.6742857142857,639,16,4,145,102,655,623,651
2018,4,3,"Meteoroloji",37.0042,35.3499,21.8571428571429,9.42857142857143,16.1842857142857,75.1,99.6714285714286,22.1071428571429,604,0,0,256,372,764,604,764
2018,5,3,"Meteoroloji",37.0042,35.3499,11.5857142857143,9.95714285714286,0.00785714285714286,70.4285714285714,146.022857142857,35.3657142857143,670,0,0,114,99,819,670,819
2018,6,3,"Meteoroloji",37.0042,35.3499,14.1285714285714,13.8571428571429,0,66.1857142857143,NA,28.22,704,0,0,75,57,1022,704,1022
2018,7,3,"Meteoroloji",37.0042,35.3499,24.2,14.1571428571429,0.763142857142857,67.3428571428571,94.63,22.2257142857143,478,103,99,46,73,557,375,458
2018,8,3,"Meteoroloji",37.0042,35.3499,16.9285714285714,13.7857142857143,2.90442857142857,69.7285714285714,91.9,25.8928571428571,711,127,229,43,28,1321,584,1092
2018,9,3,"Meteoroloji",37.0042,35.3499,18.2857142857143,13.4714285714286,5.06342857142857,79.1285714285714,106.421428571429,30.2357142857143,621,128,160,62,141,956,493,796
2018,10,3,"Meteoroloji",37.0042,35.3499,18.2428571428571,16.2571428571429,0.247571428571429,74.3857142857143,137.078571428571,27.21,556,224,497,42,62,1330,332,833
2018,11,3,"Meteoroloji",37.0042,35.3499,19.7,16.0428571428571,0.0775714285714286,74.4857142857143,98.1,27.2828571428571,551,213,686,1,0,1426,338,740
2018,12,3,"Meteoroloji",37.0042,35.3499,24.4714285714286,18.0428571428571,0,65.0428571428571,143.837142857143,16.51,425,165,528,6,6,1187,260,659
2018,13,3,"Meteoroloji",37.0042,35.3499,21.3285714285714,17.4142857142857,2.69128571428571,64.5,130.281428571429,14.43,356,44,79,29,86,428,312,349
2018,14,3,"Meteoroloji",37.0042,35.3499,21.3571428571429,18.5428571428571,0,51.5285714285714,90.8242857142857,21.4,407,17,34,49,24,486,390,452
2018,15,3,"Meteoroloji",37.0042,35.3499,20.7285714285714,18.0571428571429,3.82371428571429,79.3857142857143,87.78,17.0785714285714,374,21,43,16,28,450,353,407
2018,16,3,"Meteoroloji",37.0042,35.3499,21.4714285714286,19.2857142857143,0.033,53.7428571428571,91.2571428571429,19.6971428571429,411,96,184,78,98,648,315,464
2018,17,3,"Meteoroloji",37.0042,35.3499,19.2,21.7571428571429,0.301285714285714,61.4428571428571,113.727142857143,12.7957142857143,419,123,131,51,82,652,296,521
2018,18,3,"Meteoroloji",37.0042,35.3499,21.1,24.8857142857143,0.774428571428571,53.5857142857143,117.258333333333,7.79285714285714,303,19,25,8,7,474,284,449
2018,19,3,"Meteoroloji",37.0042,35.3499,21.1571428571429,19.6714285714286,7.18614285714286,75.6857142857143,78.07,10.54,275,92,111,15,20,467,183,356
2018,20,3,"Meteoroloji",37.0042,35.3499,17.8571428571429,25.1857142857143,0.163571428571429,57.3142857142857,70.6283333333333,8.75142857142857,204,79,114,2,0,306,125,192
2018,21,3,"Meteoroloji",37.0042,35.3499,18.8428571428571,25.8,0.00971428571428571,64.7857142857143,81.2333333333333,4.81285714285714,252,150,222,0,0,281,102,59
2018,22,3,"Meteoroloji",37.0042,35.3499,21.3142857142857,24.1285714285714,4.56914285714286,70.0571428571429,66.888,5.76857142857143,249,134,267,0,0,427,115,160
2018,23,3,"Meteoroloji",37.0042,35.3499,19.0714285714286,27.3285714285714,0,67.8857142857143,62.18,4.59142857142857,267,102,469,18,91,812,165,343
2018,24,3,"Meteoroloji",37.0042,35.3499,23.8142857142857,25.6428571428571,2.392,73.1857142857143,NA,1.95142857142857,267,88,300,5,11,448,179,148
2018,25,3,"Meteoroloji",37.0042,35.3499,23.1,25.5,1.712,72.9142857142857,55.556,2.27714285714286,358,143,259,0,0,518,215,259
2018,26,3,"Meteoroloji",37.0042,35.3499,21.2428571428571,26.5857142857143,0,70.3857142857143,59.235,1.28,355,95,137,0,0,587,260,450
2018,27,3,"Meteoroloji",37.0042,35.3499,21.8714285714286,28.2,0,71.2571428571429,66.2371428571429,3.555,342,114,230,0,0,418,228,188
2018,28,3,"Meteoroloji",37.0042,35.3499,22.0428571428571,28.6285714285714,0,71.3428571428571,65.5871428571429,3.83166666666667,286,97,267,0,0,585,189,318
2018,29,3,"Meteoroloji",37.0042,35.3499,25.3857142857143,29.1,0,69.1857142857143,64.2442857142857,5.26,260,94,162,0,0,756,166,594
2018,30,3,"Meteoroloji",37.0042,35.3499,24.4714285714286,28.8142857142857,0,70.6285714285714,65.4471428571429,3.1875,265,98,149,0,0,822,167,673
2018,31,3,"Meteoroloji",37.0042,35.3499,24.7285714285714,29.1571428571429,0.000285714285714286,71.9428571428571,73.8528571428571,4.772,267,92,120,0,0,499,175,379
2018,32,3,"Meteoroloji",37.0042,35.3499,24.6428571428571,29.6428571428571,0,64.7857142857143,78.76,NA,297,95,169,0,0,403,202,234
2018,33,3,"Meteoroloji",37.0042,35.3499,23.3571428571429,28.7857142857143,0,68.4428571428571,80.6814285714286,5.8975,216,125,171,0,0,332,91,161
2018,34,3,"Meteoroloji",37.0042,35.3499,22.6285714285714,29.0285714285714,0,71.2142857142857,85.546,5.26,144,62,114,0,0,227,82,113
2018,35,3,"Meteoroloji",37.0042,35.3499,21.9428571428571,28.8,0,68.5285714285714,84.13,7.26142857142857,201,73,132,0,0,314,128,182
2018,36,3,"Meteoroloji",37.0042,35.3499,24.5714285714286,27.7571428571429,0.64,68.8857142857143,84.646,9.41857142857143,341,169,247,0,0,370,172,123
2018,37,3,"Meteoroloji",37.0042,35.3499,19.8571428571429,26.8142857142857,0,58.5428571428571,79.4071428571429,17.83,241,80,114,4,2,419,161,305
2018,38,3,"Meteoroloji",37.0042,35.3499,19.7714285714286,27.9428571428571,0,61.5285714285714,79.7314285714286,19.5766666666667,189,103,216,19,30,344,86,128
2018,39,3,"Meteoroloji",37.0042,35.3499,19.5714285714286,26.1714285714286,0.0228571428571429,66.0285714285714,86.1657142857143,12.8242857142857,180,88,158,18,71,353,92,195
2018,40,3,"Meteoroloji",37.0042,35.3499,21.9714285714286,24.7714285714286,0.157714285714286,53.3857142857143,79.4142857142857,20.9485714285714,191,53,65,16,46,341,138,276
2018,41,3,"Meteoroloji",37.0042,35.3499,16.1428571428571,23.2571428571429,0.285142857142857,62.1285714285714,139.764285714286,27.1071428571429,187,45,109,34,117,422,142,313
2018,42,3,"Meteoroloji",37.0042,35.3499,18.9714285714286,23.8714285714286,1.07257142857143,59.1142857142857,167.768571428571,24.8885714285714,168,1,0,34,46,381,167,381
2018,43,3,"Meteoroloji",37.0042,35.3499,20.0857142857143,19.4,6.35642857142857,58.9,81.3557142857143,17.91,187,0,0,61,200,402,187,402
2018,44,3,"Meteoroloji",37.0042,35.3499,14.3571428571429,19.6285714285714,0.00642857142857143,50.4142857142857,106.777142857143,34.8671428571429,196,0,0,32,32,264,196,264
2018,45,3,"Meteoroloji",37.0042,35.3499,14.5714285714286,18.4142857142857,0.590285714285714,65.7142857142857,81.73,27.0814285714286,231,29,57,7,4,473,202,416
2018,46,3,"Meteoroloji",37.0042,35.3499,22.4142857142857,14.7285714285714,1.08485714285714,52.9285714285714,82.0571428571428,27.3214285714286,230,0,0,56,158,465,230,465
2018,47,3,"Meteoroloji",37.0042,35.3499,15.0857142857143,15.4428571428571,0.827285714285714,68.9,121.125,35.8814285714286,270,0,0,87,317,499,270,499
2018,48,3,"Meteoroloji",37.0042,35.3499,17.4714285714286,15.0571428571429,3.89657142857143,77.0857142857143,74.7233333333333,26.1214285714286,245,0,0,45,83,201,245,201
2018,49,3,"Meteoroloji",37.0042,35.3499,18.0285714285714,13.8428571428571,9.53542857142857,75.4857142857143,70.1685714285714,24.2142857142857,257,0,0,69,225,420,257,420
2018,50,3,"Meteoroloji",37.0042,35.3499,22.9285714285714,12.8142857142857,6.40557142857143,69.3,84.0157142857143,28.2857142857143,256,29,58,14,43,305,227,247
2018,51,3,"Meteoroloji",37.0042,35.3499,17.0285714285714,11.8714285714286,12.0768571428571,80.9857142857143,93.2157142857143,31.6171428571429,250,0,0,51,36,248,250,248
2018,52,3,"Meteoroloji",37.0042,35.3499,18.4857142857143,9.7,7.63,67.3142857142857,113.866666666667,28.4557142857143,244,0,0,61,146,273,244,273
2019,1,3,"Meteoroloji",37.0042,35.3499,20.8625,10.2375,20.987,84.2375,109.28125,40.49125,343,52,124,42,68,784,291,660
2019,2,3,"Meteoroloji",37.0042,35.3499,19.3571428571429,7.61428571428571,2.55085714285714,65.1857142857143,119.07,31.55,255,0,0,29,72,208,255,208
2019,3,3,"Meteoroloji",37.0042,35.3499,22.8285714285714,8.48571428571429,13.0172857142857,64.6857142857143,100.314285714286,25.8942857142857,192,24,12,44,61,198,168,186
2019,4,3,"Meteoroloji",37.0042,35.3499,20.1428571428571,11.4285714285714,0.981428571428571,64.6571428571429,153.668571428571,29.1814285714286,308,0,0,5,7,314,308,314
2019,5,3,"Meteoroloji",37.0042,35.3499,16.2,11.3,2.70471428571429,74.4,141.221428571429,32.7571428571429,253,0,0,20,15,143,253,143
2019,6,3,"Meteoroloji",37.0042,35.3499,24.3,11.2142857142857,7.72785714285714,72.4,72.3757142857143,24.0242857142857,276,0,0,38,40,127,276,127
2019,7,3,"Meteoroloji",37.0042,35.3499,18.6,11.4285714285714,0.705,75.0714285714286,122.818571428571,NA,325,31,98,4,0,234,294,136
2019,8,3,"Meteoroloji",37.0042,35.3499,15.4142857142857,12.2428571428571,0.695857142857143,74.9714285714286,104.555714285714,0.865,305,10,4,9,18,219,295,215
2019,9,3,"Meteoroloji",37.0042,35.3499,21.7285714285714,11.2,1.284,66.4857142857143,86.7571428571429,0.87,331,55,25,43,108,310,276,285
2019,10,3,"Meteoroloji",37.0042,35.3499,18.9571428571429,12.7428571428571,1.44714285714286,70.7142857142857,95.1585714285714,NA,359,44,45,115,56,252,315,207
2019,11,3,"Meteoroloji",37.0042,35.3499,18.0714285714286,13.8285714285714,6.746,79.2714285714286,91.96,NA,373,198,112,31,41,400,175,288
2019,12,3,"Meteoroloji",37.0042,35.3499,20.2142857142857,15.4857142857143,0,59.3,90.5066666666667,NA,343,31,11,64,303,416,312,405
2019,13,3,"Meteoroloji",37.0042,35.3499,22.6857142857143,13.5,5.44757142857143,74.3428571428571,61.055,NA,256,67,27,78,53,194,189,167
2019,14,3,"Meteoroloji",37.0042,35.3499,16.7428571428571,15.2142857142857,2.63471428571429,76.7,60.5285714285714,NA,365,38,19,111,51,208,327,189
2019,15,3,"Meteoroloji",37.0042,35.3499,20.3,17.6428571428571,0.0794285714285714,71.1,71.692,NA,359,132,70,2,0,183,227,113
2019,16,3,"Meteoroloji",37.0042,35.3499,21.9857142857143,13.8428571428571,4.854,76.6142857142857,52.0816666666667,29.616,318,67,71,45,35,208,251,137
2019,17,3,"Meteoroloji",37.0042,35.3499,18.2714285714286,18.0285714285714,0,55.2714285714286,87.1657142857143,28.5285714285714,412,0,0,256,197,313,412,313
2019,18,3,"Meteoroloji",37.0042,35.3499,20.8714285714286,20.7142857142857,0.0917142857142857,65.9714285714286,109.328571428571,21.745,523,142,70,40,29,353,381,283
2019,19,3,"Meteoroloji",37.0042,35.3499,23.6857142857143,19.9142857142857,0.00714285714285714,62.2142857142857,84.2542857142857,18.4083333333333,452,70,63,93,63,386,382,323
2019,20,3,"Meteoroloji",37.0042,35.3499,18.5857142857143,25.6,0,52.2142857142857,97.0228571428571,18.204,454,103,78,34,41,389,351,311
2019,21,3,"Meteoroloji",37.0042,35.3499,17.9571428571429,24.4714285714286,0.0128571428571429,65.8714285714286,93.034,15.246,457,207,184,7,4,413,250,229
2019,22,3,"Meteoroloji",37.0042,35.3499,18.2571428571429,27.1,0,58.0142857142857,129.891428571429,33.7866666666667,453,40,95,146,95,323,413,228
2019,23,3,"Meteoroloji",37.0042,35.3499,18.5142857142857,26.2428571428571,0.0127142857142857,65.0714285714286,119.39,NA,378,282,338,0,0,532,96,194
2019,24,3,"Meteoroloji",37.0042,35.3499,22.7285714285714,25.4714285714286,1.73557142857143,72.5857142857143,97.5928571428571,18.92,378,51,37,0,0,244,327,207
2019,25,3,"Meteoroloji",37.0042,35.3499,22.2,25.8285714285714,2.985,76.6,82.85,17.7925,306,94,179,0,0,325,212,146
2019,26,3,"Meteoroloji",37.0042,35.3499,20.4428571428571,28.8857142857143,0,72.3285714285714,62.3171428571429,11.1783333333333,377,109,118,11,15,342,268,224
2019,27,3,"Meteoroloji",37.0042,35.3499,21.7285714285714,27.8285714285714,0,65.4,42.892,12.3514285714286,456,207,124,4,2,222,249,98
2019,28,3,"Meteoroloji",37.0042,35.3499,22.6857142857143,27.8571428571429,0.26,73.7714285714286,42.9857142857143,9.80571428571429,398,212,138,0,0,421,186,283
2019,29,3,"Meteoroloji",37.0042,35.3499,22.1,27.1142857142857,4.15742857142857,73.2,36.4414285714286,13.2357142857143,453,118,76,0,0,203,335,127
2019,30,3,"Meteoroloji",37.0042,35.3499,22.5428571428571,28.7285714285714,0,71.8714285714286,39.13,25.0914285714286,456,193,135,0,0,335,263,200
2019,31,3,"Meteoroloji",37.0042,35.3499,21.4857142857143,28.8571428571429,0,74.1,41.3371428571429,25.0157142857143,334,135,155,0,0,375,199,220
2019,32,3,"Meteoroloji",37.0042,35.3499,23.6571428571429,29.0571428571429,0.00428571428571429,69.3428571428571,44.6642857142857,27.14,346,65,86,0,0,395,281,309
2019,33,3,"Meteoroloji",37.0042,35.3499,22.6714285714286,29.0571428571429,0.0785714285714286,73.7,36.4714285714286,24.98,337,50,53,0,0,531,287,478
2019,34,3,"Meteoroloji",37.0042,35.3499,21.4285714285714,28.8428571428571,0,63.8142857142857,43.8314285714286,30.7885714285714,299,155,192,39,42,345,144,153
2019,35,3,"Meteoroloji",37.0042,35.3499,21.6428571428571,29.4,0,72.7142857142857,47.8857142857143,30.4385714285714,307,124,188,0,0,415,183,227
2019,36,3,"Meteoroloji",37.0042,35.3499,24.1,28.2857142857143,0.955,69.7428571428571,50.6885714285714,31.9371428571429,171,81,47,0,0,67,90,20
2019,37,3,"Meteoroloji",37.0042,35.3499,23.8142857142857,27.6285714285714,0.0254285714285714,63.7714285714286,43.794,34.2685714285714,218,25,9,3,12,55,193,46
2019,38,3,"Meteoroloji",37.0042,35.3499,22.8571428571429,25.9,0,54.7571428571429,42.1914285714286,33.5171428571429,266,58,19,16,4,91,208,72
2019,39,3,"Meteoroloji",37.0042,35.3499,19.9,24.9285714285714,0,64.1428571428571,41.478,36.2614285714286,237,64,34,21,4,79,173,45
2019,40,3,"Meteoroloji",37.0042,35.3499,22.1857142857143,24.8428571428571,0,71.6,NA,34.72,241,61,70,0,0,111,180,41
2019,41,3,"Meteoroloji",37.0042,35.3499,16.9857142857143,24.4428571428571,1.99214285714286,60.8,95.56,42.5157142857143,416,55,45,110,185,448,361,403
2019,42,3,"Meteoroloji",37.0042,35.3499,19.4714285714286,25.2142857142857,0.812285714285714,57,120.482857142857,50.2171428571429,356,55,30,94,159,408,301,378
2019,43,3,"Meteoroloji",37.0042,35.3499,20.5142857142857,22.8571428571429,0.00642857142857143,53.1714285714286,79.4528571428571,47.6885714285714,306,0,0,43,70,300,306,300
2019,44,3,"Meteoroloji",37.0042,35.3499,18.7142857142857,18.9142857142857,1.717,70.6142857142857,71.6685714285714,51.9985714285714,350,55,57,105,87,250,295,193
2019,45,3,"Meteoroloji",37.0042,35.3499,18.0142857142857,20.0571428571429,0,47.9571428571429,87.6185714285714,57.8528571428571,417,0,0,142,208,328,417,328
2019,46,3,"Meteoroloji",37.0042,35.3499,15.8285714285714,19.9571428571429,0.463714285714286,46.1,105.432857142857,62.5671428571429,401,0,0,64,88,337,401,337
2019,47,3,"Meteoroloji",37.0042,35.3499,13.8,14.5857142857143,0,50.8428571428571,116.545714285714,79.3428571428571,391,0,0,80,100,339,391,339
2019,48,3,"Meteoroloji",37.0042,35.3499,18,15.2428571428571,2.67257142857143,71.9142857142857,118.263333333333,72.8185714285714,320,0,0,49,53,251,320,251
2019,49,3,"Meteoroloji",37.0042,35.3499,15.8428571428571,12.4857142857143,0.490428571428571,61.1714285714286,89.1042857142857,69.4728571428571,393,0,0,34,38,274,393,274
2019,50,3,"Meteoroloji",37.0042,35.3499,21.5142857142857,12.2285714285714,10.9102857142857,79.5714285714286,50.6066666666667,54.5828571428571,218,0,0,33,8,119,218,119
2019,51,3,"Meteoroloji",37.0042,35.3499,9.47142857142857,11.5714285714286,0,83.0285714285714,129.2575,85.6342857142857,361,0,0,84,50,488,361,488
2019,52,3,"Meteoroloji",37.0042,35.3499,20.1857142857143,10.5857142857143,43.0917142857143,86.2428571428571,85.4685714285714,65.2314285714286,279,0,0,62,49,281,279,281
2020,1,3,"Meteoroloji",37.0042,35.3499,15.18,9.62,5.0764,78.98,94.5,50.64,160,0,0,19,10,126,160,126
2020,2,3,"Meteoroloji",37.0042,35.3499,18.2714285714286,9.34285714285714,15.4842857142857,75.7428571428571,77.4675,35.9342857142857,240,0,0,124,123,173,240,173
2020,3,3,"Meteoroloji",37.0042,35.3499,17.6571428571429,9.6,0.494142857142857,66.3,88.8657142857143,55.6614285714286,270,0,0,63,49,382,270,382
2020,4,3,"Meteoroloji",37.0042,35.3499,23.2,8.48571428571429,0,44.3,74.9214285714286,57.6114285714286,358,0,0,181,162,295,358,295
2020,5,3,"Meteoroloji",37.0042,35.3499,13.9142857142857,9.98571428571429,3.21728571428571,73,127.415,75.8214285714286,331,3,3,59,69,272,328,269
2020,6,3,"Meteoroloji",37.0042,35.3499,21.7714285714286,9.75714285714286,3.17885714285714,73.2571428571429,101.345714285714,68.0014285714286,343,58,43,45,8,267,285,224
2020,7,3,"Meteoroloji",37.0042,35.3499,26.3,6.45714285714286,0.248714285714286,52.0857142857143,37.2171428571429,56.0866666666667,341,0,0,28,10,338,341,338
2020,8,3,"Meteoroloji",37.0042,35.3499,19.6571428571429,12.1714285714286,10.0631428571429,72.4428571428571,42.7828571428571,58.1985714285714,283,24,56,70,28,187,259,131
2020,9,3,"Meteoroloji",37.0042,35.3499,15.3285714285714,12.9142857142857,6.66857142857143,75.7428571428571,94.77,66.04,393,51,21,34,23,528,342,507
2020,10,3,"Meteoroloji",37.0042,35.3499,17.4,15.5,0,70.0285714285714,102.565714285714,65.4842857142857,205,21,24,27,18,210,184,186
2020,11,3,"Meteoroloji",37.0042,35.3499,22.6285714285714,17.6714285714286,2.98385714285714,66.4428571428571,112.688571428571,58.3466666666667,115,17,1,26,40,94,98,93
2020,12,3,"Meteoroloji",37.0042,35.3499,20.2285714285714,11.4142857142857,3.47742857142857,71.6571428571429,30.6414285714286,51.8742857142857,117,16,11,57,43,118,101,107
2020,13,3,"Meteoroloji",37.0042,35.3499,23.6857142857143,16.1428571428571,0.697571428571429,71.5571428571429,30.444,49.616,136,15,9,28,9,92,121,83
2020,14,3,"Meteoroloji",37.0042,35.3499,27.3285714285714,16.0857142857143,1.19642857142857,70.3714285714286,NA,NA,155,46,50,27,25,121,109,71
2020,15,3,"Meteoroloji",37.0042,35.3499,19.8428571428571,16.5142857142857,0.809,80.7,22.8283333333333,31.9166666666667,133,62,28,2,0,118,71,90
2020,16,3,"Meteoroloji",37.0042,35.3499,16.9571428571429,18.9,0.000428571428571429,65.3142857142857,22.89,34.47,141,34,29,48,38,106,107,77
2020,17,3,"Meteoroloji",37.0042,35.3499,19.6285714285714,18.1571428571429,0.758714285714286,71.7571428571429,NA,NA,137,58,31,6,22,123,79,92
2020,18,3,"Meteoroloji",37.0042,35.3499,20.7428571428571,18.5,8.04471428571429,83.2142857142857,18.774,NA,146,59,38,6,2,164,87,126
2020,19,3,"Meteoroloji",37.0042,35.3499,21.5857142857143,19.8714285714286,3.30142857142857,76.4142857142857,20.78,27.334,137,59,40,5,1,157,78,117
2020,20,3,"Meteoroloji",37.0042,35.3499,19.0571428571429,25.9,0,57.8571428571429,32.6671428571429,32.7528571428571,164,35,38,26,36,164,129,126
2020,21,3,"Meteoroloji",37.0042,35.3499,24.2,27.1285714285714,0.0848571428571429,43.1142857142857,47.508,31.2942857142857,146,29,16,57,44,96,117,80
2020,22,3,"Meteoroloji",37.0042,35.3499,22.4857142857143,22.0714285714286,0,57.1857142857143,24.125,25.28,118,49,52,16,4,100,69,48
2020,23,3,"Meteoroloji",37.0042,35.3499,20.0142857142857,24.0285714285714,0,59.8857142857143,30.2633333333333,39.4042857142857,112,45,20,1,1,70,67,50
2020,24,3,"Meteoroloji",37.0042,35.3499,21.8714285714286,24.1285714285714,1.80757142857143,72.6857142857143,24.634,34.0542857142857,140,41,24,0,0,150,99,126
2020,25,3,"Meteoroloji",37.0042,35.3499,22.4714285714286,24.7714285714286,0.712142857142857,76.4428571428571,27.8116666666667,37.4128571428571,137,75,74,0,0,108,62,34
2020,26,3,"Meteoroloji",37.0042,35.3499,21.6,26.3857142857143,0,74.2714285714286,28.1371428571429,29.7185714285714,173,73,70,0,0,133,100,63
2020,27,3,"Meteoroloji",37.0042,35.3499,20.8,28.5142857142857,0,73.6571428571429,34.5028571428571,29.3442857142857,113,36,17,0,0,113,77,96
2020,28,3,"Meteoroloji",37.0042,35.3499,20.9428571428571,28.6,0,75.8428571428571,33.5983333333333,27.9957142857143,164,65,88,0,0,122,99,34
2020,29,3,"Meteoroloji",37.0042,35.3499,21.3428571428571,29.1714285714286,0,75.7857142857143,39.5033333333333,28.5085714285714,186,50,26,0,0,111,136,85
2020,30,3,"Meteoroloji",37.0042,35.3499,19.9428571428571,29.8428571428571,0,74.3,30.9233333333333,24.6428571428571,190,94,68,0,0,142,96,74
2020,31,3,"Meteoroloji",37.0042,35.3499,20.7285714285714,30.3857142857143,0,76,31.74,24.5342857142857,150,57,81,0,0,127,93,46
2020,32,3,"Meteoroloji",37.0042,35.3499,24.5142857142857,29.8142857142857,0,74.0142857142857,33.295,24.8757142857143,146,67,56,0,0,107,79,51
2020,33,3,"Meteoroloji",37.0042,35.3499,28.1857142857143,29.2428571428571,0.0637142857142857,66.2857142857143,30.8185714285714,42.645,183,50,40,0,0,83,133,43
2020,34,3,"Meteoroloji",37.0042,35.3499,22.2714285714286,29.2571428571429,0.00128571428571429,63.2714285714286,30.5542857142857,42.3242857142857,197,60,49,24,6,97,137,48
2020,35,3,"Meteoroloji",37.0042,35.3499,20.1428571428571,29.4714285714286,0,64.1428571428571,41.7757142857143,49.75,164,58,73,2,2,157,106,84
2020,36,3,"Meteoroloji",37.0042,35.3499,18.0285714285714,31.0428571428571,0,67.7571428571429,44.0814285714286,48.2242857142857,179,82,55,0,0,112,97,57
2020,37,3,"Meteoroloji",37.0042,35.3499,18.9857142857143,30.2714285714286,0,59.1571428571429,38.338,57.1971428571429,193,39,36,30,9,91,154,55
2020,38,3,"Meteoroloji",37.0042,35.3499,19.0428571428571,28.9428571428571,0,75.7285714285714,NA,42.9471428571429,235,142,134,0,0,157,93,23
2020,39,3,"Meteoroloji",37.0042,35.3499,19.4714285714286,27.2857142857143,0.0785714285714286,72.3142857142857,25.86,46.1628571428571,220,152,102,0,0,129,68,27
2020,40,3,"Meteoroloji",37.0042,35.3499,22.6285714285714,26.1857142857143,0,67.9,29.2742857142857,54.9942857142857,187,58,44,18,2,154,129,110
2020,41,3,"Meteoroloji",37.0042,35.3499,19.3142857142857,26.5142857142857,0,47.5285714285714,38.6971428571429,63.35,182,17,6,37,21,127,165,121
2020,42,3,"Meteoroloji",37.0042,35.3499,18,24.4428571428571,0,74.4142857142857,35.2328571428571,45.4771428571429,177,63,41,4,4,111,114,70
2020,43,3,"Meteoroloji",37.0042,35.3499,14.8857142857143,24.9428571428571,0,53.7428571428571,39.5814285714286,69.6928571428571,194,1,2,55,47,161,193,159
2020,44,3,"Meteoroloji",37.0042,35.3499,14.3285714285714,22.9428571428571,0,57.2142857142857,38.3128571428571,70.2485714285714,255,62,24,1,12,233,193,209
2020,45,3,"Meteoroloji",37.0042,35.3499,21.1142857142857,19.3571428571429,6.33171428571429,62.5857142857143,17.7928571428571,50.79,156,2,1,28,23,103,154,102
2020,46,3,"Meteoroloji",37.0042,35.3499,12.9285714285714,17.7142857142857,0,53.8285714285714,28.6128571428571,83.2714285714286,208,0,0,70,37,109,208,109
2020,47,3,"Meteoroloji",37.0042,35.3499,15.7571428571429,15.4428571428571,0.388857142857143,58.3857142857143,29.2757142857143,80.7685714285714,173,0,0,44,10,83,173,83
2020,48,3,"Meteoroloji",37.0042,35.3499,16.2428571428571,12.9857142857143,0.128428571428571,53.4285714285714,34.3242857142857,88.4228571428571,199,0,0,64,47,262,199,262
2020,49,3,"Meteoroloji",37.0042,35.3499,16.2428571428571,13.6571428571429,1.33642857142857,65.3857142857143,31.4285714285714,59.02,207,0,0,57,28,116,207,116
2020,50,3,"Meteoroloji",37.0042,35.3499,18.9428571428571,13.9428571428571,1.05542857142857,68.1714285714286,29.6342857142857,63.5185714285714,181,0,0,38,26,98,181,98
2020,51,3,"Meteoroloji",37.0042,35.3499,19.6285714285714,13.6714285714286,1.49714285714286,65.8142857142857,25.3985714285714,61.1042857142857,171,0,0,56,38,90,171,90
2020,52,3,"Meteoroloji",37.0042,35.3499,17.4,10.8857142857143,0.0637142857142857,51.8142857142857,30.2528571428571,70.5114285714286,203,0,0,81,40,113,203,113
2020,53,3,"Meteoroloji",37.0042,35.3499,12.35,11.5,0,51.15,34.015,83.65,122,0,0,19,13,111,122,111
2017,1,4,"Valilik",37.0008,35.3139,18.4428571428571,9.51428571428571,4.72542857142857,77.7428571428571,42.5785714285714,22.6271428571429,563,63,79,59,88,847,500,768
2017,2,4,"Valilik",37.0008,35.3139,17.9571428571429,8.35714285714286,2.20557142857143,66.5428571428571,53.7914285714286,23.0828571428571,757,25,16,64,69,1214,732,1198
2017,3,4,"Valilik",37.0008,35.3139,15.7,9.55714285714286,0,58.3714285714286,82.4057142857143,23.6157142857143,762,0,0,164,563,1449,762,1449
2017,4,4,"Valilik",37.0008,35.3139,22.3714285714286,8.28571428571429,0.00128571428571429,44.2571428571429,45.4014285714286,16.5142857142857,639,0,0,98,127,889,639,889
2017,5,4,"Valilik",37.0008,35.3139,20.5428571428571,6.31428571428571,0,45.9,69.7342857142857,19.9028571428571,588,0,0,125,301,1163,588,1163
2017,6,4,"Valilik",37.0008,35.3139,19.1571428571429,13.2571428571429,0.0535714285714286,55.1142857142857,72.16,20.95,736,0,0,73,191,1519,736,1519
2017,7,4,"Valilik",37.0008,35.3139,24.1,8.45714285714286,0,35.7857142857143,36.14,12.7614285714286,492,0,0,122,259,717,492,717
2017,8,4,"Valilik",37.0008,35.3139,16.9142857142857,11.9857142857143,0,62.1142857142857,72.1485714285714,22.0271428571429,739,299,754,100,189,1747,440,993
2017,9,4,"Valilik",37.0008,35.3139,19.8142857142857,15.1571428571429,3.95542857142857,55.5142857142857,70.7328571428571,23.0728571428571,574,0,0,108,115,866,574,866
2017,10,4,"Valilik",37.0008,35.3139,20.3,15.3714285714286,4.008,65.6,77.8971428571429,23.7471428571429,712,52,148,14,12,1043,660,895
2017,11,4,"Valilik",37.0008,35.3139,22.9428571428571,12.9285714285714,1.81228571428571,61.7285714285714,31.0842857142857,14.9771428571429,525,125,134,45,66,725,400,591
2017,12,4,"Valilik",37.0008,35.3139,19.6571428571429,15.9428571428571,0.002,65.4857142857143,73.5057142857143,32.4714285714286,589,231,519,162,262,1077,358,558
2017,13,4,"Valilik",37.0008,35.3139,20.7714285714286,16.5285714285714,0.337571428571429,68.0714285714286,47.1557142857143,35.1985714285714,574,152,244,51,55,887,422,643
2017,14,4,"Valilik",37.0008,35.3139,24.1285714285714,18.0428571428571,0.91,64.3142857142857,47.33,29.4271428571429,639,231,578,0,0,1336,408,758
2017,15,4,"Valilik",37.0008,35.3139,21.4,16.8428571428571,6.21928571428571,64.7428571428571,36.1171428571429,33.8385714285714,587,76,62,16,155,1187,511,1125
2017,16,4,"Valilik",37.0008,35.3139,21.6428571428571,18.7285714285714,0,69.6428571428571,66.3357142857143,30.9842857142857,717,131,257,34,86,920,586,663
2017,17,4,"Valilik",37.0008,35.3139,16.9285714285714,20.7428571428571,0,47.4714285714286,61.4428571428571,32.4171428571429,731,27,21,47,139,1478,704,1457
2017,18,4,"Valilik",37.0008,35.3139,23.4285714285714,20.6714285714286,0.455142857142857,72.8428571428571,68.3642857142857,23.7571428571429,506,117,416,10,16,923,389,507
2017,19,4,"Valilik",37.0008,35.3139,19.6,22.5142857142857,0.00385714285714286,68.7714285714286,55.6228571428571,21.8857142857143,471,150,341,0,0,966,321,625
2017,20,4,"Valilik",37.0008,35.3139,19.5,21.7285714285714,1.72657142857143,66.7571428571429,43.8028571428571,26.0342857142857,472,186,515,52,83,1205,286,690
2017,21,4,"Valilik",37.0008,35.3139,20.8142857142857,20.5714285714286,1.55557142857143,73.4285714285714,42.4242857142857,26.5428571428571,448,122,278,1,2,849,326,571
2017,22,4,"Valilik",37.0008,35.3139,22.0571428571429,22.9142857142857,0.958714285714286,71.1,48.6471428571429,22.5457142857143,522,130,262,18,30,1015,392,753
2017,23,4,"Valilik",37.0008,35.3139,20.0428571428571,25.5857142857143,0.00314285714285714,72.0571428571429,63.7214285714286,16.9342857142857,578,188,438,0,0,1388,390,950
2017,24,4,"Valilik",37.0008,35.3139,20.8428571428571,25.3142857142857,4.13171428571429,73.6285714285714,50.97,18.0857142857143,552,247,585,0,0,1139,305,554
2017,25,4,"Valilik",37.0008,35.3139,24.0857142857143,25.6571428571429,0.000142857142857143,69.2285714285714,43.7571428571429,20.2114285714286,584,228,414,0,0,1041,356,627
2017,26,4,"Valilik",37.0008,35.3139,20.2142857142857,29.4571428571429,0,67.1428571428571,53.9328571428571,17.5485714285714,564,113,278,34,37,971,451,693
2017,27,4,"Valilik",37.0008,35.3139,21.9142857142857,29.4285714285714,0,68.6714285714286,57.0071428571429,15.8085714285714,511,180,333,4,16,642,331,309
2017,28,4,"Valilik",37.0008,35.3139,20.9571428571429,29.4285714285714,0,71.9714285714286,51.1857142857143,13.76,481,152,407,0,0,864,329,457
2017,29,4,"Valilik",37.0008,35.3139,22.3857142857143,29.3142857142857,0,71.2285714285714,61.3514285714286,16.67,532,188,550,0,0,1272,344,722
2017,30,4,"Valilik",37.0008,35.3139,21.9428571428571,29.8,0,68.9142857142857,57.2671428571429,14.3085714285714,531,256,543,0,0,928,275,385
2017,31,4,"Valilik",37.0008,35.3139,21.4285714285714,29.4285714285714,0.00271428571428571,71.6285714285714,52.1328571428571,13.3528571428571,559,173,570,0,0,1047,386,477
2017,32,4,"Valilik",37.0008,35.3139,20.4571428571429,30.0285714285714,0,70.3857142857143,62.4357142857143,15.3985714285714,567,166,491,0,0,1092,401,601
2017,33,4,"Valilik",37.0008,35.3139,22.2857142857143,29.2714285714286,0,71.9714285714286,73.7775,14.1628571428571,596,191,706,0,0,1199,405,493
2017,34,4,"Valilik",37.0008,35.3139,22.8857142857143,29.1,0,69.4571428571429,NA,21.0728571428571,601,173,580,0,0,1280,428,700
2017,35,4,"Valilik",37.0008,35.3139,23.1285714285714,28.6714285714286,0,70.5428571428571,NA,11.9357142857143,493,162,485,0,0,1014,331,529
2017,36,4,"Valilik",37.0008,35.3139,22.3285714285714,27.5285714285714,0.269571428571429,60.4714285714286,NA,25.9528571428571,507,151,563,3,1,1321,356,758
2017,37,4,"Valilik",37.0008,35.3139,20.1142857142857,28.1714285714286,0,72.3428571428571,NA,21.4428571428571,589,139,523,0,0,1138,450,615
2017,38,4,"Valilik",37.0008,35.3139,23.3,27.4142857142857,0.002,69.6142857142857,70.74,18.4814285714286,671,185,638,0,0,1312,486,674
2017,39,4,"Valilik",37.0008,35.3139,23.3714285714286,25.2571428571429,0.592428571428571,67.8714285714286,66.9342857142857,24.2428571428571,782,312,893,0,0,1630,470,737
2017,40,4,"Valilik",37.0008,35.3139,17.3428571428571,23.3714285714286,0.000142857142857143,45.5285714285714,49.9542857142857,27.8657142857143,543,32,58,5,15,1137,511,1079
2017,41,4,"Valilik",37.0008,35.3139,19.1857142857143,22.0285714285714,0.140857142857143,51.7571428571429,47.9428571428571,27.6171428571429,487,111,112,39,77,843,376,731
2017,42,4,"Valilik",37.0008,35.3139,19.3,22.1428571428571,0,45.8,63.2785714285714,31.8185714285714,530,151,198,13,29,815,379,617
2017,43,4,"Valilik",37.0008,35.3139,17.9285714285714,21.0285714285714,2.94714285714286,66.7714285714286,64.6628571428571,27.6,506,195,474,17,27,919,311,445
2017,44,4,"Valilik",37.0008,35.3139,16.8142857142857,17.3857142857143,6.70671428571429,64.3,46.1857142857143,28.5557142857143,561,24,26,110,276,1102,537,1076
2017,45,4,"Valilik",37.0008,35.3139,14.1857142857143,16.7857142857143,0.874142857142857,68.2142857142857,56.6585714285714,27.6942857142857,577,0,0,96,155,829,577,829
2017,46,4,"Valilik",37.0008,35.3139,18.6428571428571,18.5,2.00671428571429,57.9,94.9671428571429,31.9342857142857,587,0,0,18,24,1085,587,1085
2017,47,4,"Valilik",37.0008,35.3139,20.1428571428571,12.7571428571429,2.62428571428571,60.5,74.5328571428571,28.6257142857143,418,0,0,23,18,804,418,804
2017,48,4,"Valilik",37.0008,35.3139,12.9,13.6714285714286,4.01285714285714,76.7571428571429,106.094285714286,29.2571428571429,386,0,0,4,6,619,386,619
2017,49,4,"Valilik",37.0008,35.3139,16.4714285714286,10.6571428571429,1.61514285714286,64.2,70.8385714285714,28.7128571428571,407,0,0,44,83,645,407,645
2017,50,4,"Valilik",37.0008,35.3139,11.7,12.9285714285714,0.004,71,84.4185714285714,30.3271428571429,346,0,0,11,9,442,346,442
2017,51,4,"Valilik",37.0008,35.3139,16.8,14.6,0.871428571428571,72.4142857142857,154.85,22.9585714285714,386,34,37,23,51,349,352,312
2017,52,4,"Valilik",37.0008,35.3139,15.5375,11.575,3.986625,70.175,76.6875,23.4575,528,0,0,60,61,507,528,507
2018,1,4,"Valilik",37.0008,35.3139,15.4,10.975,17.723375,74.9625,70.1385714285714,36.7657142857143,618,0,0,105,154,914,618,914
2018,2,4,"Valilik",37.0008,35.3139,14.2,11.4285714285714,1.28928571428571,70.6714285714286,89.9185714285714,34.9028571428571,624,0,0,51,36,1309,624,1309
2018,3,4,"Valilik",37.0008,35.3139,16.6714285714286,10.0714285714286,6.75385714285714,71.1285714285714,62.1171428571429,18.3128571428571,639,0,0,173,118,655,639,655
2018,4,4,"Valilik",37.0008,35.3139,21.1571428571429,9.64285714285714,16.6217142857143,75.5142857142857,61.8771428571429,18.0114285714286,604,0,0,240,370,764,604,764
2018,5,4,"Valilik",37.0008,35.3139,11.4285714285714,10.4,0.002,69.1142857142857,88.7842857142857,20.1785714285714,670,0,0,123,58,819,670,819
2018,6,4,"Valilik",37.0008,35.3139,12.2142857142857,14.2,0,65.4857142857143,108.02,22.9128571428571,704,0,0,38,25,1022,704,1022
2018,7,4,"Valilik",37.0008,35.3139,24.1142857142857,14.4142857142857,0.585571428571429,66.5142857142857,55.0442857142857,17.5142857142857,478,82,87,43,61,557,396,470
2018,8,4,"Valilik",37.0008,35.3139,17.2857142857143,13.8714285714286,1.88114285714286,69.4714285714286,54.1728571428571,16.1171428571429,711,188,418,44,28,1321,523,903
2018,9,4,"Valilik",37.0008,35.3139,17.6142857142857,13.7142857142857,4.60342857142857,78.5428571428571,53.0985714285714,17.75,621,114,198,71,145,956,507,758
2018,10,4,"Valilik",37.0008,35.3139,18.1714285714286,16.4285714285714,0.147,74.0285714285714,90.265,13.9857142857143,556,263,518,37,56,1330,293,812
2018,11,4,"Valilik",37.0008,35.3139,19.2,16.1571428571429,0.0837142857142857,74.0714285714286,52.576,15.5185714285714,551,245,698,0,0,1426,306,728
2018,12,4,"Valilik",37.0008,35.3139,23.9,18.3,0,64.4142857142857,95.9142857142857,15.6885714285714,425,105,362,5,6,1187,320,825
2018,13,4,"Valilik",37.0008,35.3139,20.7714285714286,17.7714285714286,2.62128571428571,63.8571428571429,85.5528571428571,17.2842857142857,356,38,66,52,66,428,318,362
2018,14,4,"Valilik",37.0008,35.3139,21.8,18.9571428571429,0,51.4571428571429,48.7028571428571,20.0042857142857,407,29,90,13,2,486,378,396
2018,15,4,"Valilik",37.0008,35.3139,20.6285714285714,18.2142857142857,3.80271428571429,79.0428571428571,47.9214285714286,13.5,374,23,45,20,26,450,351,405
2018,16,4,"Valilik",37.0008,35.3139,20.4142857142857,19.7428571428571,0.0201428571428571,53.3857142857143,49.5914285714286,18.9757142857143,411,64,152,106,129,648,347,496
2018,17,4,"Valilik",37.0008,35.3139,19.1857142857143,22.0857142857143,0.289428571428571,61.1714285714286,59.7457142857143,16.4666666666667,419,101,224,0,0,652,318,428
2018,18,4,"Valilik",37.0008,35.3139,19.4285714285714,25.2142857142857,0.556,53.2142857142857,68.0928571428571,NA,303,27,63,6,6,474,276,411
2018,19,4,"Valilik",37.0008,35.3139,19.5857142857143,19.9285714285714,4.44771428571429,74.7714285714286,34.7042857142857,NA,275,101,127,31,23,467,174,340
2018,20,4,"Valilik",37.0008,35.3139,19.1428571428571,25.5857142857143,0.0508571428571429,56.8,44.1785714285714,NA,204,54,60,5,14,306,150,246
2018,21,4,"Valilik",37.0008,35.3139,18.1428571428571,25.8571428571429,0.006,66.1,70.9871428571429,NA,252,105,179,0,0,281,147,102
2018,22,4,"Valilik",37.0008,35.3139,20.2142857142857,24.3285714285714,4.05042857142857,70.7428571428571,55.29,NA,249,131,233,0,0,427,118,194
2018,23,4,"Valilik",37.0008,35.3139,19.2142857142857,27.3428571428571,0,68.6857142857143,48.902,NA,267,81,301,7,5,812,186,511
2018,24,4,"Valilik",37.0008,35.3139,24.0714285714286,25.7,2.096,74.6571428571429,35.88,NA,267,52,190,1,1,448,215,258
2018,25,4,"Valilik",37.0008,35.3139,22.0142857142857,25.5285714285714,2.36757142857143,74.7285714285714,43.79,NA,358,112,244,0,0,518,246,274
2018,26,4,"Valilik",37.0008,35.3139,20.3,26.5285714285714,0,72.3571428571429,46.1971428571429,15.11,355,77,124,0,0,587,278,463
2018,27,4,"Valilik",37.0008,35.3139,20.2,28.1285714285714,0,72.9285714285714,48.7742857142857,11.9271428571429,342,91,162,0,0,418,251,256
2018,28,4,"Valilik",37.0008,35.3139,20.5714285714286,28.5285714285714,0,73.3571428571429,55.748,8.915,286,83,241,0,0,585,203,344
2018,29,4,"Valilik",37.0008,35.3139,24.5571428571429,29.0714285714286,0,71.1285714285714,57.2271428571429,NA,260,75,153,0,0,756,185,603
2018,30,4,"Valilik",37.0008,35.3139,23.2857142857143,28.8285714285714,0,72.4428571428572,56.4328571428571,14.3,265,82,130,0,0,822,183,692
2018,31,4,"Valilik",37.0008,35.3139,24.1714285714286,29.1285714285714,0.000142857142857143,74.1,64.4971428571429,12.23,267,63,108,0,0,499,204,391
2018,32,4,"Valilik",37.0008,35.3139,24.7285714285714,29.6571428571429,0,67.1,60.9542857142857,15.2466666666667,297,83,125,0,0,403,214,278
2018,33,4,"Valilik",37.0008,35.3139,22.8571428571429,28.9714285714286,0,70.1285714285714,60.704,14.11,216,72,129,0,0,332,144,203
2018,34,4,"Valilik",37.0008,35.3139,22.2714285714286,29.1,0,73.0571428571429,59.33,NA,144,47,66,0,0,227,97,161
2018,35,4,"Valilik",37.0008,35.3139,21.6714285714286,28.9,0,70,67.2742857142857,15.1083333333333,201,59,111,0,0,314,142,203
2018,36,4,"Valilik",37.0008,35.3139,23.1142857142857,28.0142857142857,0.308,69.7857142857143,62.422,15.088,341,151,221,0,0,370,190,149
2018,37,4,"Valilik",37.0008,35.3139,19.2571428571429,27.0285714285714,0,59.7428571428571,61.2333333333333,28.1633333333333,241,89,163,0,0,419,152,256
2018,38,4,"Valilik",37.0008,35.3139,19.8,28.1571428571429,0,62.6571428571429,52.684,18.7675,189,97,211,15,17,344,92,133
2018,39,4,"Valilik",37.0008,35.3139,19.4,26.5,0.0167142857142857,66.8142857142857,60.04,11.9733333333333,180,85,149,3,2,353,95,204
2018,40,4,"Valilik",37.0008,35.3139,19,25,0.039,55.4,46.8085714285714,3.27666666666667,191,84,148,13,32,341,107,193
2018,41,4,"Valilik",37.0008,35.3139,15.9571428571429,23.5428571428571,0.460571428571429,63.3,72.09,1.99714285714286,187,54,136,28,113,422,133,286
2018,42,4,"Valilik",37.0008,35.3139,17.5714285714286,24,1.236,60.4428571428571,51.275,1.89857142857143,168,3,10,30,44,381,165,371
2018,43,4,"Valilik",37.0008,35.3139,20.6714285714286,19.6142857142857,8.97542857142857,59.4142857142857,52.8971428571429,1.88571428571429,187,0,0,64,223,402,187,402
2018,44,4,"Valilik",37.0008,35.3139,13.7714285714286,19.8142857142857,0.0122857142857143,52.0571428571429,61.4485714285714,1.88,196,16,25,10,4,264,180,239
2018,45,4,"Valilik",37.0008,35.3139,14.8428571428571,18.4428571428571,0.599857142857143,65.6714285714286,53.29,2.12857142857143,231,3,13,6,3,473,228,460
2018,46,4,"Valilik",37.0008,35.3139,20.2142857142857,14.9714285714286,1.12742857142857,53.3142857142857,54.0828571428571,1.85,230,0,0,37,128,465,230,465
2018,47,4,"Valilik",37.0008,35.3139,14.0571428571429,15.6428571428571,0.636,69.8428571428571,65.8016666666667,1.91,270,2,0,64,250,499,268,499
2018,48,4,"Valilik",37.0008,35.3139,16.1857142857143,15.2571428571429,3.95457142857143,77.4428571428572,54.1371428571429,1.92857142857143,245,0,0,23,26,201,245,201
2018,49,4,"Valilik",37.0008,35.3139,17.4857142857143,14.0571428571429,9.084,76.0142857142857,46.3128571428571,17.4014285714286,257,0,0,48,185,420,257,420
2018,50,4,"Valilik",37.0008,35.3139,22.3857142857143,12.9857142857143,5.40985714285714,69.8857142857143,45.1466666666667,33.3628571428571,256,2,1,5,15,305,254,304
2018,51,4,"Valilik",37.0008,35.3139,16.4857142857143,12.0285714285714,11.9428571428571,81.9857142857143,63.7357142857143,33.73,250,0,0,34,31,248,250,248
2018,52,4,"Valilik",37.0008,35.3139,18.1285714285714,9.91428571428571,7.421,67.8857142857143,46.075,32.525,244,0,0,43,95,273,244,273
2019,1,4,"Valilik",37.0008,35.3139,20.2375,10.3875,19.717875,85.1125,57.39,71.9,343,52,124,32,36,784,291,660
2019,2,4,"Valilik",37.0008,35.3139,18.1285714285714,7.91428571428571,2.26228571428571,65.0142857142857,NA,32.6133333333333,255,0,0,16,22,208,255,208
2019,3,4,"Valilik",37.0008,35.3139,22.8571428571429,8.85714285714286,10.8118571428571,63.8714285714286,49.5016666666667,29.5857142857143,192,36,15,42,60,198,156,183
2019,4,4,"Valilik",37.0008,35.3139,19.1428571428571,11.7142857142857,0.794142857142857,63.3285714285714,64.0575,31.44,308,0,0,2,1,314,308,314
2019,5,4,"Valilik",37.0008,35.3139,15.8857142857143,11.5428571428571,2.74542857142857,73.1428571428571,66.0083333333333,33.4871428571429,253,0,0,22,20,143,253,143
2019,6,4,"Valilik",37.0008,35.3139,23.5714285714286,11.3857142857143,7.81357142857143,71.4571428571429,38.6028571428571,30.2128571428571,276,0,0,29,24,127,276,127
2019,7,4,"Valilik",37.0008,35.3139,18.3714285714286,11.7428571428571,0.542285714285714,73.7428571428571,55.4628571428571,31.0585714285714,325,53,98,0,0,234,272,136
2019,8,4,"Valilik",37.0008,35.3139,15.1571428571429,12.5714285714286,0.203428571428571,73.3857142857143,51.1614285714286,28.4128571428571,305,48,33,6,1,219,257,186
2019,9,4,"Valilik",37.0008,35.3139,21.4285714285714,11.5142857142857,0.576285714285714,64.6285714285714,42.0571428571429,27.2757142857143,331,20,17,53,118,310,311,293
2019,10,4,"Valilik",37.0008,35.3139,18.6,12.9714285714286,2.25271428571429,69.3571428571429,43.0114285714286,35.9814285714286,359,47,27,61,45,252,312,225
2019,11,4,"Valilik",37.0008,35.3139,19.1285714285714,14.0142857142857,6.55828571428571,77.8571428571429,48.6742857142857,38.33,373,177,140,9,2,400,196,260
2019,12,4,"Valilik",37.0008,35.3139,20.7571428571429,15.7571428571429,0,59.1285714285714,50.9566666666667,36.6714285714286,343,43,34,78,49,416,300,382
2019,13,4,"Valilik",37.0008,35.3139,22.8714285714286,13.7428571428571,4.60728571428571,72.3571428571429,33.4057142857143,29.01,256,96,28,69,35,194,160,166
2019,14,4,"Valilik",37.0008,35.3139,16.5428571428571,15.4285714285714,3.18542857142857,75.3714285714286,35.3257142857143,32.8385714285714,365,34,19,73,30,208,331,189
2019,15,4,"Valilik",37.0008,35.3139,21,18.0428571428571,0.127142857142857,69.0142857142857,58.5314285714286,24.6414285714286,359,116,71,2,0,183,243,112
2019,16,4,"Valilik",37.0008,35.3139,23.0714285714286,14.1142857142857,6.54828571428571,75.0142857142857,27.7185714285714,29.5642857142857,318,64,70,33,9,208,254,138
2019,17,4,"Valilik",37.0008,35.3139,19.2,18.4714285714286,0,53.3,48.7414285714286,34.835,412,0,0,258,171,313,412,313
2019,18,4,"Valilik",37.0008,35.3139,20.6857142857143,21.0571428571429,0.0441428571428571,64.3428571428571,62.4228571428571,33.705,523,175,101,71,44,353,348,252
2019,19,4,"Valilik",37.0008,35.3139,22.6571428571429,20.1571428571429,0.0127142857142857,61.6142857142857,46.6342857142857,28.4971428571429,452,36,48,37,37,386,416,338
2019,20,4,"Valilik",37.0008,35.3139,18.7571428571429,25.8428571428571,0,52.8285714285714,54.36,43.0257142857143,454,92,71,31,41,389,362,318
2019,21,4,"Valilik",37.0008,35.3139,17.7714285714286,24.5714285714286,0.0247142857142857,66.3571428571429,51.288,23.356,457,60,43,65,30,413,397,370
2019,22,4,"Valilik",37.0008,35.3139,18.9142857142857,27.2428571428571,0,59.3857142857143,72.4514285714286,46.1014285714286,453,37,75,1,2,323,416,248
2019,23,4,"Valilik",37.0008,35.3139,18.9428571428571,26.3285714285714,0.00514285714285714,65.7857142857143,66.2842857142857,26.0528571428571,378,223,205,55,118,532,155,327
2019,24,4,"Valilik",37.0008,35.3139,22.2857142857143,25.5,2.81357142857143,73.5,49.9971428571429,25.36,378,34,31,0,0,244,344,213
2019,25,4,"Valilik",37.0008,35.3139,22.0571428571429,25.8857142857143,3.12057142857143,77.1142857142857,45.2271428571429,26.0314285714286,306,77,157,0,0,325,229,168
2019,26,4,"Valilik",37.0008,35.3139,19.8285714285714,28.7857142857143,0,74.1857142857143,52.5514285714286,18.94,377,81,77,0,0,342,296,265
2019,27,4,"Valilik",37.0008,35.3139,20.1285714285714,27.8,0,67.1571428571429,46.9657142857143,20.4171428571429,456,113,95,4,2,222,343,127
2019,28,4,"Valilik",37.0008,35.3139,22.0857142857143,27.9285714285714,0.408571428571429,75.3714285714286,48.9814285714286,17.4271428571429,398,203,139,0,0,421,195,282
2019,29,4,"Valilik",37.0008,35.3139,21.3428571428571,27.2142857142857,2.99971428571429,74,42.6671428571429,27.6,453,142,52,0,0,203,311,151
2019,30,4,"Valilik",37.0008,35.3139,21.8,28.8285714285714,0,72.9285714285714,52.4785714285714,22.6871428571429,456,127,116,0,0,335,329,219
2019,31,4,"Valilik",37.0008,35.3139,20.8285714285714,28.8714285714286,0,75.7714285714286,57.0842857142857,22.6785714285714,334,91,105,0,0,375,243,270
2019,32,4,"Valilik",37.0008,35.3139,22.9714285714286,29.1857142857143,0.00271428571428571,70.9,54.9957142857143,24.9628571428571,346,53,79,0,0,395,293,316
2019,33,4,"Valilik",37.0008,35.3139,22.0857142857143,29.1428571428571,0.0192857142857143,74.8428571428571,50.3057142857143,20.7257142857143,337,40,43,0,0,531,297,488
2019,34,4,"Valilik",37.0008,35.3139,21.1142857142857,29.0285714285714,0,64.9571428571429,47.7942857142857,40.7914285714286,299,138,158,34,38,345,161,187
2019,35,4,"Valilik",37.0008,35.3139,20.5714285714286,29.5714285714286,0,73.6571428571429,65.82,37.6328571428571,307,102,165,0,0,415,205,250
2019,36,4,"Valilik",37.0008,35.3139,23.7142857142857,28.3714285714286,1.84771428571429,72.0142857142857,63.5883333333333,38.6116666666667,171,71,46,0,0,67,100,21
2019,37,4,"Valilik",37.0008,35.3139,23.6571428571429,27.7857142857143,0.0101428571428571,65.2142857142857,NA,NA,218,29,9,3,12,55,189,46
2019,38,4,"Valilik",37.0008,35.3139,22.5857142857143,26.1285714285714,0,55.9,NA,NA,266,58,19,11,4,91,208,72
2019,39,4,"Valilik",37.0008,35.3139,19.3714285714286,25.1428571428571,0,65.7571428571429,NA,NA,237,64,35,0,0,79,173,44
2019,40,4,"Valilik",37.0008,35.3139,21.7571428571429,25.1428571428571,0,72.2571428571429,62.705,50.445,241,69,72,0,0,111,172,39
2019,41,4,"Valilik",37.0008,35.3139,17.1571428571429,24.7285714285714,0.854857142857143,61.0428571428571,59.9928571428571,68.3414285714286,416,89,54,117,183,448,327,394
2019,42,4,"Valilik",37.0008,35.3139,19.7714285714286,25.5714285714286,1.15728571428571,56.8857142857143,76.6614285714286,70.9857142857143,356,85,95,61,103,408,271,313
2019,43,4,"Valilik",37.0008,35.3139,20.6,23.0428571428571,0.0122857142857143,53.8,42.9,65.828,306,3,11,47,65,300,303,289
2019,44,4,"Valilik",37.0008,35.3139,17.0857142857143,19.0571428571429,2.02642857142857,71.0428571428571,35.7585714285714,68.812,350,62,59,88,76,250,288,191
2019,45,4,"Valilik",37.0008,35.3139,13.3428571428571,20.4285714285714,0,48.2571428571429,51.1185714285714,88.4257142857143,417,0,0,67,102,328,417,328
2019,46,4,"Valilik",37.0008,35.3139,15.3285714285714,20.2428571428571,0.342714285714286,47.1428571428571,59.2371428571429,81.7871428571429,401,0,0,31,57,337,401,337
2019,47,4,"Valilik",37.0008,35.3139,12.1857142857143,15,0,52.5857142857143,71.0085714285714,86.1442857142857,391,0,0,36,61,339,391,339
2019,48,4,"Valilik",37.0008,35.3139,16.8714285714286,15.4857142857143,2.59585714285714,71.6428571428571,62.98,74.07,320,0,0,39,46,251,320,251
2019,49,4,"Valilik",37.0008,35.3139,15.5285714285714,12.8571428571429,0.550714285714286,61.0714285714286,41.3614285714286,65.6771428571429,393,2,1,24,30,274,391,273
2019,50,4,"Valilik",37.0008,35.3139,21.0857142857143,12.5,11.2021428571429,78.7428571428571,27.0966666666667,61.3214285714286,218,0,0,32,8,119,218,119
2019,51,4,"Valilik",37.0008,35.3139,9.37142857142857,11.8714285714286,0,83.1714285714286,71.21,80.55,361,0,0,74,51,488,361,488
2019,52,4,"Valilik",37.0008,35.3139,19.1857142857143,10.7285714285714,35.7052857142857,86.0142857142857,33.6275,64.7328571428571,279,0,0,58,49,281,279,281
2020,1,4,"Valilik",37.0008,35.3139,15.12,9.86,5.9554,77.62,49.568,65.4,160,0,0,13,5,126,160,126
2020,2,4,"Valilik",37.0008,35.3139,18.4714285714286,9.62857142857143,16.1125714285714,74.0142857142857,44.0614285714286,67.2042857142857,240,0,0,103,91,173,240,173
2020,3,4,"Valilik",37.0008,35.3139,17.8571428571429,9.88571428571429,0.552857142857143,65.2714285714286,42.372,64.746,270,0,0,61,38,382,270,382
2020,4,4,"Valilik",37.0008,35.3139,22.4857142857143,8.94285714285714,0,43.8714285714286,42.0242857142857,60.7257142857143,358,0,0,164,158,295,358,295
2020,5,4,"Valilik",37.0008,35.3139,14.2,10.3142857142857,3.26671428571429,70.2,68.17,74.8014285714286,331,3,3,44,58,272,328,269
2020,6,4,"Valilik",37.0008,35.3139,22.4142857142857,10.0142857142857,3.81957142857143,70.3571428571429,43.8414285714286,62.7642857142857,343,57,43,42,8,267,286,224
2020,7,4,"Valilik",37.0008,35.3139,25.3714285714286,6.78571428571429,0.147428571428571,51.3285714285714,33.8471428571429,62.2914285714286,341,0,0,18,8,338,341,338
2020,8,4,"Valilik",37.0008,35.3139,18.9571428571429,12.4428571428571,9.55814285714286,70.2714285714286,45.3985714285714,68.3385714285714,283,40,58,61,21,187,243,129
2020,9,4,"Valilik",37.0008,35.3139,14.7,13.1857142857143,5.98628571428571,73.9857142857143,45.6542857142857,68.2985714285714,393,26,9,66,73,528,367,519
2020,10,4,"Valilik",37.0008,35.3139,16.7,15.7571428571429,0,68.4,51.875,64.5985714285714,205,20,16,16,15,210,185,194
2020,11,4,"Valilik",37.0008,35.3139,22.1285714285714,17.8,2.84242857142857,65.1142857142857,58.2928571428571,56.0642857142857,115,16,0,28,41,94,99,94
2020,12,4,"Valilik",37.0008,35.3139,20.7,11.6142857142857,4.12671428571429,68.7428571428571,26.1571428571429,46.9357142857143,117,16,11,56,43,118,101,107
2020,13,4,"Valilik",37.0008,35.3139,23.7,16.2285714285714,0.303714285714286,69.8285714285714,52.59,46.7657142857143,136,12,6,19,6,92,124,86
2020,14,4,"Valilik",37.0008,35.3139,27.2142857142857,16.2428571428571,1.15571428571429,67.8285714285714,33.1171428571429,39.9485714285714,155,45,45,20,14,121,110,76
2020,15,4,"Valilik",37.0008,35.3139,19.5142857142857,16.6285714285714,0.370714285714286,79,54.6471428571429,41.2314285714286,133,66,32,0,0,118,67,86
2020,16,4,"Valilik",37.0008,35.3139,17.6857142857143,19,0.000285714285714286,63.8428571428571,45.1871428571429,45.7914285714286,141,27,27,30,33,106,114,79
2020,17,4,"Valilik",37.0008,35.3139,19.9857142857143,18.3,0.230428571428571,70.2285714285714,42.1214285714286,42.11,137,32,35,4,21,123,105,88
2020,18,4,"Valilik",37.0008,35.3139,19.3571428571429,18.6285714285714,6.77257142857143,81.2142857142857,38.09,38.4,146,58,34,1,1,164,88,130
2020,19,4,"Valilik",37.0008,35.3139,21.9714285714286,19.9285714285714,3.37128571428571,75.1571428571429,29.5814285714286,38.72,137,55,36,3,1,157,82,121
2020,20,4,"Valilik",37.0008,35.3139,17.8428571428571,26.0142857142857,0,57.9142857142857,41.23,39.64,164,32,37,18,10,164,132,127
2020,21,4,"Valilik",37.0008,35.3139,24.2571428571429,27.3142857142857,0.130571428571429,43.3285714285714,NA,NA,146,31,17,54,59,96,115,79
2020,22,4,"Valilik",37.0008,35.3139,22.1285714285714,22.0857142857143,0,57.2571428571429,NA,NA,118,46,45,13,3,100,72,55
2020,23,4,"Valilik",37.0008,35.3139,20.5142857142857,23.9428571428571,0,60.6428571428571,54.95,37.11,112,36,17,0,0,70,76,53
2020,24,4,"Valilik",37.0008,35.3139,22.8142857142857,23.9428571428571,3.09157142857143,74.2,44.9157142857143,NA,140,44,27,0,0,150,96,123
2020,25,4,"Valilik",37.0008,35.3139,21.0857142857143,24.5,0.712857142857143,77.9857142857143,38.2142857142857,NA,137,61,58,0,0,108,76,50
2020,26,4,"Valilik",37.0008,35.3139,20.9857142857143,26.1,0,75.9285714285714,21.8642857142857,NA,173,64,65,0,0,133,109,68
2020,27,4,"Valilik",37.0008,35.3139,20.5714285714286,28.1714285714286,0,75.9142857142857,29.2971428571429,NA,113,35,17,0,0,113,78,96
2020,28,4,"Valilik",37.0008,35.3139,20.3714285714286,28.3142857142857,0,77.7857142857143,31.1185714285714,NA,164,56,49,0,0,122,108,73
2020,29,4,"Valilik",37.0008,35.3139,20.8428571428571,28.8428571428571,0,77.8428571428571,32.57,NA,186,36,24,0,0,111,150,87
2020,30,4,"Valilik",37.0008,35.3139,19.0714285714286,29.5,0,76.6571428571429,30.6033333333333,NA,190,62,62,0,0,142,128,80
2020,31,4,"Valilik",37.0008,35.3139,20.5142857142857,30.0571428571429,0,77.9857142857143,31.3628571428571,NA,150,47,50,0,0,127,103,77
2020,32,4,"Valilik",37.0008,35.3139,23.4,29.6285714285714,0,75.8571428571429,27.6057142857143,NA,146,60,37,0,0,107,86,70
2020,33,4,"Valilik",37.0008,35.3139,25.3285714285714,29.0571428571429,0.123142857142857,69.0857142857143,46.9957142857143,NA,183,41,23,0,0,83,142,60
2020,34,4,"Valilik",37.0008,35.3139,21.6142857142857,29.1285714285714,0.000714285714285714,65.2142857142857,51.0085714285714,NA,197,61,49,32,10,97,136,48
2020,35,4,"Valilik",37.0008,35.3139,19.4714285714286,29.2857142857143,0,66.8428571428571,94.6185714285714,NA,164,40,59,0,0,157,124,98
2020,36,4,"Valilik",37.0008,35.3139,17.6571428571429,30.9,0,69.9428571428572,107.53,NA,179,76,57,0,0,112,103,55
2020,37,4,"Valilik",37.0008,35.3139,18.8428571428571,30.1142857142857,0,61.5571428571429,84.5557142857143,NA,193,36,35,30,9,91,157,56
2020,38,4,"Valilik",37.0008,35.3139,18.2714285714286,28.8285714285714,0,77.4,77.7525,NA,235,128,108,0,0,157,107,49
2020,39,4,"Valilik",37.0008,35.3139,19.1428571428571,27.3142857142857,0.0192857142857143,73.4571428571429,54.525,NA,220,166,114,0,0,129,54,15
2020,40,4,"Valilik",37.0008,35.3139,22.2,26.2857142857143,0,69.3285714285714,68.6328571428571,NA,187,58,65,30,3,154,129,89
2020,41,4,"Valilik",37.0008,35.3139,18.6714285714286,26.7285714285714,0,49.3857142857143,85.4142857142857,NA,182,20,7,14,5,127,162,120
2020,42,4,"Valilik",37.0008,35.3139,17.6,24.5,0,75,65.9614285714286,NA,177,30,17,0,0,111,147,94
2020,43,4,"Valilik",37.0008,35.3139,14.6142857142857,24.9714285714286,0,55.7285714285714,80.7671428571429,NA,194,5,5,18,10,161,189,156
2020,44,4,"Valilik",37.0008,35.3139,13.9428571428571,23.0428571428571,0,58.6571428571429,77.53,NA,255,88,53,5,3,233,167,180
2020,45,4,"Valilik",37.0008,35.3139,20.2714285714286,19.6,6.03371428571429,61.8714285714286,32.0185714285714,NA,156,10,4,21,17,103,146,99
2020,46,4,"Valilik",37.0008,35.3139,12.7714285714286,17.9714285714286,0,54.9428571428571,61.0214285714286,NA,208,0,0,35,14,109,208,109
2020,47,4,"Valilik",37.0008,35.3139,15.2,15.8,0.311571428571429,59,55.81,NA,173,0,0,23,5,83,173,83
2020,48,4,"Valilik",37.0008,35.3139,15.1142857142857,13.2428571428571,0.182142857142857,55.8142857142857,68.2428571428571,NA,199,0,0,34,35,262,199,262
2020,49,4,"Valilik",37.0008,35.3139,14.7142857142857,13.8285714285714,0.749,65.9857142857143,63.4414285714286,NA,207,0,0,32,8,116,207,116
2020,50,4,"Valilik",37.0008,35.3139,17.2,14.1142857142857,1.40371428571429,68.2571428571429,58.9271428571429,NA,181,0,0,32,6,98,181,98
2020,51,4,"Valilik",37.0008,35.3139,18.2428571428571,13.9714285714286,1.34942857142857,64.7714285714286,48.8142857142857,NA,171,0,0,24,14,90,171,90
2020,52,4,"Valilik",37.0008,35.3139,15.3857142857143,11.0714285714286,0.123142857142857,52.7285714285714,62.4042857142857,NA,203,0,0,42,17,113,203,113
2020,53,4,"Valilik",37.0008,35.3139,11.9,11.675,0,52.7,75.485,NA,122,0,0,4,2,111,122,111
2017,1,5,"Adiyaman",37.7648,38.2786,14.7857142857143,3.2,1.90228571428571,80.8,47.0028571428571,NA,563,434,658,0,0,847,129,189
2017,2,5,"Adiyaman",37.7648,38.2786,14.1142857142857,2.41428571428571,4.35271428571429,69.7285714285714,80.8585714285714,NA,757,325,366,10,5,1214,432,848
2017,3,5,"Adiyaman",37.7648,38.2786,12.4285714285714,4.11428571428571,0,57.1714285714286,70.38,NA,762,189,351,41,134,1449,573,1098
2017,4,5,"Adiyaman",37.7648,38.2786,18.7571428571429,1.88571428571429,1.30771428571429,57.7,42.0614285714286,NA,639,348,416,46,70,889,291,473
2017,5,5,"Adiyaman",37.7648,38.2786,19.9428571428571,0.371428571428571,0.766857142857143,53.0428571428571,40.9657142857143,NA,588,242,605,33,46,1163,346,558
2017,6,5,"Adiyaman",37.7648,38.2786,12.6142857142857,5.68571428571429,0.0142857142857143,67.1285714285714,60.8485714285714,NA,736,538,1059,0,0,1519,198,460
2017,7,5,"Adiyaman",37.7648,38.2786,17.8285714285714,1.77142857142857,0.00857142857142857,39.4428571428571,38.3571428571429,NA,492,127,234,27,82,717,365,483
2017,8,5,"Adiyaman",37.7648,38.2786,12.5,7.88571428571429,0,44.8285714285714,78.5571428571429,NA,739,26,59,256,691,1747,713,1688
2017,9,5,"Adiyaman",37.7648,38.2786,14.4285714285714,10.4571428571429,2.62642857142857,59.8142857142857,58.3957142857143,NA,574,324,515,18,17,866,250,351
2017,10,5,"Adiyaman",37.7648,38.2786,17.0428571428571,11.3857142857143,1.573,57.8,50.7128571428571,NA,712,515,770,91,147,1043,197,273
2017,11,5,"Adiyaman",37.7648,38.2786,14.9428571428571,7.48571428571429,11.8821428571429,72.3285714285714,23.7714285714286,NA,525,44,38,68,161,725,481,687
2017,12,5,"Adiyaman",37.7648,38.2786,16.3285714285714,9.97142857142857,0.428142857142857,53.2428571428571,39.5428571428571,NA,589,251,460,80,166,1077,338,617
2017,13,5,"Adiyaman",37.7648,38.2786,14.1857142857143,11.9428571428571,2.04371428571429,62.8,30.6228571428571,NA,574,228,430,20,29,887,346,457
2017,14,5,"Adiyaman",37.7648,38.2786,16.3571428571429,12.1714285714286,3.239,56.7428571428571,23.84,NA,639,272,619,226,479,1336,367,717
2017,15,5,"Adiyaman",37.7648,38.2786,16.0285714285714,12.1571428571429,4.76971428571429,63.8714285714286,30.7014285714286,NA,587,304,515,151,360,1187,283,672
2017,16,5,"Adiyaman",37.7648,38.2786,17.3,15.3571428571429,2.97171428571429,63.1,41.6128571428571,NA,717,323,614,0,0,920,394,306
2017,17,5,"Adiyaman",37.7648,38.2786,16.6857142857143,16.6857142857143,0,37.5285714285714,31.9457142857143,NA,731,322,758,26,94,1478,409,720
2017,18,5,"Adiyaman",37.7648,38.2786,12.6285714285714,16.6857142857143,4.02157142857143,67.4142857142857,38.44,NA,506,399,661,1,0,923,107,262
2017,19,5,"Adiyaman",37.7648,38.2786,15.0714285714286,21.3857142857143,0.0285714285714286,43.6285714285714,40.76,NA,471,58,127,85,151,966,413,839
2017,20,5,"Adiyaman",37.7648,38.2786,20.4428571428571,20.5285714285714,0.154571428571429,43.0285714285714,21.8128571428571,NA,472,25,45,100,323,1205,447,1160
2017,21,5,"Adiyaman",37.7648,38.2786,13.4142857142857,18.1714285714286,1.85971428571429,54.0571428571429,17.9257142857143,NA,448,80,277,109,188,849,368,572
2017,22,5,"Adiyaman",37.7648,38.2786,15.5428571428571,22.8285714285714,0,36.1142857142857,21.0242857142857,NA,522,123,347,108,116,1015,399,668
2017,23,5,"Adiyaman",37.7648,38.2786,19.7571428571429,27.2571428571429,0.0285714285714286,30.7571428571429,27.53,NA,578,46,83,241,635,1388,532,1305
2017,24,5,"Adiyaman",37.7648,38.2786,17.1,25.5285714285714,0.0142857142857143,33.1,20.0257142857143,NA,552,8,3,206,477,1139,544,1136
2017,25,5,"Adiyaman",37.7648,38.2786,19.4142857142857,26.0285714285714,0,33.1714285714286,19.7157142857143,NA,584,53,72,239,392,1041,531,969
2017,26,5,"Adiyaman",37.7648,38.2786,24.4571428571429,31.9857142857143,0,22.0714285714286,25.7428571428571,NA,564,103,186,108,321,971,461,785
2017,27,5,"Adiyaman",37.7648,38.2786,21.4428571428571,31.3714285714286,0,24.8428571428571,30.74,NA,511,28,103,277,237,642,483,539
2017,28,5,"Adiyaman",37.7648,38.2786,18.0285714285714,32.1285714285714,0,17.0142857142857,22.35,NA,481,10,31,290,458,864,471,833
2017,29,5,"Adiyaman",37.7648,38.2786,19.0142857142857,32.2285714285714,0,25.8857142857143,36.74,NA,532,2,4,285,617,1272,530,1268
2017,30,5,"Adiyaman",37.7648,38.2786,19.5714285714286,31.1714285714286,0,24.7428571428571,28.3814285714286,NA,531,0,0,344,649,928,531,928
2017,31,5,"Adiyaman",37.7648,38.2786,15.5571428571429,31.6571428571429,0,26.2,33.3828571428571,NA,559,74,133,176,224,1047,485,914
2017,32,5,"Adiyaman",37.7648,38.2786,14.5,32.0142857142857,0,25.8285714285714,42.1685714285714,NA,567,18,32,49,49,1092,549,1060
2017,33,5,"Adiyaman",37.7648,38.2786,15.4857142857143,30.4714285714286,0,34.6,40.1885714285714,NA,596,28,159,65,94,1199,568,1040
2017,34,5,"Adiyaman",37.7648,38.2786,13.5857142857143,30.5,0,29.0571428571429,43.8728571428571,NA,601,5,2,160,219,1280,596,1278
2017,35,5,"Adiyaman",37.7648,38.2786,13.5857142857143,28.7571428571429,0,31.0857142857143,45.3442857142857,NA,493,48,316,101,174,1014,445,698
2017,36,5,"Adiyaman",37.7648,38.2786,15.6,27.6142857142857,0,22.9285714285714,43.7985714285714,NA,507,2,2,126,251,1321,505,1319
2017,37,5,"Adiyaman",37.7648,38.2786,13.1142857142857,29.7571428571429,0,17.2428571428571,58.3814285714286,NA,589,144,238,155,242,1138,445,900
2017,38,5,"Adiyaman",37.7648,38.2786,14.1142857142857,26.7571428571429,0,30.1428571428571,62.6514285714286,NA,671,111,185,65,104,1312,560,1127
2017,39,5,"Adiyaman",37.7648,38.2786,13.6428571428571,23.7857142857143,0.428142857142857,36.3,48.49,NA,782,285,723,160,228,1630,497,907
2017,40,5,"Adiyaman",37.7648,38.2786,16.4857142857143,18.8285714285714,0,30.9571428571429,33.2842857142857,NA,543,240,430,67,189,1137,303,707
2017,41,5,"Adiyaman",37.7648,38.2786,12.6285714285714,18.3857142857143,0.525714285714286,39.8428571428571,32.9457142857143,NA,487,89,160,164,348,843,398,683
2017,42,5,"Adiyaman",37.7648,38.2786,13.3857142857143,17.8142857142857,0,30.8428571428571,38.3957142857143,NA,530,120,207,114,203,815,410,608
2017,43,5,"Adiyaman",37.7648,38.2786,14.5142857142857,17.4142857142857,3.16857142857143,47.4571428571429,95.4442857142857,NA,506,313,585,44,76,919,193,334
2017,44,5,"Adiyaman",37.7648,38.2786,14.1142857142857,12.4714285714286,3.27714285714286,65.8142857142857,33.8242857142857,NA,561,141,205,133,246,1102,420,897
2017,45,5,"Adiyaman",37.7648,38.2786,12.0714285714286,13.0714285714286,0.610142857142857,58.7142857142857,122.021428571429,NA,577,123,115,180,302,829,454,714
2017,46,5,"Adiyaman",37.7648,38.2786,13.7857142857143,12.9857142857143,0.0714285714285714,53.1714285714286,88.4585714285714,NA,587,368,599,41,122,1085,219,486
2017,47,5,"Adiyaman",37.7648,38.2786,16.4571428571429,7.37142857142857,3.86942857142857,61.7857142857143,55.6571428571429,NA,418,115,328,103,183,804,303,476
2017,48,5,"Adiyaman",37.7648,38.2786,13.6857142857143,7.54285714285714,4.60771428571429,78.1571428571429,89.6057142857143,NA,386,162,289,73,107,619,224,330
2017,49,5,"Adiyaman",37.7648,38.2786,18.6285714285714,6.25714285714286,1.63342857142857,60.4714285714286,71.1871428571429,NA,407,162,245,65,44,645,245,400
2017,50,5,"Adiyaman",37.7648,38.2786,10.9857142857143,7.5,0.128428571428571,63.6285714285714,118.072857142857,NA,346,83,31,15,39,442,263,411
2017,51,5,"Adiyaman",37.7648,38.2786,15.3428571428571,9.38571428571429,4.22685714285714,76.1285714285714,186.897142857143,NA,386,298,240,0,0,349,88,109
2017,52,5,"Adiyaman",37.7648,38.2786,13.575,7.1875,0.201125,67.9375,115.415,NA,528,360,278,10,27,507,168,229
2018,1,5,"Adiyaman",37.7648,38.2786,15.675,6.375,3.620875,71.6125,53.3675,NA,618,279,434,150,203,914,339,480
2018,2,5,"Adiyaman",37.7648,38.2786,14.2,7.45714285714286,0.0428571428571429,56.8142857142857,90.6085714285714,NA,624,443,647,69,558,1309,181,662
2018,3,5,"Adiyaman",37.7648,38.2786,19.6857142857143,5.45714285714286,18.2142857142857,77.1714285714286,57.3328571428571,NA,639,339,322,79,73,655,300,333
2018,4,5,"Adiyaman",37.7648,38.2786,18.8857142857143,6.17142857142857,8.65357142857143,80.4,65.1314285714286,NA,604,445,499,0,0,764,159,265
2018,5,5,"Adiyaman",37.7648,38.2786,12.0571428571429,6.01428571428571,0,65.6285714285714,69.5257142857143,NA,670,242,371,12,19,819,428,448
2018,6,5,"Adiyaman",37.7648,38.2786,11.3,9.28571428571428,0.0142857142857143,60.0714285714286,103.935714285714,NA,704,323,396,11,6,1022,381,626
2018,7,5,"Adiyaman",37.7648,38.2786,14.9714285714286,9.3,7.408,66.6,43.7285714285714,NA,478,270,283,41,34,557,208,274
2018,8,5,"Adiyaman",37.7648,38.2786,11.5571428571429,8.14285714285714,5.62442857142857,76.8142857142857,47.54,NA,711,295,624,56,35,1321,416,697
2018,9,5,"Adiyaman",37.7648,38.2786,13.5142857142857,8.28571428571428,5.13714285714286,81.8428571428571,45.71,NA,621,463,752,0,0,956,158,204
2018,10,5,"Adiyaman",37.7648,38.2786,13.9714285714286,12.3428571428571,0.599428571428572,63.3285714285714,86.5257142857143,NA,556,261,623,4,31,1330,295,707
2018,11,5,"Adiyaman",37.7648,38.2786,13.2428571428571,12.8714285714286,0.0145714285714286,58.9714285714286,32.1757142857143,NA,551,40,81,238,858,1426,511,1345
2018,12,5,"Adiyaman",37.7648,38.2786,21.2714285714286,15.2,0,50.3428571428571,73.4042857142857,NA,425,262,794,87,99,1187,163,393
2018,13,5,"Adiyaman",37.7648,38.2786,14.8571428571429,14.7428571428571,0.999714285714286,51.0571428571429,55.5285714285714,NA,356,109,151,174,154,428,247,277
2018,14,5,"Adiyaman",37.7648,38.2786,15.4571428571429,16.5,0,33.2571428571429,23.7142857142857,NA,407,76,217,64,85,486,331,269
2018,15,5,"Adiyaman",37.7648,38.2786,21,17.5857142857143,2.04171428571429,51.8,28.4271428571429,NA,374,66,156,14,46,450,308,294
2018,16,5,"Adiyaman",37.7648,38.2786,16.5285714285714,17.6142857142857,0.285571428571429,35.7714285714286,27.0185714285714,NA,411,15,84,58,120,648,396,564
2018,17,5,"Adiyaman",37.7648,38.2786,16.0714285714286,19.2285714285714,0.799857142857143,45.3571428571429,31.1557142857143,NA,419,116,245,43,54,652,303,407
2018,18,5,"Adiyaman",37.7648,38.2786,14.5857142857143,19.7714285714286,1.17028571428571,59.4285714285714,26.7242857142857,NA,303,151,189,14,11,474,152,285
2018,19,5,"Adiyaman",37.7648,38.2786,12.2428571428571,15.3,10.2215714285714,82.0428571428571,18.0871428571429,NA,275,111,157,44,55,467,164,310
2018,20,5,"Adiyaman",37.7648,38.2786,13.7714285714286,22.9,0.000142857142857143,41.2571428571429,21.2371428571429,NA,204,105,134,18,22,306,99,172
2018,21,5,"Adiyaman",37.7648,38.2786,13.2857142857143,23.7571428571429,1.57028571428571,43.8285714285714,39.6814285714286,NA,252,64,32,31,62,281,188,249
2018,22,5,"Adiyaman",37.7648,38.2786,16.6428571428571,21.8714285714286,1.24214285714286,54.7571428571429,31.9471428571429,NA,249,60,47,78,91,427,189,380
2018,23,5,"Adiyaman",37.7648,38.2786,14.7,25.7285714285714,4.994,38.0285714285714,29.0842857142857,NA,267,3,45,102,269,812,264,767
2018,24,5,"Adiyaman",37.7648,38.2786,14.5571428571429,25.6285714285714,0.730714285714286,42.9714285714286,38.2328571428571,NA,267,36,37,102,74,448,231,411
2018,25,5,"Adiyaman",37.7648,38.2786,22.0857142857143,26.6714285714286,0,40.8142857142857,22.6771428571429,NA,358,1,0,198,252,518,357,518
2018,26,5,"Adiyaman",37.7648,38.2786,18.6142857142857,28.9142857142857,0,35.8,43.17,NA,355,5,2,86,97,587,350,585
2018,27,5,"Adiyaman",37.7648,38.2786,16.4714285714286,31.8428571428571,0,24.7571428571429,40.02,NA,342,3,3,104,105,418,339,415
2018,28,5,"Adiyaman",37.7648,38.2786,17.0285714285714,31.7,0,32.4714285714286,47.1971428571429,NA,286,8,7,91,76,585,278,578
2018,29,5,"Adiyaman",37.7648,38.2786,22.7571428571429,30.0714285714286,0,27.9428571428571,33.0271428571429,NA,260,0,0,85,382,756,260,756
2018,30,5,"Adiyaman",37.7648,38.2786,20.6857142857143,29.8857142857143,0,32.6285714285714,45.3214285714286,NA,265,0,0,95,361,822,265,822
2018,31,5,"Adiyaman",37.7648,38.2786,17.8,31.7428571428571,0,33.7714285714286,29.99,NA,267,4,3,75,115,499,263,496
2018,32,5,"Adiyaman",37.7648,38.2786,21.7142857142857,30.6571428571429,0,29.0714285714286,27.9214285714286,NA,297,0,0,102,144,403,297,403
2018,33,5,"Adiyaman",37.7648,38.2786,20.1714285714286,31.1,0,23.7428571428571,33.31,NA,216,0,0,131,256,332,216,332
2018,34,5,"Adiyaman",37.7648,38.2786,16.7428571428571,31.2571428571429,0,27.9285714285714,33.0842857142857,NA,144,2,0,66,60,227,142,227
2018,35,5,"Adiyaman",37.7648,38.2786,14.3857142857143,30.4142857142857,0,29.5285714285714,41.5228571428571,NA,201,12,6,103,147,314,189,308
2018,36,5,"Adiyaman",37.7648,38.2786,14.4571428571429,27.5857142857143,2.99642857142857,34.2428571428571,34.5957142857143,NA,341,52,48,145,104,370,289,322
2018,37,5,"Adiyaman",37.7648,38.2786,16.2857142857143,25,0.188571428571429,40.4,40.2185714285714,NA,241,116,97,62,120,419,125,322
2018,38,5,"Adiyaman",37.7648,38.2786,17.8714285714286,26.3142857142857,0,25.9285714285714,27.2283333333333,NA,189,9,0,85,168,344,180,344
2018,39,5,"Adiyaman",37.7648,38.2786,14.8857142857143,24.9714285714286,0,29.4,43.3371428571429,NA,180,3,4,81,99,353,177,349
2018,40,5,"Adiyaman",37.7648,38.2786,16.9428571428571,22.6714285714286,0,30.8142857142857,38.6328571428571,NA,191,7,13,67,91,341,184,328
2018,41,5,"Adiyaman",37.7648,38.2786,13.8,21.3571428571429,0.276857142857143,46.1,89.1585714285714,NA,187,54,105,66,205,422,133,317
2018,42,5,"Adiyaman",37.7648,38.2786,15.7571428571429,19.8428571428571,3.89757142857143,55.3857142857143,118.33,NA,168,85,97,12,53,381,83,284
2018,43,5,"Adiyaman",37.7648,38.2786,18.8428571428571,14.2142857142857,7.336,72.3142857142857,34.808,NA,187,54,103,46,195,402,133,299
2018,44,5,"Adiyaman",37.7648,38.2786,12.9,16.0428571428571,0.724714285714286,45.4142857142857,55.6214285714286,NA,196,47,45,55,84,264,149,219
2018,45,5,"Adiyaman",37.7648,38.2786,11.5428571428571,12.2428571428571,3.85042857142857,76.6142857142857,48.7542857142857,NA,231,80,143,36,35,473,151,330
2018,46,5,"Adiyaman",37.7648,38.2786,14.8,9.24285714285714,1.57314285714286,63.9285714285714,59.6214285714286,NA,230,41,98,27,47,465,189,367
2018,47,5,"Adiyaman",37.7648,38.2786,10.9428571428571,9.97142857142857,1.45771428571429,77.8142857142857,75.6357142857143,NA,270,74,88,63,260,499,196,411
2018,48,5,"Adiyaman",37.7648,38.2786,18.7428571428571,10.0714285714286,9.30371428571429,88.0142857142857,38.9014285714286,NA,245,197,81,0,0,201,48,120
2018,49,5,"Adiyaman",37.7648,38.2786,12.4285714285714,9.01428571428571,6.00971428571429,87.0714285714286,40.98,NA,257,181,193,1,1,420,76,227
2018,50,5,"Adiyaman",37.7648,38.2786,17.6714285714286,7.7,15.3841428571429,82.9571428571429,39.4457142857143,NA,256,102,115,8,5,305,154,190
2018,51,5,"Adiyaman",37.7648,38.2786,15.3857142857143,6.72857142857143,13.3357142857143,86.6285714285714,49.2157142857143,NA,250,123,92,48,86,248,127,156
2018,52,5,"Adiyaman",37.7648,38.2786,20.6428571428571,4,15.6924285714286,78.8285714285714,20.2071428571429,NA,244,108,77,22,67,273,136,196
2019,1,5,"Adiyaman",37.7648,38.2786,19.4875,5.425,17.48475,89.3125,30.525,NA,343,175,438,31,25,784,168,346
2019,2,5,"Adiyaman",37.7648,38.2786,16.2571428571429,2.01428571428571,7.70928571428571,75.5,26.27,NA,255,66,32,70,36,208,189,176
2019,3,5,"Adiyaman",37.7648,38.2786,21.3428571428571,2.9,9.31985714285714,69.6714285714286,43.1714285714286,NA,192,83,95,38,81,198,109,103
2019,4,5,"Adiyaman",37.7648,38.2786,15.6,5.38571428571429,0.02,72.9,66.6316666666667,NA,308,167,50,2,6,314,141,264
2019,5,5,"Adiyaman",37.7648,38.2786,17.6428571428571,6.9,4.00842857142857,71.0428571428571,40.46,NA,253,58,50,39,33,143,195,93
2019,6,5,"Adiyaman",37.7648,38.2786,18.2428571428571,5.51428571428571,8.94128571428571,75.8428571428571,29.5928571428571,NA,276,205,69,0,0,127,71,58
2019,7,5,"Adiyaman",37.7648,38.2786,13.3428571428571,5.98571428571429,2.07357142857143,74.8142857142857,29.7214285714286,NA,325,54,15,74,107,234,271,219
2019,8,5,"Adiyaman",37.7648,38.2786,14.4857142857143,7.25714285714286,1.98485714285714,63.6714285714286,32.25,NA,305,156,87,93,94,219,149,132
2019,9,5,"Adiyaman",37.7648,38.2786,16.5,6.65714285714286,3.22628571428571,68.4,26.3714285714286,NA,331,42,90,136,84,310,289,220
2019,10,5,"Adiyaman",37.7648,38.2786,16.0857142857143,8.47142857142857,1.87485714285714,60.1857142857143,29.1142857142857,NA,359,114,45,64,65,252,245,207
2019,11,5,"Adiyaman",37.7648,38.2786,24.2714285714286,9.62857142857143,8.84985714285714,72.3857142857143,25.7257142857143,NA,373,224,224,66,73,400,149,176
2019,12,5,"Adiyaman",37.7648,38.2786,17.0428571428571,10.5857142857143,0.677142857142857,51.6285714285714,22.6771428571429,NA,343,89,318,15,23,416,254,98
2019,13,5,"Adiyaman",37.7648,38.2786,16.7857142857143,9.1,11.0221428571429,83.1142857142857,15.8266666666667,NA,256,125,89,7,9,194,131,105
2019,14,5,"Adiyaman",37.7648,38.2786,12.4714285714286,10.4857142857143,7.69271428571429,81.9428571428572,15.7471428571429,NA,365,166,90,49,13,208,199,118
2019,15,5,"Adiyaman",37.7648,38.2786,14.7142857142857,13.6714285714286,4.594,68.4714285714286,16.5657142857143,NA,359,140,52,53,13,183,219,131
2019,16,5,"Adiyaman",37.7648,38.2786,14.6285714285714,9.72857142857143,8.14514285714286,79,12.7042857142857,NA,318,119,47,94,34,208,199,161
2019,17,5,"Adiyaman",37.7648,38.2786,12.9142857142857,13.9714285714286,0.169571428571429,48.0428571428571,10.7614285714286,NA,412,65,60,113,86,313,347,253
2019,18,5,"Adiyaman",37.7648,38.2786,13.9571428571429,17.1285714285714,0.166714285714286,60,15.0142857142857,NA,523,134,72,92,44,353,389,281
2019,19,5,"Adiyaman",37.7648,38.2786,14.7285714285714,17.0714285714286,0.653428571428571,55.4428571428571,14.6971428571429,NA,452,167,133,72,55,386,285,253
2019,20,5,"Adiyaman",37.7648,38.2786,13.6142857142857,23.1142857142857,0,40.8857142857143,44.74,NA,454,138,121,52,61,389,316,268
2019,21,5,"Adiyaman",37.7648,38.2786,16.1285714285714,24.5571428571429,0,34.5,72.098,NA,457,3,5,370,358,413,454,408
2019,22,5,"Adiyaman",37.7648,38.2786,13.4857142857143,27.4428571428571,0.000142857142857143,28.5285714285714,73.98,NA,453,183,109,10,5,323,270,214
2019,23,5,"Adiyaman",37.7648,38.2786,19.3571428571429,26.9857142857143,0,29.2428571428571,83.9928571428571,NA,378,3,1,203,250,532,375,531
2019,24,5,"Adiyaman",37.7648,38.2786,15.2714285714286,25.6,0.857285714285714,41.0857142857143,68.07,NA,378,6,2,108,111,244,372,242
2019,25,5,"Adiyaman",37.7648,38.2786,15.9142857142857,25.9142857142857,0.368,46.9,64.51,NA,306,5,1,151,85,325,301,324
2019,26,5,"Adiyaman",37.7648,38.2786,19.0285714285714,30.1857142857143,0,28.9571428571429,67.2671428571429,NA,377,0,0,134,106,342,377,342
2019,27,5,"Adiyaman",37.7648,38.2786,18.6428571428571,28.7,0,26.7428571428571,53.1128571428571,NA,456,2,1,85,24,222,454,221
2019,28,5,"Adiyaman",37.7648,38.2786,24.0285714285714,28.8571428571429,0.0571428571428571,29.3714285714286,45.0433333333333,NA,398,0,0,206,195,421,398,421
2019,29,5,"Adiyaman",37.7648,38.2786,16.7571428571429,28.1,0,35.5428571428571,45.1028571428571,NA,453,1,0,372,150,203,452,203
2019,30,5,"Adiyaman",37.7648,38.2786,22.2857142857143,29.8571428571429,0.0285714285714286,30.7857142857143,42.8971428571429,NA,456,1,1,253,220,335,455,334
2019,31,5,"Adiyaman",37.7648,38.2786,18.4714285714286,31.3285714285714,0,28.7,56.9342857142857,NA,334,9,5,147,137,375,325,370
2019,32,5,"Adiyaman",37.7648,38.2786,19.0428571428571,30.6857142857143,0,23.1428571428571,39.8857142857143,NA,346,0,0,88,97,395,346,395
2019,33,5,"Adiyaman",37.7648,38.2786,18.3285714285714,31.2571428571429,0,28.9428571428571,61.5757142857143,NA,337,17,21,67,91,531,320,510
2019,34,5,"Adiyaman",37.7648,38.2786,13.4,28.6857142857143,0.114142857142857,36.4428571428571,53.4057142857143,NA,299,11,6,165,154,345,288,339
2019,35,5,"Adiyaman",37.7648,38.2786,17.8,28.9142857142857,1.584,33.9428571428571,69.73,NA,307,82,120,48,39,415,225,295
2019,36,5,"Adiyaman",37.7648,38.2786,16.6571428571429,27.6285714285714,0,24.9571428571429,42.0228571428571,NA,171,0,0,115,49,67,171,67
2019,37,5,"Adiyaman",37.7648,38.2786,16.3571428571429,26.1428571428571,0,28.5,44.5785714285714,NA,218,49,3,95,23,55,169,52
2019,38,5,"Adiyaman",37.7648,38.2786,17.6142857142857,23.0285714285714,0.146857142857143,37.9,56.3316666666667,NA,266,8,2,139,42,91,258,89
2019,39,5,"Adiyaman",37.7648,38.2786,12.7428571428571,22.7428571428571,0,33.9857142857143,60.7171428571429,NA,237,14,11,54,11,79,223,68
2019,40,5,"Adiyaman",37.7648,38.2786,15.2142857142857,23.2428571428571,0,34.6571428571429,72.72,NA,241,28,3,108,21,111,213,108
2019,41,5,"Adiyaman",37.7648,38.2786,14.5285714285714,22.9285714285714,0,35.6142857142857,69.0514285714286,NA,416,19,2,186,302,448,397,446
2019,42,5,"Adiyaman",37.7648,38.2786,13.7571428571429,20.9428571428571,0.457,44.0714285714286,78.4871428571429,NA,356,22,13,153,229,408,334,395
2019,43,5,"Adiyaman",37.7648,38.2786,13.0285714285714,16.7428571428571,1.588,63.2428571428571,57.9928571428571,NA,306,83,69,55,75,300,223,231
2019,44,5,"Adiyaman",37.7648,38.2786,14.0428571428571,13.6285714285714,2.78585714285714,65.5428571428571,64.77,NA,350,62,52,47,48,250,288,198
2019,45,5,"Adiyaman",37.7648,38.2786,11.9142857142857,13.9857142857143,0,49.2714285714286,98.9542857142857,NA,417,16,18,149,202,328,401,310
2019,46,5,"Adiyaman",37.7648,38.2786,12.5571428571429,13.8285714285714,0,37.5428571428571,114.712857142857,NA,401,60,40,75,106,337,341,297
2019,47,5,"Adiyaman",37.7648,38.2786,13.4285714285714,9.58571428571429,0,38.3571428571429,134.085,NA,391,142,109,140,122,339,249,230
2019,48,5,"Adiyaman",37.7648,38.2786,14.2857142857143,9.94285714285714,7.13571428571429,71.4,123.245714285714,NA,320,201,116,4,1,251,119,135
2019,49,5,"Adiyaman",37.7648,38.2786,14.5857142857143,6.58571428571429,11.122,72.1142857142857,101.362857142857,NA,393,119,79,122,87,274,274,195
2019,50,5,"Adiyaman",37.7648,38.2786,16.4571428571429,6.22857142857143,14.455,90.7714285714286,71.2357142857143,NA,218,129,51,4,0,119,89,68
2019,51,5,"Adiyaman",37.7648,38.2786,13.2142857142857,8.37142857142857,0,64.2714285714286,110.856666666667,NA,361,57,112,45,119,488,304,376
2019,52,5,"Adiyaman",37.7648,38.2786,20.8571428571429,6.48571428571429,17.5384285714286,85.3,39.2542857142857,NA,279,192,232,0,0,281,87,49
2020,1,5,"Adiyaman",37.7648,38.2786,14.3,4.34,14.3956,92.06,29.992,NA,160,100,90,10,0,126,60,36
2020,2,5,"Adiyaman",37.7648,38.2786,18.4285714285714,5.08571428571429,1.708,73.0142857142857,39.22,NA,240,90,50,23,28,173,150,123
2020,3,5,"Adiyaman",37.7648,38.2786,16.1,4.02857142857143,0.428714285714286,61.5142857142857,52.08,NA,270,36,80,33,77,382,234,302
2020,4,5,"Adiyaman",37.7648,38.2786,17.5142857142857,3.78571428571429,2.97271428571429,53.8571428571429,37.0657142857143,NA,358,80,94,62,76,295,278,201
2020,5,5,"Adiyaman",37.7648,38.2786,19.9,5.24285714285714,8.045,65.8857142857143,40.1685714285714,NA,331,127,147,48,45,272,204,125
2020,6,5,"Adiyaman",37.7648,38.2786,27.0142857142857,4.11428571428571,6.65128571428571,72.5,24.4428571428571,NA,343,237,204,37,6,267,106,63
2020,7,5,"Adiyaman",37.7648,38.2786,13.2714285714286,-0.9,0.637285714285714,61.9142857142857,26.9828571428571,NA,341,115,90,63,64,338,226,248
2020,8,5,"Adiyaman",37.7648,38.2786,16.1142857142857,7.61428571428571,2.36942857142857,73.1857142857143,41.2485714285714,NA,283,174,75,25,61,187,109,112
2020,9,5,"Adiyaman",37.7648,38.2786,15.4428571428571,9.38571428571429,0.594571428571429,58.3428571428571,35.2757142857143,NA,393,140,293,49,18,528,253,235
2020,10,5,"Adiyaman",37.7648,38.2786,15.5571428571429,11.6428571428571,0.856857142857143,50.8142857142857,39.5257142857143,NA,205,53,38,82,96,210,152,172
2020,11,5,"Adiyaman",37.7648,38.2786,19.4,13.9285714285714,5.589,62.1142857142857,35.8871428571429,NA,115,60,45,0,0,94,55,49
2020,12,5,"Adiyaman",37.7648,38.2786,18.1857142857143,8.61428571428571,15.7462857142857,75.8285714285714,20.6928571428571,NA,117,67,77,10,7,118,50,41
2020,13,5,"Adiyaman",37.7648,38.2786,17.1428571428571,11.2714285714286,7.95771428571429,72.8285714285714,23.4142857142857,NA,136,53,42,12,0,92,83,50
2020,14,5,"Adiyaman",37.7648,38.2786,17.2857142857143,9.9,12.2242857142857,75.0428571428571,18.6485714285714,NA,155,43,26,31,11,121,112,95
2020,15,5,"Adiyaman",37.7648,38.2786,15.6714285714286,13.0285714285714,1.75057142857143,62.7571428571429,20.6071428571429,NA,133,0,0,61,85,118,133,118
2020,16,5,"Adiyaman",37.7648,38.2786,14.3714285714286,15.3,0.109142857142857,50.3571428571429,23.1414285714286,NA,141,12,24,45,26,106,129,82
2020,17,5,"Adiyaman",37.7648,38.2786,16.1571428571429,15.1571428571429,1.135,54,26.2985714285714,NA,137,18,50,52,51,123,119,73
2020,18,5,"Adiyaman",37.7648,38.2786,16.2857142857143,15.0285714285714,4.08571428571429,62.8857142857143,17.52,NA,146,3,0,83,63,164,143,164
2020,19,5,"Adiyaman",37.7648,38.2786,18.2857142857143,16.0857142857143,2.11685714285714,58.3428571428571,15.9133333333333,NA,137,23,2,31,26,157,114,155
2020,20,5,"Adiyaman",37.7648,38.2786,15.2714285714286,22.7857142857143,0,38.3428571428571,NA,NA,164,1,3,85,89,164,163,161
2020,21,5,"Adiyaman",37.7648,38.2786,20.7428571428571,23.3571428571429,1.80628571428571,36.6,47.385,NA,146,0,0,67,33,96,146,96
2020,22,5,"Adiyaman",37.7648,38.2786,17.2142857142857,19.2428571428571,3.47842857142857,48.3,24.5685714285714,NA,118,35,22,35,21,100,83,78
2020,23,5,"Adiyaman",37.7648,38.2786,16.1857142857143,22.4285714285714,0,36.7714285714286,33.4,NA,112,2,2,42,32,70,110,68
2020,24,5,"Adiyaman",37.7648,38.2786,17.2428571428571,24.9,0.000571428571428571,38.0571428571429,51.6257142857143,NA,140,11,7,67,72,150,129,143
2020,25,5,"Adiyaman",37.7648,38.2786,17.3,25.4857142857143,0.0717142857142857,37.4857142857143,42.31,NA,137,0,0,106,81,108,137,108
2020,26,5,"Adiyaman",37.7648,38.2786,20.6142857142857,27.9714285714286,0,33.0857142857143,43.518,NA,173,4,3,87,62,133,169,130
2020,27,5,"Adiyaman",37.7648,38.2786,18.1714285714286,29.8571428571429,0,27.4571428571429,38.6757142857143,NA,113,9,4,41,70,113,104,109
2020,28,5,"Adiyaman",37.7648,38.2786,20.8857142857143,30.8428571428571,0.0142857142857143,30.8142857142857,44.1285714285714,NA,164,8,0,57,39,122,156,122
2020,29,5,"Adiyaman",37.7648,38.2786,15.9857142857143,30.7714285714286,0,29.4285714285714,43.2128571428571,NA,186,6,1,39,41,111,180,110
2020,30,5,"Adiyaman",37.7648,38.2786,16.6,31.8571428571429,0,28.6428571428571,58.17,NA,190,50,18,25,38,142,140,124
2020,31,5,"Adiyaman",37.7648,38.2786,17.0142857142857,32.3571428571429,0.199714285714286,23.8,45.0457142857143,NA,150,1,0,54,46,127,149,127
2020,32,5,"Adiyaman",37.7648,38.2786,19.7428571428571,30.8571428571429,0,23.2142857142857,29.8014285714286,NA,146,1,1,84,50,107,145,106
2020,33,5,"Adiyaman",37.7648,38.2786,22.0285714285714,28.9285714285714,0,30.0428571428571,36.6985714285714,NA,183,0,0,97,34,83,183,83
2020,34,5,"Adiyaman",37.7648,38.2786,18.7285714285714,28.3142857142857,0.0285714285714286,27.7571428571429,39.6971428571429,NA,197,0,0,121,39,97,197,97
2020,35,5,"Adiyaman",37.7648,38.2786,13.5571428571429,28.3857142857143,0,23.1714285714286,43.0371428571429,NA,164,3,1,55,51,157,161,156
2020,36,5,"Adiyaman",37.7648,38.2786,14.1285714285714,30.8857142857143,0,20.9142857142857,69.9257142857143,NA,179,16,24,83,40,112,163,88
2020,37,5,"Adiyaman",37.7648,38.2786,15.3428571428571,29.0285714285714,0,26.0428571428571,59.6557142857143,NA,193,14,2,52,36,91,179,89
2020,38,5,"Adiyaman",37.7648,38.2786,13.2428571428571,27.2285714285714,0,28.4428571428571,87.972,NA,235,4,3,105,44,157,231,154
2020,39,5,"Adiyaman",37.7648,38.2786,12.2142857142857,24.9,0.0565714285714286,40.3428571428571,76.4857142857143,NA,220,24,11,73,46,129,196,118
2020,40,5,"Adiyaman",37.7648,38.2786,16.3142857142857,24.4285714285714,0,33.9714285714286,62.3571428571429,NA,187,0,0,116,66,154,187,154
2020,41,5,"Adiyaman",37.7648,38.2786,12.6714285714286,20.7714285714286,0,24.4857142857143,53.8157142857143,NA,182,51,32,29,22,127,131,95
2020,42,5,"Adiyaman",37.7648,38.2786,10.1428571428571,20.8714285714286,0,30.9428571428571,96.1242857142857,NA,177,42,18,63,40,111,135,93
2020,43,5,"Adiyaman",37.7648,38.2786,11.7857142857143,20.0285714285714,0,36.5428571428571,84.65,NA,194,12,0,85,54,161,182,161
2020,44,5,"Adiyaman",37.7648,38.2786,14.1571428571429,19.8,0,29.3714285714286,125.76,NA,255,103,108,33,18,233,152,125
2020,45,5,"Adiyaman",37.7648,38.2786,18.3,13.6142857142857,16.8501428571429,73.5142857142857,54.8014285714286,NA,156,21,12,10,6,103,135,91
2020,46,5,"Adiyaman",37.7648,38.2786,10.0142857142857,11.8142857142857,0,58.8285714285714,90.0085714285714,NA,208,0,0,92,58,109,208,109
2020,47,5,"Adiyaman",37.7648,38.2786,11.3857142857143,8.74285714285714,3.15714285714286,70.5428571428571,87.5842857142857,NA,173,29,5,48,34,83,144,78
2020,48,5,"Adiyaman",37.7648,38.2786,16.5285714285714,7.57142857142857,0.452714285714286,61.2285714285714,98.1885714285714,NA,199,46,26,40,84,262,153,236
2020,49,5,"Adiyaman",37.7648,38.2786,15.2857142857143,7.92857142857143,9.90328571428571,75.5,102.802857142857,NA,207,41,12,24,15,116,166,104
2020,50,5,"Adiyaman",37.7648,38.2786,13.6,6.57142857142857,1.78671428571429,73.8714285714286,84.48,NA,181,55,14,23,38,98,126,84
2020,51,5,"Adiyaman",37.7648,38.2786,15.3428571428571,7.28571428571429,5.03528571428572,78.5857142857143,93.7071428571429,NA,171,32,14,65,40,90,139,76
2020,52,5,"Adiyaman",37.7648,38.2786,17.3285714285714,3.7,0.804428571428571,63.9571428571429,96.9714285714286,NA,203,0,0,82,30,113,203,113
2020,53,5,"Adiyaman",37.7648,38.2786,10.825,5.9,0,59.45,147.63,NA,122,0,0,25,16,111,122,111
2017,1,7,"Agri",39.7191,43.0513,7.71428571428571,-10.6857142857143,0,83.1428571428571,76.1142857142857,13.7357142857143,563,0,0,133,176,847,563,847
2017,2,7,"Agri",39.7191,43.0513,5.41428571428571,-13.7571428571429,0.3,86.4428571428571,139.168571428571,17.2742857142857,757,0,0,88,118,1214,757,1214
2017,3,7,"Agri",39.7191,43.0513,4.51428571428571,-12.5285714285714,0,85.6285714285714,131.3,15.3071428571429,762,231,369,32,17,1449,531,1080
2017,4,7,"Agri",39.7191,43.0513,12.7428571428571,-12.5,7.15714285714286,83.9714285714286,121.357142857143,18.96,639,153,181,37,55,889,486,708
2017,5,7,"Agri",39.7191,43.0513,9.62857142857143,-14.3571428571429,0.442857142857143,78.5,103.485714285714,14.7166666666667,588,147,274,109,156,1163,441,889
2017,6,7,"Agri",39.7191,43.0513,9.28571428571429,-7.14285714285714,0.0857142857142857,81.9142857142857,56.5257142857143,12.2266666666667,736,308,806,306,457,1519,428,713
2017,7,7,"Agri",39.7191,43.0513,9.1,-14.3285714285714,0.271428571428571,79.2857142857143,93.31,17.2416666666667,492,290,451,73,66,717,202,266
2017,8,7,"Agri",39.7191,43.0513,7.72857142857143,-11.3,0.285714285714286,79.7571428571429,105.443333333333,NA,739,118,263,327,777,1747,621,1484
2017,9,7,"Agri",39.7191,43.0513,7.25714285714286,-3,0.1,83.5,117.308571428571,NA,574,271,319,35,47,866,303,547
2017,10,7,"Agri",39.7191,43.0513,7.12857142857143,-2.21428571428571,0.471428571428571,80.5142857142857,85.51,15.2883333333333,712,213,247,145,241,1043,499,796
2017,11,7,"Agri",39.7191,43.0513,10.9571428571429,-0.942857142857143,1.91428571428571,83.7571428571429,45.9257142857143,12.4383333333333,525,62,54,232,443,725,463,671
2017,12,7,"Agri",39.7191,43.0513,10.6285714285714,-2.3,0.0714285714285714,69.9428571428572,35.912,7.52,589,82,180,271,546,1077,507,897
2017,13,7,"Agri",39.7191,43.0513,15.1142857142857,2.9,1.17142857142857,77.0714285714286,40.345,9.88666666666667,574,64,87,236,326,887,510,800
2017,14,7,"Agri",39.7191,43.0513,20.7857142857143,5.18571428571429,0.671428571428571,62.7571428571429,34.265,8.69333333333333,639,103,201,389,686,1336,536,1135
2017,15,7,"Agri",39.7191,43.0513,15.6428571428571,5.85714285714286,3.58571428571429,68.8428571428571,22.5957142857143,7.25571428571429,587,0,0,509,1061,1187,587,1187
2017,16,7,"Agri",39.7191,43.0513,20.3428571428571,9.62857142857143,0.914285714285714,64.2285714285714,27.8071428571429,6.02285714285714,717,0,0,607,799,920,717,920
2017,17,7,"Agri",39.7191,43.0513,20.3,9,0.642857142857143,52.6142857142857,26.5414285714286,4.85142857142857,731,358,740,213,447,1478,373,738
2017,18,7,"Agri",39.7191,43.0513,21.2571428571429,11.0857142857143,2.58571428571429,70.4142857142857,29.4314285714286,5.45,506,71,154,266,486,923,435,769
2017,19,7,"Agri",39.7191,43.0513,24.9285714285714,13.7,1.11428571428571,59.7285714285714,33.5742857142857,4.09571428571429,471,28,70,416,832,966,443,896
2017,20,7,"Agri",39.7191,43.0513,21.0571428571429,12.3142857142857,1.25714285714286,64.4571428571429,23.7214285714286,3.27428571428571,472,0,0,330,993,1205,472,1205
2017,21,7,"Agri",39.7191,43.0513,19.2714285714286,11.6571428571429,4.35714285714286,64.9142857142857,16.4942857142857,3.66571428571429,448,0,0,387,670,849,448,849
2017,22,7,"Agri",39.7191,43.0513,16.8142857142857,14.3285714285714,1.1,55.3857142857143,21.5414285714286,4.04833333333333,522,0,0,288,524,1015,522,1015
2017,23,7,"Agri",39.7191,43.0513,17.2857142857143,19.0142857142857,0,49.9285714285714,32.32,3.36714285714286,578,88,185,353,909,1388,490,1203
2017,24,7,"Agri",39.7191,43.0513,29.7714285714286,17.1714285714286,0.957142857142857,52.9857142857143,23.1528571428571,3.49428571428571,552,7,26,394,842,1139,545,1113
2017,25,7,"Agri",39.7191,43.0513,22.1857142857143,17.5285714285714,0.0571428571428571,51.2571428571429,20.6957142857143,3.45428571428571,584,0,0,311,504,1041,584,1041
2017,26,7,"Agri",39.7191,43.0513,16.4,21.8,0.3,46.5,26.2814285714286,2.74714285714286,564,353,599,58,120,971,211,372
2017,27,7,"Agri",39.7191,43.0513,20.1428571428571,22.6857142857143,0.128571428571429,45.7285714285714,34.67,3.08833333333333,511,211,304,84,116,642,300,338
2017,28,7,"Agri",39.7191,43.0513,22.2142857142857,22.0428571428571,0.257142857142857,46.9571428571429,29.2585714285714,3.22,481,301,585,0,0,864,180,279
2017,29,7,"Agri",39.7191,43.0513,18.2428571428571,24.8714285714286,0,34.8857142857143,42.8914285714286,3.85714285714286,532,158,421,181,369,1272,374,851
2017,30,7,"Agri",39.7191,43.0513,18.9571428571429,24,0.571428571428572,36.5428571428571,38.5414285714286,3.998,531,93,185,164,309,928,438,743
2017,31,7,"Agri",39.7191,43.0513,22.0142857142857,25.4571428571429,0.728571428571429,35.1285714285714,47.52,5.4575,559,407,715,72,209,1047,152,332
2017,32,7,"Agri",39.7191,43.0513,21.1571428571429,25.7,0,27.9857142857143,56.5342857142857,4.53285714285714,567,218,527,229,433,1092,349,565
2017,33,7,"Agri",39.7191,43.0513,20.8714285714286,21.8857142857143,0.914285714285714,48.1142857142857,39.51,4.11428571428571,596,268,530,107,221,1199,328,669
2017,34,7,"Agri",39.7191,43.0513,20.5428571428571,23.1428571428571,0,35.5142857142857,50.4271428571429,4.45428571428571,601,264,464,236,473,1280,337,816
2017,35,7,"Agri",39.7191,43.0513,17.4428571428571,21.9,0.0285714285714286,26.5142857142857,51.9142857142857,5.1025,493,33,31,388,772,1014,460,983
2017,36,7,"Agri",39.7191,43.0513,16.6571428571429,19.6571428571429,0,28.0857142857143,47.0014285714286,6.32,507,139,440,306,744,1321,368,881
2017,37,7,"Agri",39.7191,43.0513,16.0714285714286,20.3428571428571,0,31.0285714285714,54.5257142857143,5.4275,589,327,531,139,220,1138,262,607
2017,38,7,"Agri",39.7191,43.0513,12.8857142857143,19.4,0,31.5714285714286,63.8014285714286,4.965,671,279,460,91,245,1312,392,852
2017,39,7,"Agri",39.7191,43.0513,24.1142857142857,15.5714285714286,0.0285714285714286,43.7428571428571,47.93,3.41571428571429,782,295,787,296,393,1630,487,843
2017,40,7,"Agri",39.7191,43.0513,14.4571428571429,8.37142857142857,2.95714285714286,63.0571428571429,25.8971428571429,5.00571428571429,543,277,594,209,398,1137,266,543
2017,41,7,"Agri",39.7191,43.0513,14.5142857142857,12.8571428571429,1.48571428571429,66.2714285714286,30.9857142857143,5.99714285714286,487,0,0,416,730,843,487,843
2017,42,7,"Agri",39.7191,43.0513,13.5428571428571,12.1,0.0428571428571429,64.1857142857143,51.6328571428571,6.99714285714286,530,147,291,272,377,815,383,524
2017,43,7,"Agri",39.7191,43.0513,14.9,13.6571428571429,6.9,66.0714285714286,80.1814285714286,9.59571428571429,506,0,0,361,559,919,506,919
2017,44,7,"Agri",39.7191,43.0513,16.9428571428571,9.87142857142857,1.3,71,56.33,7.96142857142857,561,0,0,324,606,1102,561,1102
2017,45,7,"Agri",39.7191,43.0513,8.58571428571429,10.7714285714286,4.5,80.4,53.3,9.16285714285714,577,55,64,307,301,829,522,765
2017,46,7,"Agri",39.7191,43.0513,10.6142857142857,10.4428571428571,0.128571428571429,72.7142857142857,94.7714285714286,11.0616666666667,587,200,436,255,465,1085,387,649
2017,47,7,"Agri",39.7191,43.0513,21.8142857142857,5.67142857142857,1.94285714285714,68.2142857142857,36.1857142857143,9.43571428571429,418,0,0,314,644,804,418,804
2017,48,7,"Agri",39.7191,43.0513,8.87142857142857,6.18571428571429,0.771428571428571,73.1142857142857,60.1457142857143,9.31285714285714,386,128,209,185,273,619,258,410
2017,49,7,"Agri",39.7191,43.0513,19.8428571428571,3.77142857142857,2.71428571428571,70.2,101.544285714286,10.4642857142857,407,7,16,242,351,645,400,629
2017,50,7,"Agri",39.7191,43.0513,11.4285714285714,1.67142857142857,0,76.7857142857143,132.591428571429,10.9542857142857,346,52,33,75,79,442,294,409
2017,51,7,"Agri",39.7191,43.0513,19.3142857142857,6,1.65714285714286,85.7571428571429,142.45,16.5671428571429,386,39,24,330,269,349,347,325
2017,52,7,"Agri",39.7191,43.0513,10.5875,3.775,1.4125,71.125,92.3875,14.11125,528,38,13,212,222,507,490,494
2018,1,7,"Agri",39.7191,43.0513,11.8,4.325,1.9375,82.3625,66.10125,15.00625,618,184,298,55,94,914,434,616
2018,2,7,"Agri",39.7191,43.0513,18.2714285714286,2.35714285714286,0.271428571428571,82.6285714285714,79.7757142857143,10.9014285714286,624,106,104,76,103,1309,518,1205
2018,3,7,"Agri",39.7191,43.0513,18.3428571428571,2.91428571428571,2.34285714285714,76.3428571428571,83.3942857142857,13.4771428571429,639,51,59,424,480,655,588,596
2018,4,7,"Agri",39.7191,43.0513,15.4857142857143,1.91428571428571,0.885714285714286,81.5285714285714,80.0928571428571,11.7814285714286,604,84,89,252,336,764,520,675
2018,5,7,"Agri",39.7191,43.0513,12.5857142857143,1.82857142857143,0,68.9428571428572,83.4885714285714,10.19,670,3,14,403,546,819,667,805
2018,6,7,"Agri",39.7191,43.0513,21.3428571428571,3.84285714285714,0.1,83.5428571428571,137.14,9.96571428571429,704,436,642,83,146,1022,268,380
2018,7,7,"Agri",39.7191,43.0513,17.8,5.58571428571429,1.11428571428571,82.0285714285714,57.4442857142857,10.1942857142857,478,172,233,63,97,557,306,324
2018,8,7,"Agri",39.7191,43.0513,14.7,4.22857142857143,0.442857142857143,80.1857142857143,41.54,8.54142857142857,711,313,590,160,388,1321,398,731
2018,9,7,"Agri",39.7191,43.0513,30.1428571428571,6.2,0.628571428571429,76.3142857142857,34.1642857142857,8.71857142857143,621,0,0,464,749,956,621,956
2018,10,7,"Agri",39.7191,43.0513,22.0714285714286,7.91428571428571,5.38571428571429,77.9,41.7471428571429,8.07,556,0,0,301,802,1330,556,1330
2018,11,7,"Agri",39.7191,43.0513,16.7857142857143,8.88571428571429,0.471428571428571,73.4285714285714,40.63,7.98,551,65,255,303,760,1426,486,1171
2018,12,7,"Agri",39.7191,43.0513,27.9428571428571,11.7857142857143,1.37142857142857,63.7142857142857,NA,6.82,425,0,0,347,956,1187,425,1187
2018,13,7,"Agri",39.7191,43.0513,17.9285714285714,10.3857142857143,3.75714285714286,70.9857142857143,50.1257142857143,5.22571428571429,356,66,76,148,195,428,290,352
2018,14,7,"Agri",39.7191,43.0513,14.1714285714286,9.97142857142857,0.2,62,34.8214285714286,5.79857142857143,407,54,41,63,65,486,353,445
2018,15,7,"Agri",39.7191,43.0513,16.6714285714286,11.1571428571429,0.0857142857142857,71.7571428571429,38.83,6.06285714285714,374,176,274,0,0,450,198,176
2018,16,7,"Agri",39.7191,43.0513,16.2714285714286,10.2285714285714,0.885714285714286,66.2142857142857,30.98,6.37666666666667,411,121,109,178,332,648,290,539
2018,17,7,"Agri",39.7191,43.0513,14.6714285714286,13.1285714285714,2.32857142857143,68.0428571428571,36.1171428571429,5.67857142857143,419,238,407,56,94,652,181,245
2018,18,7,"Agri",39.7191,43.0513,13.5714285714286,14.8285714285714,0.585714285714286,78.1,31.9457142857143,4.69142857142857,303,245,358,0,0,474,58,116
2018,19,7,"Agri",39.7191,43.0513,14.6714285714286,14.1142857142857,3.97142857142857,81.0428571428571,20.9885714285714,5.26714285714286,275,0,0,165,225,467,275,467
2018,20,7,"Agri",39.7191,43.0513,14.5857142857143,16.0142857142857,3.1,74.5285714285714,27.1116666666667,4.205,204,167,217,26,78,306,37,89
2018,21,7,"Agri",39.7191,43.0513,16.4428571428571,18.0428571428571,3.37142857142857,77.9142857142857,30.44,4.64142857142857,252,153,185,37,38,281,99,96
2018,22,7,"Agri",39.7191,43.0513,15.7285714285714,18.0285714285714,5.24285714285714,73.3857142857143,33.1171428571429,4.34,249,0,0,112,242,427,249,427
2018,23,7,"Agri",39.7191,43.0513,12.1428571428571,18.7285714285714,3.01428571428571,73.2857142857143,22.9942857142857,4.54428571428571,267,172,453,0,0,812,95,359
2018,24,7,"Agri",39.7191,43.0513,15.5142857142857,20.7,0.771428571428571,69.1428571428571,29.1414285714286,3.97714285714286,267,61,85,39,162,448,206,363
2018,25,7,"Agri",39.7191,43.0513,13,21.2428571428571,2.04285714285714,69.1857142857143,24.7066666666667,4.03,358,116,134,43,60,518,242,384
2018,26,7,"Agri",39.7191,43.0513,14.4,24.4,0,65.4571428571429,52.818,4.58428571428571,355,170,280,146,241,587,185,307
2018,27,7,"Agri",39.7191,43.0513,16,24.5142857142857,0,58.4714285714286,63.3128571428571,4.78,342,3,22,121,133,418,339,396
2018,28,7,"Agri",39.7191,43.0513,19.5142857142857,25.7142857142857,0.0428571428571429,59.5571428571429,83.2328571428571,6.50285714285714,286,60,114,109,300,585,226,471
2018,29,7,"Agri",39.7191,43.0513,14.4714285714286,23.6714285714286,0.457142857142857,58.7571428571429,51.4085714285714,5.08571428571429,260,110,282,66,147,756,150,474
2018,30,7,"Agri",39.7191,43.0513,15.9428571428571,25.9571428571429,0.728571428571429,55.5714285714286,74.0814285714286,6.54833333333333,265,0,0,197,700,822,265,822
2018,31,7,"Agri",39.7191,43.0513,18.7571428571429,25.4857142857143,0.757142857142857,59.5,67.6628571428571,4.78285714285714,267,38,85,82,145,499,229,414
2018,32,7,"Agri",39.7191,43.0513,24.3,25.2,0.0142857142857143,56.7,65.7814285714286,3.96857142857143,297,29,24,72,87,403,268,379
2018,33,7,"Agri",39.7191,43.0513,15.5428571428571,24.3571428571429,0.714285714285714,59.4571428571429,65.7671428571429,4.15571428571429,216,105,161,6,33,332,111,171
2018,34,7,"Agri",39.7191,43.0513,13.0142857142857,24.3428571428571,0.314285714285714,57.3714285714286,41.1457142857143,3.67857142857143,144,109,145,0,0,227,35,82
2018,35,7,"Agri",39.7191,43.0513,14.1714285714286,25.4571428571429,0,58.2571428571429,79.1714285714286,4.54142857142857,201,130,206,30,73,314,71,108
2018,36,7,"Agri",39.7191,43.0513,19.4285714285714,23.2285714285714,0.2,57.5285714285714,68.6914285714286,6.02142857142857,341,97,139,129,124,370,244,231
2018,37,7,"Agri",39.7191,43.0513,17.4428571428571,21.5142857142857,0.0857142857142857,60.9,56.8614285714286,6.20714285714286,241,36,67,171,305,419,205,352
2018,38,7,"Agri",39.7191,43.0513,15.3,20.2285714285714,0.342857142857143,65.5428571428571,45.7057142857143,5.45428571428571,189,66,114,47,112,344,123,230
2018,39,7,"Agri",39.7191,43.0513,19.9857142857143,18.7428571428571,0,60.1571428571429,75.4783333333333,6.44857142857143,180,27,53,73,120,353,153,300
2018,40,7,"Agri",39.7191,43.0513,18.7857142857143,18.0142857142857,0.0714285714285714,62.0571428571429,65.1771428571429,4.5,191,9,28,116,176,341,182,313
2018,41,7,"Agri",39.7191,43.0513,10.4714285714286,17.9142857142857,0.385714285714286,72.8714285714286,64.79,5.35714285714286,187,26,16,122,269,422,161,406
2018,42,7,"Agri",39.7191,43.0513,8.58571428571429,18.1285714285714,0.285714285714286,69.8714285714286,78.5966666666667,5.91714285714286,168,71,113,60,58,381,97,268
2018,43,7,"Agri",39.7191,43.0513,21.5,12.4714285714286,8.38571428571429,76.8428571428571,41.2657142857143,11.2685714285714,187,30,55,120,211,402,157,347
2018,44,7,"Agri",39.7191,43.0513,10.4142857142857,11.6714285714286,0,71.6142857142857,97.0671428571429,11.4871428571429,196,133,199,0,0,264,63,65
2018,45,7,"Agri",39.7191,43.0513,10.3142857142857,10.3428571428571,1.7,78.2142857142857,43.3842857142857,12.3542857142857,231,157,372,7,26,473,74,101
2018,46,7,"Agri",39.7191,43.0513,14.8142857142857,7.22857142857143,3.5,77.0428571428571,64.1657142857143,16.0028571428571,230,0,0,164,309,465,230,465
2018,47,7,"Agri",39.7191,43.0513,12.8714285714286,7.82857142857143,0.571428571428572,81.2571428571429,66.4128571428571,16.0342857142857,270,58,245,140,197,499,212,254
2018,48,7,"Agri",39.7191,43.0513,14.1,9,5.02857142857143,80.6571428571429,54.0228571428571,15.4285714285714,245,0,0,147,106,201,245,201
2018,49,7,"Agri",39.7191,43.0513,13.7571428571429,6.07142857142857,1.24285714285714,83.4,82.0985714285714,19.3857142857143,257,9,21,133,282,420,248,399
2018,50,7,"Agri",39.7191,43.0513,14.4571428571429,5.24285714285714,5.82857142857143,76.3142857142857,35.7028571428571,14.5442857142857,256,0,0,118,153,305,256,305
2018,51,7,"Agri",39.7191,43.0513,11.7,5.47142857142857,0.1,84.3428571428571,55.5885714285714,11.71,250,17,12,82,180,248,233,236
2018,52,7,"Agri",39.7191,43.0513,17.1142857142857,3.02857142857143,3.21428571428571,75.8714285714286,42.0514285714286,17.9783333333333,244,0,0,201,221,273,244,273
2019,1,7,"Agri",39.7191,43.0513,16.2375,2.925,1.125,81.525,106.123333333333,28.62,343,49,284,162,305,784,294,500
2019,2,7,"Agri",39.7191,43.0513,20.6285714285714,-0.757142857142857,3.55714285714286,71.5142857142857,73.4528571428571,28.55,255,0,0,175,165,208,255,208
2019,3,7,"Agri",39.7191,43.0513,18.4857142857143,0.457142857142857,0.742857142857143,69.8142857142857,73.23,36.88,192,0,0,161,140,198,192,198
2019,4,7,"Agri",39.7191,43.0513,14.5857142857143,2.27142857142857,0.285714285714286,70.6,NA,NA,308,9,15,100,91,314,299,299
2019,5,7,"Agri",39.7191,43.0513,14.5142857142857,3.57142857142857,1.82857142857143,76.6428571428571,NA,NA,253,45,29,93,35,143,208,114
2019,6,7,"Agri",39.7191,43.0513,12.9714285714286,1.92857142857143,1.25714285714286,83.2571428571429,NA,NA,276,40,12,84,45,127,236,115
2019,7,7,"Agri",39.7191,43.0513,18.3857142857143,1.4,1.14285714285714,80.2142857142857,NA,NA,325,92,109,73,29,234,233,125
2019,8,7,"Agri",39.7191,43.0513,19.5,0.657142857142857,0,80.4428571428571,NA,NA,305,46,11,63,105,219,259,208
2019,9,7,"Agri",39.7191,43.0513,19.3714285714286,1.07142857142857,3.97142857142857,79.7428571428571,NA,NA,331,0,0,146,210,310,331,310
2019,10,7,"Agri",39.7191,43.0513,15.7285714285714,3.4,1.34285714285714,75.1857142857143,NA,NA,359,139,80,94,126,252,220,172
2019,11,7,"Agri",39.7191,43.0513,18.9428571428571,5.82857142857143,0.285714285714286,81.0857142857143,NA,NA,373,3,12,33,150,400,370,388
2019,12,7,"Agri",39.7191,43.0513,13.7,2.78571428571429,2.42857142857143,75.9142857142857,NA,NA,343,132,312,99,52,416,211,104
2019,13,7,"Agri",39.7191,43.0513,16.0857142857143,4.21428571428571,3.51428571428571,79.8857142857143,NA,NA,256,115,80,54,79,194,141,114
2019,14,7,"Agri",39.7191,43.0513,12.2571428571429,6.18571428571429,1.91428571428571,84.6428571428571,NA,NA,365,262,130,50,51,208,103,78
2019,15,7,"Agri",39.7191,43.0513,20.6142857142857,10.9285714285714,1.35714285714286,72.3714285714286,NA,NA,359,52,13,144,98,183,307,170
2019,16,7,"Agri",39.7191,43.0513,19.8714285714286,7.85714285714286,4.5,78.7428571428571,NA,NA,318,7,6,148,116,208,311,202
2019,17,7,"Agri",39.7191,43.0513,13.9714285714286,8.7,0.285714285714286,68.9857142857143,NA,NA,412,255,193,87,27,313,157,120
2019,18,7,"Agri",39.7191,43.0513,15.8857142857143,13.4285714285714,5.37142857142857,72.8714285714286,NA,NA,523,0,0,432,322,353,523,353
2019,19,7,"Agri",39.7191,43.0513,20.5,14.6,0.3,69.6571428571429,NA,NA,452,0,0,288,235,386,452,386
2019,20,7,"Agri",39.7191,43.0513,16.9571428571429,16.7285714285714,0.614285714285714,66.6285714285714,NA,NA,454,58,63,312,255,389,396,326
2019,21,7,"Agri",39.7191,43.0513,23.1428571428571,17.5714285714286,0.214285714285714,71.4428571428572,NA,NA,457,76,77,287,214,413,381,336
2019,22,7,"Agri",39.7191,43.0513,11.9142857142857,19.0857142857143,0,63.5714285714286,NA,6.5,453,264,189,56,59,323,189,134
2019,23,7,"Agri",39.7191,43.0513,14.4428571428571,22.7142857142857,0,67.0428571428571,NA,5.98,378,115,245,217,192,532,263,287
2019,24,7,"Agri",39.7191,43.0513,16.5571428571429,22.0142857142857,1.81428571428571,68.2714285714286,NA,6.985,378,156,168,106,32,244,222,76
2019,25,7,"Agri",39.7191,43.0513,21.3,23.1857142857143,1.1,67.5,NA,NA,306,188,199,0,0,325,118,126
2019,26,7,"Agri",39.7191,43.0513,17.2285714285714,24.1142857142857,1.64285714285714,61.7285714285714,NA,NA,377,94,46,32,27,342,283,296
2019,27,7,"Agri",39.7191,43.0513,14.8428571428571,21.7714285714286,0.3,57.3285714285714,NA,NA,456,263,82,55,36,222,193,140
2019,28,7,"Agri",39.7191,43.0513,17.8428571428571,22.7857142857143,1.02857142857143,58.8142857142857,NA,NA,398,113,149,215,211,421,285,272
2019,29,7,"Agri",39.7191,43.0513,18.2142857142857,23.8428571428571,0,55.4,NA,NA,453,62,8,259,113,203,391,195
2019,30,7,"Agri",39.7191,43.0513,16.9142857142857,24.7,0.428571428571429,53.4857142857143,NA,NA,456,81,38,260,211,335,375,297
2019,31,7,"Agri",39.7191,43.0513,16.9285714285714,25.5857142857143,0,57.5285714285714,NA,NA,334,30,39,208,252,375,304,336
2019,32,7,"Agri",39.7191,43.0513,18.7857142857143,23.5142857142857,0,58.1285714285714,NA,NA,346,252,264,51,39,395,94,131
2019,33,7,"Agri",39.7191,43.0513,16.2142857142857,25.3142857142857,0.0285714285714286,58.5857142857143,NA,NA,337,82,78,148,286,531,255,453
2019,34,7,"Agri",39.7191,43.0513,17.8142857142857,25.0857142857143,0.0285714285714286,59.8142857142857,NA,NA,299,54,38,159,163,345,245,307
2019,35,7,"Agri",39.7191,43.0513,14.8857142857143,23.8714285714286,0.0714285714285714,60.7142857142857,NA,NA,307,62,74,109,179,415,245,341
2019,36,7,"Agri",39.7191,43.0513,15.4142857142857,22.1285714285714,0.357142857142857,61.3,NA,NA,171,105,27,22,5,67,66,40
2019,37,7,"Agri",39.7191,43.0513,18.3285714285714,20.2857142857143,0.0714285714285714,65.4428571428572,NA,NA,218,127,29,59,19,55,91,26
2019,38,7,"Agri",39.7191,43.0513,19,19.6714285714286,0,59.0428571428571,NA,NA,266,0,0,195,69,91,266,91
2019,39,7,"Agri",39.7191,43.0513,19.5571428571429,18.8714285714286,1.51428571428571,63.4857142857143,NA,NA,237,37,4,139,52,79,200,75
2019,40,7,"Agri",39.7191,43.0513,13.2571428571429,18.8714285714286,0.128571428571429,65.0428571428571,NA,NA,241,39,11,106,40,111,202,100
2019,41,7,"Agri",39.7191,43.0513,19.8428571428571,17.5571428571429,0.0714285714285714,64.5857142857143,NA,NA,416,1,0,267,257,448,415,448
2019,42,7,"Agri",39.7191,43.0513,11.8714285714286,17.4571428571429,0.285714285714286,67.0857142857143,NA,NA,356,18,15,41,53,408,338,393
2019,43,7,"Agri",39.7191,43.0513,11.8428571428571,15.9714285714286,1.27142857142857,76.6,NA,NA,306,0,0,129,124,300,306,300
2019,44,7,"Agri",39.7191,43.0513,17.0857142857143,12.0714285714286,0.257142857142857,74.6714285714286,NA,NA,350,0,0,223,156,250,350,250
2019,45,7,"Agri",39.7191,43.0513,9.2,11.3428571428571,0,65.1142857142857,NA,NA,417,19,29,240,171,328,398,299
2019,46,7,"Agri",39.7191,43.0513,8.2,10.8285714285714,0,65.9428571428572,NA,NA,401,332,316,0,0,337,69,21
2019,47,7,"Agri",39.7191,43.0513,9.02857142857143,8.42857142857143,0,67.4571428571429,NA,NA,391,41,88,179,161,339,350,251
2019,48,7,"Agri",39.7191,43.0513,19.3428571428571,10.3428571428571,3.18571428571429,74.8285714285714,NA,NA,320,4,2,238,217,251,316,249
2019,49,7,"Agri",39.7191,43.0513,14.6,4.18571428571429,5.11428571428571,82.6285714285714,NA,NA,393,93,61,125,86,274,300,213
2019,50,7,"Agri",39.7191,43.0513,10.5285714285714,6.32857142857143,0.6,75.0714285714286,NA,NA,218,0,0,75,23,119,218,119
2019,51,7,"Agri",39.7191,43.0513,8.21428571428571,5.47142857142857,0,77.3,NA,NA,361,0,0,154,166,488,361,488
2019,52,7,"Agri",39.7191,43.0513,14.5571428571429,7.18571428571429,1.97142857142857,74.1,NA,NA,279,0,0,222,243,281,279,281
2020,1,7,"Agri",39.7191,43.0513,12.28,2.3,0.62,88.22,NA,NA,160,0,0,124,105,126,160,126
2020,2,7,"Agri",39.7191,43.0513,18.2142857142857,0.585714285714286,0.142857142857143,81.3571428571429,NA,NA,240,54,34,126,85,173,186,139
2020,3,7,"Agri",39.7191,43.0513,13.6,-1.41428571428571,0.285714285714286,80.0571428571428,NA,NA,270,42,96,208,279,382,228,286
2020,4,7,"Agri",39.7191,43.0513,17.7571428571429,-1.14285714285714,0.228571428571429,76.6,NA,NA,358,0,0,358,295,295,358,295
2020,5,7,"Agri",39.7191,43.0513,16.4285714285714,1.77142857142857,3.84285714285714,73.4,NA,NA,331,0,0,225,194,272,331,272
2020,6,7,"Agri",39.7191,43.0513,30.2285714285714,3.72857142857143,1.17142857142857,74.2714285714286,NA,NA,343,0,0,339,265,267,343,267
2020,7,7,"Agri",39.7191,43.0513,18.8,-2.64285714285714,1.02857142857143,70.9857142857143,NA,NA,341,0,0,166,224,338,341,338
2020,8,7,"Agri",39.7191,43.0513,13.6142857142857,4,0.114285714285714,82.3714285714286,NA,23.2,283,82,43,5,12,187,201,144
2020,9,7,"Agri",39.7191,43.0513,26.1571428571429,3.97142857142857,1.88571428571429,77.1,NA,12.2216666666667,393,46,15,326,497,528,347,513
2020,10,7,"Agri",39.7191,43.0513,12.3714285714286,6.05714285714286,0.6,73.4428571428572,NA,11.7585714285714,205,55,77,49,42,210,150,133
2020,11,7,"Agri",39.7191,43.0513,14.5428571428571,7.94285714285714,1.82857142857143,85.7428571428571,NA,11.9757142857143,115,58,71,37,9,94,57,23
2020,12,7,"Agri",39.7191,43.0513,16.3,5.11428571428571,4.62857142857143,84.1285714285714,NA,9.94,117,23,16,55,56,118,94,102
2020,13,7,"Agri",39.7191,43.0513,16.4285714285714,8.51428571428571,3.42857142857143,83.0428571428571,37.31,9.40857142857143,136,21,25,46,17,92,115,67
2020,14,7,"Agri",39.7191,43.0513,19.9142857142857,7.54285714285714,3.88571428571429,81.4857142857143,19.15,7.12571428571429,155,0,0,113,93,121,155,121
2020,15,7,"Agri",39.7191,43.0513,22.8714285714286,5.34285714285714,2.1,72.2428571428571,20.3657142857143,6.58714285714286,133,61,17,17,18,118,72,101
2020,16,7,"Agri",39.7191,43.0513,21.8285714285714,8.18571428571429,1.14285714285714,61.9571428571429,33.7914285714286,7.13857142857143,141,29,7,92,86,106,112,99
2020,17,7,"Agri",39.7191,43.0513,23.6142857142857,7.34285714285714,9.4,82.5428571428571,22.5314285714286,7.515,137,25,11,107,100,123,112,112
2020,18,7,"Agri",39.7191,43.0513,22.5571428571429,8.17142857142857,2.34285714285714,76.6571428571429,26.16,NA,146,5,3,59,48,164,141,161
2020,19,7,"Agri",39.7191,43.0513,29.0714285714286,10,6.78571428571429,79.4571428571429,19.2342857142857,NA,137,11,3,70,64,157,126,154
2020,20,7,"Agri",39.7191,43.0513,19.1,14.5571428571429,0.0142857142857143,59.0142857142857,41.9785714285714,NA,164,69,31,51,55,164,95,133
2020,21,7,"Agri",39.7191,43.0513,29.1571428571429,15.0714285714286,0.528571428571429,54.2,43.3957142857143,NA,146,48,26,41,44,96,98,70
2020,22,7,"Agri",39.7191,43.0513,23.3428571428571,14.8428571428571,0.685714285714286,59.8142857142857,30.42,NA,118,38,27,72,46,100,80,73
2020,23,7,"Agri",39.7191,43.0513,19.5428571428571,17.8571428571429,0.257142857142857,73.9571428571429,41.7842857142857,NA,112,24,17,58,37,70,88,53
2020,24,7,"Agri",39.7191,43.0513,18.9,21.0571428571429,0.457142857142857,67.9571428571429,42.6675,NA,140,56,98,66,43,150,84,52
2020,25,7,"Agri",39.7191,43.0513,18.5285714285714,21.1714285714286,4.22857142857143,72.7285714285714,37.04,5.906,137,47,23,41,41,108,90,85
2020,26,7,"Agri",39.7191,43.0513,19.5428571428571,22.6857142857143,1.2,67.1285714285714,36.9271428571429,5.44142857142857,173,45,44,32,38,133,128,89
2020,27,7,"Agri",39.7191,43.0513,14.6142857142857,22.6571428571429,1.18571428571429,65.9142857142857,35.2614285714286,5.19428571428571,113,100,77,0,0,113,13,36
2020,28,7,"Agri",39.7191,43.0513,17.0285714285714,24.3714285714286,0.485714285714286,67.7285714285714,35.5557142857143,4.74285714285714,164,61,46,34,30,122,103,76
2020,29,7,"Agri",39.7191,43.0513,16.7,24.2714285714286,1.91428571428571,67.5,38.7757142857143,5.16,186,79,67,61,28,111,107,44
2020,30,7,"Agri",39.7191,43.0513,17.7,25.1428571428571,0.485714285714286,64.1857142857143,45.0128571428571,5.74571428571429,190,39,13,13,24,142,151,129
2020,31,7,"Agri",39.7191,43.0513,17.8142857142857,24.6428571428571,1.01428571428571,65.6,41.6814285714286,5.40571428571429,150,57,31,66,75,127,93,96
2020,32,7,"Agri",39.7191,43.0513,13.3857142857143,23.8571428571429,0.685714285714286,60.9,31.0985714285714,5.05142857142857,146,131,78,0,0,107,15,29
2020,33,7,"Agri",39.7191,43.0513,21.3428571428571,23.6428571428571,1.14285714285714,63.1142857142857,36.6542857142857,6.69857142857143,183,28,7,28,13,83,155,76
2020,34,7,"Agri",39.7191,43.0513,17.7428571428571,22.8,0.9,63.0285714285714,38.7742857142857,8.11285714285714,197,103,56,65,22,97,94,41
2020,35,7,"Agri",39.7191,43.0513,9.71428571428572,22.5,0,63.3428571428571,30.7985714285714,9.24142857142857,164,82,101,8,4,157,82,56
2020,36,7,"Agri",39.7191,43.0513,16.7571428571429,24.7428571428571,0,60.2428571428571,59.1457142857143,9.56428571428571,179,40,28,52,40,112,139,84
2020,37,7,"Agri",39.7191,43.0513,11.6857142857143,23.9571428571429,0,63.7571428571429,54.6742857142857,9.47857142857143,193,41,14,62,30,91,152,77
2020,38,7,"Agri",39.7191,43.0513,13.7285714285714,23.1857142857143,0,62.9285714285714,58.4714285714286,10.5,235,0,0,86,79,157,235,157
2020,39,7,"Agri",39.7191,43.0513,12.9428571428571,21.3,0.114285714285714,71.3142857142857,51.7571428571429,9.45285714285714,220,30,8,154,105,129,190,121
2020,40,7,"Agri",39.7191,43.0513,17.8,20.5142857142857,0.0285714285714286,69.0285714285714,46.17,8.47571428571429,187,93,63,94,91,154,94,91
2020,41,7,"Agri",39.7191,43.0513,14.2428571428571,16.9142857142857,0.0571428571428571,73.6142857142857,29.5028571428571,8.08714285714286,182,133,96,0,0,127,49,31
2020,42,7,"Agri",39.7191,43.0513,11.0571428571429,19.1,0,64.2714285714286,79.78,13.6557142857143,177,28,9,67,67,111,149,102
2020,43,7,"Agri",39.7191,43.0513,13.7571428571429,16.7857142857143,0.0571428571428571,73.3714285714286,98.2871428571429,14.32,194,28,8,45,56,161,166,153
2020,44,7,"Agri",39.7191,43.0513,14.8857142857143,17.1857142857143,0,72.9,133.84,17.8557142857143,255,0,0,183,187,233,255,233
2020,45,7,"Agri",39.7191,43.0513,18,13.6,2.12857142857143,83.8,43.588,13.026,156,0,0,109,78,103,156,103
2020,46,7,"Agri",39.7191,43.0513,13,11.2857142857143,0,75.1857142857143,107.14,14.3985714285714,208,30,20,57,33,109,178,89
2020,47,7,"Agri",39.7191,43.0513,15.8857142857143,9.31428571428571,0.2,82.5571428571429,82.1957142857143,15.2614285714286,173,0,0,160,78,83,173,83
2020,48,7,"Agri",39.7191,43.0513,11.9857142857143,6,0,71.9714285714286,66.6257142857143,13.67,199,93,101,60,104,262,106,161
2020,49,7,"Agri",39.7191,43.0513,10.1857142857143,7.58571428571429,0.0714285714285714,86.2,65.1314285714286,12.4028571428571,207,26,17,47,4,116,181,99
2020,50,7,"Agri",39.7191,43.0513,10.6428571428571,7.62857142857143,0.5,80.6571428571429,68.2385714285714,13.2871428571429,181,0,0,45,28,98,181,98
2020,51,7,"Agri",39.7191,43.0513,15.3142857142857,7.84285714285714,0.585714285714286,81.8857142857143,68.744,13.375,171,0,0,126,48,90,171,90
2020,52,7,"Agri",39.7191,43.0513,16.6714285714286,2.52857142857143,1.78571428571429,75.6142857142857,122.34,13.5357142857143,203,18,6,102,65,113,185,107
2020,53,7,"Agri",39.7191,43.0513,6.5,1.7,0,66.325,267.775,11.365,122,14,48,63,44,111,108,63
2017,1,8,"Aksaray",38.3687,34.036,12.2142857142857,-0.942857142857143,1.67214285714286,75.3571428571429,46.0385714285714,NA,563,172,257,43,68,847,391,590
2017,2,8,"Aksaray",38.3687,34.036,11.3285714285714,-2.11428571428571,0.899857142857143,70.6714285714286,50.4942857142857,NA,757,337,430,41,38,1214,420,784
2017,3,8,"Aksaray",38.3687,34.036,12.4714285714286,1.57142857142857,0.057,73.4571428571429,50.8414285714286,NA,762,303,367,61,263,1449,459,1082
2017,4,8,"Aksaray",38.3687,34.036,15.5857142857143,-3.68571428571429,1.21628571428571,80.4142857142857,54.7457142857143,NA,639,294,428,100,122,889,345,461
2017,5,8,"Aksaray",38.3687,34.036,18.7857142857143,-6.2,0.0572857142857143,68.8285714285714,76.5514285714286,NA,588,294,409,103,214,1163,294,754
2017,6,8,"Aksaray",38.3687,34.036,18.3142857142857,3.41428571428571,0.0858571428571429,77.3857142857143,58.8685714285714,NA,736,436,925,39,78,1519,300,594
2017,7,8,"Aksaray",38.3687,34.036,23.1,-1.61428571428571,0.0428571428571429,58.0285714285714,47.0014285714286,NA,492,78,58,156,264,717,414,659
2017,8,8,"Aksaray",38.3687,34.036,17.7571428571429,6.04285714285714,0,55.9285714285714,65.4,NA,739,440,850,0,0,1747,299,897
2017,9,8,"Aksaray",38.3687,34.036,14.5857142857143,8.58571428571429,0.214571428571429,57,79.345,NA,574,159,241,0,0,866,415,625
2017,10,8,"Aksaray",38.3687,34.036,16.7285714285714,9.12857142857143,2.741,54.8857142857143,47.3785714285714,NA,712,647,960,0,0,1043,65,83
2017,11,8,"Aksaray",38.3687,34.036,16.9285714285714,3.42857142857143,2.96971428571429,76.9571428571429,44.3214285714286,NA,525,107,169,160,181,725,418,556
2017,12,8,"Aksaray",38.3687,34.036,23.5714285714286,8.87142857142857,1.02757142857143,50.5571428571429,65.5828571428571,NA,589,88,110,101,338,1077,501,967
2017,13,8,"Aksaray",38.3687,34.036,13.5428571428571,10.2571428571429,1.10142857142857,55.1714285714286,51.8714285714286,NA,574,130,234,64,87,887,444,653
2017,14,8,"Aksaray",38.3687,34.036,14.0714285714286,11.4714285714286,0.815428571428571,44.7714285714286,51.1414285714286,NA,639,103,249,155,259,1336,536,1087
2017,15,8,"Aksaray",38.3687,34.036,13.5,9.64285714285714,3.157,62.0714285714286,56.9228571428571,NA,587,147,295,229,240,1187,440,892
2017,16,8,"Aksaray",38.3687,34.036,22.0857142857143,13.2857142857143,0.114285714285714,48.6142857142857,56.0928571428571,NA,717,47,32,142,112,920,670,888
2017,17,8,"Aksaray",38.3687,34.036,16.9428571428571,13.6714285714286,0,32.9714285714286,56.6842857142857,NA,731,259,674,229,430,1478,472,804
2017,18,8,"Aksaray",38.3687,34.036,16.1428571428571,15.8571428571429,0.786,53.2285714285714,59.8171428571429,NA,506,67,107,13,3,923,439,816
2017,19,8,"Aksaray",38.3687,34.036,18.2714285714286,19.1142857142857,0.699,39.8142857142857,78.7714285714286,NA,471,49,147,160,344,966,422,819
2017,20,8,"Aksaray",38.3687,34.036,17.4285714285714,15.4285714285714,1.31685714285714,54.1285714285714,42.4042857142857,NA,472,73,203,212,608,1205,399,1002
2017,21,8,"Aksaray",38.3687,34.036,16.2,14.9857142857143,0.615857142857143,57.1285714285714,41.4628571428571,NA,448,28,110,255,527,849,420,739
2017,22,8,"Aksaray",38.3687,34.036,15.3285714285714,18.4,2.98214285714286,51.2428571428571,62.0242857142857,NA,522,83,204,216,362,1015,439,811
2017,23,8,"Aksaray",38.3687,34.036,11.1857142857143,20.4714285714286,1.35485714285714,54.4285714285714,64.8266666666667,NA,578,0,0,436,1063,1388,578,1388
2017,24,8,"Aksaray",38.3687,34.036,13.2714285714286,20.5142857142857,1.15728571428571,49.7428571428571,48.516,NA,552,45,67,253,477,1139,507,1072
2017,25,8,"Aksaray",38.3687,34.036,15.6714285714286,19.4,1.17328571428571,55.2,47.0971428571429,NA,584,0,0,384,728,1041,584,1041
2017,26,8,"Aksaray",38.3687,34.036,17.4857142857143,26.3857142857143,0,31.0142857142857,62.5557142857143,NA,564,0,0,216,474,971,564,971
2017,27,8,"Aksaray",38.3687,34.036,25.2571428571429,24.6,0,34.9714285714286,71.355,NA,511,0,0,90,132,642,511,642
2017,28,8,"Aksaray",38.3687,34.036,25.4,26,0,25.5428571428571,70.5842857142857,NA,481,0,0,126,168,864,481,864
2017,29,8,"Aksaray",38.3687,34.036,28.9285714285714,26.4857142857143,0,33.9857142857143,83.405,NA,532,0,0,96,178,1272,532,1272
2017,30,8,"Aksaray",38.3687,34.036,21.3428571428571,25.8857142857143,0,29.0571428571429,101.431428571429,NA,531,64,150,118,111,928,467,778
2017,31,8,"Aksaray",38.3687,34.036,20.3571428571429,24.5857142857143,0.488,46.2285714285714,80.2114285714286,NA,559,0,0,216,403,1047,559,1047
2017,32,8,"Aksaray",38.3687,34.036,22.0714285714286,27.7857142857143,0,32.9714285714286,88.8871428571429,NA,567,83,154,22,88,1092,484,938
2017,33,8,"Aksaray",38.3687,34.036,24.9428571428571,26.5571428571429,0.328,39.0714285714286,87.9042857142857,NA,596,2,12,181,443,1199,594,1187
2017,34,8,"Aksaray",38.3687,34.036,20.1142857142857,22.5142857142857,0.114285714285714,44.6285714285714,90.7242857142857,NA,601,0,0,223,539,1280,601,1280
2017,35,8,"Aksaray",38.3687,34.036,16.7,22.1428571428571,0,38.1142857142857,64.09,NA,493,52,73,270,622,1014,441,941
2017,36,8,"Aksaray",38.3687,34.036,14.5428571428571,21.6285714285714,0,28.7428571428571,96.5842857142857,NA,507,197,450,162,382,1321,310,871
2017,37,8,"Aksaray",38.3687,34.036,13.8142857142857,25.9571428571429,0,21.1142857142857,141.6075,NA,589,126,125,77,294,1138,463,1013
2017,38,8,"Aksaray",38.3687,34.036,15.3,23.2,0.0142857142857143,26.1857142857143,123.51,NA,671,32,13,163,367,1312,639,1299
2017,39,8,"Aksaray",38.3687,34.036,14.0428571428571,19.2428571428571,0.856285714285714,38.8857142857143,88.7771428571429,NA,782,84,190,116,116,1630,698,1440
2017,40,8,"Aksaray",38.3687,34.036,11.9428571428571,14.0714285714286,0.00128571428571429,44.7142857142857,63.8928571428571,NA,543,185,422,84,178,1137,358,715
2017,41,8,"Aksaray",38.3687,34.036,12.7,12.5857142857143,0.000285714285714286,46.1,61.1828571428571,NA,487,17,14,143,134,843,470,829
2017,42,8,"Aksaray",38.3687,34.036,13.2571428571429,12.9571428571429,0,38,90.2785714285714,NA,530,286,413,23,64,815,244,402
2017,43,8,"Aksaray",38.3687,34.036,15.6142857142857,13.4142857142857,2.35514285714286,52.2142857142857,85.86,NA,506,287,572,44,81,919,219,347
2017,44,8,"Aksaray",38.3687,34.036,14.5571428571429,6.44285714285714,4.46585714285714,63.0857142857143,72.0514285714286,NA,561,289,560,150,223,1102,272,542
2017,45,8,"Aksaray",38.3687,34.036,15.6142857142857,6.84285714285714,0.428,74.1571428571429,111.415714285714,NA,577,296,507,41,19,829,281,322
2017,46,8,"Aksaray",38.3687,34.036,13.8,9.54285714285714,0.0142857142857143,61.6428571428571,110.074285714286,NA,587,466,900,0,0,1085,121,185
2017,47,8,"Aksaray",38.3687,34.036,16.4857142857143,4.64285714285714,3.085,74.5571428571428,51.0257142857143,NA,418,134,347,47,40,804,284,457
2017,48,8,"Aksaray",38.3687,34.036,19.0428571428571,6.78571428571429,1.34214285714286,70.9857142857143,67.8957142857143,NA,386,309,471,25,53,619,77,148
2017,49,8,"Aksaray",38.3687,34.036,19.0857142857143,3.21428571428571,0.574285714285714,68.6857142857143,67.405,NA,407,206,316,78,114,645,201,329
2017,50,8,"Aksaray",38.3687,34.036,17.5428571428571,5.98571428571429,0.0142857142857143,70.2285714285714,64.3542857142857,NA,346,247,277,0,0,442,99,165
2017,51,8,"Aksaray",38.3687,34.036,17.1857142857143,7.72857142857143,1.51785714285714,75.1714285714286,27.6814285714286,NA,386,135,85,0,0,349,251,264
2017,52,8,"Aksaray",38.3687,34.036,13.9375,1.325,2.085125,79.6875,37.3925,NA,528,234,241,66,31,507,294,266
2018,1,8,"Aksaray",38.3687,34.036,15.1,3.625,2.099625,78.85,23.385,NA,618,475,747,78,96,914,143,167
2018,2,8,"Aksaray",38.3687,34.036,15.6285714285714,3.3,0.658285714285714,81.4,31.71,NA,624,516,1259,0,0,1309,108,50
2018,3,8,"Aksaray",38.3687,34.036,20.4142857142857,2.34285714285714,2.82528571428571,75.8428571428571,21.9333333333333,NA,639,382,512,194,117,655,257,143
2018,4,8,"Aksaray",38.3687,34.036,25.0714285714286,0.757142857142857,2.41528571428571,78.2142857142857,12.8828571428571,NA,604,86,169,226,241,764,518,595
2018,5,8,"Aksaray",38.3687,34.036,18.8142857142857,3.77142857142857,0,66.4285714285714,38.3571428571429,NA,670,565,712,19,20,819,105,107
2018,6,8,"Aksaray",38.3687,34.036,19.0857142857143,9.02857142857143,0.0998571428571429,55.6,56.64,NA,704,444,625,79,142,1022,260,397
2018,7,8,"Aksaray",38.3687,34.036,22.7142857142857,6.65714285714286,0.0432857142857143,59.5428571428571,27.5814285714286,NA,478,134,165,157,158,557,344,392
2018,8,8,"Aksaray",38.3687,34.036,19.4714285714286,6.78571428571429,3.55328571428571,68.3714285714286,30.7457142857143,NA,711,636,1090,0,0,1321,75,231
2018,9,8,"Aksaray",38.3687,34.036,24.2857142857143,7.92857142857143,0.501,59.4428571428571,28.5171428571429,NA,621,206,352,92,159,956,415,604
2018,10,8,"Aksaray",38.3687,34.036,18.1714285714286,9.92857142857143,2.21457142857143,65.9,54.3185714285714,NA,556,303,719,76,188,1330,253,611
2018,11,8,"Aksaray",38.3687,34.036,22.7714285714286,10.2142857142857,1.18628571428571,61.7714285714286,31.6316666666667,NA,551,263,689,35,55,1426,288,737
2018,12,8,"Aksaray",38.3687,34.036,19.3714285714286,13.7142857142857,0.000142857142857143,42.2571428571429,55.0514285714286,NA,425,172,387,1,2,1187,253,800
2018,13,8,"Aksaray",38.3687,34.036,17.1571428571429,11.9142857142857,0.574142857142857,55.5,45.49,NA,356,171,199,39,11,428,185,229
2018,14,8,"Aksaray",38.3687,34.036,15.5714285714286,11.5428571428571,0.029,47.8714285714286,21.7985714285714,NA,407,241,354,24,35,486,166,132
2018,15,8,"Aksaray",38.3687,34.036,17.3428571428571,13.3285714285714,2.29657142857143,63.8285714285714,33.8314285714286,NA,374,204,199,55,170,450,170,251
2018,16,8,"Aksaray",38.3687,34.036,23.2428571428571,12.8428571428571,0.115285714285714,43.2285714285714,28.4428571428571,NA,411,172,218,68,138,648,239,430
2018,17,8,"Aksaray",38.3687,34.036,20.2857142857143,17,0,37.1714285714286,26.8814285714286,NA,419,208,339,3,1,652,211,313
2018,18,8,"Aksaray",38.3687,34.036,16.7571428571429,18.2714285714286,1.88385714285714,50.0428571428571,33.7014285714286,NA,303,240,368,0,0,474,63,106
2018,19,8,"Aksaray",38.3687,34.036,14.7142857142857,13.8142857142857,8.93157142857143,71.2571428571429,16.562,NA,275,69,184,39,49,467,206,283
2018,20,8,"Aksaray",38.3687,34.036,17.0714285714286,19,0.129857142857143,50.2571428571429,22.3457142857143,NA,204,56,63,36,67,306,148,243
2018,21,8,"Aksaray",38.3687,34.036,15.6142857142857,19.7285714285714,0.671714285714286,54.6428571428571,32.0485714285714,NA,252,67,102,54,37,281,185,179
2018,22,8,"Aksaray",38.3687,34.036,14.3,17.8714285714286,3.28528571428571,62.2142857142857,22.7766666666667,NA,249,59,94,52,121,427,190,333
2018,23,8,"Aksaray",38.3687,34.036,16.9857142857143,22.3142857142857,0.0431428571428571,41.0428571428571,32.7185714285714,NA,267,30,90,126,236,812,237,722
2018,24,8,"Aksaray",38.3687,34.036,23.5142857142857,22.2285714285714,0.2,44.2142857142857,23.5157142857143,NA,267,54,94,36,18,448,213,354
2018,25,8,"Aksaray",38.3687,34.036,18.2285714285714,20.6285714285714,3.459,59.1428571428571,28.3585714285714,NA,358,49,69,202,191,518,309,449
2018,26,8,"Aksaray",38.3687,34.036,15.8571428571429,24.3571428571429,0.0152857142857143,41.5428571428571,48.2728571428571,NA,355,38,61,103,111,587,317,526
2018,27,8,"Aksaray",38.3687,34.036,25.3571428571429,24.5285714285714,0,39.9142857142857,28.018,NA,342,69,103,3,1,418,273,315
2018,28,8,"Aksaray",38.3687,34.036,28.3571428571429,25.9714285714286,0,38.3,17.57,NA,286,0,0,61,86,585,286,585
2018,29,8,"Aksaray",38.3687,34.036,23.6142857142857,23.5571428571429,0.314,38.8428571428571,41.36,NA,260,0,0,208,553,756,260,756
2018,30,8,"Aksaray",38.3687,34.036,18.4714285714286,25.4285714285714,0,39.1857142857143,62.7342857142857,NA,265,0,0,127,307,822,265,822
2018,31,8,"Aksaray",38.3687,34.036,32.3142857142857,26.2285714285714,0.285285714285714,41.7,30.365,NA,267,13,114,44,89,499,254,385
2018,32,8,"Aksaray",38.3687,34.036,33.2142857142857,23.2714285714286,0,40.7857142857143,28.26,NA,297,5,20,0,0,403,292,383
2018,33,8,"Aksaray",38.3687,34.036,22.5428571428571,23.9,0.0285714285714286,34.6142857142857,39.24,NA,216,19,55,9,28,332,197,277
2018,34,8,"Aksaray",38.3687,34.036,20.3857142857143,24.9142857142857,0,32.5285714285714,27.4685714285714,NA,144,53,102,8,2,227,91,125
2018,35,8,"Aksaray",38.3687,34.036,27.1285714285714,25.7571428571429,0.000571428571428571,34.2714285714286,49.2314285714286,NA,201,22,36,10,8,314,179,278
2018,36,8,"Aksaray",38.3687,34.036,15.9571428571429,22.3142857142857,0.157285714285714,38.1571428571429,45.3857142857143,NA,341,52,36,182,195,370,289,334
2018,37,8,"Aksaray",38.3687,34.036,18.8,19.9714285714286,0.000142857142857143,44.5142857142857,46.4885714285714,NA,241,8,22,163,269,419,233,397
2018,38,8,"Aksaray",38.3687,34.036,20.2571428571429,19.1285714285714,0,37.8285714285714,39.9757142857143,NA,189,18,18,1,1,344,171,326
2018,39,8,"Aksaray",38.3687,34.036,17.4142857142857,18.4,0.212714285714286,43.5857142857143,42.7185714285714,NA,180,38,59,0,0,353,142,294
2018,40,8,"Aksaray",38.3687,34.036,15.9285714285714,16.8428571428571,0.683142857142857,44.1857142857143,36.0157142857143,NA,191,70,124,25,56,341,121,217
2018,41,8,"Aksaray",38.3687,34.036,15.6142857142857,15.2428571428571,2.87914285714286,66.6428571428571,42.7316666666667,NA,187,61,191,45,52,422,126,231
2018,42,8,"Aksaray",38.3687,34.036,14.3285714285714,15.2857142857143,0.0897142857142857,65,79.4171428571428,NA,168,139,367,14,6,381,29,14
2018,43,8,"Aksaray",38.3687,34.036,15.6142857142857,9.88571428571429,2.728,70.6571428571429,40.9357142857143,NA,187,88,202,59,166,402,99,200
2018,44,8,"Aksaray",38.3687,34.036,12.4857142857143,10.2142857142857,0,61,54.1428571428571,NA,196,179,221,0,0,264,17,43
2018,45,8,"Aksaray",38.3687,34.036,11.4,8.31428571428571,0.0428571428571429,63.3571428571429,42.79,NA,231,112,251,58,112,473,119,222
2018,46,8,"Aksaray",38.3687,34.036,13.5142857142857,5.28571428571429,0.357285714285714,65.9428571428571,27.26,NA,230,98,154,37,74,465,132,311
2018,47,8,"Aksaray",38.3687,34.036,17.4714285714286,8.55714285714286,0.0431428571428571,68.0142857142857,38.2166666666667,NA,270,161,181,10,55,499,109,318
2018,48,8,"Aksaray",38.3687,34.036,14.5857142857143,8.92857142857143,1.63085714285714,71.7857142857143,19.6183333333333,NA,245,174,150,0,0,201,71,51
2018,49,8,"Aksaray",38.3687,34.036,16.4571428571429,4.81428571428571,3.772,81.5714285714286,35.2266666666667,NA,257,122,188,1,2,420,135,232
2018,50,8,"Aksaray",38.3687,34.036,19.5857142857143,5.21428571428571,2.17328571428571,73.6142857142857,17.18,NA,256,151,165,4,10,305,105,140
2018,51,8,"Aksaray",38.3687,34.036,17.2,6,2.41585714285714,80.6,24.5228571428571,NA,250,142,179,0,0,248,108,69
2018,52,8,"Aksaray",38.3687,34.036,17.3428571428571,-0.742857142857143,4.03771428571429,76.0142857142857,20.24,NA,244,95,111,43,46,273,149,162
2019,1,8,"Aksaray",38.3687,34.036,17.8875,2.3625,1.449125,78.3,28.64875,NA,343,252,678,0,0,784,91,106
2019,2,8,"Aksaray",38.3687,34.036,23.8857142857143,-1.92857142857143,2.71485714285714,74.8857142857143,18.6142857142857,NA,255,127,90,82,83,208,128,118
2019,3,8,"Aksaray",38.3687,34.036,21.5857142857143,-2.15714285714286,3.60071428571429,75.0857142857143,22.5971428571429,NA,192,134,122,22,13,198,58,76
2019,4,8,"Aksaray",38.3687,34.036,20.4571428571429,4.6,1.05685714285714,68.8571428571429,29.884,NA,308,260,271,0,0,314,48,43
2019,5,8,"Aksaray",38.3687,34.036,16.2714285714286,4.9,0.359142857142857,66.2285714285714,39.54,NA,253,214,125,0,0,143,39,18
2019,6,8,"Aksaray",38.3687,34.036,15.6428571428571,5.64285714285714,3.51714285714286,73.7428571428571,24.3214285714286,NA,276,169,54,65,35,127,107,73
2019,7,8,"Aksaray",38.3687,34.036,16.4714285714286,4.65714285714286,0.0142857142857143,66.0857142857143,19.7433333333333,NA,325,102,45,0,0,234,223,189
2019,8,8,"Aksaray",38.3687,34.036,13.6142857142857,4.75714285714286,0.285285714285714,61.8857142857143,36.85,NA,305,168,124,2,1,219,137,95
2019,9,8,"Aksaray",38.3687,34.036,15.2428571428571,3.78571428571429,0.591,67.7142857142857,18.1528571428571,NA,331,92,38,82,25,310,239,272
2019,10,8,"Aksaray",38.3687,34.036,14.8714285714286,6.34285714285714,0.314142857142857,55.5857142857143,22.8757142857143,NA,359,177,159,47,36,252,182,93
2019,11,8,"Aksaray",38.3687,34.036,16.1142857142857,8.7,0.542714285714286,58,21.1771428571429,NA,373,96,197,1,0,400,277,203
2019,12,8,"Aksaray",38.3687,34.036,21.2857142857143,7.57142857142857,0,48.0857142857143,35.03,NA,343,132,322,94,43,416,211,94
2019,13,8,"Aksaray",38.3687,34.036,26.7,4.87142857142857,0.289142857142857,54.9857142857143,NA,NA,256,6,20,109,81,194,250,174
2019,14,8,"Aksaray",38.3687,34.036,13.9285714285714,9.31428571428571,0.214857142857143,58.6857142857143,NA,NA,365,196,108,0,0,208,169,100
2019,15,8,"Aksaray",38.3687,34.036,16.6428571428571,12.5142857142857,0.631428571428571,57.1714285714286,NA,NA,359,148,87,4,7,183,211,96
2019,16,8,"Aksaray",38.3687,34.036,16.9857142857143,6.6,2.975,73.1857142857143,18.898,NA,318,15,7,144,94,208,303,201
2019,17,8,"Aksaray",38.3687,34.036,13.8714285714286,11.4714285714286,0.613714285714286,59.3,36.5228571428571,NA,412,129,95,129,101,313,283,218
2019,18,8,"Aksaray",38.3687,34.036,17.7285714285714,15.4428571428571,1.58642857142857,51.4428571428571,36.0833333333333,NA,523,51,30,72,44,353,472,323
2019,19,8,"Aksaray",38.3687,34.036,17.3,13.8428571428571,1.18628571428571,55.7428571428571,38.3571428571429,NA,452,199,153,128,112,386,253,233
2019,20,8,"Aksaray",38.3687,34.036,16.5285714285714,19.6714285714286,0.0722857142857143,43.5428571428571,46.652,NA,454,150,118,191,185,389,304,271
2019,21,8,"Aksaray",38.3687,34.036,14.0571428571429,20.4285714285714,0.199714285714286,43.4,49.968,NA,457,55,69,125,140,413,402,344
2019,22,8,"Aksaray",38.3687,34.036,16.0714285714286,23,0.00442857142857143,40.2285714285714,54.7014285714286,NA,453,111,65,158,149,323,342,258
2019,23,8,"Aksaray",38.3687,34.036,15.3857142857143,22.9285714285714,0.0871428571428571,36.2285714285714,44.4114285714286,NA,378,63,126,44,89,532,315,406
2019,24,8,"Aksaray",38.3687,34.036,15.5142857142857,19.5571428571429,0.952428571428572,65.1571428571429,28.4385714285714,NA,378,0,0,248,142,244,378,244
2019,25,8,"Aksaray",38.3687,34.036,13.7428571428571,20.4857142857143,5.07142857142857,67.8285714285714,22.7885714285714,NA,306,42,31,142,142,325,264,294
2019,26,8,"Aksaray",38.3687,34.036,24.3714285714286,24.4857142857143,0,41.8428571428571,29.9842857142857,NA,377,1,1,73,152,342,376,341
2019,27,8,"Aksaray",38.3687,34.036,26.4428571428571,22.9714285714286,0,38.4,33.2514285714286,NA,456,0,0,109,85,222,456,222
2019,28,8,"Aksaray",38.3687,34.036,15.5714285714286,22.9285714285714,0.356857142857143,43.3285714285714,36.4071428571429,NA,398,2,3,249,284,421,396,418
2019,29,8,"Aksaray",38.3687,34.036,21.6714285714286,20.9428571428571,0.504,55.3142857142857,25.3742857142857,NA,453,0,0,224,100,203,453,203
2019,30,8,"Aksaray",38.3687,34.036,27.2428571428571,23.0285714285714,0,40.8142857142857,28.3428571428571,NA,456,2,4,124,87,335,454,331
2019,31,8,"Aksaray",38.3687,34.036,17.4142857142857,26.5714285714286,0.000285714285714286,33.5571428571429,51.13,NA,334,48,55,161,142,375,286,320
2019,32,8,"Aksaray",38.3687,34.036,30.0857142857143,22.5428571428571,0.00114285714285714,39.5857142857143,28.1185714285714,NA,346,3,4,18,9,395,343,391
2019,33,8,"Aksaray",38.3687,34.036,18.2857142857143,24.5857142857143,0.599571428571429,43.1428571428571,37.3385714285714,NA,337,2,1,183,327,531,335,530
2019,34,8,"Aksaray",38.3687,34.036,22.4142857142857,21.1714285714286,0.476142857142857,59.6142857142857,24.32,NA,299,0,0,132,138,345,299,345
2019,35,8,"Aksaray",38.3687,34.036,26.5857142857143,23.3714285714286,0.057,46.2142857142857,27.3928571428571,NA,307,0,0,93,106,415,307,415
2019,36,8,"Aksaray",38.3687,34.036,16.2714285714286,22.6142857142857,0,34.4714285714286,28.992,NA,171,22,3,18,5,67,149,64
2019,37,8,"Aksaray",38.3687,34.036,25.0142857142857,19.6,2.29657142857143,48.0142857142857,25.7514285714286,NA,218,0,0,0,0,55,218,55
2019,38,8,"Aksaray",38.3687,34.036,14.5142857142857,17.0571428571429,0,48.6857142857143,32.4628571428571,NA,266,144,60,35,16,91,122,31
2019,39,8,"Aksaray",38.3687,34.036,13.5142857142857,17.5571428571429,0.0294285714285714,46.6857142857143,33.9314285714286,NA,237,129,56,53,6,79,108,23
2019,40,8,"Aksaray",38.3687,34.036,12.9714285714286,18.5857142857143,0,38.2142857142857,66.4671428571429,NA,241,72,63,35,7,111,169,48
2019,41,8,"Aksaray",38.3687,34.036,10.7857142857143,16.3,0,48.5285714285714,45.9357142857143,NA,416,84,60,31,20,448,332,388
2019,42,8,"Aksaray",38.3687,34.036,9.88571428571429,16.8857142857143,0.00157142857142857,47.7285714285714,33.3728571428571,NA,356,140,165,5,4,408,216,243
2019,43,8,"Aksaray",38.3687,34.036,12.1428571428571,13.6714285714286,1.854,62.2857142857143,21.6657142857143,NA,306,16,11,64,60,300,290,289
2019,44,8,"Aksaray",38.3687,34.036,9.72857142857143,9.65714285714286,0.875714285714286,65.6571428571429,31.3857142857143,NA,350,221,125,0,0,250,129,125
2019,45,8,"Aksaray",38.3687,34.036,16.4142857142857,11.6571428571429,0,49,42.1442857142857,NA,417,388,287,0,0,328,29,41
2019,46,8,"Aksaray",38.3687,34.036,11.3,10.5142857142857,0.0295714285714286,57.1571428571429,46.8514285714286,NA,401,277,225,38,50,337,124,112
2019,47,8,"Aksaray",38.3687,34.036,8.9,2.37142857142857,0,72.7142857142857,98.4257142857143,NA,391,246,239,55,24,339,145,100
2019,48,8,"Aksaray",38.3687,34.036,19.0571428571429,9.41428571428571,0.516714285714286,65.3714285714286,60.1785714285714,NA,320,164,87,14,6,251,156,164
2019,49,8,"Aksaray",38.3687,34.036,11.0857142857143,1.78571428571429,2.03957142857143,75.6428571428571,35.6657142857143,NA,393,123,105,12,4,274,270,169
2019,50,8,"Aksaray",38.3687,34.036,13.0857142857143,5.57142857142857,0.308714285714286,75.0142857142857,45.4142857142857,NA,218,167,109,0,0,119,51,10
2019,51,8,"Aksaray",38.3687,34.036,8.4,3.21428571428571,0,77.4285714285714,88.2928571428571,NA,361,106,204,91,100,488,255,284
2019,52,8,"Aksaray",38.3687,34.036,13.9285714285714,3.97142857142857,6.00914285714286,82.4428571428572,30.9542857142857,NA,279,190,237,40,18,281,89,44
2020,1,8,"Aksaray",38.3687,34.036,12.16,1.12,0.6962,82.62,30.426,NA,160,29,24,28,2,126,131,102
2020,2,8,"Aksaray",38.3687,34.036,19.8,1.88571428571429,0.605285714285714,71.9714285714286,40.1785714285714,NA,240,98,64,23,29,173,142,109
2020,3,8,"Aksaray",38.3687,34.036,10.3,0.2,0.240142857142857,76.8285714285714,62.6285714285714,NA,270,2,1,113,171,382,268,381
2020,4,8,"Aksaray",38.3687,34.036,16.9142857142857,-1.28571428571429,0.514428571428571,63.3285714285714,42.1371428571429,NA,358,117,159,58,17,295,241,136
2020,5,8,"Aksaray",38.3687,34.036,19.3428571428571,3.05714285714286,5.48271428571429,72.1428571428571,54.7842857142857,NA,331,206,202,33,24,272,125,70
2020,6,8,"Aksaray",38.3687,34.036,20.3571428571429,2.4,4.61342857142857,72.6428571428571,31.2814285714286,NA,343,121,113,52,32,267,222,154
2020,7,8,"Aksaray",38.3687,34.036,17.8714285714286,-0.7,2.99971428571429,71.4571428571429,40.59,NA,341,199,230,38,22,338,142,108
2020,8,8,"Aksaray",38.3687,34.036,13.7571428571429,3.4,1.18528571428571,73.9857142857143,44.0585714285714,NA,283,155,123,0,0,187,128,64
2020,9,8,"Aksaray",38.3687,34.036,17.0857142857143,7.18571428571429,1.56285714285714,60.0142857142857,35.7085714285714,NA,393,80,23,54,70,528,313,505
2020,10,8,"Aksaray",38.3687,34.036,15.9857142857143,10.2,0.0695714285714286,48.2285714285714,54.0428571428571,NA,205,169,171,4,1,210,36,39
2020,11,8,"Aksaray",38.3687,34.036,20.1428571428571,12.7285714285714,0.0855714285714286,48.4428571428571,48.6328571428571,NA,115,52,27,0,0,94,63,67
2020,12,8,"Aksaray",38.3687,34.036,24.4857142857143,1.45714285714286,1.86314285714286,75.6142857142857,23.6457142857143,NA,117,11,10,34,32,118,106,108
2020,13,8,"Aksaray",38.3687,34.036,12.9142857142857,9.22857142857143,7.10942857142857,68.0142857142857,38.1885714285714,NA,136,95,52,0,0,92,41,40
2020,14,8,"Aksaray",38.3687,34.036,11.3714285714286,8.77142857142857,2.99128571428571,67.1714285714286,26.48,NA,155,84,63,7,3,121,71,58
2020,15,8,"Aksaray",38.3687,34.036,14.2571428571429,9.71428571428572,1.38,57.2142857142857,31.8485714285714,NA,133,7,1,23,57,118,126,117
2020,16,8,"Aksaray",38.3687,34.036,13.1,12.5,0.167714285714286,49.2428571428571,37.58,NA,141,45,34,21,10,106,96,72
2020,17,8,"Aksaray",38.3687,34.036,14.9142857142857,11.6142857142857,0.000857142857142857,53.8285714285714,30.3157142857143,NA,137,30,27,2,2,123,107,96
2020,18,8,"Aksaray",38.3687,34.036,14.1,13.6857142857143,6.46942857142857,57.3857142857143,26.9485714285714,NA,146,51,48,13,60,164,95,116
2020,19,8,"Aksaray",38.3687,34.036,13.5428571428571,12.3857142857143,7.14628571428571,64.2857142857143,17.0742857142857,NA,137,3,2,74,79,157,134,155
2020,20,8,"Aksaray",38.3687,34.036,11.7571428571429,21.0142857142857,0,39.8285714285714,47.56,NA,164,23,45,27,43,164,141,119
2020,21,8,"Aksaray",38.3687,34.036,16.7285714285714,19.2857142857143,0.328428571428571,42.0142857142857,57.6128571428571,NA,146,11,3,63,64,96,135,93
2020,22,8,"Aksaray",38.3687,34.036,15.0857142857143,15.9285714285714,0.142571428571429,42.5714285714286,24.1357142857143,NA,118,8,2,43,21,100,110,98
2020,23,8,"Aksaray",38.3687,34.036,14.9571428571429,18.5428571428571,0.791571428571429,45.6714285714286,28.9014285714286,NA,112,25,17,45,25,70,87,53
2020,24,8,"Aksaray",38.3687,34.036,18.1857142857143,20.7857142857143,0.231714285714286,46.7285714285714,59.0675,NA,140,60,110,8,2,150,80,40
2020,25,8,"Aksaray",38.3687,34.036,13.2142857142857,20.3142857142857,3.02714285714286,53.5285714285714,27.5133333333333,NA,137,21,17,28,32,108,116,91
2020,26,8,"Aksaray",38.3687,34.036,19.7571428571429,22.1285714285714,2.654,48.4857142857143,33.5828571428571,NA,173,20,3,30,28,133,153,130
2020,27,8,"Aksaray",38.3687,34.036,21.4142857142857,24.7428571428571,0.000285714285714286,34.5714285714286,33.0871428571429,NA,113,9,8,9,12,113,104,105
2020,28,8,"Aksaray",38.3687,34.036,25.2857142857143,24.9428571428571,0.0312857142857143,43.6285714285714,31.2328571428571,NA,164,0,0,40,37,122,164,122
2020,29,8,"Aksaray",38.3687,34.036,20.9857142857143,25.8571428571429,0,38.9285714285714,44.4066666666667,NA,186,44,15,15,31,111,142,96
2020,30,8,"Aksaray",38.3687,34.036,27.9142857142857,24.8857142857143,0,39.9857142857143,38.6785714285714,NA,190,0,0,76,61,142,190,142
2020,31,8,"Aksaray",38.3687,34.036,19.3428571428571,25.8142857142857,0,36.0285714285714,37.4385714285714,NA,150,50,34,38,20,127,100,93
2020,32,8,"Aksaray",38.3687,34.036,26.7,24.6714285714286,0,33.0142857142857,28.4085714285714,NA,146,7,4,9,6,107,139,103
2020,33,8,"Aksaray",38.3687,34.036,30.3428571428571,23.4571428571429,0,34.9142857142857,30.7728571428571,NA,183,3,5,3,0,83,180,78
2020,34,8,"Aksaray",38.3687,34.036,17.7285714285714,22.2571428571429,0,37.2,31.6485714285714,NA,197,13,5,28,15,97,184,92
2020,35,8,"Aksaray",38.3687,34.036,15.2142857142857,23.5142857142857,0,27.9714285714286,43.1385714285714,NA,164,42,32,45,63,157,122,125
2020,36,8,"Aksaray",38.3687,34.036,14.0714285714286,25.7,0.000285714285714286,28.4571428571429,66.9257142857143,NA,179,68,36,23,15,112,111,76
2020,37,8,"Aksaray",38.3687,34.036,24.6571428571429,22.4714285714286,0.999142857142857,44.3285714285714,54.4042857142857,NA,193,22,24,19,8,91,171,67
2020,38,8,"Aksaray",38.3687,34.036,13.8,22.0142857142857,0,42.2857142857143,45.5728571428571,NA,235,79,70,53,54,157,156,87
2020,39,8,"Aksaray",38.3687,34.036,17.7142857142857,20.0428571428571,0.427857142857143,47.7142857142857,45.8,NA,220,128,51,41,25,129,92,78
2020,40,8,"Aksaray",38.3687,34.036,16.7428571428571,18.1142857142857,1.71214285714286,45.6142857142857,47.1085714285714,NA,187,114,104,3,3,154,73,50
2020,41,8,"Aksaray",38.3687,34.036,16.0428571428571,19.5,0,31.6571428571429,70.0085714285714,NA,182,160,106,0,0,127,22,21
2020,42,8,"Aksaray",38.3687,34.036,15.2285714285714,17.2714285714286,0,38.1285714285714,71.2585714285714,NA,177,174,108,0,0,111,3,3
2020,43,8,"Aksaray",38.3687,34.036,11.0428571428571,15.1428571428571,0.171142857142857,53.5285714285714,55.9242857142857,NA,194,159,134,30,21,161,35,27
2020,44,8,"Aksaray",38.3687,34.036,15.3857142857143,14.9714285714286,0,42.9428571428571,57.5557142857143,NA,255,139,149,41,46,233,116,84
2020,45,8,"Aksaray",38.3687,34.036,25.4,9.28571428571429,4.828,65.1714285714286,31.9942857142857,NA,156,53,38,36,22,103,103,65
2020,46,8,"Aksaray",38.3687,34.036,12.6,6.41428571428571,0,71.2428571428571,60.9585714285714,NA,208,160,93,0,0,109,48,16
2020,47,8,"Aksaray",38.3687,34.036,11.4285714285714,5.05714285714286,1.16942857142857,68.1857142857143,52.0628571428571,NA,173,139,55,0,0,83,34,28
2020,48,8,"Aksaray",38.3687,34.036,18.5428571428571,1.27142857142857,0,66.0285714285714,71.84,NA,199,143,194,0,0,262,56,68
2020,49,8,"Aksaray",38.3687,34.036,9.9,5.04285714285714,0.0287142857142857,64.2714285714286,75.3657142857143,NA,207,114,96,1,0,116,93,20
2020,50,8,"Aksaray",38.3687,34.036,20.9285714285714,6.9,2.39942857142857,70.2428571428571,56.4142857142857,NA,181,177,97,0,0,98,4,1
2020,51,8,"Aksaray",38.3687,34.036,14.6714285714286,5.8,3.02457142857143,73.8857142857143,37.6028571428571,NA,171,83,45,0,0,90,88,45
2020,52,8,"Aksaray",38.3687,34.036,14.9571428571429,2.11428571428571,0.0285714285714286,72.2142857142857,85.5357142857143,NA,203,181,85,9,23,113,22,28
2020,53,8,"Aksaray",38.3687,34.036,13.7,4.6,0,63.625,68.025,NA,122,107,98,0,0,111,15,13
2017,1,9,"Amasya",40.6534,35.8333,18.6142857142857,3.21428571428571,2.85242857142857,66.6285714285714,33.0716666666667,NA,563,72,119,101,118,847,491,728
2017,2,9,"Amasya",40.6534,35.8333,14.5428571428571,-0.0285714285714287,1.39614285714286,73.9857142857143,39.8042857142857,NA,757,0,0,163,202,1214,757,1214
2017,3,9,"Amasya",40.6534,35.8333,14.2,3.21428571428571,0.0724285714285714,71.6,49.0085714285714,NA,762,56,124,116,193,1449,706,1325
2017,4,9,"Amasya",40.6534,35.8333,13.7285714285714,0.414285714285714,0.728142857142857,66.2,31.4042857142857,NA,639,0,0,350,371,889,639,889
2017,5,9,"Amasya",40.6534,35.8333,14.0142857142857,-0.414285714285714,0.0592857142857143,56.9571428571429,42.4228571428571,NA,588,13,13,206,360,1163,575,1150
2017,6,9,"Amasya",40.6534,35.8333,15.2571428571429,5.08571428571429,0.0714285714285714,66.1857142857143,38.6071428571429,NA,736,90,285,7,12,1519,646,1234
2017,7,9,"Amasya",40.6534,35.8333,13.8142857142857,0.385714285714286,0.385285714285714,59.4428571428571,26.2414285714286,NA,492,21,19,36,69,717,471,698
2017,8,9,"Amasya",40.6534,35.8333,19.5285714285714,8.07142857142857,0.0285714285714286,53.0571428571429,35.28,NA,739,15,53,240,563,1747,724,1694
2017,9,9,"Amasya",40.6534,35.8333,17.7428571428571,9.62857142857143,0.571857142857143,59.2714285714286,49.87,NA,574,1,0,187,319,866,573,866
2017,10,9,"Amasya",40.6534,35.8333,14.0428571428571,11.3857142857143,0.0435714285714286,53.6571428571429,63.4742857142857,NA,712,191,272,287,393,1043,521,771
2017,11,9,"Amasya",40.6534,35.8333,13.2428571428571,7.28571428571429,3.64414285714286,72.9714285714286,15.6557142857143,NA,525,60,61,62,146,725,465,664
2017,12,9,"Amasya",40.6534,35.8333,18.7571428571429,8.64285714285714,0.128571428571429,54.0857142857143,26.1671428571429,NA,589,0,0,8,53,1077,589,1077
2017,13,9,"Amasya",40.6534,35.8333,16.8285714285714,9.42857142857143,2.34028571428571,58.7714285714286,24.5957142857143,NA,574,108,185,89,150,887,466,702
2017,14,9,"Amasya",40.6534,35.8333,14.4571428571429,11.2714285714286,2.85514285714286,55.1714285714286,27.6542857142857,NA,639,20,41,79,170,1336,619,1295
2017,15,9,"Amasya",40.6534,35.8333,14.0285714285714,11.2142857142857,3.47142857142857,64.2714285714286,24.9528571428571,NA,587,67,78,173,384,1187,520,1109
2017,16,9,"Amasya",40.6534,35.8333,20.9571428571429,13.0571428571429,1.45971428571429,56.2,23.1828571428571,NA,717,0,0,147,117,920,717,920
2017,17,9,"Amasya",40.6534,35.8333,14.3,13.5571428571429,0.209857142857143,44.9,29.3642857142857,NA,731,97,217,65,189,1478,634,1261
2017,18,9,"Amasya",40.6534,35.8333,16.3571428571429,16.7714285714286,3.33428571428571,55.6571428571429,33.1914285714286,NA,506,62,76,2,16,923,444,847
2017,19,9,"Amasya",40.6534,35.8333,19.1,19.4857142857143,0.656857142857143,49.6714285714286,33.06,NA,471,84,236,28,81,966,387,730
2017,20,9,"Amasya",40.6534,35.8333,18.2285714285714,14.1428571428571,2.13757142857143,67.4857142857143,17.0371428571429,NA,472,0,0,129,559,1205,472,1205
2017,21,9,"Amasya",40.6534,35.8333,17.2571428571429,15.7428571428571,3.94014285714286,64.3142857142857,15.5642857142857,NA,448,103,101,1,2,849,345,748
2017,22,9,"Amasya",40.6534,35.8333,17.4571428571429,19.6571428571429,0.0294285714285714,60.5857142857143,21.1257142857143,NA,522,0,0,49,25,1015,522,1015
2017,23,9,"Amasya",40.6534,35.8333,17.2142857142857,21.2428571428571,4.74271428571429,65.1571428571429,18.5385714285714,NA,578,0,0,95,325,1388,578,1388
2017,24,9,"Amasya",40.6534,35.8333,17.7428571428571,20.0714285714286,0.442571428571429,55.1857142857143,15.1428571428571,NA,552,0,0,0,0,1139,552,1139
2017,25,9,"Amasya",40.6534,35.8333,15.6142857142857,19.8,6.49,69.7428571428571,11.5614285714286,NA,584,0,0,95,136,1041,584,1041
2017,26,9,"Amasya",40.6534,35.8333,18.7428571428571,24.9142857142857,0.0142857142857143,52.2857142857143,12.2314285714286,NA,564,0,0,31,133,971,564,971
2017,27,9,"Amasya",40.6534,35.8333,19.9285714285714,23.1571428571429,0.429,51.9857142857143,11.2785714285714,NA,511,0,0,0,0,642,511,642
2017,28,9,"Amasya",40.6534,35.8333,21.8857142857143,23.5857142857143,0.0142857142857143,47.9285714285714,10.7142857142857,NA,481,0,0,0,0,864,481,864
2017,29,9,"Amasya",40.6534,35.8333,23.6,24.5714285714286,0.000285714285714286,54.9285714285714,15.755,NA,532,0,0,0,0,1272,532,1272
2017,30,9,"Amasya",40.6534,35.8333,19.7857142857143,26.4428571428571,0.0134285714285714,41.5428571428571,37.8775,NA,531,0,0,0,0,928,531,928
2017,31,9,"Amasya",40.6534,35.8333,25.9714285714286,25.4714285714286,0,53.9,25.1285714285714,NA,559,0,0,0,0,1047,559,1047
2017,32,9,"Amasya",40.6534,35.8333,22.0571428571429,27.4857142857143,0,50.6,36.5671428571429,NA,567,0,0,0,0,1092,567,1092
2017,33,9,"Amasya",40.6534,35.8333,24.4,25.8,0.000285714285714286,55.7428571428571,30.2257142857143,NA,596,0,0,0,0,1199,596,1199
2017,34,9,"Amasya",40.6534,35.8333,22.5714285714286,22.6857142857143,0.00685714285714286,55.8,27.5342857142857,NA,601,18,19,0,0,1280,583,1261
2017,35,9,"Amasya",40.6534,35.8333,19.9,21.3285714285714,0.0571428571428571,52.2142857142857,25.5728571428571,NA,493,0,0,20,123,1014,493,1014
2017,36,9,"Amasya",40.6534,35.8333,18.6,22.3571428571429,0.431714285714286,47.2285714285714,33.518,NA,507,6,0,127,513,1321,501,1321
2017,37,9,"Amasya",40.6534,35.8333,18.9857142857143,25.4857142857143,0,37.2857142857143,56.72,NA,589,0,0,86,173,1138,589,1138
2017,38,9,"Amasya",40.6534,35.8333,19.1285714285714,24.2857142857143,0,41.2571428571429,NA,NA,671,0,0,51,157,1312,671,1312
2017,39,9,"Amasya",40.6534,35.8333,19.9285714285714,18.2428571428571,0.301571428571429,60.3,19.1566666666667,NA,782,0,0,3,12,1630,782,1630
2017,40,9,"Amasya",40.6534,35.8333,15.6142857142857,13.8,2.28585714285714,56.8142857142857,24.56,NA,543,156,365,125,326,1137,387,772
2017,41,9,"Amasya",40.6534,35.8333,17.2571428571429,12.9571428571429,0.670571428571428,66.0857142857143,16.9042857142857,NA,487,0,0,132,270,843,487,843
2017,42,9,"Amasya",40.6534,35.8333,9.04285714285714,12.4857142857143,0.029,57.2142857142857,38.5271428571429,NA,530,241,323,47,100,815,289,492
2017,43,9,"Amasya",40.6534,35.8333,13.6285714285714,14.7,0.0998571428571429,53.9857142857143,48.6442857142857,NA,506,1,0,253,337,919,505,919
2017,44,9,"Amasya",40.6534,35.8333,13.5285714285714,7.64285714285714,0.529428571428571,54.6571428571429,50.06,NA,561,0,0,363,770,1102,561,1102
2017,45,9,"Amasya",40.6534,35.8333,8.31428571428571,9.15714285714286,0.571857142857143,74.2571428571429,88.285,NA,577,84,225,443,490,829,493,604
2017,46,9,"Amasya",40.6534,35.8333,9.85714285714286,9.14285714285714,0.0997142857142857,74.1857142857143,21.2416666666667,NA,587,0,0,347,707,1085,587,1085
2017,47,9,"Amasya",40.6534,35.8333,14.5428571428571,6.2,5.09714285714286,75.5571428571428,6.132,NA,418,93,243,58,75,804,325,561
2017,48,9,"Amasya",40.6534,35.8333,9.6,7.57142857142857,0.414571428571429,75.3142857142857,12.7014285714286,NA,386,3,4,57,93,619,383,615
2017,49,9,"Amasya",40.6534,35.8333,13.5142857142857,5.64285714285714,3.088,70.3428571428571,21.2014285714286,NA,407,27,84,115,200,645,380,561
2017,50,9,"Amasya",40.6534,35.8333,11.2428571428571,6.17142857142857,0.427714285714286,79.2,53.9342857142857,NA,346,14,47,93,78,442,332,395
2017,51,9,"Amasya",40.6534,35.8333,14.0714285714286,6.92857142857143,6.99742857142857,81.6714285714286,16.8116666666667,NA,386,0,0,253,225,349,386,349
2017,52,9,"Amasya",40.6534,35.8333,10.6625,3.175,0.674375,78.4625,41.0175,NA,528,11,27,75,94,507,517,480
2018,1,9,"Amasya",40.6534,35.8333,12.3625,5.4625,1.42575,82.1375,31.2375,NA,618,10,16,190,259,914,608,898
2018,2,9,"Amasya",40.6534,35.8333,14.2428571428571,6.12857142857143,0.587285714285714,77.7714285714286,21.0142857142857,NA,624,39,69,187,285,1309,585,1240
2018,3,9,"Amasya",40.6534,35.8333,16.8285714285714,5.25714285714286,3.31942857142857,70.1857142857143,14.7857142857143,NA,639,9,13,0,0,655,630,642
2018,4,9,"Amasya",40.6534,35.8333,19.6714285714286,3.5,1.99828571428571,70.1714285714286,7.60166666666667,NA,604,12,17,108,123,764,592,747
2018,5,9,"Amasya",40.6534,35.8333,11.7,6.04285714285714,0,64.3714285714286,13.7028571428571,NA,670,0,0,350,423,819,670,819
2018,6,9,"Amasya",40.6534,35.8333,14.0857142857143,8.44285714285714,0.856428571428571,75.3857142857143,13.6514285714286,NA,704,0,0,280,383,1022,704,1022
2018,7,9,"Amasya",40.6534,35.8333,18.9857142857143,7.54285714285714,0.357285714285714,69.6285714285714,7.018,NA,478,0,0,146,166,557,478,557
2018,8,9,"Amasya",40.6534,35.8333,19.9142857142857,7.9,0.685571428571429,71.7714285714286,5.65666666666667,NA,711,103,202,16,42,1321,608,1119
2018,9,9,"Amasya",40.6534,35.8333,19.8571428571429,7.67142857142857,3.11728571428571,65.3857142857143,8.77,NA,621,0,0,90,106,956,621,956
2018,10,9,"Amasya",40.6534,35.8333,18.8,10.5142857142857,1.47228571428571,69.7428571428571,8.23833333333333,NA,556,1,0,76,175,1330,555,1330
2018,11,9,"Amasya",40.6534,35.8333,11.1428571428571,11.3428571428571,2.71771428571429,67.4142857142857,7.2,NA,551,133,391,114,275,1426,418,1035
2018,12,9,"Amasya",40.6534,35.8333,18.2857142857143,14.0142857142857,1.77028571428571,56.6857142857143,21.48,NA,425,23,51,60,351,1187,402,1136
2018,13,9,"Amasya",40.6534,35.8333,13.2428571428571,12.6,2.45914285714286,64.0714285714286,19.355,NA,356,53,47,122,162,428,303,381
2018,14,9,"Amasya",40.6534,35.8333,13.8,13.2,0.0574285714285714,52.7714285714286,8.65,NA,407,75,96,62,62,486,332,390
2018,15,9,"Amasya",40.6534,35.8333,15.7857142857143,15.8714285714286,0,51.6714285714286,9.80142857142857,NA,374,14,3,12,11,450,360,447
2018,16,9,"Amasya",40.6534,35.8333,15.3428571428571,13,0.157428571428571,48.9428571428571,15.2766666666667,NA,411,68,92,82,74,648,343,556
2018,17,9,"Amasya",40.6534,35.8333,17.3142857142857,17.5428571428571,0.000285714285714286,44.3142857142857,23.7314285714286,NA,419,51,83,0,0,652,368,569
2018,18,9,"Amasya",40.6534,35.8333,14.8857142857143,19.9714285714286,0.829714285714286,52.7428571428571,14.0057142857143,NA,303,92,169,5,58,474,211,305
2018,19,9,"Amasya",40.6534,35.8333,15.3571428571429,15.8714285714286,6.26185714285714,70.0428571428571,11.22,NA,275,59,201,16,13,467,216,266
2018,20,9,"Amasya",40.6534,35.8333,14.8428571428571,19.7,2.44385714285714,58.2285714285714,24.9142857142857,NA,204,15,13,36,40,306,189,293
2018,21,9,"Amasya",40.6534,35.8333,20.1857142857143,21.3428571428571,0.553428571428571,62.3285714285714,29.28,NA,252,0,0,7,10,281,252,281
2018,22,9,"Amasya",40.6534,35.8333,17.7428571428571,19.4857142857143,0.542571428571429,62.4571428571429,24.0828571428571,NA,249,7,0,6,10,427,242,427
2018,23,9,"Amasya",40.6534,35.8333,18.0714285714286,22.1428571428571,0.0735714285714286,51.4714285714286,24.74,NA,267,0,0,40,112,812,267,812
2018,24,9,"Amasya",40.6534,35.8333,19.4428571428571,22.4571428571429,1.40357142857143,53.6857142857143,21.7314285714286,NA,267,3,0,45,124,448,264,448
2018,25,9,"Amasya",40.6534,35.8333,17.2571428571429,22.3285714285714,0.431714285714286,60.0285714285714,18.6842857142857,NA,358,0,0,0,0,518,358,518
2018,26,9,"Amasya",40.6534,35.8333,23.4571428571429,25.6571428571429,0,54.5142857142857,24.4742857142857,NA,355,0,0,0,0,587,355,587
2018,27,9,"Amasya",40.6534,35.8333,21.1571428571429,22.9142857142857,0,53.7142857142857,24.5828571428571,NA,342,0,0,0,0,418,342,418
2018,28,9,"Amasya",40.6534,35.8333,24.7428571428571,25.6428571428571,0.00185714285714286,49.8285714285714,31.5385714285714,NA,286,0,0,0,0,585,286,585
2018,29,9,"Amasya",40.6534,35.8333,19.8285714285714,24.0857142857143,1.85528571428571,52.8142857142857,21.0328571428571,NA,260,0,0,10,17,756,260,756
2018,30,9,"Amasya",40.6534,35.8333,20.9857142857143,25.9142857142857,1.30142857142857,56.8857142857143,28.6042857142857,NA,265,0,0,1,0,822,265,822
2018,31,9,"Amasya",40.6534,35.8333,21.3285714285714,25.9428571428571,0.00214285714285714,51.9428571428571,29.24,NA,267,6,10,1,3,499,261,489
2018,32,9,"Amasya",40.6534,35.8333,21.0285714285714,23.2285714285714,0.0255714285714286,52.1571428571429,26.1457142857143,NA,297,4,0,48,33,403,293,403
2018,33,9,"Amasya",40.6534,35.8333,20.9714285714286,23.9142857142857,0,48.1285714285714,27.55,NA,216,0,0,19,43,332,216,332
2018,34,9,"Amasya",40.6534,35.8333,19.1428571428571,24.8428571428571,0,42.6714285714286,32.2442857142857,NA,144,0,0,0,0,227,144,227
2018,35,9,"Amasya",40.6534,35.8333,22.7285714285714,25.4285714285714,0,48.7285714285714,33.5585714285714,NA,201,0,0,0,0,314,201,314
2018,36,9,"Amasya",40.6534,35.8333,20.8714285714286,23.7285714285714,0.0321428571428571,51.1142857142857,39.8466666666667,NA,341,0,0,44,62,370,341,370
2018,37,9,"Amasya",40.6534,35.8333,21.0571428571429,20.8142857142857,1.36,62.7142857142857,27.294,NA,241,0,0,49,103,419,241,419
2018,38,9,"Amasya",40.6534,35.8333,26.1714285714286,18.5857142857143,0.0714285714285714,60.2857142857143,27.32,NA,189,0,0,0,0,344,189,344
2018,39,9,"Amasya",40.6534,35.8333,21.2,17.6714285714286,0.656,56.5571428571429,33.2328571428571,NA,180,23,48,0,0,353,157,305
2018,40,9,"Amasya",40.6534,35.8333,18.0714285714286,17.4714285714286,0.100428571428571,58.7857142857143,29.42,NA,191,0,0,22,27,341,191,341
2018,41,9,"Amasya",40.6534,35.8333,18.5857142857143,16.9714285714286,1.56857142857143,71.1571428571429,41.2857142857143,NA,187,0,0,33,143,422,187,422
2018,42,9,"Amasya",40.6534,35.8333,17.2428571428571,18.2714285714286,3.72285714285714,69.0857142857143,101.578571428571,NA,168,0,0,80,233,381,168,381
2018,43,9,"Amasya",40.6534,35.8333,11.8428571428571,11.7857142857143,4.05471428571429,76.0285714285714,45.0657142857143,NA,187,11,41,50,95,402,176,361
2018,44,9,"Amasya",40.6534,35.8333,12.6571428571429,11.6,0,70.4857142857143,64.9057142857143,NA,196,36,85,5,32,264,160,179
2018,45,9,"Amasya",40.6534,35.8333,11.4714285714286,10.6571428571429,0.000142857142857143,74.4285714285714,52.7385714285714,NA,231,0,0,94,266,473,231,473
2018,46,9,"Amasya",40.6534,35.8333,13.5,6.72857142857143,0.13,72.3142857142857,34.2916666666667,NA,230,32,29,101,198,465,198,436
2018,47,9,"Amasya",40.6534,35.8333,11.8714285714286,8.44285714285714,1.31542857142857,77.4571428571429,36.216,NA,270,91,80,50,195,499,179,419
2018,48,9,"Amasya",40.6534,35.8333,18.6428571428571,9.65714285714286,2.69528571428571,78.3142857142857,31.2771428571429,NA,245,27,16,6,25,201,218,185
2018,49,9,"Amasya",40.6534,35.8333,10.2285714285714,6.08571428571429,1.02914285714286,82.5714285714286,32.7571428571429,NA,257,8,8,119,189,420,249,412
2018,50,9,"Amasya",40.6534,35.8333,12.8571428571429,5.1,4.66328571428571,81.4714285714286,38.2571428571429,NA,256,48,60,92,124,305,208,245
2018,51,9,"Amasya",40.6534,35.8333,10.5714285714286,7.61428571428571,0.885428571428571,81.4714285714286,46.6542857142857,NA,250,115,113,49,39,248,135,135
2018,52,9,"Amasya",40.6534,35.8333,13.9571428571429,1.6,7.84542857142857,78.7,30.7428571428571,NA,244,14,0,105,139,273,230,273
2019,1,9,"Amasya",40.6534,35.8333,14.8625,3.775,3.5345,79.8125,40.9825,NA,343,46,42,124,273,784,297,742
2019,2,9,"Amasya",40.6534,35.8333,13.0285714285714,-0.814285714285714,1.19914285714286,79.7571428571429,47.0485714285714,NA,255,73,87,42,27,208,182,121
2019,3,9,"Amasya",40.6534,35.8333,14.0428571428571,1.87142857142857,1.70128571428571,77.6428571428571,41.1571428571429,NA,192,57,81,43,41,198,135,117
2019,4,9,"Amasya",40.6534,35.8333,13.7142857142857,5.44285714285714,1.52557142857143,74.1428571428571,68.15,NA,308,18,42,0,0,314,290,272
2019,5,9,"Amasya",40.6534,35.8333,14.9857142857143,7.31428571428571,1.72514285714286,68.1428571428571,23.6325,NA,253,34,21,0,0,143,219,122
2019,6,9,"Amasya",40.6534,35.8333,12.5857142857143,6.28571428571429,1.91414285714286,76.7428571428571,49.705,NA,276,26,13,42,17,127,250,114
2019,7,9,"Amasya",40.6534,35.8333,16.2285714285714,5.87142857142857,0.0428571428571429,68.1,31.68,NA,325,26,6,2,1,234,299,228
2019,8,9,"Amasya",40.6534,35.8333,19.4,6.74285714285714,0.0442857142857143,64.7,43.36,NA,305,18,3,0,0,219,287,216
2019,9,9,"Amasya",40.6534,35.8333,18.2857142857143,5,0.271,65.6714285714286,21.5228571428571,NA,331,0,0,55,118,310,331,310
2019,10,9,"Amasya",40.6534,35.8333,11.9714285714286,7.38571428571429,0.855714285714286,59.7571428571429,39.1785714285714,NA,359,9,7,97,27,252,350,245
2019,11,9,"Amasya",40.6534,35.8333,21.7142857142857,8.91428571428571,1.65642857142857,66.9285714285714,31.9314285714286,NA,373,0,0,69,89,400,373,400
2019,12,9,"Amasya",40.6534,35.8333,15.2714285714286,7.3,0.000142857142857143,60.3428571428571,25.5414285714286,NA,343,0,0,45,267,416,343,416
2019,13,9,"Amasya",40.6534,35.8333,25.6,5.45714285714286,0,57.4285714285714,19.8814285714286,NA,256,0,0,54,38,194,256,194
2019,14,9,"Amasya",40.6534,35.8333,16.9571428571429,10.9714285714286,0,52.5285714285714,29.7971428571429,NA,365,0,0,0,0,208,365,208
2019,15,9,"Amasya",40.6534,35.8333,14.6285714285714,14.8285714285714,1.21442857142857,59.5142857142857,27.84,NA,359,0,0,97,52,183,359,183
2019,16,9,"Amasya",40.6534,35.8333,17.6714285714286,7.7,4.21671428571429,77.0714285714286,12.6014285714286,NA,318,0,0,32,29,208,318,208
2019,17,9,"Amasya",40.6534,35.8333,14.8428571428571,13.0142857142857,0.000714285714285714,57.8142857142857,31.8428571428571,NA,412,52,18,77,71,313,360,295
2019,18,9,"Amasya",40.6534,35.8333,14.9285714285714,17.2,0.999857142857143,53.9571428571429,37.8942857142857,NA,523,0,0,56,21,353,523,353
2019,19,9,"Amasya",40.6534,35.8333,17.6857142857143,15.9285714285714,6.47985714285714,67.4714285714286,24.925,NA,452,82,77,153,142,386,370,309
2019,20,9,"Amasya",40.6534,35.8333,16.0571428571429,19.7857142857143,1.968,60.2571428571429,27.53,NA,454,0,0,136,106,389,454,389
2019,21,9,"Amasya",40.6534,35.8333,14.3142857142857,20.0714285714286,2.64242857142857,65.7428571428571,29.63,NA,457,0,0,68,79,413,457,413
2019,22,9,"Amasya",40.6534,35.8333,15.0571428571429,23.0428571428571,0.000285714285714286,52.1714285714286,35.4728571428571,NA,453,0,0,7,33,323,453,323
2019,23,9,"Amasya",40.6534,35.8333,21.3714285714286,23.7285714285714,0.599714285714286,59.2857142857143,26.7842857142857,NA,378,0,0,0,0,532,378,532
2019,24,9,"Amasya",40.6534,35.8333,19.7285714285714,22.6,1.40728571428571,67.0714285714286,24.2671428571429,NA,378,0,0,48,13,244,378,244
2019,25,9,"Amasya",40.6534,35.8333,18.1714285714286,23.4142857142857,3.23171428571429,65.8571428571429,NA,NA,306,0,0,34,56,325,306,325
2019,26,9,"Amasya",40.6534,35.8333,19.6,23.5428571428571,0.128714285714286,56.2285714285714,NA,NA,377,0,0,4,1,342,377,342
2019,27,9,"Amasya",40.6534,35.8333,20.0714285714286,22.3142857142857,0,53.8857142857143,30.585,NA,456,0,0,0,0,222,456,222
2019,28,9,"Amasya",40.6534,35.8333,19.0142857142857,22.2714285714286,1.74714285714286,56.5857142857143,20.65,NA,398,0,0,1,0,421,398,421
2019,29,9,"Amasya",40.6534,35.8333,20.0571428571429,21.4,0.629428571428571,60.7,24.4185714285714,NA,453,0,0,7,4,203,453,203
2019,30,9,"Amasya",40.6534,35.8333,18.9571428571429,22.5571428571429,0,55.5857142857143,28.0814285714286,NA,456,0,0,4,2,335,456,335
2019,31,9,"Amasya",40.6534,35.8333,22.7428571428571,25.4428571428571,0.016,51.9857142857143,32.2728571428571,NA,334,0,0,23,29,375,334,375
2019,32,9,"Amasya",40.6534,35.8333,20.1571428571429,21.3857142857143,0,55.9,24,NA,346,0,0,1,1,395,346,395
2019,33,9,"Amasya",40.6534,35.8333,21.2857142857143,23.7,1.501,55.8571428571429,29.31,NA,337,0,0,6,5,531,337,531
2019,34,9,"Amasya",40.6534,35.8333,16.6285714285714,21.8571428571429,1.30928571428571,70.3714285714286,34.1142857142857,NA,299,5,37,46,40,345,294,308
2019,35,9,"Amasya",40.6534,35.8333,19.7,22.6428571428571,0.0208571428571429,58.1285714285714,35.4742857142857,NA,307,0,0,1,1,415,307,415
2019,36,9,"Amasya",40.6534,35.8333,18.4285714285714,21.0285714285714,0,53.7285714285714,34.9328571428571,NA,171,0,0,0,0,67,171,67
2019,37,9,"Amasya",40.6534,35.8333,18,20.4142857142857,0,57.5428571428571,28.6085714285714,NA,218,23,5,1,0,55,195,50
2019,38,9,"Amasya",40.6534,35.8333,19.6428571428571,18.4428571428571,0.201,56.8285714285714,36.6014285714286,NA,266,55,36,1,0,91,211,55
2019,39,9,"Amasya",40.6534,35.8333,13.4285714285714,17.8571428571429,0.0154285714285714,61.3714285714286,36.17,NA,237,0,0,59,21,79,237,79
2019,40,9,"Amasya",40.6534,35.8333,16.5571428571429,20.1714285714286,0.286142857142857,48.9285714285714,48.11,NA,241,0,0,73,65,111,241,111
2019,41,9,"Amasya",40.6534,35.8333,18.7571428571429,16.8,0.0142857142857143,61.6857142857143,31.1228571428571,NA,416,0,0,131,227,448,416,448
2019,42,9,"Amasya",40.6534,35.8333,12.4428571428571,17.8,0.158,57.3571428571429,51.9842857142857,NA,356,0,0,113,126,408,356,408
2019,43,9,"Amasya",40.6534,35.8333,14.6428571428571,15.5714285714286,0.228,70.9857142857143,33.3457142857143,NA,306,0,0,87,116,300,306,300
2019,44,9,"Amasya",40.6534,35.8333,18.1285714285714,11.2714285714286,2.17385714285714,72.4285714285714,33.1528571428571,NA,350,29,26,48,47,250,321,224
2019,45,9,"Amasya",40.6534,35.8333,9.51428571428571,11.5714285714286,0,64.7428571428571,74.9328571428571,NA,417,71,96,173,146,328,346,232
2019,46,9,"Amasya",40.6534,35.8333,8.6,9.88571428571429,0,64.6714285714286,110.974285714286,NA,401,27,53,142,180,337,374,284
2019,47,9,"Amasya",40.6534,35.8333,7.74285714285714,5.37142857142857,0,68.2428571428571,106.588571428571,NA,391,2,16,224,168,339,389,323
2019,48,9,"Amasya",40.6534,35.8333,11.2571428571429,8.68571428571429,2.58614285714286,77.1857142857143,86.2285714285714,NA,320,24,13,130,78,251,296,238
2019,49,9,"Amasya",40.6534,35.8333,15.7714285714286,3.88571428571429,0.0151428571428571,69.6428571428571,30.0285714285714,NA,393,21,8,99,39,274,372,266
2019,50,9,"Amasya",40.6534,35.8333,9.84285714285714,5.84285714285714,0.114142857142857,76.9571428571429,68.4257142857143,NA,218,6,0,160,105,119,212,119
2019,51,9,"Amasya",40.6534,35.8333,9.5,5.05714285714286,0.143142857142857,76.7285714285714,66.1828571428571,NA,361,7,22,143,196,488,354,466
2019,52,9,"Amasya",40.6534,35.8333,17,7.57142857142857,4.69657142857143,75.5428571428571,31.5371428571429,NA,279,41,83,155,107,281,238,198
2020,1,9,"Amasya",40.6534,35.8333,11.82,4.06,0.8214,81.56,29.598,NA,160,32,24,41,29,126,128,102
2020,2,9,"Amasya",40.6534,35.8333,12.6857142857143,3.24285714285714,0.474428571428571,78.2142857142857,43.8214285714286,NA,240,0,0,187,145,173,240,173
2020,3,9,"Amasya",40.6534,35.8333,12,2.51428571428571,0.0431428571428571,76.5428571428571,45.0142857142857,NA,270,0,0,60,46,382,270,382
2020,4,9,"Amasya",40.6534,35.8333,13.4,1.27142857142857,1.54628571428571,70.7,35.0642857142857,NA,358,1,1,139,82,295,357,294
2020,5,9,"Amasya",40.6534,35.8333,12.7142857142857,4.55714285714286,2.52585714285714,74.8571428571429,46.5557142857143,NA,331,19,27,37,27,272,312,245
2020,6,9,"Amasya",40.6534,35.8333,19.3571428571429,5.61428571428571,4.46842857142857,66.6857142857143,21.5428571428571,NA,343,66,57,72,42,267,277,210
2020,7,9,"Amasya",40.6534,35.8333,12.5,1.2,1.62557142857143,70.2285714285714,36.7685714285714,NA,341,18,14,31,22,338,323,324
2020,8,9,"Amasya",40.6534,35.8333,16.0285714285714,5.04285714285714,1.93942857142857,70.8,43.5828571428571,NA,283,28,57,56,40,187,255,130
2020,9,9,"Amasya",40.6534,35.8333,23,8.4,0.272142857142857,58.6,27.5328571428571,NA,393,0,0,74,73,528,393,528
2020,10,9,"Amasya",40.6534,35.8333,18.3571428571429,11.5714285714286,0.427857142857143,54.0142857142857,41.3557142857143,NA,205,18,9,12,12,210,187,201
2020,11,9,"Amasya",40.6534,35.8333,22.6142857142857,13,0.228857142857143,58.1285714285714,40.4214285714286,NA,115,17,8,9,6,94,98,86
2020,12,9,"Amasya",40.6534,35.8333,17.8571428571429,4.1,0.814571428571429,69.0714285714286,17.1714285714286,NA,117,8,6,33,45,118,109,112
2020,13,9,"Amasya",40.6534,35.8333,21.1142857142857,9.68571428571429,0.588142857142857,68.4428571428571,24.3485714285714,NA,136,0,0,1,1,92,136,92
2020,14,9,"Amasya",40.6534,35.8333,22.0857142857143,9.9,1.61271428571429,70.7142857142857,27.7733333333333,NA,155,0,0,46,39,121,155,121
2020,15,9,"Amasya",40.6534,35.8333,36.4142857142857,7.95714285714286,0.128285714285714,56.1428571428571,27.9085714285714,NA,133,0,0,0,0,118,133,118
2020,16,9,"Amasya",40.6534,35.8333,22.1714285714286,10.9142857142857,1.13657142857143,54.7142857142857,31.4642857142857,NA,141,0,0,9,5,106,141,106
2020,17,9,"Amasya",40.6534,35.8333,28.4428571428571,9.42857142857143,0.617285714285714,59.6142857142857,24.3328571428571,NA,137,0,0,0,0,123,137,123
2020,18,9,"Amasya",40.6534,35.8333,24.3571428571429,13.3857142857143,5.27742857142857,62.8285714285714,26.27,NA,146,17,5,49,42,164,129,159
2020,19,9,"Amasya",40.6534,35.8333,23.0428571428571,13.0142857142857,3.42642857142857,67.4,18.7628571428571,NA,137,0,0,20,21,157,137,157
2020,20,9,"Amasya",40.6534,35.8333,20.7428571428571,20.6714285714286,0,46.9,46.7585714285714,NA,164,52,46,0,0,164,112,118
2020,21,9,"Amasya",40.6534,35.8333,31.3857142857143,18.4714285714286,2.599,52.2428571428571,39.7657142857143,NA,146,13,22,21,10,96,133,74
2020,22,9,"Amasya",40.6534,35.8333,30.3428571428571,15.2285714285714,0.421,60.8714285714286,19.7514285714286,NA,118,31,15,0,0,100,87,85
2020,23,9,"Amasya",40.6534,35.8333,19.9857142857143,19.9142857142857,1.24557142857143,56.2857142857143,24.485,NA,112,17,2,3,2,70,95,68
2020,24,9,"Amasya",40.6534,35.8333,18.0142857142857,22.4857142857143,3.42271428571429,56.0857142857143,30.08,NA,140,44,61,0,0,150,96,89
2020,25,9,"Amasya",40.6534,35.8333,17.2,21.3285714285714,3.06971428571429,64.7857142857143,32.3971428571429,NA,137,0,0,60,23,108,137,108
2020,26,9,"Amasya",40.6534,35.8333,18.7,23.2714285714286,0.00414285714285714,57.7285714285714,33.9228571428571,NA,173,0,0,6,7,133,173,133
2020,27,9,"Amasya",40.6534,35.8333,20.9285714285714,24.4857142857143,0,50.1142857142857,36.0357142857143,NA,113,0,0,2,5,113,113,113
2020,28,9,"Amasya",40.6534,35.8333,22.0857142857143,24.5571428571429,0.00514285714285714,56,31.4885714285714,NA,164,0,0,23,36,122,164,122
2020,29,9,"Amasya",40.6534,35.8333,25.4,24.1142857142857,0.286428571428571,56.5571428571429,30.5614285714286,NA,186,0,0,0,0,111,186,111
2020,30,9,"Amasya",40.6534,35.8333,21.0285714285714,24.4428571428571,0,50.6714285714286,29.8514285714286,NA,190,0,0,0,0,142,190,142
2020,31,9,"Amasya",40.6534,35.8333,24.8285714285714,24.7285714285714,0,53.9,29.6242857142857,NA,150,0,0,0,0,127,150,127
2020,32,9,"Amasya",40.6534,35.8333,22.9428571428571,23.9571428571429,0,50.9428571428571,27.3342857142857,NA,146,0,0,0,0,107,146,107
2020,33,9,"Amasya",40.6534,35.8333,22.2428571428571,22.9714285714286,0,48.7142857142857,29.6514285714286,NA,183,3,0,0,0,83,180,83
2020,34,9,"Amasya",40.6534,35.8333,21.2571428571429,22.4,0.0442857142857143,50.1142857142857,27.8842857142857,NA,197,0,0,11,5,97,197,97
2020,35,9,"Amasya",40.6534,35.8333,19.2,23.2857142857143,0,45.3857142857143,29.2657142857143,NA,164,0,0,19,36,157,164,157
2020,36,9,"Amasya",40.6534,35.8333,21.2142857142857,26.3142857142857,0,41.4,40.1528571428571,NA,179,0,0,38,34,112,179,112
2020,37,9,"Amasya",40.6534,35.8333,23.7857142857143,23.1857142857143,0,59.4142857142857,35.4571428571429,NA,193,0,0,7,9,91,193,91
2020,38,9,"Amasya",40.6534,35.8333,20.7571428571429,21.8714285714286,0.000571428571428571,53.9714285714286,38.5085714285714,NA,235,0,0,35,19,157,235,157
2020,39,9,"Amasya",40.6534,35.8333,19.5285714285714,21.4,0.0142857142857143,55.8714285714286,40.4985714285714,NA,220,12,5,23,9,129,208,124
2020,40,9,"Amasya",40.6534,35.8333,22.6428571428571,21.4,0.0744285714285714,53.2285714285714,39.4685714285714,NA,187,0,0,14,11,154,187,154
2020,41,9,"Amasya",40.6534,35.8333,18.5428571428571,19.9857142857143,0,47.2428571428571,45.8933333333333,NA,182,22,9,6,1,127,160,118
2020,42,9,"Amasya",40.6534,35.8333,15.7142857142857,19.4285714285714,0,49.8428571428571,64.2033333333333,NA,177,0,0,66,29,111,177,111
2020,43,9,"Amasya",40.6534,35.8333,16.1714285714286,15.9285714285714,0.0258571428571429,57.5428571428571,43.0957142857143,NA,194,4,0,51,80,161,190,161
2020,44,9,"Amasya",40.6534,35.8333,11.4,15.7428571428571,0.100571428571429,48.7571428571429,64.2671428571429,NA,255,0,0,191,165,233,255,233
2020,45,9,"Amasya",40.6534,35.8333,15.3142857142857,11.1,0.058,63.7857142857143,38.59,NA,156,0,0,59,41,103,156,103
2020,46,9,"Amasya",40.6534,35.8333,11.7285714285714,8.37142857142857,0.001,66.9857142857143,49.1185714285714,NA,208,15,16,91,43,109,193,93
2020,47,9,"Amasya",40.6534,35.8333,14.9714285714286,7.14285714285714,0.0388571428571429,66.3571428571429,27.6885714285714,NA,173,0,0,52,30,83,173,83
2020,48,9,"Amasya",40.6534,35.8333,9.82857142857143,3.17142857142857,0.0351428571428571,64.9571428571429,48.2585714285714,NA,199,0,0,117,223,262,199,262
2020,49,9,"Amasya",40.6534,35.8333,7.71428571428571,3.6,0.406,73.3714285714286,74.42,NA,207,39,18,60,39,116,168,98
2020,50,9,"Amasya",40.6534,35.8333,11.5428571428571,6.25714285714286,0.752714285714286,80.6857142857143,51.9957142857143,NA,181,37,10,53,45,98,144,88
2020,51,9,"Amasya",40.6534,35.8333,11.1428571428571,7.08571428571429,1.52914285714286,80.8285714285714,35.6871428571429,NA,171,30,15,61,37,90,141,75
2020,52,9,"Amasya",40.6534,35.8333,9.74285714285714,3.47142857142857,0.000571428571428571,72.4142857142857,40.2742857142857,NA,203,60,41,30,38,113,143,72
2020,53,9,"Amasya",40.6534,35.8333,10.475,4.9,0,70.975,61.8525,NA,122,19,23,26,15,111,103,88
2017,1,10,"Bahcelievler",39.9195,32.829,15.3714285714286,-1.71428571428571,0.998428571428571,79.5142857142857,43.6228571428571,83.0028571428571,563,32,39,175,272,847,531,808
2017,2,10,"Bahcelievler",39.9195,32.829,14.8285714285714,-2.28571428571429,0.637857142857143,76.7285714285714,39.6357142857143,95.9114285714286,757,1,2,74,91,1214,756,1212
2017,3,10,"Bahcelievler",39.9195,32.829,11.2714285714286,1.62857142857143,1.10885714285714,85.1428571428571,51.0214285714286,98.0214285714286,762,0,0,126,174,1449,762,1449
2017,4,10,"Bahcelievler",39.9195,32.829,15.1,-2.07142857142857,0.133,68.3,38.58,97.5833333333333,639,0,0,108,135,889,639,889
2017,5,10,"Bahcelievler",39.9195,32.829,9.37142857142857,-2.7,0.144142857142857,64.4428571428571,59.95,131.275,588,61,88,57,108,1163,527,1075
2017,6,10,"Bahcelievler",39.9195,32.829,14.0428571428571,4.07142857142857,0.267714285714286,78.5,51.31,92.372,736,0,0,250,455,1519,736,1519
2017,7,10,"Bahcelievler",39.9195,32.829,13.2142857142857,-1.24285714285714,0.0645714285714286,58.7857142857143,35.63,111.1,492,61,47,181,248,717,431,670
2017,8,10,"Bahcelievler",39.9195,32.829,16.0142857142857,6.42857142857143,0.321428571428571,67.5285714285714,49.05,102.35,739,2,2,109,303,1747,737,1745
2017,9,10,"Bahcelievler",39.9195,32.829,14.9142857142857,8.84285714285714,0.933571428571429,63.5285714285714,60.72,93.555,574,143,249,20,37,866,431,617
2017,10,10,"Bahcelievler",39.9195,32.829,14.2142857142857,8.94285714285714,2.27371428571429,60.7285714285714,53.7957142857143,98.406,712,543,660,0,0,1043,169,383
2017,11,10,"Bahcelievler",39.9195,32.829,14.9714285714286,3.65714285714286,2.02828571428571,77.6,24.0528571428571,79.515,525,0,0,181,329,725,525,725
2017,12,10,"Bahcelievler",39.9195,32.829,16.2571428571429,9.62857142857143,0.122142857142857,48.4142857142857,36.8542857142857,NA,589,0,0,255,524,1077,589,1077
2017,13,10,"Bahcelievler",39.9195,32.829,17.3285714285714,9.95714285714286,0.149428571428571,47.4571428571429,36.4042857142857,NA,574,23,29,55,90,887,551,858
2017,14,10,"Bahcelievler",39.9195,32.829,17.4,10.8714285714286,0.832857142857143,47.0714285714286,35.5114285714286,NA,639,97,276,179,295,1336,542,1060
2017,15,10,"Bahcelievler",39.9195,32.829,14.0857142857143,9.78571428571428,0.307142857142857,56.8428571428571,23.8742857142857,NA,587,99,250,151,378,1187,488,937
2017,16,10,"Bahcelievler",39.9195,32.829,21.4285714285714,9.92857142857143,1.32342857142857,62.1,28.6014285714286,35.1616666666667,717,0,0,110,76,920,717,920
2017,17,10,"Bahcelievler",39.9195,32.829,12.1571428571429,12.6428571428571,0,42.6285714285714,70.1914285714286,65.0285714285714,731,69,246,314,627,1478,662,1232
2017,18,10,"Bahcelievler",39.9195,32.829,21.2571428571429,16.3571428571429,2.03485714285714,55.8,60.9257142857143,56.8685714285714,506,34,36,71,114,923,472,887
2017,19,10,"Bahcelievler",39.9195,32.829,20.7714285714286,18.1714285714286,0.0572857142857143,47.1,65.0685714285714,36.5428571428571,471,2,2,262,499,966,469,964
2017,20,10,"Bahcelievler",39.9195,32.829,19.9714285714286,14.5,0.772571428571429,55.5,23.5085714285714,19.4928571428571,472,11,19,83,446,1205,461,1186
2017,21,10,"Bahcelievler",39.9195,32.829,15.1714285714286,13.8142857142857,4.26857142857143,63.3571428571429,33.3,20.3842857142857,448,14,121,178,320,849,434,728
2017,22,10,"Bahcelievler",39.9195,32.829,16.5285714285714,17,0.906714285714286,67.9,39.8385714285714,14.9785714285714,522,0,0,148,251,1015,522,1015
2017,23,10,"Bahcelievler",39.9195,32.829,13.4857142857143,19.2571428571429,2.486,65.7285714285714,39.2142857142857,14.0914285714286,578,0,0,294,711,1388,578,1388
2017,24,10,"Bahcelievler",39.9195,32.829,12.3142857142857,20.2857142857143,0.543142857142857,53.1571428571429,33.5714285714286,12.0357142857143,552,0,0,285,544,1139,552,1139
2017,25,10,"Bahcelievler",39.9195,32.829,9.52857142857143,18.6857142857143,3.99957142857143,63.7857142857143,38.2385714285714,12.1871428571429,584,0,0,295,544,1041,584,1041
2017,26,10,"Bahcelievler",39.9195,32.829,11.0571428571429,26.4428571428571,0,40.4571428571429,45.5385714285714,15.8542857142857,564,0,0,238,441,971,564,971
2017,27,10,"Bahcelievler",39.9195,32.829,14.9857142857143,24.0571428571429,0,41.9571428571429,39.9657142857143,13.41,511,0,0,173,281,642,511,642
2017,28,10,"Bahcelievler",39.9195,32.829,13.1714285714286,26.1285714285714,1.20228571428571,37.1142857142857,42.2385714285714,14.3914285714286,481,0,0,55,132,864,481,864
2017,29,10,"Bahcelievler",39.9195,32.829,12.6142857142857,25.5428571428571,0.00842857142857143,44.3285714285714,36.1,23.2928571428571,532,0,0,52,163,1272,532,1272
2017,30,10,"Bahcelievler",39.9195,32.829,15.7,25.5,0.00771428571428571,35.2285714285714,60.6485714285714,34.7628571428571,531,1,1,86,119,928,530,927
2017,31,10,"Bahcelievler",39.9195,32.829,19.9142857142857,24.9428571428571,1.31085714285714,50.3142857142857,40.0157142857143,27.7585714285714,559,0,0,65,77,1047,559,1047
2017,32,10,"Bahcelievler",39.9195,32.829,21.5714285714286,27.9,0.0462857142857143,39.1428571428571,56.2414285714286,35.33,567,0,0,170,317,1092,567,1092
2017,33,10,"Bahcelievler",39.9195,32.829,17.4428571428571,24.8857142857143,0.451857142857143,48.7285714285714,52.5471428571429,38.42,596,0,0,399,784,1199,596,1199
2017,34,10,"Bahcelievler",39.9195,32.829,18.8428571428571,22.0142857142857,0.086,48.0142857142857,31.9442857142857,30.0733333333333,601,0,0,171,537,1280,601,1280
2017,35,10,"Bahcelievler",39.9195,32.829,15.3428571428571,21.8142857142857,0.119571428571429,41.5571428571429,32.0685714285714,44.64,493,12,3,1,0,1014,481,1011
2017,36,10,"Bahcelievler",39.9195,32.829,13,21.1142857142857,0.0225714285714286,36.1,61.68,60.4842857142857,507,0,0,258,530,1321,507,1321
2017,37,10,"Bahcelievler",39.9195,32.829,14.8857142857143,25.9428571428571,0,27.3571428571429,102.584285714286,60.4842857142857,589,0,0,74,87,1138,589,1138
2017,38,10,"Bahcelievler",39.9195,32.829,14.6714285714286,23.0142857142857,0,32.4857142857143,79.51,57.0414285714286,671,96,148,45,121,1312,575,1164
2017,39,10,"Bahcelievler",39.9195,32.829,16.2285714285714,17.8142857142857,2.08128571428571,53.6,45.4571428571429,39.29,782,0,0,24,21,1630,782,1630
2017,40,10,"Bahcelievler",39.9195,32.829,10.8714285714286,13.4571428571429,1.85628571428571,52.6714285714286,56.2442857142857,49.6757142857143,543,104,274,124,199,1137,439,863
2017,41,10,"Bahcelievler",39.9195,32.829,7.6,11.6142857142857,0.262714285714286,59.1428571428571,51.7642857142857,53.0442857142857,487,0,0,136,346,843,487,843
2017,42,10,"Bahcelievler",39.9195,32.829,7.45714285714286,12.4571428571429,0,50.7571428571429,93.7971428571429,62.4685714285714,530,17,36,154,223,815,513,779
2017,43,10,"Bahcelievler",39.9195,32.829,8.51428571428571,12.2714285714286,0.512428571428571,67.9285714285714,66.9028571428571,47.8171428571429,506,218,373,0,0,919,288,546
2017,44,10,"Bahcelievler",39.9195,32.829,10.9285714285714,5.3,0.596285714285714,61.6714285714286,64.9271428571429,52.0657142857143,561,0,0,91,211,1102,561,1102
2017,45,10,"Bahcelievler",39.9195,32.829,6.98571428571429,6.91428571428571,0.375,78.9428571428572,105.488571428571,62.4314285714286,577,0,0,245,328,829,577,829
2017,46,10,"Bahcelievler",39.9195,32.829,6.58571428571429,9.41428571428571,0.00657142857142857,65.6428571428571,117.828571428571,75.8171428571429,587,0,0,39,62,1085,587,1085
2017,47,10,"Bahcelievler",39.9195,32.829,9.35714285714286,4.94285714285714,2.45642857142857,74.9142857142857,39.59,47.1133333333333,418,0,0,43,38,804,418,804
2017,48,10,"Bahcelievler",39.9195,32.829,7.14285714285714,6.62857142857143,0.806,77.9,72.0557142857143,62.4683333333333,386,68,118,53,62,619,318,501
2017,49,10,"Bahcelievler",39.9195,32.829,9.35714285714286,3.8,1.74714285714286,72.5142857142857,57.31,54.27,407,0,0,130,209,645,407,645
2017,50,10,"Bahcelievler",39.9195,32.829,6.32857142857143,5.02857142857143,0.745857142857143,84.9142857142857,120.522857142857,72.3271428571429,346,47,41,0,0,442,299,401
2017,51,10,"Bahcelievler",39.9195,32.829,9.44285714285714,4.98571428571429,3.438,82.3,39.4214285714286,44.6816666666667,386,0,0,26,23,349,386,349
2017,52,10,"Bahcelievler",39.9195,32.829,7.0375,2.1,0.443625,75.725,52.20625,59.7925,528,226,261,36,18,507,302,246
2018,1,10,"Bahcelievler",39.9195,32.829,7.6125,3.625,3.600875,81.9625,53.2042857142857,51.6985714285714,618,195,313,86,113,914,423,601
2018,2,10,"Bahcelievler",39.9195,32.829,8.45714285714286,4.12857142857143,2.27642857142857,86.3285714285714,66.3985714285714,48.9485714285714,624,24,19,12,13,1309,600,1290
2018,3,10,"Bahcelievler",39.9195,32.829,9.5,2.44285714285714,1.38128571428571,74.8428571428571,33.2228571428571,40.8428571428571,639,81,126,102,55,655,558,529
2018,4,10,"Bahcelievler",39.9195,32.829,13.4714285714286,1.21428571428571,1.57671428571429,66.3285714285714,22.7585714285714,27.9757142857143,604,86,169,166,177,764,518,595
2018,5,10,"Bahcelievler",39.9195,32.829,8.8,4.35714285714286,0,70.9571428571429,65.7571428571429,58.5971428571429,670,22,69,252,300,819,648,750
2018,6,10,"Bahcelievler",39.9195,32.829,9.02857142857143,7.71428571428571,0.711571428571429,74.1428571428571,78.2571428571429,46.2428571428571,704,30,73,44,91,1022,674,949
2018,7,10,"Bahcelievler",39.9195,32.829,13.1571428571429,5.11428571428571,1.40285714285714,73.2857142857143,39.52,38.3428571428571,478,1,1,99,95,557,477,556
2018,8,10,"Bahcelievler",39.9195,32.829,8.54285714285714,6.51428571428571,1.46014285714286,75.1142857142857,49.6971428571429,38.3928571428571,711,101,219,72,230,1321,610,1102
2018,9,10,"Bahcelievler",39.9195,32.829,16.2714285714286,5.57142857142857,3.69942857142857,72.7857142857143,31.0228571428571,25.5357142857143,621,2,4,19,35,956,619,952
2018,10,10,"Bahcelievler",39.9195,32.829,11.3571428571429,9.24285714285714,2.421,72.4285714285714,62.1485714285714,28.3485714285714,556,2,1,88,228,1330,554,1329
2018,11,10,"Bahcelievler",39.9195,32.829,11.5571428571429,10.0428571428571,0.761,65.9714285714286,50.0871428571429,23.8971428571429,551,66,124,119,276,1426,485,1302
2018,12,10,"Bahcelievler",39.9195,32.829,18.6857142857143,12.1857142857143,0.734142857142857,53.1428571428571,78.9457142857143,20.9142857142857,425,6,0,0,0,1187,419,1187
2018,13,10,"Bahcelievler",39.9195,32.829,15.5142857142857,11.1142857142857,2.30071428571429,58.7714285714286,72.51,22.2785714285714,356,116,155,59,65,428,240,273
2018,14,10,"Bahcelievler",39.9195,32.829,15.7857142857143,12.3857142857143,0.271857142857143,51.1,53.0114285714286,19.9971428571429,407,110,244,136,93,486,297,242
2018,15,10,"Bahcelievler",39.9195,32.829,14.6857142857143,15.7571428571429,0.064,55.4857142857143,56.1328571428571,15.8957142857143,374,45,145,52,49,450,329,305
2018,16,10,"Bahcelievler",39.9195,32.829,14.7285714285714,13.1571428571429,0.0372857142857143,46.4857142857143,47.46,16.89,411,0,0,73,98,648,411,648
2018,17,10,"Bahcelievler",39.9195,32.829,13.8857142857143,17.7428571428571,0,36.6571428571429,NA,NA,419,0,0,20,51,652,419,652
2018,18,10,"Bahcelievler",39.9195,32.829,18.2571428571429,19.0285714285714,2.43428571428571,47.3142857142857,NA,NA,303,33,28,53,95,474,270,446
2018,19,10,"Bahcelievler",39.9195,32.829,17.3428571428571,14.6,3.98442857142857,70.5714285714286,NA,NA,275,0,0,87,197,467,275,467
2018,20,10,"Bahcelievler",39.9195,32.829,13.6714285714286,19.2428571428571,2.20928571428571,55.1285714285714,NA,NA,204,32,31,44,73,306,172,275
2018,21,10,"Bahcelievler",39.9195,32.829,21.2571428571429,18.6571428571429,2.62542857142857,62.9571428571429,NA,18.22,252,10,5,0,0,281,242,276
2018,22,10,"Bahcelievler",39.9195,32.829,18.7857142857143,18.6857142857143,4.41485714285714,61.9571428571429,NA,21.06,249,0,0,3,24,427,249,427
2018,23,10,"Bahcelievler",39.9195,32.829,17.4428571428571,20.8428571428571,1.06785714285714,54.2857142857143,NA,25.98,267,0,0,160,471,812,267,812
2018,24,10,"Bahcelievler",39.9195,32.829,17.9428571428571,21.6428571428571,2.13471428571429,48.8,NA,22.1642857142857,267,0,0,79,35,448,267,448
2018,25,10,"Bahcelievler",39.9195,32.829,17.6571428571429,20.4285714285714,2.18714285714286,63.7142857142857,NA,15.38,358,33,41,89,95,518,325,477
2018,26,10,"Bahcelievler",39.9195,32.829,16.4285714285714,23.3428571428571,0.922428571428571,51.0285714285714,NA,5.39666666666667,355,26,13,88,196,587,329,574
2018,27,10,"Bahcelievler",39.9195,32.829,17.8,24.5,0,39.4428571428571,NA,NA,342,0,0,2,1,418,342,418
2018,28,10,"Bahcelievler",39.9195,32.829,18.5857142857143,25.9,0.312,44.7714285714286,NA,25.555,286,0,0,0,0,585,286,585
2018,29,10,"Bahcelievler",39.9195,32.829,19.5857142857143,22.8285714285714,0.310142857142857,48.6142857142857,NA,38.392,260,0,0,184,464,756,260,756
2018,30,10,"Bahcelievler",39.9195,32.829,15.3,23.9285714285714,1.16242857142857,52.7857142857143,29.335,44.328,265,0,0,201,588,822,265,822
2018,31,10,"Bahcelievler",39.9195,32.829,22.2285714285714,24.7,2.50314285714286,52.3142857142857,24.8133333333333,41.618,267,0,0,1,0,499,267,499
2018,32,10,"Bahcelievler",39.9195,32.829,20.8428571428571,23.3,0.024,43.2,22.688,NA,297,0,0,0,0,403,297,403
2018,33,10,"Bahcelievler",39.9195,32.829,18.8857142857143,24.9285714285714,0,32.2428571428571,26.0171428571429,51.6,216,0,0,0,0,332,216,332
2018,34,10,"Bahcelievler",39.9195,32.829,13.5285714285714,25.6857142857143,0,31.3714285714286,23.02,NA,144,1,19,1,0,227,143,208
2018,35,10,"Bahcelievler",39.9195,32.829,21.0714285714286,26.7,0.394428571428571,36.9142857142857,29.8675,42.4,201,0,0,2,12,314,201,314
2018,36,10,"Bahcelievler",39.9195,32.829,17.2571428571429,22.4142857142857,0.124571428571429,46.0571428571429,26.8433333333333,NA,341,2,6,202,193,370,339,364
2018,37,10,"Bahcelievler",39.9195,32.829,20.1428571428571,18.8285714285714,0.278,52.9,23.428,35.79,241,0,0,96,161,419,241,419
2018,38,10,"Bahcelievler",39.9195,32.829,19.3714285714286,18.6142857142857,0,41.1857142857143,28.17,34.864,189,17,23,0,0,344,172,321
2018,39,10,"Bahcelievler",39.9195,32.829,21.1,17.0571428571429,0.685142857142857,48.9714285714286,NA,35.66,180,10,5,47,96,353,170,348
2018,40,10,"Bahcelievler",39.9195,32.829,15.1857142857143,15.8142857142857,0.119857142857143,55.6428571428571,NA,53.024,191,0,0,40,85,341,191,341
2018,41,10,"Bahcelievler",39.9195,32.829,13.5714285714286,16.5714285714286,0.0605714285714286,53.3857142857143,35.67,48.376,187,2,2,0,0,422,185,420
2018,42,10,"Bahcelievler",39.9195,32.829,12.0571428571429,16.9571428571429,2.76385714285714,61.3571428571429,138.21,67.715,168,11,2,0,0,381,157,379
2018,43,10,"Bahcelievler",39.9195,32.829,12.1428571428571,9.94285714285714,3.31785714285714,72.8428571428571,41.535,NA,187,0,0,59,77,402,187,402
2018,44,10,"Bahcelievler",39.9195,32.829,10.8857142857143,11.6285714285714,0,54.5142857142857,NA,NA,196,0,0,0,0,264,196,264
2018,45,10,"Bahcelievler",39.9195,32.829,10.8142857142857,9.74285714285714,0,59.9142857142857,55.6366666666667,77.588,231,0,0,0,0,473,231,473
2018,46,10,"Bahcelievler",39.9195,32.829,10.3857142857143,5.62857142857143,0.001,63.5142857142857,NA,NA,230,32,29,3,11,465,198,436
2018,47,10,"Bahcelievler",39.9195,32.829,12.4857142857143,8.11428571428571,0.389714285714286,74.7142857142857,NA,NA,270,1,0,31,63,499,269,499
2018,48,10,"Bahcelievler",39.9195,32.829,14.4714285714286,7.92857142857143,2.89914285714286,80.5285714285714,20.8383333333333,49.41,245,5,1,0,0,201,240,200
2018,49,10,"Bahcelievler",39.9195,32.829,13.0428571428571,4.58571428571429,0.474285714285714,76.2428571428571,39.3071428571429,63.2771428571429,257,0,0,37,108,420,257,420
2018,50,10,"Bahcelievler",39.9195,32.829,14.7428571428571,3.17142857142857,2.68457142857143,86.1571428571429,23.04,57.056,256,33,20,11,49,305,223,285
2018,51,10,"Bahcelievler",39.9195,32.829,13.1714285714286,5.65714285714286,1.584,81.9142857142857,21.5725,52.9125,250,14,17,38,31,248,236,231
2018,52,10,"Bahcelievler",39.9195,32.829,9.5,-1.14285714285714,7.68042857142857,80.8,24.05,62.035,244,0,0,73,76,273,244,273
2019,1,10,"Bahcelievler",39.9195,32.829,19.025,2.0125,2.783375,80.5125,21.35125,44.02625,343,48,282,28,81,784,295,502
2019,2,10,"Bahcelievler",39.9195,32.829,11.0428571428571,-1.35714285714286,1.16042857142857,79.3142857142857,31.6971428571429,60.8214285714286,255,0,0,7,12,208,255,208
2019,3,10,"Bahcelievler",39.9195,32.829,14.7571428571429,1.15714285714286,1.27828571428571,78.9,36.572,53.096,192,67,55,25,33,198,125,143
2019,4,10,"Bahcelievler",39.9195,32.829,12.3142857142857,4.68571428571429,1.66214285714286,78.2857142857143,39.185,50.5425,308,72,86,0,0,314,236,228
2019,5,10,"Bahcelievler",39.9195,32.829,14.5571428571429,5.02857142857143,0.327857142857143,72.6428571428571,21.3675,35.285,253,127,62,25,13,143,126,81
2019,6,10,"Bahcelievler",39.9195,32.829,12.5428571428571,5.88571428571429,4.72742857142857,77.5857142857143,22.5533333333333,54.6533333333333,276,0,0,7,0,127,276,127
2019,7,10,"Bahcelievler",39.9195,32.829,16.3428571428571,4.88571428571429,0.00314285714285714,68.4428571428571,15.81,37.862,325,20,96,0,0,234,305,138
2019,8,10,"Bahcelievler",39.9195,32.829,13.6857142857143,4.75714285714286,0.225142857142857,66.5285714285714,40.098,73.11,305,0,0,141,122,219,305,219
2019,9,10,"Bahcelievler",39.9195,32.829,18.3857142857143,3.24285714285714,0.00914285714285714,63.9571428571429,18.725,46.9466666666667,331,0,0,116,115,310,331,310
2019,10,10,"Bahcelievler",39.9195,32.829,13.9428571428571,6.91428571428571,0.416428571428571,56.3,27.7516666666667,59.8,359,0,0,119,91,252,359,252
2019,11,10,"Bahcelievler",39.9195,32.829,17.0285714285714,7.75714285714286,4.25914285714286,69.7714285714286,17.6742857142857,44.4728571428571,373,0,0,77,121,400,373,400
2019,12,10,"Bahcelievler",39.9195,32.829,17.3142857142857,8.01428571428571,0,52.1571428571429,24.7328571428571,50.6985714285714,343,0,0,130,325,416,343,416
2019,13,10,"Bahcelievler",39.9195,32.829,24.2,5.81428571428571,0,46.4571428571429,18.9757142857143,37.9316666666667,256,3,0,9,20,194,253,194
2019,14,10,"Bahcelievler",39.9195,32.829,14,10.3571428571429,0.00842857142857143,48.4285714285714,24.4657142857143,54.0485714285714,365,109,52,21,8,208,256,156
2019,15,10,"Bahcelievler",39.9195,32.829,19.2142857142857,11,4.14014285714286,72.4285714285714,15.48,49.4166666666667,359,89,57,11,21,183,270,126
2019,16,10,"Bahcelievler",39.9195,32.829,16.6,6.8,1.03242857142857,62.5714285714286,13.7114285714286,34.6728571428571,318,45,19,185,108,208,273,189
2019,17,10,"Bahcelievler",39.9195,32.829,15.5,11.8,0.0192857142857143,53.4857142857143,41.455,52.092,412,0,0,292,162,313,412,313
2019,18,10,"Bahcelievler",39.9195,32.829,15.8142857142857,15.5,0.693285714285714,50,42.8614285714286,30.0216666666667,523,0,0,214,91,353,523,353
2019,19,10,"Bahcelievler",39.9195,32.829,14.4,12.6714285714286,0.631,65.6,81.126,40.782,452,0,0,112,116,386,452,386
2019,20,10,"Bahcelievler",39.9195,32.829,14.7571428571429,19.3142857142857,0.699857142857143,48.2142857142857,45.932,39.07,454,0,0,43,44,389,454,389
2019,21,10,"Bahcelievler",39.9195,32.829,15.1714285714286,19.0714285714286,1.91971428571429,55.3571428571429,52.0385714285714,37.0028571428571,457,0,0,48,64,413,457,413
2019,22,10,"Bahcelievler",39.9195,32.829,13.9285714285714,23.1428571428571,0.415285714285714,45.4571428571429,53.1057142857143,47.44,453,0,0,60,15,323,453,323
2019,23,10,"Bahcelievler",39.9195,32.829,16.7571428571429,22.9714285714286,1.87514285714286,46.4857142857143,41.7928571428571,32.56,378,0,0,147,101,532,378,532
2019,24,10,"Bahcelievler",39.9195,32.829,18.4714285714286,20.3142857142857,3.275,63.7142857142857,29.8957142857143,45.6571428571429,378,0,0,158,96,244,378,244
2019,25,10,"Bahcelievler",39.9195,32.829,17.2714285714286,21.2,0.708428571428571,62.3,30.7125,54.6214285714286,306,0,0,75,50,325,306,325
2019,26,10,"Bahcelievler",39.9195,32.829,17.1714285714286,23.7428571428571,0,45.8285714285714,23.125,31.36,377,0,0,24,25,342,377,342
2019,27,10,"Bahcelievler",39.9195,32.829,19.2571428571429,23.2714285714286,1.08642857142857,39.4571428571429,34.2916666666667,35.88,456,0,0,0,0,222,456,222
2019,28,10,"Bahcelievler",39.9195,32.829,15.7857142857143,21.9714285714286,0.909,45.2571428571429,26.1771428571429,33.085,398,0,0,328,368,421,398,421
2019,29,10,"Bahcelievler",39.9195,32.829,16.9857142857143,20.6571428571429,2.35014285714286,56.4571428571429,17.1314285714286,33.5328571428571,453,0,0,1,0,203,453,203
2019,30,10,"Bahcelievler",39.9195,32.829,15.4571428571429,23.5142857142857,0,39.5428571428571,25.7985714285714,35.058,456,0,0,22,18,335,456,335
2019,31,10,"Bahcelievler",39.9195,32.829,17.2428571428571,26.0428571428571,0,40.1285714285714,32.3442857142857,40.3357142857143,334,0,0,239,275,375,334,375
2019,32,10,"Bahcelievler",39.9195,32.829,18.0714285714286,23.5857142857143,0,34.5428571428571,18.388,25.9516666666667,346,0,0,0,0,395,346,395
2019,33,10,"Bahcelievler",39.9195,32.829,20.1142857142857,25.2142857142857,1.85857142857143,39.5857142857143,19.6,33.0442857142857,337,0,0,104,212,531,337,531
2019,34,10,"Bahcelievler",39.9195,32.829,21.4428571428571,22.2142857142857,1.57471428571429,55.8857142857143,18.8971428571429,39.0071428571429,299,0,0,44,63,345,299,345
2019,35,10,"Bahcelievler",39.9195,32.829,18.7,24.1285714285714,0.00771428571428571,39.3142857142857,27.5457142857143,30.9057142857143,307,0,0,1,0,415,307,415
2019,36,10,"Bahcelievler",39.9195,32.829,16.8428571428571,22.8428571428571,0.0258571428571429,39.3285714285714,31.0028571428571,39.1228571428571,171,0,0,20,7,67,171,67
2019,37,10,"Bahcelievler",39.9195,32.829,17.5,21.2142857142857,0,38.8571428571429,27.2442857142857,33.0742857142857,218,0,0,0,0,55,218,55
2019,38,10,"Bahcelievler",39.9195,32.829,15.7285714285714,17.8142857142857,0,39.2571428571429,38.1857142857143,61.395,266,0,0,113,42,91,266,91
2019,39,10,"Bahcelievler",39.9195,32.829,11.5285714285714,17.4857142857143,0.0425714285714286,45.8571428571429,43.5171428571429,28.1833333333333,237,0,0,209,69,79,237,79
2019,40,10,"Bahcelievler",39.9195,32.829,12.2,18.2,0.347857142857143,40.5714285714286,36.0314285714286,33.6371428571429,241,0,0,158,99,111,241,111
2019,41,10,"Bahcelievler",39.9195,32.829,10.0857142857143,16.0714285714286,0.00128571428571429,53.8,31.376,54.3225,416,0,0,166,169,448,416,448
2019,42,10,"Bahcelievler",39.9195,32.829,9.4,16.4571428571429,0.704857142857143,51.5142857142857,60.1428571428571,74.28,356,0,0,149,182,408,356,408
2019,43,10,"Bahcelievler",39.9195,32.829,15.0857142857143,14.4857142857143,0,54.9428571428571,35,48.2728571428571,306,0,0,0,0,300,306,300
2019,44,10,"Bahcelievler",39.9195,32.829,9.04285714285714,9.9,0.701,63.4571428571429,50.1914285714286,64.3228571428571,350,0,0,171,126,250,350,250
2019,45,10,"Bahcelievler",39.9195,32.829,8.71428571428571,11.7857142857143,0,57.4,65.1814285714286,78.9671428571429,417,33,8,67,99,328,384,320
2019,46,10,"Bahcelievler",39.9195,32.829,8.81428571428571,11.6428571428571,0.314428571428571,55.3857142857143,77.6028571428571,81.9014285714286,401,1,3,1,0,337,400,334
2019,47,10,"Bahcelievler",39.9195,32.829,6.47142857142857,5.81428571428571,0,61.5285714285714,101.74,102.718333333333,391,0,0,212,199,339,391,339
2019,48,10,"Bahcelievler",39.9195,32.829,10.8285714285714,8.44285714285714,2.47128571428571,76.8857142857143,40.3657142857143,57.6485714285714,320,0,0,104,112,251,320,251
2019,49,10,"Bahcelievler",39.9195,32.829,8.41428571428571,1.12857142857143,1.30314285714286,78.8142857142857,36.4642857142857,52.8357142857143,393,0,0,130,98,274,393,274
2019,50,10,"Bahcelievler",39.9195,32.829,10.5142857142857,5.14285714285714,0.793285714285714,81.1714285714286,40.0742857142857,50.2114285714286,218,28,3,38,25,119,190,116
2019,51,10,"Bahcelievler",39.9195,32.829,5.85714285714286,3.11428571428571,0.00142857142857143,85.0428571428571,118.52,98.3866666666667,361,0,0,237,372,488,361,488
2019,52,10,"Bahcelievler",39.9195,32.829,12.2142857142857,5.07142857142857,4.36385714285714,79.2428571428571,31.9314285714286,46.55,279,84,142,71,51,281,195,139
2020,1,10,"Bahcelievler",39.9195,32.829,13.48,1.34,0.1462,76.24,20.648,49.888,160,0,0,57,37,126,160,126
2020,2,10,"Bahcelievler",39.9195,32.829,12.7571428571429,1.02857142857143,1.541,76.9428571428572,24.1342857142857,70.98,240,0,0,118,105,173,240,173
2020,3,10,"Bahcelievler",39.9195,32.829,9.7,-0.0428571428571428,0.0371428571428571,76.5571428571429,85.3757142857143,80.9416666666667,270,0,0,107,178,382,270,382
2020,4,10,"Bahcelievler",39.9195,32.829,11.1142857142857,-1.08571428571429,0.0407142857142857,68.2,65.0375,69.6357142857143,358,0,0,167,200,295,358,295
2020,5,10,"Bahcelievler",39.9195,32.829,11.1428571428571,3.87142857142857,1.39585714285714,74.7285714285714,54.085,56.2583333333333,331,0,0,30,24,272,331,272
2020,6,10,"Bahcelievler",39.9195,32.829,19.7142857142857,3.34285714285714,2.08257142857143,71.3142857142857,30.7128571428571,44.208,343,59,69,54,34,267,284,198
2020,7,10,"Bahcelievler",39.9195,32.829,11.3428571428571,1.41428571428571,1.04714285714286,69.7285714285714,54.62,68.978,341,0,0,11,10,338,341,338
2020,8,10,"Bahcelievler",39.9195,32.829,11.4428571428571,4.07142857142857,1.44071428571429,66.6285714285714,62.6016666666667,69.4642857142857,283,0,0,52,23,187,283,187
2020,9,10,"Bahcelievler",39.9195,32.829,16.7142857142857,6.71428571428571,1.82485714285714,59.1142857142857,40.37,50.2314285714286,393,87,95,118,139,528,306,433
2020,10,10,"Bahcelievler",39.9195,32.829,12.7571428571429,9.58571428571429,0.164,55.1428571428571,65.02,65.0916666666667,205,23,5,92,132,210,182,205
2020,11,10,"Bahcelievler",39.9195,32.829,17.1428571428571,12.6857142857143,0.292571428571429,50.3,61.5085714285714,58.0185714285714,115,9,4,33,19,94,106,90
2020,12,10,"Bahcelievler",39.9195,32.829,17.1142857142857,3.2,1.38085714285714,62.2428571428571,27.6557142857143,35.4814285714286,117,0,0,36,23,118,117,118
2020,13,10,"Bahcelievler",39.9195,32.829,16.5571428571429,10.3857142857143,0.770714285714286,62.8428571428571,50.4014285714286,41.5428571428571,136,0,0,5,10,92,136,92
2020,14,10,"Bahcelievler",39.9195,32.829,18.4571428571429,8.72857142857143,2.45857142857143,69.5571428571428,46.4185714285714,34.5871428571429,155,1,0,11,2,121,154,121
2020,15,10,"Bahcelievler",39.9195,32.829,27.6857142857143,9.85714285714286,0.0758571428571429,44.4285714285714,34.0528571428571,21.4942857142857,133,0,0,13,14,118,133,118
2020,16,10,"Bahcelievler",39.9195,32.829,17.7714285714286,12.0857142857143,0.408857142857143,51.7571428571429,47.3314285714286,40.2142857142857,141,45,21,38,20,106,96,85
2020,17,10,"Bahcelievler",39.9195,32.829,17.4571428571429,11.0428571428571,0.109285714285714,50.4857142857143,32.8685714285714,26.3942857142857,137,0,0,59,63,123,137,123
2020,18,10,"Bahcelievler",39.9195,32.829,19.9,12.6857142857143,2.79885714285714,60.9428571428571,46.4185714285714,39.8928571428571,146,7,12,53,39,164,139,152
2020,19,10,"Bahcelievler",39.9195,32.829,18.8428571428571,12.3571428571429,0.979,60.5,27.1614285714286,22.97,137,0,0,89,113,157,137,157
2020,20,10,"Bahcelievler",39.9195,32.829,18.0714285714286,21.0428571428571,0,43.4,80.6157142857143,39.1885714285714,164,0,0,91,90,164,164,164
2020,21,10,"Bahcelievler",39.9195,32.829,27.4,18.7857142857143,0.242714285714286,45.4714285714286,80.0971428571429,23.7414285714286,146,0,0,89,78,96,146,96
2020,22,10,"Bahcelievler",39.9195,32.829,21.7,14.4,4.62014285714286,58.9285714285714,32.8328571428571,24.3657142857143,118,15,10,60,56,100,103,90
2020,23,10,"Bahcelievler",39.9195,32.829,16.9857142857143,18.4285714285714,0.0961428571428572,47.6714285714286,44.6557142857143,39.6757142857143,112,22,16,33,29,70,90,54
2020,24,10,"Bahcelievler",39.9195,32.829,19.1857142857143,20.6714285714286,6.95885714285714,51.8285714285714,62.04,45.9657142857143,140,0,0,91,122,150,140,150
2020,25,10,"Bahcelievler",39.9195,32.829,14.1428571428571,19.1285714285714,3.78328571428571,66.2571428571429,51.2371428571429,49.5371428571429,137,0,0,116,102,108,137,108
2020,26,10,"Bahcelievler",39.9195,32.829,15.6571428571429,22.0285714285714,0.751857142857143,54.0142857142857,41.0714285714286,28.09,173,0,0,29,13,133,173,133
2020,27,10,"Bahcelievler",39.9195,32.829,16.2571428571429,25.7142857142857,0,38.8285714285714,39.9071428571429,27.16,113,0,0,18,43,113,113,113
2020,28,10,"Bahcelievler",39.9195,32.829,20.6,25.2428571428571,0.0882857142857143,41.0428571428571,41.46,26.1614285714286,164,0,0,12,1,122,164,122
2020,29,10,"Bahcelievler",39.9195,32.829,16.9571428571429,25.5285714285714,0.428571428571429,43.7142857142857,35.01,26.9757142857143,186,0,0,44,34,111,186,111
2020,30,10,"Bahcelievler",39.9195,32.829,19.3428571428571,25.3571428571429,0,36.1857142857143,40.0785714285714,30.0542857142857,190,0,0,58,38,142,190,142
2020,31,10,"Bahcelievler",39.9195,32.829,17.9,26.3428571428571,0,37.1714285714286,14.4585714285714,22.9514285714286,150,0,0,52,49,127,150,127
2020,32,10,"Bahcelievler",39.9195,32.829,16.4571428571429,26.5857142857143,0,28.2285714285714,28.5671428571429,30.83,146,0,0,0,0,107,146,107
2020,33,10,"Bahcelievler",39.9195,32.829,17.5,23.9714285714286,0,36.7714285714286,32.3371428571429,22.2,183,0,0,0,0,83,183,83
2020,34,10,"Bahcelievler",39.9195,32.829,15.5428571428571,23.2857142857143,0.00128571428571429,36.8857142857143,37.9342857142857,39.6942857142857,197,0,0,39,21,97,197,97
2020,35,10,"Bahcelievler",39.9195,32.829,11.6285714285714,25.2571428571429,0,29.3142857142857,51.0342857142857,53.0414285714286,164,0,0,72,58,157,164,157
2020,36,10,"Bahcelievler",39.9195,32.829,13.9857142857143,26.0142857142857,0,27.9142857142857,44.4414285714286,62.5371428571429,179,0,0,103,70,112,179,112
2020,37,10,"Bahcelievler",39.9195,32.829,16,23.6,0.00357142857142857,42.0857142857143,66.0971428571429,41.5157142857143,193,0,0,60,21,91,193,91
2020,38,10,"Bahcelievler",39.9195,32.829,16.9142857142857,22.9857142857143,0.112571428571429,37.2857142857143,56.4742857142857,43.5,235,0,0,64,42,157,235,157
2020,39,10,"Bahcelievler",39.9195,32.829,13.1,19.8857142857143,0.706714285714286,52.2142857142857,65.4085714285714,62.7428571428571,220,0,0,137,52,129,220,129
2020,40,10,"Bahcelievler",39.9195,32.829,12.2142857142857,18.4857142857143,0.00457142857142857,42.1571428571429,79.3971428571429,66.2814285714286,187,0,0,65,22,154,187,154
2020,41,10,"Bahcelievler",39.9195,32.829,11.0428571428571,19.5571428571429,0.465285714285714,43.9857142857143,98.6771428571429,67.08,182,14,7,109,76,127,168,120
2020,42,10,"Bahcelievler",39.9195,32.829,10.9428571428571,17.5714285714286,1.09885714285714,45.2571428571429,95.5742857142857,76.5471428571429,177,0,0,105,83,111,177,111
2020,43,10,"Bahcelievler",39.9195,32.829,12.4428571428571,15.6714285714286,0.0755714285714286,56.2428571428571,65.3,61.5542857142857,194,0,0,28,18,161,194,161
2020,44,10,"Bahcelievler",39.9195,32.829,12.5142857142857,13.4285714285714,2.41571428571429,59.5571428571429,75.0071428571429,70.4857142857143,255,41,62,63,24,233,214,171
2020,45,10,"Bahcelievler",39.9195,32.829,14.2428571428571,9.24285714285714,0.577714285714286,64.4,53.4985714285714,66.0785714285714,156,0,0,24,11,103,156,103
2020,46,10,"Bahcelievler",39.9195,32.829,8.75714285714286,7.5,0,66.4857142857143,78.8414285714286,72.9814285714286,208,0,0,4,0,109,208,109
2020,47,10,"Bahcelievler",39.9195,32.829,11.9428571428571,5,0,62.8285714285714,60.2328571428571,68.38,173,0,0,51,5,83,173,83
2020,48,10,"Bahcelievler",39.9195,32.829,9.85714285714286,2.47142857142857,0,60.8857142857143,77.0928571428571,81.3014285714286,199,0,0,19,56,262,199,262
2020,49,10,"Bahcelievler",39.9195,32.829,7.58571428571429,5.18571428571429,0.0981428571428571,65.2571428571429,102.552857142857,99.4657142857143,207,0,0,16,24,116,207,116
2020,50,10,"Bahcelievler",39.9195,32.829,10.6285714285714,6.35714285714286,0.736428571428571,77.1714285714286,48.3085714285714,73.57,181,31,8,16,6,98,150,90
2020,51,10,"Bahcelievler",39.9195,32.829,9.3,6.35714285714286,1.07728571428571,76.1571428571429,32.19,60.8171428571429,171,0,0,33,19,90,171,90
2020,52,10,"Bahcelievler",39.9195,32.829,7.08571428571429,3.01428571428571,0.0695714285714286,71.7,51.44,72.2585714285714,203,2,3,65,28,113,201,110
2020,53,10,"Bahcelievler",39.9195,32.829,7.6,6.5,0.7445,73.85,53.855,71.555,122,0,0,8,0,111,122,111
2017,1,11,"Demetevler",39.9617,32.7849,17.1857142857143,-1.61428571428571,0.833142857142857,79.1714285714286,58.1628571428571,69.2657142857143,563,55,80,199,298,847,508,767
2017,2,11,"Demetevler",39.9617,32.7849,15.7571428571429,-2.12857142857143,0.656428571428571,76.2857142857143,59.1157142857143,84.7814285714286,757,54,75,47,43,1214,703,1139
2017,3,11,"Demetevler",39.9617,32.7849,11.8,1.78571428571429,1.46742857142857,83.2,55.8685714285714,91.0128571428571,762,3,0,230,348,1449,759,1449
2017,4,11,"Demetevler",39.9617,32.7849,15.9714285714286,-1.95714285714286,0.0908571428571429,68.1857142857143,43.52,57.9042857142857,639,0,0,184,236,889,639,889
2017,5,11,"Demetevler",39.9617,32.7849,9.5,-2.84285714285714,0.0755714285714286,65.3571428571429,87.7342857142857,109.99,588,33,48,169,563,1163,555,1115
2017,6,11,"Demetevler",39.9617,32.7849,15.0571428571429,4.11428571428571,0.242142857142857,77,62.9742857142857,82.5442857142857,736,49,89,295,509,1519,687,1430
2017,7,11,"Demetevler",39.9617,32.7849,14.5571428571429,-1.42857142857143,0.0877142857142857,59.5142857142857,50.5371428571429,68.9842857142857,492,0,0,309,390,717,492,717
2017,8,11,"Demetevler",39.9617,32.7849,18.9142857142857,6.11428571428571,0.270285714285714,68.1571428571429,90.3071428571429,96.9242857142857,739,0,0,106,300,1747,739,1747
2017,9,11,"Demetevler",39.9617,32.7849,16.0285714285714,8.6,0.807,64.2714285714286,88.24,91.1785714285714,574,137,250,73,91,866,437,616
2017,10,11,"Demetevler",39.9617,32.7849,15.1714285714286,8.84285714285714,1.52385714285714,60.7857142857143,68.7085714285714,90.0085714285714,712,636,857,0,0,1043,76,186
2017,11,11,"Demetevler",39.9617,32.7849,19.4428571428571,3.7,1.82128571428571,76.7,30.5842857142857,69.8628571428571,525,0,0,236,402,725,525,725
2017,12,11,"Demetevler",39.9617,32.7849,18.3142857142857,9.52857142857143,0.109285714285714,49.0428571428571,51.3242857142857,92.6014285714286,589,0,0,273,536,1077,589,1077
2017,13,11,"Demetevler",39.9617,32.7849,18.3428571428571,9.77142857142857,0.150142857142857,48.8,48.815,52.78,574,18,17,150,265,887,556,870
2017,14,11,"Demetevler",39.9617,32.7849,20.7714285714286,10.7142857142857,0.803142857142857,47.7285714285714,56.3514285714286,60.6228571428571,639,96,276,257,437,1336,543,1060
2017,15,11,"Demetevler",39.9617,32.7849,16.0285714285714,9.72857142857143,0.192857142857143,56.9714285714286,51.1657142857143,58.7614285714286,587,145,278,250,495,1187,442,909
2017,16,11,"Demetevler",39.9617,32.7849,25.1142857142857,10.0285714285714,1.36471428571429,61.7714285714286,35.3057142857143,41.74,717,0,0,106,73,920,717,920
2017,17,11,"Demetevler",39.9617,32.7849,13.9285714285714,12.2857142857143,0,44.8571428571429,90.256,71.1785714285714,731,69,246,372,772,1478,662,1232
2017,18,11,"Demetevler",39.9617,32.7849,22.8285714285714,16.3142857142857,1.71114285714286,57.2428571428571,61.87,58.3371428571429,506,72,119,176,340,923,434,804
2017,19,11,"Demetevler",39.9617,32.7849,24.7428571428571,18.1714285714286,0.0691428571428571,47.7285714285714,81.5057142857143,42.95,471,2,2,207,415,966,469,964
2017,20,11,"Demetevler",39.9617,32.7849,21.8142857142857,14.6142857142857,0.736857142857143,55.6142857142857,33.3471428571429,23.3685714285714,472,10,19,137,494,1205,462,1186
2017,21,11,"Demetevler",39.9617,32.7849,17.0285714285714,13.9,4.62728571428571,63.3142857142857,38.2314285714286,50.1057142857143,448,43,146,184,324,849,405,703
2017,22,11,"Demetevler",39.9617,32.7849,19.0285714285714,16.9714285714286,0.968,68.1428571428571,47.1,48.6928571428571,522,0,0,229,367,1015,522,1015
2017,23,11,"Demetevler",39.9617,32.7849,19.1571428571429,19.2285714285714,2.57471428571429,66.5142857142857,43.4785714285714,42.7642857142857,578,0,0,345,820,1388,578,1388
2017,24,11,"Demetevler",39.9617,32.7849,17,20.3142857142857,0.468428571428571,53.8142857142857,32.3942857142857,26.1228571428571,552,0,0,344,655,1139,552,1139
2017,25,11,"Demetevler",39.9617,32.7849,14.4857142857143,18.7,3.861,64.4285714285714,46.8185714285714,46.3028571428571,584,0,0,515,873,1041,584,1041
2017,26,11,"Demetevler",39.9617,32.7849,15.3714285714286,26.3571428571429,0,41.6714285714286,45.6728571428571,41.6057142857143,564,0,0,257,448,971,564,971
2017,27,11,"Demetevler",39.9617,32.7849,19.9571428571429,24.0714285714286,0,42.7142857142857,38.9785714285714,26.4157142857143,511,0,0,189,298,642,511,642
2017,28,11,"Demetevler",39.9617,32.7849,17.1142857142857,26.0714285714286,0.935142857142857,38.3285714285714,38.4514285714286,22.2914285714286,481,0,0,230,449,864,481,864
2017,29,11,"Demetevler",39.9617,32.7849,16.1571428571429,25.5,0.00314285714285714,44.8,32.7742857142857,20.768,532,0,0,68,189,1272,532,1272
2017,30,11,"Demetevler",39.9617,32.7849,19.9571428571429,25.4857142857143,0.00257142857142857,36.3,57.5957142857143,38.4083333333333,531,0,0,139,236,928,531,928
2017,31,11,"Demetevler",39.9617,32.7849,21.5428571428571,24.9714285714286,1.17985714285714,51.2857142857143,37.63,27.32,559,0,0,115,236,1047,559,1047
2017,32,11,"Demetevler",39.9617,32.7849,22.1285714285714,27.9,0.0158571428571429,40.2428571428571,52.6328571428571,39.29,567,0,0,231,269,1092,567,1092
2017,33,11,"Demetevler",39.9617,32.7849,17.6,24.8857142857143,0.205428571428571,49.5,54.7828571428571,42.0783333333333,596,0,0,436,851,1199,596,1199
2017,34,11,"Demetevler",39.9617,32.7849,20.9285714285714,22,0.105142857142857,48.9285714285714,28.3185714285714,26.186,601,0,0,184,552,1280,601,1280
2017,35,11,"Demetevler",39.9617,32.7849,15.7428571428571,21.7142857142857,0.164142857142857,42.5571428571429,32.1642857142857,27.93,493,0,0,147,356,1014,493,1014
2017,36,11,"Demetevler",39.9617,32.7849,15.9714285714286,20.8285714285714,0.0205714285714286,38.1285714285714,63.94,59.5557142857143,507,0,0,417,974,1321,507,1321
2017,37,11,"Demetevler",39.9617,32.7849,16.3857142857143,25.4714285714286,0,29.8714285714286,101.334285714286,61.5757142857143,589,0,0,167,251,1138,589,1138
2017,38,11,"Demetevler",39.9617,32.7849,16.7571428571429,22.6142857142857,0,34.4285714285714,95.0585714285714,68.0133333333333,671,1,1,266,469,1312,670,1311
2017,39,11,"Demetevler",39.9617,32.7849,17.5142857142857,17.8,2.27142857142857,54.2857142857143,43.2185714285714,47.3175,782,0,0,118,230,1630,782,1630
2017,40,11,"Demetevler",39.9617,32.7849,13.5571428571429,13.4142857142857,1.88314285714286,53.8714285714286,55.2528571428571,56.1983333333333,543,76,214,118,196,1137,467,923
2017,41,11,"Demetevler",39.9617,32.7849,10.9714285714286,11.4571428571429,0.251714285714286,61.1,57.0857142857143,52.0928571428571,487,0,0,218,432,843,487,843
2017,42,11,"Demetevler",39.9617,32.7849,10.5714285714286,12.0142857142857,0,54.1714285714286,96.17,79.9114285714286,530,0,0,242,401,815,530,815
2017,43,11,"Demetevler",39.9617,32.7849,12.3428571428571,12.1,0.427142857142857,68.9714285714286,73.2842857142857,67.4428571428571,506,168,235,124,127,919,338,684
2017,44,11,"Demetevler",39.9617,32.7849,15.4142857142857,5.04285714285714,0.525428571428572,63.4571428571429,75.9714285714286,68.8928571428571,561,0,0,206,389,1102,561,1102
2017,45,11,"Demetevler",39.9617,32.7849,10.5714285714286,6.5,0.323142857142857,79.9857142857143,168.314285714286,96.1171428571429,577,0,0,283,293,829,577,829
2017,46,11,"Demetevler",39.9617,32.7849,9.2,8.85714285714286,0.011,68.4571428571429,122.53,97.1085714285714,587,36,37,175,295,1085,551,1048
2017,47,11,"Demetevler",39.9617,32.7849,13.8142857142857,4.87142857142857,2.06028571428571,75.6428571428571,48.1828571428571,57.4657142857143,418,39,86,106,218,804,379,718
2017,48,11,"Demetevler",39.9617,32.7849,10.3571428571429,6.38571428571429,1.097,78.6857142857143,82.2014285714286,75.9528571428571,386,68,118,53,62,619,318,501
2017,49,11,"Demetevler",39.9617,32.7849,13.2428571428571,3.61428571428571,1.71142857142857,73.5428571428571,70.5957142857143,64.74,407,12,7,144,210,645,395,638
2017,50,11,"Demetevler",39.9617,32.7849,9.1,4.8,0.642,84.7857142857143,131.605,101.088571428571,346,47,41,103,81,442,299,401
2017,51,11,"Demetevler",39.9617,32.7849,13.7571428571429,5.12857142857143,3.07485714285714,80.8428571428571,36.1057142857143,52.9214285714286,386,0,0,99,122,349,386,349
2017,52,11,"Demetevler",39.9617,32.7849,9.9875,1.9375,0.380375,76.0875,70.6375,74.53,528,254,240,83,49,507,274,267
2018,1,11,"Demetevler",39.9617,32.7849,10.6125,3.4,1.697875,82.1,60.75625,68.6175,618,249,413,165,202,914,369,501
2018,2,11,"Demetevler",39.9617,32.7849,11.4,4.21428571428571,2.52014285714286,84.9142857142857,64.6428571428571,62.5828571428571,624,0,0,115,111,1309,624,1309
2018,3,11,"Demetevler",39.9617,32.7849,14.0714285714286,2.35714285714286,1.50971428571429,75.4428571428571,37.32,57.1342857142857,639,81,126,160,106,655,558,529
2018,4,11,"Demetevler",39.9617,32.7849,17.3571428571429,1.42857142857143,1.61171428571429,65.5,21.9,29.3128571428571,604,86,169,167,177,764,518,595
2018,5,11,"Demetevler",39.9617,32.7849,12.6428571428571,4.02857142857143,0,72.3714285714286,93.2071428571429,82.7071428571429,670,8,24,294,299,819,662,795
2018,6,11,"Demetevler",39.9617,32.7849,13.2285714285714,7.65714285714286,0.660714285714286,74.5857142857143,85.5914285714286,64.4914285714286,704,131,168,234,383,1022,573,854
2018,7,11,"Demetevler",39.9617,32.7849,18.2857142857143,4.97142857142857,1.31042857142857,73.9714285714286,42.7157142857143,59.3342857142857,478,0,0,134,130,557,478,557
2018,8,11,"Demetevler",39.9617,32.7849,12.6,6.44285714285714,1.31542857142857,75.3571428571429,47.9271428571429,66.9114285714286,711,58,164,84,235,1321,653,1157
2018,9,11,"Demetevler",39.9617,32.7849,22.4857142857143,5.65714285714286,3.27057142857143,72.7,36.8114285714286,47.8442857142857,621,2,4,96,156,956,619,952
2018,10,11,"Demetevler",39.9617,32.7849,16.5142857142857,9.21428571428571,1.98428571428571,72.6285714285714,73.1385714285714,42.4728571428571,556,2,1,110,275,1330,554,1329
2018,11,11,"Demetevler",39.9617,32.7849,16.3,10,0.611857142857143,66.5428571428571,58.2114285714286,16.8928571428571,551,48,67,382,1045,1426,503,1359
2018,12,11,"Demetevler",39.9617,32.7849,22.8142857142857,12.1428571428571,0.527285714285714,54.2428571428571,92.41,13.25,425,53,101,199,538,1187,372,1086
2018,13,11,"Demetevler",39.9617,32.7849,17.7142857142857,11.0714285714286,2.08357142857143,59.4571428571429,78.2714285714286,12.0042857142857,356,113,134,136,152,428,243,294
2018,14,11,"Demetevler",39.9617,32.7849,17.8571428571429,12.0571428571429,0.235571428571429,53.3857142857143,66.2928571428571,16.72,407,174,311,221,155,486,233,175
2018,15,11,"Demetevler",39.9617,32.7849,16.3571428571429,15.5857142857143,0.0332857142857143,57.3,62.9042857142857,14.8357142857143,374,0,0,99,90,450,374,450
2018,16,11,"Demetevler",39.9617,32.7849,15.9428571428571,12.9571428571429,0.0525714285714286,47.9714285714286,62.36,17.115,411,0,0,238,376,648,411,648
2018,17,11,"Demetevler",39.9617,32.7849,14.8857142857143,17.4285714285714,0,38.7142857142857,NA,NA,419,43,50,64,99,652,376,602
2018,18,11,"Demetevler",39.9617,32.7849,18.9142857142857,18.9571428571429,1.43542857142857,48.7428571428571,NA,NA,303,59,71,89,215,474,244,403
2018,19,11,"Demetevler",39.9617,32.7849,20.8142857142857,14.6714285714286,3.54528571428571,71.1428571428571,NA,NA,275,0,0,188,345,467,275,467
2018,20,11,"Demetevler",39.9617,32.7849,15.4428571428571,19.1857142857143,2.87,56.6714285714286,NA,NA,204,6,6,105,167,306,198,300
2018,21,11,"Demetevler",39.9617,32.7849,21.9285714285714,18.6857142857143,3.03085714285714,63.7571428571429,NA,NA,252,50,84,0,0,281,202,197
2018,22,11,"Demetevler",39.9617,32.7849,19.1285714285714,18.6,5.92157142857143,63.0714285714286,NA,NA,249,0,0,24,66,427,249,427
2018,23,11,"Demetevler",39.9617,32.7849,20.5571428571429,20.7428571428571,0.901714285714286,56.6428571428571,NA,NA,267,38,112,181,584,812,229,700
2018,24,11,"Demetevler",39.9617,32.7849,19.2714285714286,21.7142857142857,1.74342857142857,49.4428571428571,NA,NA,267,39,13,95,146,448,228,435
2018,25,11,"Demetevler",39.9617,32.7849,18.3714285714286,20.5142857142857,1.91357142857143,64.5571428571429,NA,NA,358,45,46,175,192,518,313,472
2018,26,11,"Demetevler",39.9617,32.7849,19.0428571428571,23.3285714285714,1.48857142857143,52.6,NA,NA,355,34,16,187,365,587,321,571
2018,27,11,"Demetevler",39.9617,32.7849,19.5142857142857,24.4857142857143,0,40.1428571428571,NA,NA,342,4,10,63,125,418,338,408
2018,28,11,"Demetevler",39.9617,32.7849,19.7714285714286,25.9857142857143,0.129428571428571,45.3285714285714,NA,NA,286,0,0,59,80,585,286,585
2018,29,11,"Demetevler",39.9617,32.7849,23.0428571428571,22.9285714285714,0.324142857142857,49.3285714285714,NA,NA,260,0,0,186,494,756,260,756
2018,30,11,"Demetevler",39.9617,32.7849,17.5428571428571,24.0142857142857,1.39042857142857,54.1571428571429,NA,NA,265,0,0,254,789,822,265,822
2018,31,11,"Demetevler",39.9617,32.7849,24.3857142857143,24.7142857142857,3.391,53.7,NA,NA,267,9,11,42,24,499,258,488
2018,32,11,"Demetevler",39.9617,32.7849,21.6,23.3428571428571,0.038,44.6,NA,NA,297,4,46,0,0,403,293,357
2018,33,11,"Demetevler",39.9617,32.7849,18.4,24.7714285714286,0,33.1285714285714,NA,NA,216,0,0,0,0,332,216,332
2018,34,11,"Demetevler",39.9617,32.7849,14.2,25.4,0,33.0714285714286,NA,NA,144,20,46,22,54,227,124,181
2018,35,11,"Demetevler",39.9617,32.7849,22.6857142857143,26.5285714285714,0.393428571428571,38.8,NA,NA,201,0,0,10,58,314,201,314
2018,36,11,"Demetevler",39.9617,32.7849,20.3857142857143,22.3857142857143,0.183285714285714,47.1714285714286,NA,NA,341,0,0,257,247,370,341,370
2018,37,11,"Demetevler",39.9617,32.7849,22.6428571428571,18.8285714285714,0.344714285714286,53.4,NA,NA,241,0,0,145,206,419,241,419
2018,38,11,"Demetevler",39.9617,32.7849,19.5142857142857,18.5285714285714,0,41.3,NA,NA,189,11,11,27,36,344,178,333
2018,39,11,"Demetevler",39.9617,32.7849,21.7714285714286,17.0857142857143,0.543,49.2285714285714,NA,NA,180,46,96,41,62,353,134,257
2018,40,11,"Demetevler",39.9617,32.7849,17.1142857142857,15.7428571428571,0.163428571428571,56.5,NA,NA,191,39,60,72,129,341,152,281
2018,41,11,"Demetevler",39.9617,32.7849,14.3571428571429,16.3285714285714,0.0387142857142857,54.7857142857143,NA,NA,187,24,17,0,0,422,163,405
2018,42,11,"Demetevler",39.9617,32.7849,12.8285714285714,16.7285714285714,2.36028571428571,63.0142857142857,NA,NA,168,50,149,35,69,381,118,232
2018,43,11,"Demetevler",39.9617,32.7849,13.4714285714286,9.81428571428571,3.04357142857143,73.6571428571429,NA,NA,187,1,0,110,210,402,186,402
2018,44,11,"Demetevler",39.9617,32.7849,10.6571428571429,11.0142857142857,0,58.8,NA,NA,196,1,0,79,73,264,195,264
2018,45,11,"Demetevler",39.9617,32.7849,10.6,9.31428571428571,0,62.4571428571429,NA,NA,231,18,21,16,43,473,213,452
2018,46,11,"Demetevler",39.9617,32.7849,10.9428571428571,5.41428571428571,0.00114285714285714,65.0714285714286,NA,NA,230,45,58,46,89,465,185,407
2018,47,11,"Demetevler",39.9617,32.7849,13.6857142857143,7.98571428571429,0.302714285714286,75.3,NA,NA,270,40,19,112,156,499,230,480
2018,48,11,"Demetevler",39.9617,32.7849,16.0857142857143,7.92857142857143,2.56771428571429,80.4714285714286,60.5175,NA,245,21,3,54,27,201,224,198
2018,49,11,"Demetevler",39.9617,32.7849,12.8,4.55714285714286,0.368571428571429,76.2,94.5785714285714,NA,257,2,2,52,129,420,255,418
2018,50,11,"Demetevler",39.9617,32.7849,16.3428571428571,3.15714285714286,2.64628571428571,85.7428571428571,70.19,NA,256,33,20,53,64,305,223,285
2018,51,11,"Demetevler",39.9617,32.7849,14.7142857142857,5.6,1.46614285714286,81.7285714285714,102.385,66.08,250,13,1,47,34,248,237,247
2018,52,11,"Demetevler",39.9617,32.7849,11.7571428571429,-1.34285714285714,5.74614285714286,81.5714285714286,80.4285714285714,66.3157142857143,244,0,0,93,79,273,244,273
2019,1,11,"Demetevler",39.9617,32.7849,21.1625,2.125,3.67075,79.9375,38.6675,48.2671428571429,343,49,284,29,82,784,294,500
2019,2,11,"Demetevler",39.9617,32.7849,11.8428571428571,-1.28571428571429,1.032,79,67.0671428571429,66.7585714285714,255,36,3,52,29,208,219,205
2019,3,11,"Demetevler",39.9617,32.7849,16.9142857142857,1.15714285714286,1.10742857142857,78.4714285714286,42.2925,60.8871428571429,192,87,70,58,93,198,105,128
2019,4,11,"Demetevler",39.9617,32.7849,13.6,4.92857142857143,1.47842857142857,76.7142857142857,71.215,56.6714285714286,308,181,204,48,43,314,127,110
2019,5,11,"Demetevler",39.9617,32.7849,16.1285714285714,4.91428571428571,0.269428571428571,72.8,75.7542857142857,65.1557142857143,253,123,60,31,22,143,130,83
2019,6,11,"Demetevler",39.9617,32.7849,12.1,5.87142857142857,4.09771428571429,77.3428571428571,57.8842857142857,54.06,276,3,2,76,60,127,273,125
2019,7,11,"Demetevler",39.9617,32.7849,16.5285714285714,4.92857142857143,0.00357142857142857,67.8285714285714,61.8785714285714,49.0485714285714,325,21,98,60,10,234,304,136
2019,8,11,"Demetevler",39.9617,32.7849,15.7,4.55714285714286,0.165285714285714,67.6285714285714,112.99,72.2128571428571,305,25,5,168,131,219,280,214
2019,9,11,"Demetevler",39.9617,32.7849,20.6428571428571,3.17142857142857,0.00371428571428571,64.1142857142857,56.6185714285714,45.8928571428571,331,0,0,121,162,310,331,310
2019,10,11,"Demetevler",39.9617,32.7849,16.4142857142857,6.65714285714286,0.396571428571429,58.2428571428571,80.4542857142857,72.2042857142857,359,0,0,223,127,252,359,252
2019,11,11,"Demetevler",39.9617,32.7849,21.1571428571429,7.77142857142857,3.71528571428571,70.0571428571428,52.8214285714286,51.5028571428571,373,0,0,151,219,400,373,400
2019,12,11,"Demetevler",39.9617,32.7849,17.7571428571429,7.8,0,53.5857142857143,75.3142857142857,65.4742857142857,343,0,0,171,78,416,343,416
2019,13,11,"Demetevler",39.9617,32.7849,24.2428571428571,5.84285714285714,0,46.7857142857143,48.0871428571429,37.17,256,0,0,30,23,194,256,194
2019,14,11,"Demetevler",39.9617,32.7849,15.4571428571429,10.3285714285714,0.0131428571428571,49.2142857142857,68.12,58.27,365,114,53,117,80,208,251,155
2019,15,11,"Demetevler",39.9617,32.7849,20.4571428571429,11.0714285714286,3.24885714285714,72,NA,53.04,359,137,77,56,34,183,222,106
2019,16,11,"Demetevler",39.9617,32.7849,19.5428571428571,6.82857142857143,1.02228571428571,63.0714285714286,NA,28.966,318,0,0,199,124,208,318,208
2019,17,11,"Demetevler",39.9617,32.7849,19.0857142857143,11.5714285714286,0.0115714285714286,53.9714285714286,NA,66.915,412,0,0,378,212,313,412,313
2019,18,11,"Demetevler",39.9617,32.7849,20.5,15.2714285714286,0.766142857142857,51.5142857142857,NA,34.41,523,0,0,143,70,353,523,353
2019,19,11,"Demetevler",39.9617,32.7849,18.7,12.5571428571429,0.726571428571429,67.4714285714286,NA,46.4616666666667,452,0,0,245,204,386,452,386
2019,20,11,"Demetevler",39.9617,32.7849,17.0571428571429,18.9428571428571,0.529714285714286,51.2428571428571,77.8033333333333,48.302,454,75,54,87,91,389,379,335
2019,21,11,"Demetevler",39.9617,32.7849,19.7285714285714,18.9142857142857,1.62157142857143,57.1571428571429,46.28,41.79,457,0,0,298,245,413,457,413
2019,22,11,"Demetevler",39.9617,32.7849,15.5285714285714,22.8428571428571,0.393285714285714,48.5714285714286,53.3785714285714,55.77,453,0,0,125,90,323,453,323
2019,23,11,"Demetevler",39.9617,32.7849,19.9857142857143,22.8,2.37714285714286,48.7857142857143,34.6157142857143,33.7185714285714,378,0,0,163,115,532,378,532
2019,24,11,"Demetevler",39.9617,32.7849,22.2285714285714,20.2714285714286,2.70485714285714,64.5142857142857,16.7214285714286,42.8871428571429,378,0,0,209,159,244,378,244
2019,25,11,"Demetevler",39.9617,32.7849,19.0857142857143,21.0571428571429,1.09671428571429,64.1857142857143,42.3785714285714,49.9583333333333,306,0,0,165,115,325,306,325
2019,26,11,"Demetevler",39.9617,32.7849,18.7857142857143,23.6857142857143,0,47.4714285714286,33.3085714285714,23.2485714285714,377,0,0,50,141,342,377,342
2019,27,11,"Demetevler",39.9617,32.7849,19.9285714285714,23.2285714285714,1.07642857142857,41.4,32.89,29.5714285714286,456,0,0,3,2,222,456,222
2019,28,11,"Demetevler",39.9617,32.7849,19.1,21.8428571428571,0.944571428571429,47.4714285714286,33.8414285714286,34.2183333333333,398,0,0,391,397,421,398,421
2019,29,11,"Demetevler",39.9617,32.7849,18.9142857142857,20.6857142857143,2.18114285714286,57.6714285714286,28.3971428571429,32.1114285714286,453,3,5,114,63,203,450,198
2019,30,11,"Demetevler",39.9617,32.7849,17.6714285714286,23.4285714285714,0,41.5857142857143,36.1985714285714,26.1771428571429,456,0,0,175,132,335,456,335
2019,31,11,"Demetevler",39.9617,32.7849,20.1285714285714,25.9142857142857,0,42.4857142857143,50.0514285714286,38.2814285714286,334,0,0,226,233,375,334,375
2019,32,11,"Demetevler",39.9617,32.7849,19.3285714285714,23.6142857142857,0,36.1428571428571,24.8342857142857,19.565,346,0,0,2,0,395,346,395
2019,33,11,"Demetevler",39.9617,32.7849,21.5428571428571,25.0571428571429,1.64757142857143,41.8714285714286,33.4071428571429,30.2657142857143,337,0,0,108,218,531,337,531
2019,34,11,"Demetevler",39.9617,32.7849,23.6142857142857,22.1714285714286,1.19514285714286,57.0428571428571,34.9316666666667,33.3383333333333,299,0,0,45,63,345,299,345
2019,35,11,"Demetevler",39.9617,32.7849,19.5714285714286,23.9428571428571,0.00257142857142857,41.5571428571429,34.2314285714286,24.4557142857143,307,0,0,12,2,415,307,415
2019,36,11,"Demetevler",39.9617,32.7849,18.7,22.6857142857143,0.0268571428571429,41.4571428571429,36.48,33.7228571428571,171,0,0,28,9,67,171,67
2019,37,11,"Demetevler",39.9617,32.7849,18.5428571428571,21.1714285714286,0,40.1428571428571,3.75,27.2128571428571,218,0,0,1,0,55,218,55
2019,38,11,"Demetevler",39.9617,32.7849,19.3285714285714,17.4857142857143,0,41.5857142857143,6.73142857142857,57.16,266,2,0,141,42,91,264,91
2019,39,11,"Demetevler",39.9617,32.7849,14.5142857142857,17.1571428571429,0.0521428571428571,48.8714285714286,6.45714285714286,62.9828571428571,237,0,0,212,68,79,237,79
2019,40,11,"Demetevler",39.9617,32.7849,15.8142857142857,17.6857142857143,0.211857142857143,43.6714285714286,6.99285714285714,78.3242857142857,241,0,0,228,107,111,241,111
2019,41,11,"Demetevler",39.9617,32.7849,12.2714285714286,15.6857142857143,0.00142857142857143,56.4428571428571,44.73,56.8728571428571,416,0,0,181,179,448,416,448
2019,42,11,"Demetevler",39.9617,32.7849,11.2285714285714,15.8571428571429,0.832142857142857,55.3571428571429,78.23,84.0914285714286,356,0,0,204,220,408,356,408
2019,43,11,"Demetevler",39.9617,32.7849,14.7,14.0428571428571,0,56.9857142857143,38.0171428571429,42.0042857142857,306,0,0,8,22,300,306,300
2019,44,11,"Demetevler",39.9617,32.7849,10.8428571428571,9.41428571428571,0.767714285714286,66.0285714285714,61.1314285714286,60.47,350,0,0,198,136,250,350,250
2019,45,11,"Demetevler",39.9617,32.7849,10.9714285714286,11.1,0,61.0714285714286,96.8175,70.745,417,110,85,137,153,328,307,243
2019,46,11,"Demetevler",39.9617,32.7849,9.21428571428571,10.7571428571429,0.310857142857143,60.8285714285714,86.3266666666667,74.78,401,56,39,15,62,337,345,298
2019,47,11,"Demetevler",39.9617,32.7849,8.68571428571429,4.91428571428571,0,66.8142857142857,134.008571428571,98.0114285714286,391,0,0,295,270,339,391,339
2019,48,11,"Demetevler",39.9617,32.7849,13.6285714285714,8.14285714285714,2.26114285714286,78.2142857142857,57.0585714285714,58.0414285714286,320,7,4,107,116,251,313,247
2019,49,11,"Demetevler",39.9617,32.7849,9.81428571428571,0.871428571428572,1.31771428571429,79.8571428571429,52.6185714285714,53.1271428571429,393,0,0,186,119,274,393,274
2019,50,11,"Demetevler",39.9617,32.7849,11.8,5.1,0.437571428571429,80.7857142857143,40.2671428571429,51.39,218,77,34,32,23,119,141,85
2019,51,11,"Demetevler",39.9617,32.7849,8.17142857142857,2.55714285714286,0.00114285714285714,87.8714285714286,135.441428571429,107.822857142857,361,0,0,347,479,488,361,488
2019,52,11,"Demetevler",39.9617,32.7849,14.6571428571429,5.08571428571429,4.00614285714286,79.2714285714286,30.0385714285714,43.67,279,58,101,95,71,281,221,180
2020,1,11,"Demetevler",39.9617,32.7849,15.92,1.1,0.191,76.94,32.6625,53.586,160,0,0,59,33,126,160,126
2020,2,11,"Demetevler",39.9617,32.7849,14.4571428571429,0.757142857142857,1.90685714285714,77.6142857142857,44.27,68.9171428571429,240,0,0,151,105,173,240,173
2020,3,11,"Demetevler",39.9617,32.7849,11.5,-0.628571428571429,0.0332857142857143,79.2857142857143,85.4857142857143,90.1571428571429,270,0,0,203,269,382,270,382
2020,4,11,"Demetevler",39.9617,32.7849,15.3142857142857,-1.55714285714286,0.0284285714285714,70.0142857142857,60.9128571428571,71.0042857142857,358,0,0,250,261,295,358,295
2020,5,11,"Demetevler",39.9617,32.7849,14.4,3.57142857142857,1.26085714285714,76,60.0385714285714,70.5342857142857,331,0,0,73,92,272,331,272
2020,6,11,"Demetevler",39.9617,32.7849,23.4285714285714,3.28571428571429,2.34657142857143,71.7571428571429,29.24,46.2571428571429,343,50,66,55,34,267,293,201
2020,7,11,"Demetevler",39.9617,32.7849,13.6,1.31428571428571,0.904,70.5714285714286,44.7957142857143,65.1657142857143,341,57,49,31,16,338,284,289
2020,8,11,"Demetevler",39.9617,32.7849,12.8428571428571,3.85714285714286,1.39042857142857,67.6571428571429,43.0857142857143,65.69,283,4,12,30,12,187,279,175
2020,9,11,"Demetevler",39.9617,32.7849,19.4142857142857,6.48571428571429,1.411,60.3857142857143,33.14,57.7514285714286,393,93,142,118,139,528,300,386
2020,10,11,"Demetevler",39.9617,32.7849,15.2428571428571,9.12857142857143,0.176571428571429,57.5714285714286,64.7828571428571,71.7642857142857,205,83,51,69,94,210,122,159
2020,11,11,"Demetevler",39.9617,32.7849,20.5,12.3714285714286,0.304857142857143,52.4571428571429,69.1485714285714,52.78,115,12,7,36,34,94,103,87
2020,12,11,"Demetevler",39.9617,32.7849,18.8857142857143,3.14285714285714,0.921142857142857,62.1571428571429,35.3171428571429,36.0628571428571,117,0,0,38,27,118,117,118
2020,13,11,"Demetevler",39.9617,32.7849,18.4142857142857,10.2571428571429,0.983571428571428,64.3571428571429,58.9085714285714,48.3942857142857,136,2,2,22,14,92,134,90
2020,14,11,"Demetevler",39.9617,32.7849,19.3428571428571,8.8,2.426,69.4428571428571,51.7157142857143,39.1071428571429,155,7,5,11,2,121,148,116
2020,15,11,"Demetevler",39.9617,32.7849,27.8428571428571,9.91428571428571,0.0634285714285714,44.6,37.6542857142857,23.2471428571429,133,0,0,18,19,118,133,118
2020,16,11,"Demetevler",39.9617,32.7849,18.0571428571429,12.1,0.420285714285714,52.3714285714286,56.0985714285714,43.87,141,42,19,37,19,106,99,87
2020,17,11,"Demetevler",39.9617,32.7849,17.7285714285714,11.0571428571429,0.107285714285714,50.9571428571429,40.2428571428571,25.14,137,1,1,66,67,123,136,122
2020,18,11,"Demetevler",39.9617,32.7849,21.2,12.6428571428571,2.48514285714286,61.9,56.6171428571429,46.4428571428571,146,2,0,55,41,164,144,164
2020,19,11,"Demetevler",39.9617,32.7849,18.9,12.3714285714286,0.824571428571429,60.8285714285714,32.3071428571429,33.5228571428571,137,0,0,90,127,157,137,157
2020,20,11,"Demetevler",39.9617,32.7849,18.2428571428571,20.9714285714286,0,44.4285714285714,120.223333333333,51.6071428571429,164,0,0,80,87,164,164,164
2020,21,11,"Demetevler",39.9617,32.7849,27.7857142857143,18.7571428571429,0.287857142857143,46.1857142857143,94.162,31.13,146,0,0,92,81,96,146,96
2020,22,11,"Demetevler",39.9617,32.7849,21.9142857142857,14.3714285714286,4.18957142857143,59.4714285714286,43.875,29.26,118,13,10,59,55,100,105,90
2020,23,11,"Demetevler",39.9617,32.7849,17.9714285714286,18.3142857142857,0.146,49.2,NA,46.2771428571429,112,25,17,38,30,70,87,53
2020,24,11,"Demetevler",39.9617,32.7849,24.3142857142857,20.4,4.40885714285714,54.2142857142857,42.92,24.9971428571429,140,0,0,91,112,150,140,150
2020,25,11,"Demetevler",39.9617,32.7849,16.8142857142857,19.0571428571429,3.207,67.4285714285714,37.3728571428571,12.3228571428571,137,0,0,116,103,108,137,108
2020,26,11,"Demetevler",39.9617,32.7849,18.5857142857143,21.8714285714286,0.787571428571428,55.9571428571429,29.0542857142857,10.5657142857143,173,0,0,36,23,133,173,133
2020,27,11,"Demetevler",39.9617,32.7849,17.8428571428571,25.6142857142857,0,40.6714285714286,31.3971428571429,8.08285714285714,113,0,0,31,53,113,113,113
2020,28,11,"Demetevler",39.9617,32.7849,21.9,25.1,0.118428571428571,42.6714285714286,29.1028571428571,20.59,164,0,0,28,16,122,164,122
2020,29,11,"Demetevler",39.9617,32.7849,18.6285714285714,25.4714285714286,0.214142857142857,44.5857142857143,36.9228571428571,26.4642857142857,186,1,0,85,65,111,185,111
2020,30,11,"Demetevler",39.9617,32.7849,21.8714285714286,25.2857142857143,0,37.7142857142857,36.0571428571429,30.0471428571429,190,0,0,83,69,142,190,142
2020,31,11,"Demetevler",39.9617,32.7849,19.3571428571429,26.2857142857143,0,38.7142857142857,33.4857142857143,26.8442857142857,150,0,0,75,78,127,150,127
2020,32,11,"Demetevler",39.9617,32.7849,18.0571428571429,26.5285714285714,0,29.7428571428571,29.9942857142857,28.93,146,0,0,0,0,107,146,107
2020,33,11,"Demetevler",39.9617,32.7849,18.3571428571429,23.9142857142857,0,38.1428571428571,19.1675,20.3333333333333,183,0,0,14,2,83,183,83
2020,34,11,"Demetevler",39.9617,32.7849,18.1,23.1428571428571,0.00142857142857143,38.4571428571429,25.48,39.0042857142857,197,1,1,76,30,97,196,96
2020,35,11,"Demetevler",39.9617,32.7849,12.2142857142857,24.8428571428571,0,32.1857142857143,52.264,60.1285714285714,164,2,2,79,83,157,162,155
2020,36,11,"Demetevler",39.9617,32.7849,17.3428571428571,25.4142857142857,0,31.6142857142857,60.5085714285714,68.9914285714286,179,23,9,151,100,112,156,103
2020,37,11,"Demetevler",39.9617,32.7849,18.7857142857143,23.2571428571429,0.00585714285714286,44.1714285714286,57.3857142857143,45.3757142857143,193,0,0,72,33,91,193,91
2020,38,11,"Demetevler",39.9617,32.7849,18.7285714285714,22.8,0.0938571428571429,39.0714285714286,42.7942857142857,35.7971428571429,235,0,0,61,40,157,235,157
2020,39,11,"Demetevler",39.9617,32.7849,15.4571428571429,19.6,0.747,55.1571428571429,59.09,58,220,0,0,113,42,129,220,129
2020,40,11,"Demetevler",39.9617,32.7849,15.4714285714286,18.0571428571429,0.00442857142857143,45.3857142857143,71.025,70.5275,187,0,0,79,45,154,187,154
2020,41,11,"Demetevler",39.9617,32.7849,14.2857142857143,19.1142857142857,0.199857142857143,46.7428571428571,87.8428571428571,64.8271428571429,182,14,7,129,84,127,168,120
2020,42,11,"Demetevler",39.9617,32.7849,13.8,16.9571428571429,0.833142857142857,48.7714285714286,86.9114285714286,74.2,177,10,4,105,85,111,167,107
2020,43,11,"Demetevler",39.9617,32.7849,13.6571428571429,15.2142857142857,0.0988571428571429,59.9428571428571,62.8014285714286,58.75,194,1,1,49,77,161,193,160
2020,44,11,"Demetevler",39.9617,32.7849,15.2571428571429,12.9,2.837,63.3,67.5028571428571,66.3714285714286,255,12,4,71,42,233,243,229
2020,45,11,"Demetevler",39.9617,32.7849,15.4428571428571,8.95714285714286,0.375285714285714,66.3285714285714,47.0142857142857,55.9542857142857,156,0,0,47,31,103,156,103
2020,46,11,"Demetevler",39.9617,32.7849,9.54285714285714,6.87142857142857,0,69.9857142857143,64.9,66.2657142857143,208,3,2,68,38,109,205,107
2020,47,11,"Demetevler",39.9617,32.7849,13.1142857142857,4.58571428571429,0,65.1857142857143,50.9557142857143,59.6742857142857,173,0,0,56,7,83,173,83
2020,48,11,"Demetevler",39.9617,32.7849,10.2428571428571,1.65714285714286,0,65.0142857142857,74.1528571428571,78.0071428571429,199,0,0,44,84,262,199,262
2020,49,11,"Demetevler",39.9617,32.7849,8.25714285714286,4.45714285714286,0.0438571428571429,68.3857142857143,78.1028571428571,77.1414285714286,207,10,0,42,19,116,197,116
2020,50,11,"Demetevler",39.9617,32.7849,12.9,6.12857142857143,0.709714285714286,77.9571428571429,60.8714285714286,56.3971428571429,181,68,33,48,16,98,113,65
2020,51,11,"Demetevler",39.9617,32.7849,11.1142857142857,6.07142857142857,0.938285714285714,77.4571428571429,44.1185714285714,47.6533333333333,171,0,0,61,47,90,171,90
2020,52,11,"Demetevler",39.9617,32.7849,7.51428571428571,2.71428571428571,0.0675714285714286,72.8142857142857,70.4371428571429,48.6185714285714,203,0,0,60,28,113,203,113
2020,53,11,"Demetevler",39.9617,32.7849,7.575,6,0.93175,76.275,68.9075,48.6325,122,0,0,52,64,111,122,111
2017,1,12,"Sincan",39.9615,32.5842,17.2428571428571,-2.14285714285714,0.910571428571429,80.7571428571429,61.0285714285714,74.7114285714286,563,108,214,202,298,847,455,633
2017,2,12,"Sincan",39.9615,32.5842,14.1857142857143,-2.81428571428571,0.603142857142857,78.2857142857143,61.5357142857143,80.4757142857143,757,38,62,181,192,1214,719,1152
2017,3,12,"Sincan",39.9615,32.5842,10.2428571428571,1.24285714285714,0.994428571428571,84.4285714285714,54.4557142857143,77.1914285714286,762,0,0,455,1014,1449,762,1449
2017,4,12,"Sincan",39.9615,32.5842,16.6,-2.25714285714286,0.07,70.0571428571429,41.4971428571429,51.8357142857143,639,0,0,276,367,889,639,889
2017,5,12,"Sincan",39.9615,32.5842,9.22857142857143,-3.44285714285714,0.0904285714285714,68.0285714285714,79.6242857142857,75.54,588,0,0,367,861,1163,588,1163
2017,6,12,"Sincan",39.9615,32.5842,13.7285714285714,3.71428571428571,0.133857142857143,77.8571428571429,62.4014285714286,59.29,736,37,88,266,443,1519,699,1431
2017,7,12,"Sincan",39.9615,32.5842,14.5142857142857,-1.72857142857143,0.154714285714286,60.5142857142857,42.1642857142857,52.9442857142857,492,0,0,318,395,717,492,717
2017,8,12,"Sincan",39.9615,32.5842,18.3714285714286,5.64285714285714,0.193714285714286,69.3,62.3728571428571,60.8642857142857,739,0,0,108,238,1747,739,1747
2017,9,12,"Sincan",39.9615,32.5842,15.5571428571429,8.21428571428572,1.06557142857143,64.9571428571429,64.8314285714286,61.3228571428571,574,131,250,154,172,866,443,616
2017,10,12,"Sincan",39.9615,32.5842,15.6571428571429,8.31428571428571,1.52485714285714,63.3285714285714,67.2457142857143,70.3371428571429,712,639,857,0,0,1043,73,186
2017,11,12,"Sincan",39.9615,32.5842,19.6428571428571,3.57142857142857,1.71628571428571,76.7714285714286,26.6014285714286,43.2871428571429,525,0,0,280,481,725,525,725
2017,12,12,"Sincan",39.9615,32.5842,17.7142857142857,9.25714285714286,0.0584285714285714,50.0857142857143,49.9728571428571,53.0385714285714,589,0,0,308,563,1077,589,1077
2017,13,12,"Sincan",39.9615,32.5842,17.3714285714286,9.3,0.235142857142857,50.6714285714286,45.4557142857143,50.5657142857143,574,0,0,180,318,887,574,887
2017,14,12,"Sincan",39.9615,32.5842,21.6285714285714,10.3428571428571,0.722285714285714,49.0857142857143,56.2685714285714,51.2585714285714,639,199,477,190,313,1336,440,859
2017,15,12,"Sincan",39.9615,32.5842,16.6285714285714,9.32857142857143,0.095,57.4428571428571,49.7914285714286,51.7585714285714,587,22,17,324,555,1187,565,1170
2017,16,12,"Sincan",39.9615,32.5842,25.7428571428571,9.75714285714286,1.06114285714286,61.8142857142857,35.0914285714286,38.3814285714286,717,0,0,111,76,920,717,920
2017,17,12,"Sincan",39.9615,32.5842,13.9428571428571,11.8571428571429,0,46.4142857142857,47.025,53.75,731,69,246,348,741,1478,662,1232
2017,18,12,"Sincan",39.9615,32.5842,24.3,15.9857142857143,1.67142857142857,58.4,NA,NA,506,67,101,142,217,923,439,822
2017,19,12,"Sincan",39.9615,32.5842,24.7428571428571,17.7142857142857,0.0897142857142857,49.6,NA,NA,471,2,2,215,417,966,469,964
2017,20,12,"Sincan",39.9615,32.5842,22.2714285714286,14.4,1.36042857142857,56.6714285714286,29.43,20.372,472,0,0,144,508,1205,472,1205
2017,21,12,"Sincan",39.9615,32.5842,18.7285714285714,13.6857142857143,4.44185714285714,64.5428571428571,34.1414285714286,34.2828571428571,448,34,144,180,323,849,414,705
2017,22,12,"Sincan",39.9615,32.5842,17.7285714285714,16.6142857142857,1.70314285714286,70.3142857142857,36.4785714285714,27.5114285714286,522,0,0,242,410,1015,522,1015
2017,23,12,"Sincan",39.9615,32.5842,19.0285714285714,18.8714285714286,3.23285714285714,68.7857142857143,39.4342857142857,32.954,578,0,0,511,1178,1388,578,1388
2017,24,12,"Sincan",39.9615,32.5842,18.0285714285714,19.8571428571429,0.475,56.3428571428571,36.3871428571429,21.6083333333333,552,0,0,425,781,1139,552,1139
2017,25,12,"Sincan",39.9615,32.5842,15.7857142857143,18.5285714285714,2.75414285714286,65.0142857142857,37.0128571428571,33.1385714285714,584,0,0,516,874,1041,584,1041
2017,26,12,"Sincan",39.9615,32.5842,17.1142857142857,26,0,43.2142857142857,44.6542857142857,29.45,564,0,0,396,765,971,564,971
2017,27,12,"Sincan",39.9615,32.5842,22.0857142857143,23.7571428571429,0,43.9714285714286,41.0214285714286,27.6885714285714,511,0,0,253,368,642,511,642
2017,28,12,"Sincan",39.9615,32.5842,18.7,25.7142857142857,0.643714285714286,40.2285714285714,45.5314285714286,25.0071428571429,481,0,0,240,488,864,481,864
2017,29,12,"Sincan",39.9615,32.5842,18.7428571428571,25.1571428571429,0.00157142857142857,45.8571428571429,43.0514285714286,24.6414285714286,532,0,0,105,209,1272,532,1272
2017,30,12,"Sincan",39.9615,32.5842,20.9,25.1714285714286,0.000857142857142857,37.3428571428571,72.6785714285714,34.38,531,0,0,164,291,928,531,928
2017,31,12,"Sincan",39.9615,32.5842,22.4714285714286,24.8,1.04671428571429,52,47.7957142857143,26.3742857142857,559,0,0,178,374,1047,559,1047
2017,32,12,"Sincan",39.9615,32.5842,23.2,27.6428571428571,0.00514285714285714,41.5714285714286,63.4314285714286,33.0185714285714,567,0,0,234,314,1092,567,1092
2017,33,12,"Sincan",39.9615,32.5842,19.4571428571429,24.6857142857143,0.110857142857143,50.3428571428571,55.8014285714286,29.4042857142857,596,0,0,436,851,1199,596,1199
2017,34,12,"Sincan",39.9615,32.5842,21.5428571428571,21.6571428571429,0.519428571428571,50.6714285714286,38.2085714285714,32.7114285714286,601,0,0,249,718,1280,601,1280
2017,35,12,"Sincan",39.9615,32.5842,15.2571428571429,21.3285714285714,0.262285714285714,43.9428571428571,39.9071428571429,33.4785714285714,493,0,0,196,580,1014,493,1014
2017,36,12,"Sincan",39.9615,32.5842,16.3571428571429,20.2285714285714,0.137142857142857,40.2857142857143,69.3385714285714,59.06,507,0,0,445,1056,1321,507,1321
2017,37,12,"Sincan",39.9615,32.5842,15.6857142857143,25,0,31.2571428571429,121.785714285714,75.9657142857143,589,0,0,168,251,1138,589,1138
2017,38,12,"Sincan",39.9615,32.5842,17.4857142857143,22.2,0,35.7428571428571,79.55,56.33,671,0,0,388,839,1312,671,1312
2017,39,12,"Sincan",39.9615,32.5842,17.5714285714286,17.5,1.40842857142857,56.3857142857143,50.37,49.3328571428571,782,0,0,178,385,1630,782,1630
2017,40,12,"Sincan",39.9615,32.5842,15.4714285714286,12.9428571428571,2.26557142857143,56.1142857142857,66.4257142857143,58.2414285714286,543,41,154,133,213,1137,502,983
2017,41,12,"Sincan",39.9615,32.5842,12.3714285714286,11.2285714285714,0.181142857142857,61.7857142857143,46.1728571428571,45.7728571428571,487,0,0,347,637,843,487,843
2017,42,12,"Sincan",39.9615,32.5842,12.1142857142857,11.5,0,55.8,93.0557142857143,68.0471428571429,530,0,0,334,574,815,530,815
2017,43,12,"Sincan",39.9615,32.5842,13.8142857142857,11.5857142857143,0.414857142857143,70.5285714285714,77.7557142857143,56.4571428571429,506,161,231,176,236,919,345,688
2017,44,12,"Sincan",39.9615,32.5842,15.7285714285714,4.6,0.619,65,69.76,61.6828571428571,561,0,0,239,416,1102,561,1102
2017,45,12,"Sincan",39.9615,32.5842,11.0142857142857,5.92857142857143,0.335714285714286,81.3,110.345714285714,63.79,577,0,0,299,310,829,577,829
2017,46,12,"Sincan",39.9615,32.5842,8.68571428571429,8.05714285714286,0.0275714285714286,70.9571428571429,143.351428571429,89.9942857142857,587,0,0,225,440,1085,587,1085
2017,47,12,"Sincan",39.9615,32.5842,14.5285714285714,4.55714285714286,1.45942857142857,76.9,61.4,51.6942857142857,418,0,0,162,334,804,418,804
2017,48,12,"Sincan",39.9615,32.5842,9.14285714285714,5.7,1.14928571428571,80.8571428571429,96.5214285714286,65.3771428571429,386,68,118,53,62,619,318,501
2017,49,12,"Sincan",39.9615,32.5842,14.9571428571429,3.15714285714286,1.604,74.9571428571429,81.0671428571429,53.8271428571429,407,0,0,232,395,645,407,645
2017,50,12,"Sincan",39.9615,32.5842,9.57142857142857,4.1,0.473428571428571,86.4714285714286,124.757142857143,72.2685714285714,346,47,41,154,147,442,299,401
2017,51,12,"Sincan",39.9615,32.5842,14.2714285714286,4.91428571428571,3.05457142857143,80.8714285714286,39.8985714285714,49.1228571428571,386,0,0,100,110,349,386,349
2017,52,12,"Sincan",39.9615,32.5842,10.075,1.3875,0.449625,78.3375,78.98,75.6175,528,126,152,50,41,507,402,355
2018,1,12,"Sincan",39.9615,32.5842,11.7875,2.9375,1.80025,83.3125,58.805,59.3914285714286,618,223,447,188,232,914,395,467
2018,2,12,"Sincan",39.9615,32.5842,11.2285714285714,3.92857142857143,2.91057142857143,85.7,68.2514285714286,58.85,624,0,0,36,59,1309,624,1309
2018,3,12,"Sincan",39.9615,32.5842,14.8714285714286,2.05714285714286,1.506,76.5857142857143,53.6616666666667,57.3871428571429,639,80,126,346,363,655,559,529
2018,4,12,"Sincan",39.9615,32.5842,18.4142857142857,1.18571428571429,1.684,66.2,24.19,31.8271428571429,604,86,169,173,177,764,518,595
2018,5,12,"Sincan",39.9615,32.5842,13.2428571428571,3.3,0,74.4285714285714,93.564,62.55,670,2,10,351,417,819,668,809
2018,6,12,"Sincan",39.9615,32.5842,12.3857142857143,7.04285714285714,0.810428571428571,77.3714285714286,84.1042857142857,62.3028571428571,704,21,72,266,422,1022,683,950
2018,7,12,"Sincan",39.9615,32.5842,19.6,4.72857142857143,1.24985714285714,74.8857142857143,54.5357142857143,44.7228571428571,478,0,0,170,181,557,478,557
2018,8,12,"Sincan",39.9615,32.5842,12.7285714285714,6.07142857142857,1.118,76.5714285714286,60.99,48.1314285714286,711,101,247,95,273,1321,610,1074
2018,9,12,"Sincan",39.9615,32.5842,23.6857142857143,5.32857142857143,3.64528571428571,74.3714285714286,41.3185714285714,40.2428571428571,621,0,0,122,199,956,621,956
2018,10,12,"Sincan",39.9615,32.5842,17.9428571428571,8.95714285714286,1.87942857142857,73.1857142857143,69.7057142857143,41.0314285714286,556,0,0,91,262,1330,556,1330
2018,11,12,"Sincan",39.9615,32.5842,17.0142857142857,9.54285714285714,0.647857142857143,68.8,59.79,39.4185714285714,551,46,67,303,865,1426,505,1359
2018,12,12,"Sincan",39.9615,32.5842,24.4,11.6285714285714,0.558714285714286,57.0571428571429,106.637142857143,39.0328571428571,425,0,0,39,186,1187,425,1187
2018,13,12,"Sincan",39.9615,32.5842,17.9428571428571,10.6857142857143,1.53671428571429,61.1428571428571,79.2528571428571,36.0542857142857,356,107,134,120,154,428,249,294
2018,14,12,"Sincan",39.9615,32.5842,17,11.4428571428571,0.259142857142857,56.0571428571429,61.3157142857143,40.2985714285714,407,132,262,171,92,486,275,224
2018,15,12,"Sincan",39.9615,32.5842,18.0571428571429,15.2,0.0337142857142857,59,59.1728571428571,35.5314285714286,374,0,0,101,93,450,374,450
2018,16,12,"Sincan",39.9615,32.5842,16.7142857142857,12.4428571428571,0.0752857142857143,50.1571428571429,53.6457142857143,34.6357142857143,411,0,0,212,344,648,411,648
2018,17,12,"Sincan",39.9615,32.5842,15.0142857142857,16.9428571428571,0,40.9142857142857,56.3571428571429,40.5357142857143,419,0,0,123,128,652,419,652
2018,18,12,"Sincan",39.9615,32.5842,19.2285714285714,18.5285714285714,0.968714285714286,50.5142857142857,69.0514285714286,37.3085714285714,303,53,67,41,122,474,250,407
2018,19,12,"Sincan",39.9615,32.5842,20.4285714285714,14.4428571428571,3.22514285714286,72.0428571428571,30.5557142857143,23.4414285714286,275,0,0,188,351,467,275,467
2018,20,12,"Sincan",39.9615,32.5842,15.5,18.8142857142857,1.985,58.5571428571429,44.2428571428571,29.0328571428571,204,0,0,152,239,306,204,306
2018,21,12,"Sincan",39.9615,32.5842,21.9714285714286,18.4142857142857,3.11414285714286,64.9142857142857,44.3471428571429,28.3771428571429,252,19,11,39,70,281,233,270
2018,22,12,"Sincan",39.9615,32.5842,20.8428571428571,18.3571428571429,6.00328571428572,64.5285714285714,32.1828571428571,23.4657142857143,249,0,0,101,234,427,249,427
2018,23,12,"Sincan",39.9615,32.5842,20.5142857142857,20.4571428571429,0.852285714285714,57.9714285714286,45.47,27.1285714285714,267,0,0,204,603,812,267,812
2018,24,12,"Sincan",39.9615,32.5842,19.3571428571429,21.4285714285714,2.28228571428571,50.9428571428571,32.2942857142857,24.1814285714286,267,0,0,77,143,448,267,448
2018,25,12,"Sincan",39.9615,32.5842,19.1714285714286,20.3714285714286,2.91028571428571,65.7428571428571,33.9114285714286,20.6242857142857,358,0,0,205,242,518,358,518
2018,26,12,"Sincan",39.9615,32.5842,18.2714285714286,23.1,1.10442857142857,54.1714285714286,40.855,36.7371428571429,355,0,0,160,312,587,355,587
2018,27,12,"Sincan",39.9615,32.5842,20.4857142857143,24.1571428571429,0,40.7428571428571,30.5928571428571,43.2685714285714,342,0,0,133,207,418,342,418
2018,28,12,"Sincan",39.9615,32.5842,24.5428571428571,25.6857142857143,0.201428571428571,46.6714285714286,37.7457142857143,32.3814285714286,286,0,0,124,315,585,286,585
2018,29,12,"Sincan",39.9615,32.5842,24.4571428571429,22.6714285714286,0.415714285714286,50.5714285714286,33.1371428571429,44.8785714285714,260,0,0,236,541,756,260,756
2018,30,12,"Sincan",39.9615,32.5842,19.3571428571429,23.8,2.52528571428571,55.5571428571429,39.7014285714286,42.9171428571429,265,0,0,261,819,822,265,822
2018,31,12,"Sincan",39.9615,32.5842,24.2,24.5428571428571,3.00157142857143,54.9857142857143,36.9271428571429,43.3342857142857,267,0,0,115,172,499,267,499
2018,32,12,"Sincan",39.9615,32.5842,22.4571428571429,23.1142857142857,0.127714285714286,46.6142857142857,32.6428571428571,40.5814285714286,297,0,0,17,42,403,297,403
2018,33,12,"Sincan",39.9615,32.5842,18.7714285714286,24.3142857142857,0,34.2857142857143,39.87,56.8628571428571,216,0,0,0,0,332,216,332
2018,34,12,"Sincan",39.9615,32.5842,14.0857142857143,25.1285714285714,0,34.4714285714286,NA,59.4371428571429,144,1,19,54,70,227,143,208
2018,35,12,"Sincan",39.9615,32.5842,24.5142857142857,26.2857142857143,0.139571428571429,40.1857142857143,NA,36.2228571428571,201,0,0,57,156,314,201,314
2018,36,12,"Sincan",39.9615,32.5842,22.5857142857143,22,0.424142857142857,49.2857142857143,NA,28.72,341,0,0,271,279,370,341,370
2018,37,12,"Sincan",39.9615,32.5842,22.9428571428571,18.5428571428571,0.595571428571429,54.4857142857143,NA,24.4314285714286,241,0,0,137,235,419,241,419
2018,38,12,"Sincan",39.9615,32.5842,19.4142857142857,18.3285714285714,0,41.4428571428571,NA,51.5442857142857,189,1,0,11,35,344,188,344
2018,39,12,"Sincan",39.9615,32.5842,21.8,16.8714285714286,0.543,49.4285714285714,NA,56.2616666666667,180,0,0,34,47,353,180,353
2018,40,12,"Sincan",39.9615,32.5842,17.2,15.3285714285714,0.424857142857143,58.9571428571429,NA,NA,191,0,0,76,139,341,191,341
2018,41,12,"Sincan",39.9615,32.5842,14.8428571428571,16.0285714285714,0.0632857142857143,56.3571428571429,25.0025,36.6325,187,0,0,33,50,422,187,422
2018,42,12,"Sincan",39.9615,32.5842,12.9571428571429,16.3285714285714,2.98614285714286,65.1428571428571,366.514285714286,51.7228571428571,168,19,134,35,69,381,149,247
2018,43,12,"Sincan",39.9615,32.5842,13.0428571428571,9.48571428571429,3.46557142857143,75.0428571428571,183.1,46.6885714285714,187,0,0,102,159,402,187,402
2018,44,12,"Sincan",39.9615,32.5842,10.5428571428571,10.3714285714286,0,61.2714285714286,102.788571428571,80.7442857142857,196,0,0,89,112,264,196,264
2018,45,12,"Sincan",39.9615,32.5842,9.88571428571429,8.81428571428571,0,64.7285714285714,83.01,60.4185714285714,231,0,0,35,110,473,231,473
2018,46,12,"Sincan",39.9615,32.5842,12.3142857142857,5.08571428571429,0.00971428571428571,66.3,43.6828571428571,34.87,230,45,58,120,258,465,185,407
2018,47,12,"Sincan",39.9615,32.5842,12.6571428571429,7.54285714285714,0.267428571428571,76.7285714285714,60.1914285714286,71.1614285714286,270,0,0,44,94,499,270,499
2018,48,12,"Sincan",39.9615,32.5842,14.3142857142857,7.52857142857143,3.307,82.4,43.998,41.93,245,0,0,63,27,201,245,201
2018,49,12,"Sincan",39.9615,32.5842,12.4714285714286,4.14285714285714,0.387714285714286,77.6714285714286,41.3628571428571,40.832,257,1,2,63,161,420,256,418
2018,50,12,"Sincan",39.9615,32.5842,15.9714285714286,2.87142857142857,2.80842857142857,86.1571428571429,272.94,28.34,256,33,20,57,67,305,223,285
2018,51,12,"Sincan",39.9615,32.5842,14.4571428571429,5.34285714285714,1.53557142857143,82.4285714285714,38.46,NA,250,27,42,106,45,248,223,206
2018,52,12,"Sincan",39.9615,32.5842,12.7428571428571,-1.47142857142857,4.323,82.0428571428571,43.5666666666667,NA,244,0,0,167,203,273,244,273
2019,1,12,"Sincan",39.9615,32.5842,20.95,1.9875,3.87475,81.5625,28.2425,46.165,343,49,284,29,82,784,294,500
2019,2,12,"Sincan",39.9615,32.5842,11.1428571428571,-1.82857142857143,0.969714285714286,81.1285714285714,45.98,NA,255,23,21,126,116,208,232,187
2019,3,12,"Sincan",39.9615,32.5842,16.3,0.757142857142857,1.46742857142857,80.7571428571429,39.96,NA,192,32,23,58,93,198,160,175
2019,4,12,"Sincan",39.9615,32.5842,13.9285714285714,4.68571428571429,1.61285714285714,78.9571428571429,67.445,NA,308,158,184,48,43,314,150,130
2019,5,12,"Sincan",39.9615,32.5842,15.6571428571429,4.54285714285714,0.413857142857143,75.0142857142857,55.0275,NA,253,133,70,31,22,143,120,73
2019,6,12,"Sincan",39.9615,32.5842,11.5,5.52857142857143,4.55257142857143,79.1428571428571,59.9885714285714,NA,276,0,0,77,61,127,276,127
2019,7,12,"Sincan",39.9615,32.5842,16.3714285714286,4.51428571428571,0.0321428571428571,69.5142857142857,44.07,NA,325,24,100,60,10,234,301,134
2019,8,12,"Sincan",39.9615,32.5842,15.5571428571429,4.17142857142857,0.161714285714286,68.9571428571429,75.1971428571429,NA,305,27,5,183,145,219,278,214
2019,9,12,"Sincan",39.9615,32.5842,20.2,2.84285714285714,0.00228571428571429,65.2142857142857,33.1757142857143,NA,331,0,0,166,215,310,331,310
2019,10,12,"Sincan",39.9615,32.5842,16.6285714285714,6.12857142857143,0.335428571428571,59.9,59.0442857142857,NA,359,0,0,232,118,252,359,252
2019,11,12,"Sincan",39.9615,32.5842,20.6428571428571,7.47142857142857,4.12985714285714,71.5142857142857,33.71,NA,373,0,0,142,173,400,373,400
2019,12,12,"Sincan",39.9615,32.5842,18.7857142857143,7.45714285714286,0,55.1428571428571,43.9414285714286,NA,343,0,0,174,76,416,343,416
2019,13,12,"Sincan",39.9615,32.5842,23.9714285714286,5.51428571428571,0,47.8571428571429,36.7214285714286,NA,256,0,0,67,106,194,256,194
2019,14,12,"Sincan",39.9615,32.5842,16.1857142857143,9.94285714285714,0.0468571428571429,51.5714285714286,38.78,NA,365,109,52,76,42,208,256,156
2019,15,12,"Sincan",39.9615,32.5842,21.7857142857143,10.7,3.24571428571429,74.2428571428571,7.44,32.35,359,76,53,56,31,183,283,130
2019,16,12,"Sincan",39.9615,32.5842,22.1857142857143,6.68571428571429,0.933857142857143,63.6857142857143,18.415,33.8825,318,0,0,266,198,208,318,208
2019,17,12,"Sincan",39.9615,32.5842,19.2428571428571,11.1285714285714,0.0218571428571429,55.3714285714286,36.27,61.0575,412,0,0,293,189,313,412,313
2019,18,12,"Sincan",39.9615,32.5842,20.2428571428571,14.7142857142857,0.813714285714286,54.3857142857143,31.084,38.614,523,0,0,147,80,353,523,353
2019,19,12,"Sincan",39.9615,32.5842,18.6285714285714,12.2,1.34357142857143,69.9142857142857,78.4114285714286,48.8657142857143,452,0,0,192,189,386,452,386
2019,20,12,"Sincan",39.9615,32.5842,17.2428571428571,18.2428571428571,0.787142857142857,55.3142857142857,46.2314285714286,77.0914285714286,454,74,52,157,128,389,380,337
2019,21,12,"Sincan",39.9615,32.5842,19.4714285714286,18.5285714285714,1.72542857142857,60.3285714285714,41.0985714285714,54.98,457,0,0,302,255,413,457,413
2019,22,12,"Sincan",39.9615,32.5842,14.4,22.3285714285714,0.398142857142857,52.2,61.6133333333333,NA,453,0,0,208,124,323,453,323
2019,23,12,"Sincan",39.9615,32.5842,21.4142857142857,22.3142857142857,4.42414285714286,51.6142857142857,41.2528571428571,NA,378,0,0,233,197,532,378,532
2019,24,12,"Sincan",39.9615,32.5842,21.9142857142857,20.0142857142857,1.49,66.4,11.2571428571429,37.168,378,0,0,237,175,244,378,244
2019,25,12,"Sincan",39.9615,32.5842,19.6285714285714,20.5714285714286,2.75128571428571,67.8142857142857,31.0671428571429,43.3285714285714,306,0,0,230,213,325,306,325
2019,26,12,"Sincan",39.9615,32.5842,20.1571428571429,23.2285714285714,0,50.5,32.3814285714286,30.6028571428571,377,0,0,155,168,342,377,342
2019,27,12,"Sincan",39.9615,32.5842,20.8285714285714,22.8428571428571,0.542571428571429,43.5571428571429,34.81,38.2816666666667,456,0,0,38,15,222,456,222
2019,28,12,"Sincan",39.9615,32.5842,19.9,21.4428571428571,1.153,49.9714285714286,28.8328571428571,34.035,398,0,0,393,411,421,398,421
2019,29,12,"Sincan",39.9615,32.5842,19.2142857142857,20.4428571428571,2.63128571428571,59.5714285714286,24.1214285714286,41.8057142857143,453,2,1,118,63,203,451,202
2019,30,12,"Sincan",39.9615,32.5842,19,23.1142857142857,0,43.9571428571429,35.1842857142857,38.7657142857143,456,0,0,263,145,335,456,335
2019,31,12,"Sincan",39.9615,32.5842,21.9142857142857,25.5,0,45.0428571428571,45.1028571428571,45.318,334,0,0,278,296,375,334,375
2019,32,12,"Sincan",39.9615,32.5842,19.9714285714286,23.3,0,38.0285714285714,33.42,40.7733333333333,346,0,0,17,30,395,346,395
2019,33,12,"Sincan",39.9615,32.5842,21.1,24.8857142857143,1.81442857142857,42.8571428571429,33.8414285714286,34.7928571428571,337,0,0,113,219,531,337,531
2019,34,12,"Sincan",39.9615,32.5842,24.3857142857143,22.0285714285714,0.985428571428571,57.8285714285714,30.17,31.1428571428571,299,0,0,56,66,345,299,345
2019,35,12,"Sincan",39.9615,32.5842,21.4285714285714,23.7,0.000857142857142857,42.8428571428571,38.31,37.262,307,0,0,86,143,415,307,415
2019,36,12,"Sincan",39.9615,32.5842,17.8428571428571,22.3,0.171571428571429,43.8285714285714,41.1028571428571,37.9375,171,0,0,52,34,67,171,67
2019,37,12,"Sincan",39.9615,32.5842,18.3,20.9285714285714,0,42.2285714285714,39.6571428571429,46.5314285714286,218,0,0,27,4,55,218,55
2019,38,12,"Sincan",39.9615,32.5842,18.8714285714286,17.0428571428571,0,43.4142857142857,50.2314285714286,67.65,266,22,2,157,42,91,244,89
2019,39,12,"Sincan",39.9615,32.5842,15.1571428571429,16.7285714285714,0.0447142857142857,50.6428571428571,49.5271428571429,82.3857142857143,237,0,0,192,64,79,237,79
2019,40,12,"Sincan",39.9615,32.5842,16.9285714285714,17.1285714285714,0.212571428571429,45.5428571428571,54.92,72.75,241,0,0,215,85,111,241,111
2019,41,12,"Sincan",39.9615,32.5842,12.3142857142857,15.1714285714286,0.0128571428571429,59.3571428571429,NA,NA,416,0,0,202,187,448,416,448
2019,42,12,"Sincan",39.9615,32.5842,11.6428571428571,15.3142857142857,1.93114285714286,57.8142857142857,NA,NA,356,0,0,224,267,408,356,408
2019,43,12,"Sincan",39.9615,32.5842,14.2142857142857,13.6857142857143,0,58.7571428571429,NA,NA,306,0,0,69,116,300,306,300
2019,44,12,"Sincan",39.9615,32.5842,10.5142857142857,8.91428571428571,0.645714285714286,68.4285714285714,NA,NA,350,0,0,237,148,250,350,250
2019,45,12,"Sincan",39.9615,32.5842,9.67142857142857,10.2142857142857,0,64.2571428571429,NA,NA,417,35,23,225,150,328,382,305
2019,46,12,"Sincan",39.9615,32.5842,9.22857142857143,9.94285714285714,0.443285714285714,64.4,79.4333333333333,200.853333333333,401,56,39,104,111,337,345,298
2019,47,12,"Sincan",39.9615,32.5842,8.42857142857143,4.07142857142857,0,69.5285714285714,100.367142857143,236.521428571429,391,0,0,287,275,339,391,339
2019,48,12,"Sincan",39.9615,32.5842,14.0142857142857,7.62857142857143,2.72414285714286,81.1857142857143,54.8471428571429,141.341428571429,320,3,2,148,166,251,317,249
2019,49,12,"Sincan",39.9615,32.5842,9.75714285714286,0.528571428571429,1.53028571428571,81.4142857142857,39.1714285714286,105.252857142857,393,0,0,229,146,274,393,274
2019,50,12,"Sincan",39.9615,32.5842,10.6,4.75714285714286,0.451428571428571,83.0285714285714,47.4857142857143,62.1542857142857,218,102,37,16,17,119,116,82
2019,51,12,"Sincan",39.9615,32.5842,8.42857142857143,1.84285714285714,0.00142857142857143,90.8,85.065,82.4266666666667,361,0,0,339,474,488,361,488
2019,52,12,"Sincan",39.9615,32.5842,15.6285714285714,4.9,5.021,81.1142857142857,25.4071428571429,40.2642857142857,279,88,152,165,98,281,191,129
2020,1,12,"Sincan",39.9615,32.5842,15.76,0.84,0.0876,77.8,31.634,42.826,160,0,0,69,45,126,160,126
2020,2,12,"Sincan",39.9615,32.5842,14.7571428571429,0.3,3.26614285714286,79.7285714285714,57.0557142857143,62.5157142857143,240,0,0,166,110,173,240,173
2020,3,12,"Sincan",39.9615,32.5842,11.5428571428571,-1.02857142857143,0.0355714285714286,81.2142857142857,82.6414285714286,61.9771428571429,270,0,0,167,236,382,270,382
2020,4,12,"Sincan",39.9615,32.5842,17.0857142857143,-1.8,0.0165714285714286,71.3571428571429,52.2442857142857,52.638,358,0,0,270,241,295,358,295
2020,5,12,"Sincan",39.9615,32.5842,15.6571428571429,3.25714285714286,1.31242857142857,77.8,62.1185714285714,54.7157142857143,331,0,0,78,96,272,331,272
2020,6,12,"Sincan",39.9615,32.5842,27.6571428571429,3.05714285714286,2.18042857142857,73.6571428571429,27.78,35.9214285714286,343,65,75,61,46,267,278,192
2020,7,12,"Sincan",39.9615,32.5842,14.1571428571429,1.07142857142857,0.882571428571429,73.5285714285714,40.8833333333333,52.3766666666667,341,53,62,31,22,338,288,276
2020,8,12,"Sincan",39.9615,32.5842,12.7571428571429,3.41428571428571,1.52428571428571,69.5571428571428,56.7271428571429,57.2842857142857,283,0,0,34,11,187,283,187
2020,9,12,"Sincan",39.9615,32.5842,19.6571428571429,6.07142857142857,1.31242857142857,62.9,38.6428571428571,43.83,393,74,144,121,139,528,319,384
2020,10,12,"Sincan",39.9615,32.5842,16.4285714285714,8.11428571428571,0.195,61.4857142857143,76.5442857142857,55.154,205,81,50,81,126,210,124,160
2020,11,12,"Sincan",39.9615,32.5842,19.8714285714286,11.7,0.434428571428571,56.0714285714286,68.92,44.11,115,12,7,52,47,94,103,87
2020,12,12,"Sincan",39.9615,32.5842,20.3428571428571,2.82857142857143,0.740142857142857,62.3285714285714,30.7342857142857,28.0642857142857,117,0,0,51,39,118,117,118
2020,13,12,"Sincan",39.9615,32.5842,17.0714285714286,9.91428571428571,1.80171428571429,66.9857142857143,59.49,40.4957142857143,136,0,0,44,25,92,136,92
2020,14,12,"Sincan",39.9615,32.5842,18.1,8.55714285714286,2.32442857142857,71.6714285714286,47.5985714285714,36.5371428571429,155,0,0,8,5,121,155,121
2020,15,12,"Sincan",39.9615,32.5842,27.2428571428571,9.72857142857143,0.126,45.9571428571429,38.2314285714286,23.654,133,0,0,26,22,118,133,118
2020,16,12,"Sincan",39.9615,32.5842,18.0571428571429,11.4428571428571,0.470428571428571,55.1,51.6133333333333,38.4533333333333,141,0,0,40,20,106,141,106
2020,17,12,"Sincan",39.9615,32.5842,17.9142857142857,10.8857142857143,0.087,52.5,33.18,20.87,137,0,0,64,65,123,137,123
2020,18,12,"Sincan",39.9615,32.5842,21.4571428571429,12.5,2.66371428571429,63.8142857142857,58.62,43.78,146,13,14,54,82,164,133,150
2020,19,12,"Sincan",39.9615,32.5842,18.9428571428571,12.1714285714286,1.328,62.7428571428571,NA,NA,137,0,0,84,102,157,137,157
2020,20,12,"Sincan",39.9615,32.5842,17.4857142857143,20.6571428571429,0,46.8142857142857,90.52,NA,164,0,0,85,92,164,164,164
2020,21,12,"Sincan",39.9615,32.5842,25.6142857142857,18.4428571428571,0.345,48.6142857142857,67.6314285714286,12.9466666666667,146,0,0,95,79,96,146,96
2020,22,12,"Sincan",39.9615,32.5842,21.3428571428571,14.1714285714286,4.77871428571429,61.9714285714286,18.9757142857143,19.7928571428571,118,2,5,65,57,100,116,95
2020,23,12,"Sincan",39.9615,32.5842,18.5285714285714,17.8428571428571,0.432,52.8857142857143,29.326,26.806,112,25,17,17,22,70,87,53
2020,24,12,"Sincan",39.9615,32.5842,22.8,19.9285714285714,3.46542857142857,57.2428571428571,39.115,32.8583333333333,140,0,0,110,122,150,140,150
2020,25,12,"Sincan",39.9615,32.5842,20.1714285714286,18.6571428571429,3.24085714285714,70.4142857142857,33.08,35.5783333333333,137,1,0,110,91,108,136,108
2020,26,12,"Sincan",39.9615,32.5842,19.8285714285714,21.5,0.865,58.8714285714286,28.7966666666667,23.9133333333333,173,0,0,49,31,133,173,133
2020,27,12,"Sincan",39.9615,32.5842,17.0714285714286,25.1714285714286,0,43.9142857142857,36.9875,26.48,113,0,0,48,87,113,113,113
2020,28,12,"Sincan",39.9615,32.5842,23.4857142857143,24.7285714285714,0.182285714285714,45.1428571428571,31.828,23.33,164,0,0,45,31,122,164,122
2020,29,12,"Sincan",39.9615,32.5842,20.5285714285714,25.1142857142857,0.0724285714285714,46.4,38.9942857142857,22.6628571428571,186,0,0,93,71,111,186,111
2020,30,12,"Sincan",39.9615,32.5842,22.3,24.9571428571429,0,39.8571428571429,48.5642857142857,23.4842857142857,190,0,0,84,69,142,190,142
2020,31,12,"Sincan",39.9615,32.5842,22.5428571428571,25.9142857142857,0,41.0285714285714,33.53,18.7242857142857,150,0,0,91,95,127,150,127
2020,32,12,"Sincan",39.9615,32.5842,18.7428571428571,26.1142857142857,0,31.5,53.0542857142857,35.4157142857143,146,0,0,9,10,107,146,107
2020,33,12,"Sincan",39.9615,32.5842,21.7285714285714,23.5285714285714,0,40.0857142857143,38.2242857142857,21.6842857142857,183,0,0,52,21,83,183,83
2020,34,12,"Sincan",39.9615,32.5842,19.8428571428571,22.8285714285714,0.0128571428571429,40.5571428571429,51.12,31.5942857142857,197,0,0,85,37,97,197,97
2020,35,12,"Sincan",39.9615,32.5842,14.5285714285714,24.4285714285714,0,34.7714285714286,70.2842857142857,44.59,164,0,0,117,119,157,164,157
2020,36,12,"Sincan",39.9615,32.5842,19.1142857142857,24.8571428571429,0,33.8428571428571,81.6428571428571,45.18,179,26,12,144,99,112,153,100
2020,37,12,"Sincan",39.9615,32.5842,21.3,22.9,0.017,45.8428571428571,77.1014285714286,39.4385714285714,193,0,0,76,33,91,193,91
2020,38,12,"Sincan",39.9615,32.5842,17.8857142857143,22.5285714285714,0.211428571428571,40.8714285714286,59.4257142857143,33.1683333333333,235,0,0,52,32,157,235,157
2020,39,12,"Sincan",39.9615,32.5842,16.4285714285714,19.1285714285714,0.801428571428571,57.2285714285714,63.4871428571429,48.9228571428571,220,0,0,94,35,129,220,129
2020,40,12,"Sincan",39.9615,32.5842,16.1142857142857,17.4428571428571,0.0221428571428571,47.7,65.7385714285714,47.2871428571429,187,0,0,88,55,154,187,154
2020,41,12,"Sincan",39.9615,32.5842,14.8571428571429,18.5571428571429,0.173571428571429,48.7,107.368571428571,46.8471428571429,182,14,7,154,113,127,168,120
2020,42,12,"Sincan",39.9615,32.5842,15.2428571428571,16.1142857142857,1.09542857142857,51.4857142857143,117.658571428571,58.1114285714286,177,17,4,93,79,111,160,107
2020,43,12,"Sincan",39.9615,32.5842,13.9714285714286,14.5285714285714,0.192285714285714,63.5714285714286,60.7342857142857,53.8666666666667,194,6,1,48,77,161,188,160
2020,44,12,"Sincan",39.9615,32.5842,15.3428571428571,12.2,2.46285714285714,65.6,73.94,53.5514285714286,255,0,0,141,128,233,255,233
2020,45,12,"Sincan",39.9615,32.5842,17.3428571428571,8.71428571428571,0.188571428571429,65.8571428571429,43.1757142857143,45.0928571428571,156,0,0,53,38,103,156,103
2020,46,12,"Sincan",39.9615,32.5842,9.47142857142857,6.07142857142857,0,71.2571428571429,86.89,62.4671428571429,208,0,0,85,35,109,208,109
2020,47,12,"Sincan",39.9615,32.5842,13.2285714285714,3.91428571428571,0,66.5,66.5742857142857,58.4985714285714,173,0,0,58,7,83,173,83
2020,48,12,"Sincan",39.9615,32.5842,9.64285714285714,0.7,0,66.5571428571428,92.0814285714286,68.8657142857143,199,0,0,57,145,262,199,262
2020,49,12,"Sincan",39.9615,32.5842,7.45714285714286,3.37142857142857,0.0331428571428571,69.1714285714286,100.701428571429,82.2257142857143,207,2,0,64,34,116,205,116
2020,50,12,"Sincan",39.9615,32.5842,11.3857142857143,5,0.885142857142857,81.9285714285714,67.3485714285714,71.592,181,31,8,54,20,98,150,90
2020,51,12,"Sincan",39.9615,32.5842,10.7428571428571,5.68571428571429,0.765428571428571,80.0142857142857,39.9042857142857,48.805,171,0,0,105,62,90,171,90
2020,52,12,"Sincan",39.9615,32.5842,8.2,2.08571428571429,0.063,75.0428571428571,61.3942857142857,57.6257142857143,203,0,0,57,28,113,203,113
2020,53,12,"Sincan",39.9615,32.5842,7,5.15,1.0635,80.05,61.825,75.5475,122,0,0,48,63,111,122,111
2017,1,13,"Kepez",36.9155,30.7133,24.2857142857143,10.4,2.94785714285714,64.9285714285714,47.33,NA,563,195,301,339,523,847,368,546
2017,2,13,"Kepez",36.9155,30.7133,14.0428571428571,8.04285714285714,8.40685714285714,66.0285714285714,72.13,NA,757,0,0,731,1210,1214,757,1214
2017,3,13,"Kepez",36.9155,30.7133,15.0428571428571,11.4285714285714,5.24985714285714,67.6,51.3571428571429,NA,762,95,101,644,1314,1449,667,1348
2017,4,13,"Kepez",36.9155,30.7133,22.9714285714286,8.02857142857143,0.784,47.2428571428571,55.6842857142857,NA,639,0,0,634,886,889,639,889
2017,5,13,"Kepez",36.9155,30.7133,14.2857142857143,8.95714285714286,0.0668571428571429,51.4714285714286,87.76,NA,588,0,0,487,999,1163,588,1163
2017,6,13,"Kepez",36.9155,30.7133,13.3714285714286,13.6571428571429,0.721142857142857,69.4142857142857,63.5957142857143,NA,736,0,0,534,1129,1519,736,1519
2017,7,13,"Kepez",36.9155,30.7133,20.5571428571429,9.17142857142857,1.25057142857143,38.6142857142857,61.5314285714286,NA,492,0,0,444,669,717,492,717
2017,8,13,"Kepez",36.9155,30.7133,14.3857142857143,12.7857142857143,0.0961428571428572,71.2285714285714,72.1542857142857,NA,739,164,441,320,699,1747,575,1306
2017,9,13,"Kepez",36.9155,30.7133,17.3142857142857,15.1571428571429,0.0188571428571429,55.8857142857143,85.0757142857143,NA,574,0,0,474,770,866,574,866
2017,10,13,"Kepez",36.9155,30.7133,16.7857142857143,12.8571428571429,20.4382857142857,77.2428571428571,44.2314285714286,NA,712,115,149,324,522,1043,597,894
2017,11,13,"Kepez",36.9155,30.7133,17.9285714285714,12.5714285714286,0.487714285714286,51.8571428571429,36.48,NA,525,0,0,348,512,725,525,725
2017,12,13,"Kepez",36.9155,30.7133,13.6142857142857,15.4714285714286,0,63.2857142857143,61.1814285714286,NA,589,78,132,183,331,1077,511,945
2017,13,13,"Kepez",36.9155,30.7133,16.5,15.8857142857143,0.999857142857143,72.5428571428571,44.8228571428571,NA,574,345,511,146,216,887,229,376
2017,14,13,"Kepez",36.9155,30.7133,18.1,17.1142857142857,0.066,57.4428571428571,36.9814285714286,NA,639,261,622,322,616,1336,378,714
2017,15,13,"Kepez",36.9155,30.7133,15.9285714285714,16.2142857142857,5.05971428571429,67.6428571428571,30.3742857142857,NA,587,179,570,316,480,1187,408,617
2017,16,13,"Kepez",36.9155,30.7133,15.7,16.9571428571429,1.34985714285714,73.6428571428571,32.0514285714286,NA,717,429,495,61,69,920,288,425
2017,17,13,"Kepez",36.9155,30.7133,13.8714285714286,19.2714285714286,0,47.6857142857143,54.9028571428571,NA,731,257,496,194,349,1478,474,982
2017,18,13,"Kepez",36.9155,30.7133,16.1142857142857,19.9714285714286,0,74.3714285714286,60.8257142857143,NA,506,474,834,0,0,923,32,89
2017,19,13,"Kepez",36.9155,30.7133,14.7,22.1857142857143,0,66.9714285714286,43.6885714285714,NA,471,264,518,118,289,966,207,448
2017,20,13,"Kepez",36.9155,30.7133,18.0571428571429,22.0571428571429,0.687714285714286,55.7714285714286,30.4457142857143,NA,472,85,215,327,761,1205,387,990
2017,21,13,"Kepez",36.9155,30.7133,17.0285714285714,20.2,6.31871428571429,71.0714285714286,24.1128571428571,NA,448,269,572,76,123,849,179,277
2017,22,13,"Kepez",36.9155,30.7133,15.6142857142857,23.1,1.039,65.4142857142857,28.9771428571429,NA,522,271,671,144,233,1015,251,344
2017,23,13,"Kepez",36.9155,30.7133,15.8714285714286,24.6857142857143,0,70.7142857142857,37.8557142857143,NA,578,394,979,53,188,1388,184,409
2017,24,13,"Kepez",36.9155,30.7133,17.3857142857143,25.1428571428571,0,68.0428571428571,37.49,NA,552,395,820,57,146,1139,157,319
2017,25,13,"Kepez",36.9155,30.7133,18.3285714285714,27.3,0.326,47.3,29.0114285714286,NA,584,0,0,367,651,1041,584,1041
2017,26,13,"Kepez",36.9155,30.7133,15.7142857142857,31.1571428571429,0,53.6714285714286,42.6671428571429,NA,564,280,537,170,226,971,284,434
2017,27,13,"Kepez",36.9155,30.7133,16.4857142857143,30.3857142857143,0,49.4142857142857,43.3742857142857,NA,511,319,445,115,100,642,192,197
2017,28,13,"Kepez",36.9155,30.7133,16.5142857142857,30.5285714285714,0,55.5,47.3657142857143,NA,481,360,595,0,0,864,121,269
2017,29,13,"Kepez",36.9155,30.7133,15.8857142857143,28.9285714285714,0,69.6285714285714,47.0057142857143,NA,532,444,1004,0,0,1272,88,268
2017,30,13,"Kepez",36.9155,30.7133,17.3,29.9285714285714,0.0384285714285714,58.3428571428571,41.8485714285714,NA,531,181,347,170,249,928,350,581
2017,31,13,"Kepez",36.9155,30.7133,15.6142857142857,29.4714285714286,0.0948571428571429,56.7857142857143,40.3785714285714,NA,559,178,353,168,272,1047,381,694
2017,32,13,"Kepez",36.9155,30.7133,14.3714285714286,28.7714285714286,0,76.3428571428571,48.5557142857143,NA,567,567,1092,0,0,1092,0,0
2017,33,13,"Kepez",36.9155,30.7133,16.9428571428571,28.3571428571429,0,70.1428571428571,49.5428571428571,NA,596,596,1199,0,0,1199,0,0
2017,34,13,"Kepez",36.9155,30.7133,17.3285714285714,30,0.0192857142857143,48.4571428571429,39.2985714285714,NA,601,252,622,349,658,1280,349,658
2017,35,13,"Kepez",36.9155,30.7133,16.7857142857143,28.2142857142857,0.077,58.2142857142857,39.8757142857143,NA,493,360,824,0,0,1014,133,190
2017,36,13,"Kepez",36.9155,30.7133,16.6285714285714,27.2571428571429,0,51.9857142857143,43.4657142857143,NA,507,318,893,131,318,1321,189,428
2017,37,13,"Kepez",36.9155,30.7133,13.6,26.5142857142857,0,71.3857142857143,56.0171428571429,NA,589,485,944,0,0,1138,104,194
2017,38,13,"Kepez",36.9155,30.7133,15.9428571428571,26.5285714285714,0,64.8571428571429,49.7485714285714,NA,671,280,463,183,413,1312,391,849
2017,39,13,"Kepez",36.9155,30.7133,15.6571428571429,24.0714285714286,1.73642857142857,68.0714285714286,46.9457142857143,NA,782,285,654,129,244,1630,497,976
2017,40,13,"Kepez",36.9155,30.7133,15.8714285714286,22.7,1.82171428571429,54.5285714285714,34.6157142857143,NA,543,22,45,286,630,1137,521,1092
2017,41,13,"Kepez",36.9155,30.7133,14.7714285714286,22.2428571428571,0,42.1285714285714,36.7771428571429,NA,487,0,0,399,773,843,487,843
2017,42,13,"Kepez",36.9155,30.7133,13.4857142857143,22.1857142857143,0,45.3,48.4071428571429,NA,530,0,0,459,684,815,530,815
2017,43,13,"Kepez",36.9155,30.7133,15.3714285714286,19.2428571428571,5.97385714285714,72.9285714285714,36.1342857142857,NA,506,181,255,226,555,919,325,664
2017,44,13,"Kepez",36.9155,30.7133,15.3428571428571,16.8428571428571,5.21585714285714,53.8571428571429,36.3457142857143,NA,561,0,0,493,927,1102,561,1102
2017,45,13,"Kepez",36.9155,30.7133,10.5285714285714,16.8428571428571,0,60.8285714285714,63.1157142857143,NA,577,0,0,562,826,829,577,829
2017,46,13,"Kepez",36.9155,30.7133,10.8285714285714,17.2714285714286,1.35157142857143,69.9142857142857,102.321428571429,NA,587,0,0,454,902,1085,587,1085
2017,47,13,"Kepez",36.9155,30.7133,17.1285714285714,14,1.98371428571429,56.2,47.26,NA,418,0,0,415,804,804,418,804
2017,48,13,"Kepez",36.9155,30.7133,10.5857142857143,14.5428571428571,3.07885714285714,75.4142857142857,73.28,NA,386,0,0,345,568,619,386,619
2017,49,13,"Kepez",36.9155,30.7133,18.6857142857143,11.7714285714286,0.307285714285714,58.7285714285714,77.9528571428571,NA,407,0,0,394,635,645,407,645
2017,50,13,"Kepez",36.9155,30.7133,11.3714285714286,14.5,1.86,74.6428571428571,88.7042857142857,NA,346,47,41,292,391,442,299,401
2017,51,13,"Kepez",36.9155,30.7133,20.3142857142857,14.9285714285714,3.33257142857143,74.2857142857143,65.5514285714286,NA,386,58,40,244,200,349,328,309
2017,52,13,"Kepez",36.9155,30.7133,13.3875,11.275,4.837875,72.575,73.63,NA,528,30,46,458,439,507,498,461
2018,1,13,"Kepez",36.9155,30.7133,15.55,12.6125,6.95125,61.9875,43.8171428571429,NA,618,95,166,494,661,914,523,748
2018,2,13,"Kepez",36.9155,30.7133,11.3428571428571,12.0571428571429,11.9508571428571,81.8285714285714,78.0633333333333,NA,624,0,0,620,1309,1309,624,1309
2018,3,13,"Kepez",36.9155,30.7133,21.7714285714286,11.8857142857143,0.506142857142857,58.2571428571429,48.5842857142857,NA,639,15,10,533,514,655,624,645
2018,4,13,"Kepez",36.9155,30.7133,25.4428571428571,11.5857142857143,3.89971428571429,51.2285714285714,29.9857142857143,NA,604,59,135,518,595,764,545,629
2018,5,13,"Kepez",36.9155,30.7133,11.6,13.0142857142857,0.0282857142857143,70.4428571428571,71.0242857142857,NA,670,3,0,374,379,819,667,819
2018,6,13,"Kepez",36.9155,30.7133,14.1,15.1142857142857,0.519142857142857,82.1,94.4871428571429,NA,704,85,74,513,662,1022,619,948
2018,7,13,"Kepez",36.9155,30.7133,19,14.4285714285714,4.354,62.8571428571429,35.5042857142857,NA,478,4,10,413,464,557,474,547
2018,8,13,"Kepez",36.9155,30.7133,14.3714285714286,13.1142857142857,7.231,83.9285714285714,31.74,NA,711,103,221,375,439,1321,608,1100
2018,9,13,"Kepez",36.9155,30.7133,18.3285714285714,13.7,5.933,72.4571428571429,35.4028571428571,NA,621,188,250,257,379,956,433,706
2018,10,13,"Kepez",36.9155,30.7133,15.1571428571429,16.2285714285714,0.372,71.3285714285714,71.9642857142857,NA,556,97,346,176,343,1330,459,984
2018,11,13,"Kepez",36.9155,30.7133,16.5428571428571,14.9857142857143,0.899,73.1285714285714,45.4428571428571,NA,551,143,279,88,446,1426,408,1147
2018,12,13,"Kepez",36.9155,30.7133,17.2857142857143,16.5714285714286,0.0192857142857143,67.0428571428571,57.8214285714286,NA,425,179,609,96,231,1187,246,578
2018,13,13,"Kepez",36.9155,30.7133,15.9142857142857,15.4285714285714,18.2338571428571,65.2285714285714,97.0925,NA,356,127,117,110,171,428,229,311
2018,14,13,"Kepez",36.9155,30.7133,13.1285714285714,17.0571428571429,0.0961428571428571,57.2,42.6983333333333,NA,407,112,225,118,90,486,295,261
2018,15,13,"Kepez",36.9155,30.7133,14.1,18.4714285714286,0,75.3428571428571,47.0916666666667,NA,374,246,237,116,206,450,128,213
2018,16,13,"Kepez",36.9155,30.7133,17.4142857142857,19.9,0,50,49.3757142857143,NA,411,183,326,112,146,648,228,322
2018,17,13,"Kepez",36.9155,30.7133,14.5857142857143,22.1285714285714,0,52.9428571428571,49.3042857142857,NA,419,195,282,224,370,652,224,370
2018,18,13,"Kepez",36.9155,30.7133,15.1571428571429,23.4,0.673428571428571,58,67.6514285714286,NA,303,149,233,79,164,474,154,241
2018,19,13,"Kepez",36.9155,30.7133,18.3857142857143,20.8,3.13042857142857,63.7714285714286,34.1871428571429,NA,275,77,236,123,156,467,198,231
2018,20,13,"Kepez",36.9155,30.7133,13.3714285714286,24.6,0,56.8857142857143,48.8985714285714,NA,204,108,151,35,40,306,96,155
2018,21,13,"Kepez",36.9155,30.7133,15.6428571428571,24.5,1.13528571428571,64.3142857142857,58.3285714285714,NA,252,197,235,0,0,281,55,46
2018,22,13,"Kepez",36.9155,30.7133,17.3428571428571,24.2,0.0577142857142857,62.3285714285714,33.6628571428571,NA,249,183,347,35,32,427,66,80
2018,23,13,"Kepez",36.9155,30.7133,18.8,26.8428571428571,0,58.7428571428571,47.4785714285714,NA,267,169,529,37,51,812,98,283
2018,24,13,"Kepez",36.9155,30.7133,16,25.1857142857143,5.72571428571429,72.0571428571429,34.1157142857143,NA,267,207,259,23,21,448,60,189
2018,25,13,"Kepez",36.9155,30.7133,17.2428571428571,25.2571428571429,0.0192857142857143,65.1428571428571,28.8975,NA,358,325,454,0,0,518,33,64
2018,26,13,"Kepez",36.9155,30.7133,16.9857142857143,25.6,0,71.5714285714286,35.37,NA,355,271,468,0,0,587,84,119
2018,27,13,"Kepez",36.9155,30.7133,18.1857142857143,30.8428571428571,0,46.4428571428571,38.03,NA,342,95,129,162,171,418,247,289
2018,28,13,"Kepez",36.9155,30.7133,16.4714285714286,29.3857142857143,0,59.5714285714286,39.4328571428571,NA,286,191,425,57,115,585,95,160
2018,29,13,"Kepez",36.9155,30.7133,18.4857142857143,29.7428571428571,0,56.0428571428571,42.4014285714286,NA,260,119,269,119,451,756,141,487
2018,30,13,"Kepez",36.9155,30.7133,19.1428571428571,28.3428571428571,0.392571428571429,64.7571428571429,39.3457142857143,NA,265,223,740,31,62,822,42,82
2018,31,13,"Kepez",36.9155,30.7133,17.5857142857143,29.1142857142857,0,70.6142857142857,42.9714285714286,NA,267,229,465,0,0,499,38,34
2018,32,13,"Kepez",36.9155,30.7133,16.9714285714286,31.2,0,41.1285714285714,37.4785714285714,NA,297,73,120,224,283,403,224,283
2018,33,13,"Kepez",36.9155,30.7133,15.3714285714286,28.7428571428571,0,56.6714285714286,42.446,NA,216,134,231,75,91,332,82,101
2018,34,13,"Kepez",36.9155,30.7133,14.7714285714286,28.1571428571429,0,73.6428571428571,42.2214285714286,NA,144,144,227,0,0,227,0,0
2018,35,13,"Kepez",36.9155,30.7133,15.4142857142857,28.3714285714286,0,66.9142857142857,43.4642857142857,NA,201,165,275,0,0,314,36,39
2018,36,13,"Kepez",36.9155,30.7133,17.4857142857143,28.7428571428571,0,55.0571428571429,46.14,NA,341,126,124,61,85,370,215,246
2018,37,13,"Kepez",36.9155,30.7133,18.4571428571429,26.8857142857143,0.112,49.0428571428571,33.2271428571429,NA,241,43,106,114,163,419,198,313
2018,38,13,"Kepez",36.9155,30.7133,19.7571428571429,27.6857142857143,0,44.2142857142857,39.8166666666667,NA,189,28,53,107,220,344,161,291
2018,39,13,"Kepez",36.9155,30.7133,17.1857142857143,25.1,1.67914285714286,59.4142857142857,44.1714285714286,NA,180,76,158,77,133,353,104,195
2018,40,13,"Kepez",36.9155,30.7133,17.9571428571429,24.5285714285714,0,47.9857142857143,31.7257142857143,NA,191,28,47,91,185,341,163,294
2018,41,13,"Kepez",36.9155,30.7133,12.9857142857143,23.1428571428571,0.553285714285714,48.5857142857143,40.5971428571429,NA,187,0,0,144,346,422,187,422
2018,42,13,"Kepez",36.9155,30.7133,12.4714285714286,23.1571428571429,0.140428571428571,55.3571428571429,105.172857142857,NA,168,0,0,114,280,381,168,381
2018,43,13,"Kepez",36.9155,30.7133,19.8857142857143,19.0571428571429,0.746142857142857,54.8285714285714,35.4314285714286,NA,187,0,0,163,334,402,187,402
2018,44,13,"Kepez",36.9155,30.7133,10.3714285714286,19.7714285714286,0,45.7,65.2714285714286,NA,196,0,0,181,216,264,196,264
2018,45,13,"Kepez",36.9155,30.7133,12.8857142857143,19.0428571428571,1.77828571428571,47.3571428571429,45.2542857142857,NA,231,0,0,224,460,473,231,473
2018,46,13,"Kepez",36.9155,30.7133,16.6714285714286,16.1714285714286,1.532,45.7571428571429,37.9571428571429,NA,230,0,0,230,465,465,230,465
2018,47,13,"Kepez",36.9155,30.7133,12.5714285714286,16.4285714285714,3.33057142857143,68.7142857142857,51.5957142857143,NA,270,0,0,269,499,499,270,499
2018,48,13,"Kepez",36.9155,30.7133,14.3,15.4714285714286,5.14114285714286,79.9,36.4414285714286,NA,245,40,50,164,136,201,205,151
2018,49,13,"Kepez",36.9155,30.7133,15.3428571428571,13.0857142857143,8.47428571428572,70.5857142857143,29.8428571428571,NA,257,0,0,257,420,420,257,420
2018,50,13,"Kepez",36.9155,30.7133,19.0285714285714,12.6428571428571,14.8327142857143,68.5142857142857,31.8642857142857,NA,256,33,20,223,285,305,223,285
2018,51,13,"Kepez",36.9155,30.7133,12.7714285714286,12.2571428571429,12.9402857142857,73.2857142857143,54.6757142857143,NA,250,0,0,250,248,248,250,248
2018,52,13,"Kepez",36.9155,30.7133,22.0142857142857,11.0857142857143,1.13214285714286,47.1,35.8428571428571,NA,244,0,0,204,226,273,244,273
2019,1,13,"Kepez",36.9155,30.7133,19.3125,10.325,27.085875,77.2375,33.31125,39.165,343,49,284,294,500,784,294,500
2019,2,13,"Kepez",36.9155,30.7133,15.4285714285714,8.15714285714286,4.17985714285714,68.8142857142857,36.3114285714286,NA,255,0,0,242,197,208,255,208
2019,3,13,"Kepez",36.9155,30.7133,20.5428571428571,9.98571428571429,5.50385714285714,63.7,46.2257142857143,NA,192,0,0,162,186,198,192,198
2019,4,13,"Kepez",36.9155,30.7133,27.7857142857143,11.8857142857143,26.9904285714286,81.7285714285714,63.6357142857143,NA,308,116,161,146,127,314,192,153
2019,5,13,"Kepez",36.9155,30.7133,14.4571428571429,11.3142857142857,7.38485714285714,74.1,42.3857142857143,NA,253,0,0,217,134,143,253,143
2019,6,13,"Kepez",36.9155,30.7133,22.4428571428571,12.3571428571429,3.86385714285714,70.1285714285714,52.2971428571429,NA,276,87,26,155,92,127,189,101
2019,7,13,"Kepez",36.9155,30.7133,12.9857142857143,12.4428571428571,1.325,62.5285714285714,33.4271428571429,NA,325,0,0,289,209,234,325,234
2019,8,13,"Kepez",36.9155,30.7133,14.7571428571429,12.5142857142857,4.35857142857143,69.7285714285714,44.195,NA,305,0,0,221,141,219,305,219
2019,9,13,"Kepez",36.9155,30.7133,19.7285714285714,12.1571428571429,3.41028571428571,58.6857142857143,37.5314285714286,NA,331,0,0,288,219,310,331,310
2019,10,13,"Kepez",36.9155,30.7133,13.1714285714286,13.2,3.491,67.2285714285714,49.0757142857143,NA,359,1,0,249,127,252,358,252
2019,11,13,"Kepez",36.9155,30.7133,20.8285714285714,14.3428571428571,6.27614285714286,70.8571428571429,28.3171428571429,NA,373,107,60,147,245,400,266,340
2019,12,13,"Kepez",36.9155,30.7133,15.4142857142857,16.2285714285714,0,56.0714285714286,41.6314285714286,NA,343,44,268,253,114,416,299,148
2019,13,13,"Kepez",36.9155,30.7133,16.6428571428571,14.2,1.404,57,25.6771428571429,NA,256,7,1,126,64,194,249,193
2019,14,13,"Kepez",36.9155,30.7133,11.5571428571429,14.7857142857143,0.690857142857143,70.3,31.1385714285714,NA,365,103,84,106,49,208,262,124
2019,15,13,"Kepez",36.9155,30.7133,18.7,16.6285714285714,0.809857142857143,70.8571428571429,27.195,NA,359,196,122,107,46,183,163,61
2019,16,13,"Kepez",36.9155,30.7133,21.8285714285714,15.3285714285714,2.45457142857143,51.1,15.1185714285714,NA,318,0,0,254,162,208,318,208
2019,17,13,"Kepez",36.9155,30.7133,14.6714285714286,17.7142857142857,0.283857142857143,58.3857142857143,18.925,NA,412,199,170,37,10,313,213,143
2019,18,13,"Kepez",36.9155,30.7133,14.6142857142857,18.8714285714286,0.478714285714286,66.2571428571429,38.68,NA,523,242,204,101,37,353,281,149
2019,19,13,"Kepez",36.9155,30.7133,18.3857142857143,18.5142857142857,0.0577142857142857,61.7857142857143,24.7014285714286,NA,452,61,78,78,72,386,391,308
2019,20,13,"Kepez",36.9155,30.7133,13.8714285714286,22.9,0.276428571428571,51.0857142857143,36.9385714285714,NA,454,57,48,75,59,389,397,341
2019,21,13,"Kepez",36.9155,30.7133,14.7285714285714,22.7,0,69.2571428571429,42.3057142857143,NA,457,177,197,72,32,413,280,216
2019,22,13,"Kepez",36.9155,30.7133,12.7714285714286,25.5428571428571,0,60,50.6414285714286,NA,453,453,323,0,0,323,0,0
2019,23,13,"Kepez",36.9155,30.7133,14.9428571428571,24.3,0,58.3571428571429,37.2271428571429,NA,378,269,371,59,121,532,109,161
2019,24,13,"Kepez",36.9155,30.7133,19.2,25.4142857142857,0.974142857142857,64.5428571428571,31.33,NA,378,163,98,49,11,244,215,146
2019,25,13,"Kepez",36.9155,30.7133,16.2571428571429,25.8285714285714,0.836857142857143,66.8571428571429,28.7642857142857,NA,306,234,260,0,0,325,72,65
2019,26,13,"Kepez",36.9155,30.7133,16.4142857142857,29.7428571428571,1.04371428571429,50.2714285714286,31.8871428571429,NA,377,48,24,127,48,342,329,318
2019,27,13,"Kepez",36.9155,30.7133,16.9,29.3,0,41.8714285714286,33.4085714285714,NA,456,9,15,81,44,222,447,207
2019,28,13,"Kepez",36.9155,30.7133,17.1142857142857,28.8285714285714,0,55.0571428571429,38.5314285714286,NA,398,133,161,0,0,421,265,260
2019,29,13,"Kepez",36.9155,30.7133,17.6857142857143,27.5428571428571,0.00928571428571429,57.4142857142857,26.49,NA,453,235,95,7,2,203,218,108
2019,30,13,"Kepez",36.9155,30.7133,17.3285714285714,30.3285714285714,0,44.2571428571429,33.39,NA,456,73,22,56,80,335,383,313
2019,31,13,"Kepez",36.9155,30.7133,14.7285714285714,27.8714285714286,0,76.9857142857143,38.2485714285714,NA,334,329,371,0,0,375,5,4
2019,32,13,"Kepez",36.9155,30.7133,16.3857142857143,31.0142857142857,0,39.4,34.3757142857143,NA,346,10,3,94,83,395,336,392
2019,33,13,"Kepez",36.9155,30.7133,16.1285714285714,29.1714285714286,0.0574285714285714,59.7,29.5242857142857,NA,337,195,321,55,131,531,142,210
2019,34,13,"Kepez",36.9155,30.7133,17.3142857142857,30.4428571428571,0,42.0714285714286,25.4342857142857,NA,299,0,0,63,49,345,299,345
2019,35,13,"Kepez",36.9155,30.7133,16.1428571428571,30.4714285714286,0,47.3142857142857,34.3728571428571,NA,307,71,109,5,10,415,236,306
2019,36,13,"Kepez",36.9155,30.7133,15.8285714285714,27.4571428571429,0,64.5142857142857,36.39,NA,171,171,67,0,0,67,0,0
2019,37,13,"Kepez",36.9155,30.7133,16.6,28.1714285714286,0.077,51.1285714285714,36.5028571428571,NA,218,124,28,54,20,55,94,27
2019,38,13,"Kepez",36.9155,30.7133,16.7285714285714,26.0714285714286,0,44.1142857142857,31.1371428571429,NA,266,164,61,102,30,91,102,30
2019,39,13,"Kepez",36.9155,30.7133,13.7,24.6857142857143,1.66871428571429,61.6714285714286,29.9871428571429,NA,237,84,37,49,10,79,153,42
2019,40,13,"Kepez",36.9155,30.7133,13.9571428571429,23.8142857142857,0.133571428571429,68.5571428571429,34.9271428571429,NA,241,83,39,62,30,111,158,72
2019,41,13,"Kepez",36.9155,30.7133,12.8714285714286,25.0142857142857,0,48.3571428571429,31.1385714285714,NA,416,1,1,260,321,448,415,447
2019,42,13,"Kepez",36.9155,30.7133,13.8428571428571,24.3,1.87957142857143,52.3,40.0442857142857,NA,356,0,0,244,334,408,356,408
2019,43,13,"Kepez",36.9155,30.7133,12.5142857142857,23.5428571428571,0,43.6571428571429,31.9133333333333,NA,306,0,0,257,231,300,306,300
2019,44,13,"Kepez",36.9155,30.7133,13.4571428571429,19.7428571428571,0.245428571428571,62,32.0657142857143,49.01,350,0,0,150,94,250,350,250
2019,45,13,"Kepez",36.9155,30.7133,9.92857142857143,20.0857142857143,0,53.7428571428571,53.6057142857143,68.4228571428571,417,0,0,355,305,328,417,328
2019,46,13,"Kepez",36.9155,30.7133,10.9571428571429,19.2142857142857,4.999,50.7142857142857,56.0114285714286,74.31,401,0,0,401,337,337,401,337
2019,47,13,"Kepez",36.9155,30.7133,8.15714285714286,16.4428571428571,0.292428571428571,61.7,60.67,67.3257142857143,391,0,0,384,336,339,391,339
2019,48,13,"Kepez",36.9155,30.7133,17.1714285714286,16.1285714285714,8.19314285714286,77.2857142857143,44.7985714285714,46.9642857142857,320,0,0,304,238,251,320,251
2019,49,13,"Kepez",36.9155,30.7133,13.8142857142857,13.1857142857143,0,43.3428571428571,52.8028571428571,46.16,393,0,0,393,274,274,393,274
2019,50,13,"Kepez",36.9155,30.7133,14.0285714285714,12.7285714285714,21.3334285714286,82.5428571428571,45.9971428571429,41.39,218,5,3,190,116,119,213,116
2019,51,13,"Kepez",36.9155,30.7133,9.65714285714286,13.5142857142857,0,69.4571428571429,127.672857142857,61.4771428571429,361,0,0,358,481,488,361,488
2019,52,13,"Kepez",36.9155,30.7133,18.1142857142857,12.7571428571429,5.50057142857143,63.1714285714286,38.0585714285714,32.2271428571429,279,49,66,230,215,281,230,215
2020,1,13,"Kepez",36.9155,30.7133,14.9,11.1,0.321,48.64,42.156,32.026,160,0,0,160,126,126,160,126
2020,2,13,"Kepez",36.9155,30.7133,19.7285714285714,10.8857142857143,10.9585714285714,57.2285714285714,46.9028571428571,38.6042857142857,240,15,22,223,150,173,225,151
2020,3,13,"Kepez",36.9155,30.7133,13.2142857142857,11.8428571428571,0.0467142857142857,47.8571428571429,70.32,46.9228571428571,270,0,0,270,382,382,270,382
2020,4,13,"Kepez",36.9155,30.7133,25.6285714285714,10.0285714285714,0,30.3857142857143,45.9771428571429,34.4785714285714,358,0,0,358,295,295,358,295
2020,5,13,"Kepez",36.9155,30.7133,14.7857142857143,11.8,0.0574285714285714,59.7428571428571,65.2214285714286,44.9371428571429,331,0,0,323,266,272,331,272
2020,6,13,"Kepez",36.9155,30.7133,29.2142857142857,11.1,2.552,60.1857142857143,31.7214285714286,24.9642857142857,343,121,123,142,109,267,222,144
2020,7,13,"Kepez",36.9155,30.7133,13.1142857142857,10.4571428571429,5.07142857142857,75.8714285714286,43.0742857142857,38.1471428571429,341,0,0,316,326,338,341,338
2020,8,13,"Kepez",36.9155,30.7133,13.9714285714286,12.4571428571429,2.29771428571429,59.5285714285714,45.4628571428571,43.6828571428571,283,0,0,271,175,187,283,187
2020,9,13,"Kepez",36.9155,30.7133,23.5857142857143,13.9142857142857,3.67014285714286,60.8428571428571,37.038,41.23,393,130,224,262,304,528,263,304
2020,10,13,"Kepez",36.9155,30.7133,13.0571428571429,13.8428571428571,1.05242857142857,68.5857142857143,59.7528571428571,53.365,205,0,0,127,116,210,205,210
2020,11,13,"Kepez",36.9155,30.7133,19.1857142857143,16.6285714285714,0.0752857142857143,62.5714285714286,46.9071428571429,40.385,115,55,29,48,65,94,60,65
2020,12,13,"Kepez",36.9155,30.7133,23.0285714285714,12.2285714285714,5.70857142857143,43.1,23.082,NA,117,0,0,96,102,118,117,118
2020,13,13,"Kepez",36.9155,30.7133,13.1428571428571,15.0857142857143,0.897285714285714,67.8428571428571,41.7128571428571,NA,136,2,1,33,27,92,134,91
2020,14,13,"Kepez",36.9155,30.7133,17.9428571428571,15.7857142857143,0.256,61.6,30.5728571428571,NA,155,51,39,66,56,121,104,82
2020,15,13,"Kepez",36.9155,30.7133,20.3857142857143,16.2857142857143,0.737714285714286,70.1428571428571,40.3185714285714,NA,133,67,29,45,76,118,66,89
2020,16,13,"Kepez",36.9155,30.7133,18.7714285714286,17.5857142857143,0,61.7571428571429,33.2642857142857,NA,141,46,24,45,45,106,95,82
2020,17,13,"Kepez",36.9155,30.7133,20.8,17.2714285714286,1.453,72.1714285714286,30.4357142857143,NA,137,67,70,40,41,123,70,53
2020,18,13,"Kepez",36.9155,30.7133,21.0285714285714,17.5,2.48128571428571,74.3142857142857,30.41,NA,146,114,131,0,0,164,32,33
2020,19,13,"Kepez",36.9155,30.7133,25.1142857142857,19.0142857142857,1.64228571428571,67.2428571428571,22.86,NA,137,6,26,94,104,157,131,131
2020,20,13,"Kepez",36.9155,30.7133,16.3857142857143,24.3428571428571,0,58.7285714285714,52.0357142857143,NA,164,91,86,71,76,164,73,78
2020,21,13,"Kepez",36.9155,30.7133,27.5142857142857,26.1428571428571,1.822,40.2428571428571,62.47,NA,146,2,2,97,76,96,144,94
2020,22,13,"Kepez",36.9155,30.7133,23.9714285714286,19.8571428571429,1.00585714285714,63.3285714285714,22.1314285714286,NA,118,63,38,18,6,100,55,62
2020,23,13,"Kepez",36.9155,30.7133,18.3714285714286,20.7428571428571,0.478142857142857,60.5428571428571,31.6833333333333,NA,112,58,34,38,18,70,54,36
2020,24,13,"Kepez",36.9155,30.7133,14.1,22.3714285714286,0,68.5285714285714,43.5557142857143,NA,140,70,77,0,0,150,70,73
2020,25,13,"Kepez",36.9155,30.7133,17.5,24.9428571428571,0,60.0142857142857,38.79,NA,137,74,33,41,41,108,63,75
2020,26,13,"Kepez",36.9155,30.7133,17.6285714285714,26.7857142857143,0,55.8142857142857,40.0685714285714,NA,173,88,63,20,16,133,85,70
2020,27,13,"Kepez",36.9155,30.7133,14.6142857142857,29.2285714285714,0,55.3142857142857,48.7542857142857,NA,113,28,40,9,2,113,85,73
2020,28,13,"Kepez",36.9155,30.7133,14.5714285714286,28.7857142857143,0,63.1285714285714,46.3414285714286,NA,164,86,45,0,0,122,78,77
2020,29,13,"Kepez",36.9155,30.7133,15.7428571428571,28.0428571428571,0,71.6571428571429,46.44,NA,186,160,93,0,0,111,26,18
2020,30,13,"Kepez",36.9155,30.7133,16.0857142857143,30.7285714285714,0,47.0571428571429,44.5214285714286,NA,190,46,25,78,79,142,144,117
2020,31,13,"Kepez",36.9155,30.7133,16.0428571428571,29.5571428571429,0,68.2142857142857,57.3085714285714,NA,150,142,114,0,0,127,8,13
2020,32,13,"Kepez",36.9155,30.7133,16.4571428571429,29.8285714285714,0,57.6571428571429,49.0028571428571,NA,146,59,24,0,0,107,87,83
2020,33,13,"Kepez",36.9155,30.7133,16.5,30.1857142857143,0,46.8142857142857,41.7242857142857,NA,183,81,40,45,22,83,102,43
2020,34,13,"Kepez",36.9155,30.7133,18.3285714285714,30.0857142857143,0,44.6142857142857,44.2985714285714,16.505,197,59,24,41,16,97,138,73
2020,35,13,"Kepez",36.9155,30.7133,13.8571428571429,28.9857142857143,0.00928571428571429,54.9428571428571,48.2414285714286,32.8542857142857,164,6,3,0,0,157,158,154
2020,36,13,"Kepez",36.9155,30.7133,14.6,29.4142857142857,0,52.2142857142857,62.1442857142857,43.3242857142857,179,55,31,23,16,112,124,81
2020,37,13,"Kepez",36.9155,30.7133,14.3,29.9,0,48.5142857142857,45.9757142857143,30.8871428571429,193,89,40,48,15,91,104,51
2020,38,13,"Kepez",36.9155,30.7133,13.6428571428571,28.6571428571429,0,58.7714285714286,53.7885714285714,27.0014285714286,235,32,37,74,49,157,203,120
2020,39,13,"Kepez",36.9155,30.7133,15.5857142857143,26.7428571428571,0.0285714285714286,62.0142857142857,41.4742857142857,24.8085714285714,220,89,24,0,0,129,131,105
2020,40,13,"Kepez",36.9155,30.7133,14.8,26.3714285714286,0.0467142857142857,46.8142857142857,45.9183333333333,28.2016666666667,187,35,32,91,84,154,152,122
2020,41,13,"Kepez",36.9155,30.7133,13.5428571428571,25.6714285714286,0,54.8714285714286,64.1057142857143,35.95,182,8,7,8,1,127,174,120
2020,42,13,"Kepez",36.9155,30.7133,12.5285714285714,22.9857142857143,0,64.9,44.0671428571429,32.3357142857143,177,9,10,15,9,111,168,101
2020,43,13,"Kepez",36.9155,30.7133,11.8142857142857,22.9428571428571,2.25728571428571,55.2571428571429,48.7271428571429,38.4257142857143,194,0,0,160,136,161,194,161
2020,44,13,"Kepez",36.9155,30.7133,13.2571428571429,21.6857142857143,1.76057142857143,56.6714285714286,49.21,35.9316666666667,255,23,11,160,195,233,232,222
2020,45,13,"Kepez",36.9155,30.7133,18.4142857142857,20.3714285714286,0.0467142857142857,34.7,28.3314285714286,20.936,156,0,0,152,99,103,156,103
2020,46,13,"Kepez",36.9155,30.7133,12.1428571428571,19.3285714285714,0.0664285714285714,45.4285714285714,43.3128571428571,44.0928571428571,208,0,0,157,84,109,208,109
2020,47,13,"Kepez",36.9155,30.7133,11.9571428571429,15.9428571428571,4.04842857142857,55.6714285714286,39.9442857142857,40.7842857142857,173,0,0,171,81,83,173,83
2020,48,13,"Kepez",36.9155,30.7133,12.6142857142857,15.1,0,35.2571428571429,52.4866666666667,48.692,199,0,0,199,262,262,199,262
2020,49,13,"Kepez",36.9155,30.7133,9.55714285714286,14.3142857142857,4.53171428571429,74.4428571428571,61.81,38.2628571428571,207,0,0,206,116,116,207,116
2020,50,13,"Kepez",36.9155,30.7133,9.68571428571429,14.3428571428571,18.8954285714286,81.9285714285714,33.2116666666667,32.9528571428571,181,0,0,149,83,98,181,98
2020,51,13,"Kepez",36.9155,30.7133,14.9,14.0428571428571,23.052,64.9714285714286,37.6585714285714,34.9042857142857,171,0,0,158,84,90,171,90
2020,52,13,"Kepez",36.9155,30.7133,12.5285714285714,13.2857142857143,0.295,60.4285714285714,56.1975,45.966,203,0,0,203,113,113,203,113
2020,53,13,"Kepez",36.9155,30.7133,10.275,12.95,23.25025,86.325,43.8725,57.37,122,0,0,122,111,111,122,111
2017,1,14,"Ardahan",41.1105,42.7022,6.91428571428571,-18.2714285714286,0.000142857142857143,76.6714285714286,90.4971428571429,74.0685714285714,563,0,0,315,520,847,563,847
2017,2,14,"Ardahan",41.1105,42.7022,9.48571428571429,-14.6428571428571,48.5315714285714,76.3428571428571,45.4385714285714,53.4357142857143,757,0,0,367,530,1214,757,1214
2017,3,14,"Ardahan",41.1105,42.7022,7.74285714285714,-12.1857142857143,64.3514285714286,75.5285714285714,59.86,62.8928571428571,762,0,0,193,485,1449,762,1449
2017,4,14,"Ardahan",41.1105,42.7022,18.0571428571429,-12.4,21.9575714285714,74.4142857142857,25.8757142857143,37.7014285714286,639,0,0,203,321,889,639,889
2017,5,14,"Ardahan",41.1105,42.7022,16.6285714285714,-11.7,1.64142857142857,68.5571428571429,19.4,35.15,588,0,0,197,510,1163,588,1163
2017,6,14,"Ardahan",41.1105,42.7022,9.9,-12.8428571428571,27.1247142857143,77.6,53.8785714285714,60.3171428571429,736,105,297,182,326,1519,631,1222
2017,7,14,"Ardahan",41.1105,42.7022,10.1142857142857,-17.2285714285714,0.714428571428571,71.1857142857143,42.2371428571429,44.7028571428571,492,139,212,135,160,717,353,505
2017,8,14,"Ardahan",41.1105,42.7022,13.5428571428571,-10.4714285714286,0.144,69.5714285714286,46.3128571428571,58.1314285714286,739,0,0,465,1071,1747,739,1747
2017,9,14,"Ardahan",41.1105,42.7022,10.4571428571429,-3.75714285714286,0,78.3857142857143,34.8185714285714,46.2385714285714,574,86,154,3,0,866,488,712
2017,10,14,"Ardahan",41.1105,42.7022,11.1857142857143,-1.91428571428571,0.123142857142857,76.6,24.9842857142857,32.66,712,66,72,5,18,1043,646,971
2017,11,14,"Ardahan",41.1105,42.7022,14.5428571428571,-0.414285714285714,1.43714285714286,73.2714285714286,11.2928571428571,18.11,525,0,0,134,161,725,525,725
2017,12,14,"Ardahan",41.1105,42.7022,13.0428571428571,-2.42857142857143,0.185,65.3142857142857,14.2057142857143,16.155,589,0,0,1,0,1077,589,1077
2017,13,14,"Ardahan",41.1105,42.7022,22.2857142857143,2.37142857142857,0.114857142857143,62.8428571428571,14.0042857142857,15.9457142857143,574,0,0,177,250,887,574,887
2017,14,14,"Ardahan",41.1105,42.7022,20.4428571428571,3.94285714285714,2.132,56.6571428571429,13.4928571428571,15.5228571428571,639,0,0,8,8,1336,639,1336
2017,15,14,"Ardahan",41.1105,42.7022,17.5714285714286,3.71428571428571,1.23928571428571,66.4571428571429,8.52666666666667,13.6528571428571,587,266,686,89,254,1187,321,501
2017,16,14,"Ardahan",41.1105,42.7022,22.4857142857143,7.45714285714286,0.742285714285714,59.4142857142857,15.6185714285714,13.2614285714286,717,50,53,95,60,920,667,867
2017,17,14,"Ardahan",41.1105,42.7022,20.6714285714286,4.81428571428571,0.857142857142857,58.2142857142857,11.8571428571429,11.6985714285714,731,249,418,93,215,1478,482,1060
2017,18,14,"Ardahan",41.1105,42.7022,19.3,10.2142857142857,2.44114285714286,66.1142857142857,13.1114285714286,14.6871428571429,506,74,104,210,394,923,432,819
2017,19,14,"Ardahan",41.1105,42.7022,26.1285714285714,9.92857142857143,2.87185714285714,63.2571428571429,11.89,15.1175,471,186,462,262,490,966,285,504
2017,20,14,"Ardahan",41.1105,42.7022,21.4571428571429,9.67142857142857,2.44742857142857,67.8428571428571,12.5771428571429,15.8771428571429,472,148,529,39,24,1205,324,676
2017,21,14,"Ardahan",41.1105,42.7022,20.4,9.32857142857143,2.62642857142857,65.7857142857143,9.70142857142857,18.1914285714286,448,193,435,77,131,849,255,414
2017,22,14,"Ardahan",41.1105,42.7022,18.3428571428571,11.5,1.799,63.2714285714286,13.35,19.29,522,279,527,30,132,1015,243,488
2017,23,14,"Ardahan",41.1105,42.7022,23.2428571428571,15.6428571428571,3.31914285714286,63.8714285714286,14.6971428571429,19.8257142857143,578,391,902,0,0,1388,187,486
2017,24,14,"Ardahan",41.1105,42.7022,15.5714285714286,12.3857142857143,1.83471428571429,67.0857142857143,10.4442857142857,17.0657142857143,552,371,798,0,0,1139,181,341
2017,25,14,"Ardahan",41.1105,42.7022,21.1571428571429,13.6142857142857,3.04042857142857,62.6285714285714,11.4028571428571,16.8957142857143,584,400,758,93,145,1041,184,283
2017,26,14,"Ardahan",41.1105,42.7022,20.6714285714286,18.1857142857143,0.480142857142857,60.0714285714286,15.5057142857143,15.7528571428571,564,231,347,53,119,971,333,624
2017,27,14,"Ardahan",41.1105,42.7022,21.1857142857143,17.8714285714286,0.236285714285714,61.1285714285714,20.9314285714286,15.0514285714286,511,215,164,95,178,642,296,478
2017,28,14,"Ardahan",41.1105,42.7022,23.5285714285714,16.9857142857143,5.28057142857143,63.9,12.5142857142857,13.1471428571429,481,244,568,66,86,864,237,296
2017,29,14,"Ardahan",41.1105,42.7022,23.8571428571429,19.9428571428571,0.456857142857143,56.1,19.2428571428571,15.3942857142857,532,410,907,0,0,1272,122,365
2017,30,14,"Ardahan",41.1105,42.7022,20.6285714285714,19.2142857142857,2.33228571428571,58.4285714285714,17.575,13.57,531,315,527,0,0,928,216,401
2017,31,14,"Ardahan",41.1105,42.7022,26.9857142857143,22.1142857142857,0.0577142857142857,51.8285714285714,21.5857142857143,14.9414285714286,559,495,837,0,0,1047,64,210
2017,32,14,"Ardahan",41.1105,42.7022,22.4857142857143,22.3285714285714,2.768,44.0428571428571,23.3857142857143,15.6957142857143,567,368,655,0,0,1092,199,437
2017,33,14,"Ardahan",41.1105,42.7022,24.5285714285714,18.5285714285714,1.88442857142857,61.4428571428571,18.2871428571429,15.1157142857143,596,358,707,79,147,1199,238,492
2017,34,14,"Ardahan",41.1105,42.7022,27.0428571428571,18.9,0.000714285714285714,51.2428571428571,28.5,15.8614285714286,601,599,1279,0,0,1280,2,1
2017,35,14,"Ardahan",41.1105,42.7022,18.8285714285714,18.5714285714286,0.228285714285714,46.5285714285714,NA,14.4271428571429,493,333,783,0,0,1014,160,231
2017,36,14,"Ardahan",41.1105,42.7022,16.6857142857143,16.5285714285714,0.714714285714286,38.9285714285714,NA,19.6585714285714,507,235,659,0,0,1321,272,662
2017,37,14,"Ardahan",41.1105,42.7022,17.9714285714286,17.2714285714286,0,37.7142857142857,25.1933333333333,19.7957142857143,589,355,566,21,53,1138,234,572
2017,38,14,"Ardahan",41.1105,42.7022,18.2714285714286,17.0428571428571,0.242571428571429,41.8428571428571,31.0457142857143,18.6214285714286,671,312,698,112,227,1312,359,614
2017,39,14,"Ardahan",41.1105,42.7022,19.5571428571429,11.2142857142857,0.689285714285714,63.2285714285714,15.3514285714286,16.4157142857143,782,464,995,1,3,1630,318,635
2017,40,14,"Ardahan",41.1105,42.7022,13.5142857142857,6.14285714285714,2.145,68.0285714285714,11.7885714285714,17.81,543,238,463,75,141,1137,305,674
2017,41,14,"Ardahan",41.1105,42.7022,17.7142857142857,7.15714285714286,2.31557142857143,70.2571428571429,12.4514285714286,17.4471428571429,487,368,720,16,15,843,119,123
2017,42,14,"Ardahan",41.1105,42.7022,18.0857142857143,3.75714285714286,3.77357142857143,69.8,17.0914285714286,19.91,530,56,65,144,215,815,474,750
2017,43,14,"Ardahan",41.1105,42.7022,13.5571428571429,7.05714285714286,0.166285714285714,59.8857142857143,36.8457142857143,23.9333333333333,506,146,143,59,109,919,360,776
2017,44,14,"Ardahan",41.1105,42.7022,20.1857142857143,2.77142857142857,0.199142857142857,63.3857142857143,15.7885714285714,25.6766666666667,561,125,271,240,428,1102,436,831
2017,45,14,"Ardahan",41.1105,42.7022,9.9,5.02857142857143,2.91914285714286,81.9285714285714,19.71,22.9814285714286,577,128,267,67,61,829,449,562
2017,46,14,"Ardahan",41.1105,42.7022,11.9714285714286,2.67142857142857,0,71.9142857142857,31.7757142857143,29.1571428571429,587,49,83,114,224,1085,538,1002
2017,47,14,"Ardahan",41.1105,42.7022,21.1857142857143,-3.68571428571429,2.16,73.0571428571429,10.39,18.73,418,56,108,150,279,804,362,696
2017,48,14,"Ardahan",41.1105,42.7022,9.37142857142857,-5.31428571428571,0.550142857142857,79.2571428571429,26.4985714285714,30.9585714285714,386,52,109,224,344,619,334,510
2017,49,14,"Ardahan",41.1105,42.7022,17.0428571428571,-6.32857142857143,2.15971428571429,78.3571428571429,25.9885714285714,30.9183333333333,407,120,202,60,48,645,287,443
2017,50,14,"Ardahan",41.1105,42.7022,8.82857142857143,-11,0,79.8285714285714,72.8771428571429,43.2614285714286,346,0,0,174,327,442,346,442
2017,51,14,"Ardahan",41.1105,42.7022,19.0428571428571,-1.41428571428571,0.632428571428571,81.6714285714286,51.1057142857143,38.6871428571429,386,63,42,226,199,349,323,307
2017,52,14,"Ardahan",41.1105,42.7022,15.3375,-4.5375,0.88775,77.8875,44.0157142857143,39.205,528,11,4,448,394,507,517,503
2018,1,14,"Ardahan",41.1105,42.7022,14.25,-6.675,4.1865,84.1875,39.0616666666667,42.965,618,95,138,133,260,914,523,776
2018,2,14,"Ardahan",41.1105,42.7022,24.9142857142857,-5.65714285714286,0.245571428571429,74.1571428571429,30.79,31.55,624,74,153,295,381,1309,550,1156
2018,3,14,"Ardahan",41.1105,42.7022,16.1714285714286,-6.42857142857143,3.12285714285714,81.0571428571429,18.6542857142857,19.42,639,153,94,164,159,655,486,561
2018,4,14,"Ardahan",41.1105,42.7022,19.3571428571429,-4.6,0.482,79.9428571428571,18.9614285714286,25.3725,604,411,534,0,0,764,193,230
2018,5,14,"Ardahan",41.1105,42.7022,14.6714285714286,-8.97142857142857,0.640142857142857,72.1142857142857,27.5314285714286,30.1,670,5,44,566,629,819,665,775
2018,6,14,"Ardahan",41.1105,42.7022,14.9,-5.15714285714286,0.823428571428571,82.6857142857143,29.1514285714286,32.6666666666667,704,4,8,364,439,1022,700,1014
2018,7,14,"Ardahan",41.1105,42.7022,22.6142857142857,-1.98571428571429,0.867,78.6,26.75,25.6457142857143,478,123,148,145,167,557,355,409
2018,8,14,"Ardahan",41.1105,42.7022,11.1285714285714,-4.51428571428571,14.4134285714286,81.8571428571429,27.5371428571429,29.3242857142857,711,272,552,82,209,1321,439,769
2018,9,14,"Ardahan",41.1105,42.7022,23.3142857142857,-0.757142857142857,14.3104285714286,72.6571428571429,16.0042857142857,21.012,621,97,158,433,644,956,524,798
2018,10,14,"Ardahan",41.1105,42.7022,20.1428571428571,1.74285714285714,1.51814285714286,75.0571428571428,14.36,19.275,556,215,457,246,695,1330,341,873
2018,11,14,"Ardahan",41.1105,42.7022,16.1714285714286,2.95714285714286,0.341714285714286,68.9285714285714,25.5216666666667,17.874,551,69,269,287,726,1426,482,1157
2018,12,14,"Ardahan",41.1105,42.7022,30.8571428571429,7.04285714285714,1.017,55.7428571428571,37.13,15.296,425,0,0,334,1044,1187,425,1187
2018,13,14,"Ardahan",41.1105,42.7022,18.7428571428571,5.88571428571429,1.71328571428571,63.5857142857143,22.2257142857143,15.2525,356,0,0,181,216,428,356,428
2018,14,14,"Ardahan",41.1105,42.7022,15.9142857142857,5.04285714285714,1.04728571428571,56.8142857142857,17.2157142857143,14.185,407,212,308,9,28,486,195,178
2018,15,14,"Ardahan",41.1105,42.7022,24.0857142857143,7.81428571428571,0.472714285714286,57.8428571428571,20.0757142857143,13.3416666666667,374,124,108,94,68,450,250,342
2018,16,14,"Ardahan",41.1105,42.7022,16.7714285714286,5.11428571428571,0.0397142857142857,52.8142857142857,16.5871428571429,13.125,411,363,543,0,0,648,48,105
2018,17,14,"Ardahan",41.1105,42.7022,19.5571428571429,8.81428571428571,0.485428571428571,54.9285714285714,16.0314285714286,19.416,419,245,326,0,0,652,174,326
2018,18,14,"Ardahan",41.1105,42.7022,16.8428571428571,11.3571428571429,2.37142857142857,65.2142857142857,13.3642857142857,13.65,303,37,33,54,177,474,266,441
2018,19,14,"Ardahan",41.1105,42.7022,15.1,9.68571428571429,3.35314285714286,74.5142857142857,10.4514285714286,13.6228571428571,275,78,200,55,49,467,197,267
2018,20,14,"Ardahan",41.1105,42.7022,16.0857142857143,11.4428571428571,5.29885714285714,73.0285714285714,9.385,15.0985714285714,204,101,205,81,81,306,103,101
2018,21,14,"Ardahan",41.1105,42.7022,16.3857142857143,12.9,4.64042857142857,73,13.596,17.3114285714286,252,27,61,99,96,281,225,220
2018,22,14,"Ardahan",41.1105,42.7022,16.6428571428571,12.2571428571429,5.586,75.5571428571429,9.17142857142857,15.6457142857143,249,43,82,0,0,427,206,345
2018,23,14,"Ardahan",41.1105,42.7022,16.4285714285714,13.2285714285714,2.46828571428571,70.3857142857143,8.78571428571428,18.2057142857143,267,85,204,83,277,812,182,608
2018,24,14,"Ardahan",41.1105,42.7022,15.6142857142857,14.5714285714286,1.24957142857143,69.6714285714286,11.7442857142857,15.6585714285714,267,80,85,104,77,448,187,363
2018,25,14,"Ardahan",41.1105,42.7022,13.7714285714286,14.1428571428571,8.25471428571429,75.4714285714286,7.47857142857143,17.5314285714286,358,86,155,126,192,518,272,363
2018,26,14,"Ardahan",41.1105,42.7022,17.7571428571429,18.6571428571429,2.47414285714286,67.3857142857143,15.5842857142857,17.4171428571429,355,137,156,101,220,587,218,431
2018,27,14,"Ardahan",41.1105,42.7022,21.2,19.4285714285714,3.80442857142857,67.4571428571429,18.9985714285714,17.2657142857143,342,161,230,0,0,418,181,188
2018,28,14,"Ardahan",41.1105,42.7022,17.8,19.8285714285714,4.697,70.8285714285714,13.0585714285714,21.2514285714286,286,183,398,3,2,585,103,187
2018,29,14,"Ardahan",41.1105,42.7022,19.0285714285714,16.5571428571429,1.09271428571429,66.4,8.43142857142857,21.5942857142857,260,180,568,0,0,756,80,188
2018,30,14,"Ardahan",41.1105,42.7022,20.8857142857143,20.1,2.36728571428571,58.9857142857143,21.7442857142857,21.5171428571429,265,75,194,31,62,822,190,628
2018,31,14,"Ardahan",41.1105,42.7022,19.5571428571429,18.4142857142857,6.16485714285714,69.0857142857143,7.39333333333333,21.9416666666667,267,85,221,36,100,499,182,278
2018,32,14,"Ardahan",41.1105,42.7022,21.7428571428571,16.3,4.80885714285714,75.3,8.59857142857143,22.4033333333333,297,262,335,0,0,403,35,68
2018,33,14,"Ardahan",41.1105,42.7022,21.4,16.9428571428571,0.922285714285714,66.5714285714286,10.4928571428571,21.2828571428571,216,173,257,0,0,332,43,75
2018,34,14,"Ardahan",41.1105,42.7022,20.6714285714286,17.2571428571429,4.38957142857143,69.2857142857143,9.28714285714286,22.3042857142857,144,109,197,0,0,227,35,30
2018,35,14,"Ardahan",41.1105,42.7022,28.8857142857143,17.3714285714286,0.694142857142857,63.0571428571429,14.7116666666667,24.1014285714286,201,192,272,0,0,314,9,42
2018,36,14,"Ardahan",41.1105,42.7022,18.5285714285714,15.4714285714286,1.48171428571429,62.4714285714286,14.266,22.0685714285714,341,237,213,0,0,370,104,157
2018,37,14,"Ardahan",41.1105,42.7022,16.1714285714286,13.7142857142857,4.07714285714286,70.0857142857143,9.37428571428572,25.1485714285714,241,116,197,0,0,419,125,222
2018,38,14,"Ardahan",41.1105,42.7022,23.2571428571429,12.2571428571429,0.826285714285714,70.0285714285714,8.12142857142857,25.1457142857143,189,124,251,3,9,344,65,93
2018,39,14,"Ardahan",41.1105,42.7022,15.6571428571429,11.9,0,67.7285714285714,9.65857142857143,19.4314285714286,180,173,326,0,0,353,7,27
2018,40,14,"Ardahan",41.1105,42.7022,19.3857142857143,9.27142857142857,0.630285714285714,68.5857142857143,8.59,34.0542857142857,191,131,198,28,45,341,60,143
2018,41,14,"Ardahan",41.1105,42.7022,13.0428571428571,10.5428571428571,0.190857142857143,69.9571428571429,16.0128571428571,27.87,187,76,175,55,187,422,111,247
2018,42,14,"Ardahan",41.1105,42.7022,8.31428571428571,8.8,0.0572857142857143,60.3857142857143,21.1,31.2233333333333,168,0,0,59,287,381,168,381
2018,43,14,"Ardahan",41.1105,42.7022,27.0714285714286,5.94285714285714,4.89971428571429,78.9571428571429,11.0657142857143,33.4714285714286,187,8,24,100,166,402,179,378
2018,44,14,"Ardahan",41.1105,42.7022,17.8142857142857,3.81428571428571,0,67.4285714285714,18.0628571428571,47.0014285714286,196,26,14,22,74,264,170,250
2018,45,14,"Ardahan",41.1105,42.7022,12.5285714285714,1.01428571428571,0,70.7857142857143,17.5157142857143,39.7728571428571,231,36,27,46,209,473,195,446
2018,46,14,"Ardahan",41.1105,42.7022,18.5714285714286,0.871428571428571,1.87457142857143,81.2285714285714,8.586,40.1185714285714,230,66,95,111,231,465,164,370
2018,47,14,"Ardahan",41.1105,42.7022,17.7571428571429,-0.085714285714286,0.245142857142857,80.5857142857143,13.3271428571429,39.5314285714286,270,102,135,102,123,499,168,364
2018,48,14,"Ardahan",41.1105,42.7022,19.9142857142857,2.4,0.503571428571429,77.8142857142857,13.8171428571429,49.0128571428571,245,62,20,76,62,201,183,181
2018,49,14,"Ardahan",41.1105,42.7022,8.8,-0.871428571428571,0.570857142857143,85.7,17.0042857142857,44.7728571428571,257,44,57,39,54,420,213,363
2018,50,14,"Ardahan",41.1105,42.7022,16.8142857142857,-2.77142857142857,2.86571428571429,83.1,39.6833333333333,46.1342857142857,256,96,50,103,140,305,160,255
2018,51,14,"Ardahan",41.1105,42.7022,9.84285714285714,-4.58571428571429,0.147714285714286,87.9142857142857,79.1057142857143,47.9571428571429,250,4,3,72,70,248,246,245
2018,52,14,"Ardahan",41.1105,42.7022,21.4571428571429,-7.11428571428571,2.34142857142857,81.4142857142857,41.45,41.63,244,82,79,89,111,273,162,194
2019,1,14,"Ardahan",41.1105,42.7022,17.175,-6.225,0.974875,80.2125,28.275,23.365,343,47,42,122,144,784,296,742
2019,2,14,"Ardahan",41.1105,42.7022,16.8,-11.4142857142857,0.725285714285714,77.5571428571428,110.85,49.644,255,46,28,90,111,208,209,180
2019,3,14,"Ardahan",41.1105,42.7022,23.1142857142857,-9.01428571428571,0.504428571428571,75.4142857142857,69.3228571428571,39.1942857142857,192,23,7,58,51,198,169,191
2019,4,14,"Ardahan",41.1105,42.7022,10.4,-8.98571428571429,0.0525714285714286,77.5714285714286,106.228,46.218,308,44,23,57,84,314,264,291
2019,5,14,"Ardahan",41.1105,42.7022,15.1428571428571,-5.92857142857143,0.308571428571429,78.7571428571429,78.6342857142857,46.2528571428571,253,40,37,107,70,143,213,106
2019,6,14,"Ardahan",41.1105,42.7022,9.65714285714286,-7.52857142857143,0.024,80.4285714285714,98.1814285714286,52.8,276,7,5,169,91,127,269,122
2019,7,14,"Ardahan",41.1105,42.7022,13.3571428571429,-7.68571428571429,0.945428571428571,79.5714285714286,81.3475,35.9828571428571,325,69,37,184,58,234,256,197
2019,8,14,"Ardahan",41.1105,42.7022,14.9285714285714,-8.31428571428571,0.308857142857143,75.6857142857143,66.6616666666667,45.066,305,4,7,128,92,219,301,212
2019,9,14,"Ardahan",41.1105,42.7022,22.3714285714286,-4.22857142857143,2.29471428571429,74.1571428571429,24.8228571428571,24.6642857142857,331,83,25,127,234,310,248,285
2019,10,14,"Ardahan",41.1105,42.7022,14.3714285714286,-7.11428571428571,0.306285714285714,76.6285714285714,69.7028571428571,40.7742857142857,359,157,78,53,92,252,202,174
2019,11,14,"Ardahan",41.1105,42.7022,22.7,1.64285714285714,0.3,72.2142857142857,32.84,41.8914285714286,373,76,49,258,317,400,297,351
2019,12,14,"Ardahan",41.1105,42.7022,16.5142857142857,-1.95714285714286,0.548285714285714,68.4857142857143,31.99,16.3657142857143,343,182,65,0,0,416,161,351
2019,13,14,"Ardahan",41.1105,42.7022,20.3714285714286,-0.842857142857143,1.11571428571429,75.1857142857143,24.29,13.26,256,202,151,0,0,194,54,43
2019,14,14,"Ardahan",41.1105,42.7022,16.8571428571429,2.55714285714286,1.51485714285714,76.5571428571429,28.6657142857143,13.9833333333333,365,169,59,4,4,208,196,149
2019,15,14,"Ardahan",41.1105,42.7022,13.2571428571429,5.42857142857143,0.485571428571429,63.3714285714286,39.7057142857143,14.2142857142857,359,57,22,51,33,183,302,161
2019,16,14,"Ardahan",41.1105,42.7022,25.3714285714286,3.91428571428571,3.38414285714286,74.6714285714286,23.0514285714286,15.2228571428571,318,179,122,104,72,208,139,86
2019,17,14,"Ardahan",41.1105,42.7022,17.5,3.84285714285714,0.238,56.9571428571429,18.565,14.96,412,226,153,0,0,313,186,160
2019,18,14,"Ardahan",41.1105,42.7022,16.9,8.78571428571429,1.02728571428571,63.4,26.218,NA,523,150,69,98,38,353,373,284
2019,19,14,"Ardahan",41.1105,42.7022,21.9714285714286,11.0428571428571,1.228,56.8857142857143,33.1085714285714,NA,452,3,0,268,227,386,449,386
2019,20,14,"Ardahan",41.1105,42.7022,16.7,13.6571428571429,0.580857142857143,47.2714285714286,33.9085714285714,NA,454,201,186,0,0,389,253,203
2019,21,14,"Ardahan",41.1105,42.7022,20.1285714285714,11.5857142857143,2.40157142857143,72.2285714285714,26.48,NA,457,170,196,68,26,413,287,217
2019,22,14,"Ardahan",41.1105,42.7022,15.3571428571429,14.2428571428571,0.542285714285714,56.2571428571429,22.89,NA,453,152,139,0,0,323,301,184
2019,23,14,"Ardahan",41.1105,42.7022,19.0428571428571,17.1,0.484714285714286,59.5285714285714,32.5542857142857,NA,378,58,132,48,40,532,320,400
2019,24,14,"Ardahan",41.1105,42.7022,20.6428571428571,16.0428571428571,1.14,62.3857142857143,26.6728571428571,16.926,378,153,90,114,46,244,225,154
2019,25,14,"Ardahan",41.1105,42.7022,19.9,15.7285714285714,7.96371428571429,70.0285714285714,20.7357142857143,12.8228571428571,306,224,196,0,0,325,82,129
2019,26,14,"Ardahan",41.1105,42.7022,17.7857142857143,16.3714285714286,3.558,69.6714285714286,21.3385714285714,12.1742857142857,377,162,180,142,106,342,215,162
2019,27,14,"Ardahan",41.1105,42.7022,17.1857142857143,14.6,2.57385714285714,63.9,22.765,12.58,456,321,121,0,0,222,135,101
2019,28,14,"Ardahan",41.1105,42.7022,19.8571428571429,16.1285714285714,6.63028571428571,67.0714285714286,18.1128571428571,11.8542857142857,398,136,150,24,24,421,262,271
2019,29,14,"Ardahan",41.1105,42.7022,20.9142857142857,17.8428571428571,0.384,65.3142857142857,29.2842857142857,12.1671428571429,453,340,176,0,0,203,113,27
2019,30,14,"Ardahan",41.1105,42.7022,21.7428571428571,17.8571428571429,0.896571428571428,63.6,22.3185714285714,13.31,456,395,277,52,52,335,61,58
2019,31,14,"Ardahan",41.1105,42.7022,22.2714285714286,19.1714285714286,0.000571428571428571,53.6142857142857,29.1042857142857,12.64,334,278,279,29,62,375,56,96
2019,32,14,"Ardahan",41.1105,42.7022,26.1714285714286,15.6142857142857,0,58.6142857142857,25.2271428571429,12.8628571428571,346,342,390,0,0,395,4,5
2019,33,14,"Ardahan",41.1105,42.7022,23.6,19.9285714285714,5.07071428571429,54.9428571428571,35.8657142857143,15.9042857142857,337,283,503,0,0,531,54,28
2019,34,14,"Ardahan",41.1105,42.7022,25.6857142857143,19.7,0.671285714285714,45.5571428571429,38.8028571428571,13.4166666666667,299,296,343,0,0,345,3,2
2019,35,14,"Ardahan",41.1105,42.7022,18.2285714285714,15.7,2.27414285714286,66.6428571428571,19.9285714285714,13.1057142857143,307,269,364,0,0,415,38,51
2019,36,14,"Ardahan",41.1105,42.7022,24.2714285714286,13.8,4.20342857142857,70.2714285714286,18.5966666666667,12.0214285714286,171,124,51,0,0,67,47,16
2019,37,14,"Ardahan",41.1105,42.7022,21.7,11.4285714285714,2.33885714285714,69.9714285714286,19.3614285714286,11.2028571428571,218,217,55,0,0,55,1,0
2019,38,14,"Ardahan",41.1105,42.7022,15.1,11.6857142857143,0.695285714285714,63.7285714285714,24.7671428571429,11.2557142857143,266,0,0,97,42,91,266,91
2019,39,14,"Ardahan",41.1105,42.7022,14.6285714285714,11.3,1.52971428571429,56.1142857142857,28.3114285714286,11.4114285714286,237,0,0,76,37,79,237,79
2019,40,14,"Ardahan",41.1105,42.7022,16.7428571428571,11.5142857142857,0.324,57.4,34.6485714285714,11.5242857142857,241,39,11,42,19,111,202,100
2019,41,14,"Ardahan",41.1105,42.7022,16.3285714285714,10.8,0.217428571428571,57.7142857142857,32.76,15.5114285714286,416,24,3,185,159,448,392,445
2019,42,14,"Ardahan",41.1105,42.7022,12.2285714285714,8.87142857142857,0.142857142857143,47.7714285714286,41.4857142857143,26.5928571428571,356,22,58,127,159,408,334,350
2019,43,14,"Ardahan",41.1105,42.7022,13.2857142857143,7.12857142857143,0,65.3142857142857,40.5771428571429,22.6957142857143,306,112,73,55,27,300,194,227
2019,44,14,"Ardahan",41.1105,42.7022,16.2285714285714,3.42857142857143,0.0215714285714286,68.4714285714286,34.3085714285714,21.2928571428571,350,0,0,219,180,250,350,250
2019,45,14,"Ardahan",41.1105,42.7022,9.4,1.65714285714286,0,63.5,47.1585714285714,32.6571428571429,417,0,0,92,92,328,417,328
2019,46,14,"Ardahan",41.1105,42.7022,10.9428571428571,-0.442857142857143,0,56.3,64.38,38.9257142857143,401,0,0,77,59,337,401,337
2019,47,14,"Ardahan",41.1105,42.7022,9.34285714285714,-3.71428571428571,0,61.7142857142857,60.4257142857143,30.39,391,60,28,120,105,339,331,311
2019,48,14,"Ardahan",41.1105,42.7022,12.4571428571429,0.414285714285714,0.723,77.7285714285714,45.93,29.7316666666667,320,18,9,107,95,251,302,242
2019,49,14,"Ardahan",41.1105,42.7022,14.0714285714286,-4.34285714285714,1,80.4857142857143,41.3614285714286,29.7042857142857,393,209,145,110,62,274,184,129
2019,50,14,"Ardahan",41.1105,42.7022,10.4285714285714,-3.35714285714286,0.133,81.7285714285714,50.9242857142857,36.8428571428571,218,35,22,109,59,119,183,97
2019,51,14,"Ardahan",41.1105,42.7022,9.6,-2.62857142857143,0.107571428571429,70.1285714285714,40.6614285714286,31.4157142857143,361,0,0,107,147,488,361,488
2019,52,14,"Ardahan",41.1105,42.7022,18.0142857142857,-0.3,0.424285714285714,70.8142857142857,35.0928571428571,25.5675,279,49,66,71,87,281,230,215
2020,1,14,"Ardahan",41.1105,42.7022,14.08,-5.88,0.368,84.24,18.842,17.494,160,0,0,131,103,126,160,126
2020,2,14,"Ardahan",41.1105,42.7022,8.31428571428571,-7.88571428571429,0.0325714285714286,81.2142857142857,26.85,21.84,240,0,0,104,37,173,240,173
2020,3,14,"Ardahan",41.1105,42.7022,9.02857142857143,-11.0857142857143,0.0982857142857143,72.5,32.6242857142857,22.76,270,0,0,128,203,382,270,382
2020,4,14,"Ardahan",41.1105,42.7022,14.8285714285714,-8.95714285714286,0.00457142857142857,70,26.0314285714286,19.7328571428571,358,0,0,134,116,295,358,295
2020,5,14,"Ardahan",41.1105,42.7022,22.0428571428571,-5.48571428571429,1.00485714285714,69.4,29.9185714285714,23.1657142857143,331,0,0,278,247,272,331,272
2020,6,14,"Ardahan",41.1105,42.7022,44.2142857142857,-3.2,1.82928571428571,69.4857142857143,17.4285714285714,16.4714285714286,343,0,0,307,234,267,343,267
2020,7,14,"Ardahan",41.1105,42.7022,18.7142857142857,-13,0.107285714285714,67.3285714285714,44.375,32.0228571428571,341,0,0,191,160,338,341,338
2020,8,14,"Ardahan",41.1105,42.7022,12.6142857142857,-2.24285714285714,0.228428571428571,78.5857142857143,46.68,31.7771428571429,283,42,20,135,122,187,241,167
2020,9,14,"Ardahan",41.1105,42.7022,19.8,-2.08571428571429,0.558285714285714,71.2285714285714,23.76,18.455,393,77,102,152,156,528,316,426
2020,10,14,"Ardahan",41.1105,42.7022,11.1142857142857,0.728571428571429,0,66.6428571428571,44.6785714285714,23.0042857142857,205,40,69,132,106,210,165,141
2020,11,14,"Ardahan",41.1105,42.7022,14.8428571428571,5.58571428571429,1.29785714285714,66.4714285714286,43.5242857142857,22.6128571428571,115,0,0,50,46,94,115,94
2020,12,14,"Ardahan",41.1105,42.7022,22.5,-0.185714285714286,3.82757142857143,81.1714285714286,20.5085714285714,15.5616666666667,117,70,82,27,24,118,47,36
2020,13,14,"Ardahan",41.1105,42.7022,20.8714285714286,4.17142857142857,0.463,71.1714285714286,30.7857142857143,14.93,136,80,78,29,9,92,56,14
2020,14,14,"Ardahan",41.1105,42.7022,22.8285714285714,3.57142857142857,3.985,74.7142857142857,17.3985714285714,14.1114285714286,155,7,1,106,90,121,148,120
2020,15,14,"Ardahan",41.1105,42.7022,23.8714285714286,2.75714285714286,0.415857142857143,69.6428571428571,21.63,10.8328571428571,133,66,29,22,13,118,67,89
2020,16,14,"Ardahan",41.1105,42.7022,22.0428571428571,6.62857142857143,0.000428571428571429,55.7285714285714,25.0242857142857,12.91,141,23,6,95,90,106,118,100
2020,17,14,"Ardahan",41.1105,42.7022,28.5,5.17142857142857,3.39442857142857,76.5142857142857,10.2733333333333,NA,137,41,36,74,74,123,96,87
2020,18,14,"Ardahan",41.1105,42.7022,26.6,7.51428571428571,4.29942857142857,67.6428571428571,19.7514285714286,NA,146,0,0,72,50,164,146,164
2020,19,14,"Ardahan",41.1105,42.7022,29.5142857142857,7.92857142857143,8.03114285714286,76.8428571428571,13.2628571428571,NA,137,18,9,82,86,157,119,148
2020,20,14,"Ardahan",41.1105,42.7022,29.1428571428571,11.5428571428571,0.0142857142857143,54.1428571428571,32.4542857142857,NA,164,12,1,11,18,164,152,163
2020,21,14,"Ardahan",41.1105,42.7022,32.6857142857143,12.7714285714286,5.272,54.5,28.5714285714286,NA,146,7,0,49,21,96,139,96
2020,22,14,"Ardahan",41.1105,42.7022,27.8571428571429,13.6857142857143,1.83257142857143,58.9714285714286,20.2471428571429,NA,118,16,6,57,46,100,102,94
2020,23,14,"Ardahan",41.1105,42.7022,28.2428571428571,14.0428571428571,0.0145714285714286,52.9,25.7285714285714,16.49,112,12,14,71,40,70,100,56
2020,24,14,"Ardahan",41.1105,42.7022,26.6714285714286,16.8571428571429,0.0581428571428571,51.4857142857143,31.9685714285714,16.51,140,64,72,34,27,150,76,78
2020,25,14,"Ardahan",41.1105,42.7022,23.3285714285714,14.5571428571429,4.15914285714286,68.2857142857143,23.91,16.8871428571429,137,91,48,6,11,108,46,60
2020,26,14,"Ardahan",41.1105,42.7022,26.3857142857143,16.4714285714286,1.395,67.2857142857143,16.8825,14.3914285714286,173,116,94,0,0,133,57,39
2020,27,14,"Ardahan",41.1105,42.7022,19.2714285714286,16.0142857142857,1.31342857142857,64.1142857142857,24.9885714285714,16.5942857142857,113,110,108,0,0,113,3,5
2020,28,14,"Ardahan",41.1105,42.7022,20.3714285714286,16.9285714285714,2.62714285714286,67.4428571428572,22.75,16.632,164,137,94,0,0,122,27,28
2020,29,14,"Ardahan",41.1105,42.7022,19.6,17.6571428571429,1.46285714285714,68.2857142857143,21.2142857142857,16.8171428571429,186,149,86,0,0,111,37,25
2020,30,14,"Ardahan",41.1105,42.7022,22.2142857142857,19.1142857142857,5.69642857142857,67.4571428571429,25.6342857142857,15.9842857142857,190,151,94,0,0,142,39,48
2020,31,14,"Ardahan",41.1105,42.7022,23.4714285714286,18.4,2.92628571428571,66.8714285714286,22.0514285714286,19.4514285714286,150,76,44,23,36,127,74,83
2020,32,14,"Ardahan",41.1105,42.7022,20.9714285714286,16.1714285714286,0.000142857142857143,56.4857142857143,19.4171428571429,21.4871428571429,146,130,82,0,0,107,16,25
2020,33,14,"Ardahan",41.1105,42.7022,23.0428571428571,16,0.0454285714285714,60.6142857142857,19.39,19.3857142857143,183,123,44,0,0,83,60,39
2020,34,14,"Ardahan",41.1105,42.7022,27.1571428571429,16.6428571428571,4.572,65.3285714285714,19.1585714285714,20.16,197,121,66,0,0,97,76,31
2020,35,14,"Ardahan",41.1105,42.7022,23.3857142857143,15.9428571428571,0.000285714285714286,55.2142857142857,21.5685714285714,23.48,164,132,108,0,0,157,32,49
2020,36,14,"Ardahan",41.1105,42.7022,18.3857142857143,18.7428571428571,0.442285714285714,49.0285714285714,35.5283333333333,25.9842857142857,179,50,25,38,13,112,129,87
2020,37,14,"Ardahan",41.1105,42.7022,20.4428571428571,17.0571428571429,0.197571428571429,54.5142857142857,25.6628571428571,21.9042857142857,193,135,52,1,0,91,58,39
2020,38,14,"Ardahan",41.1105,42.7022,19.1571428571429,15.5142857142857,0.745,57.5857142857143,31.9557142857143,23.5285714285714,235,108,49,0,0,157,127,108
2020,39,14,"Ardahan",41.1105,42.7022,22.1428571428571,13.7,1.89628571428571,68.9,21.3042857142857,24.48,220,134,86,24,8,129,86,43
2020,40,14,"Ardahan",41.1105,42.7022,19.9857142857143,12.0428571428571,2.041,67.2857142857143,24.6242857142857,20.7814285714286,187,119,123,0,0,154,68,31
2020,41,14,"Ardahan",41.1105,42.7022,14.8714285714286,7.51428571428571,1.00828571428571,67.8285714285714,20.4685714285714,21.6857142857143,182,100,72,0,0,127,82,55
2020,42,14,"Ardahan",41.1105,42.7022,9.34285714285714,10.2571428571429,0.00942857142857143,47.5714285714286,45.62,31.7357142857143,177,0,0,58,31,111,177,111
2020,43,14,"Ardahan",41.1105,42.7022,11.3857142857143,8.72857142857143,1.89457142857143,59.5428571428571,31.9028571428571,26.3228571428571,194,0,0,69,33,161,194,161
2020,44,14,"Ardahan",41.1105,42.7022,11.1,8.88571428571429,0.00942857142857143,48.9714285714286,58.6285714285714,31.0471428571429,255,0,0,150,139,233,255,233
2020,45,14,"Ardahan",41.1105,42.7022,15.5285714285714,6.32857142857143,4.26528571428571,79.9,25.5471428571429,22.41,156,51,31,47,29,103,105,72
2020,46,14,"Ardahan",41.1105,42.7022,11.7571428571429,0.685714285714285,0.117571428571429,76.1714285714286,38.8314285714286,29.8285714285714,208,0,0,10,18,109,208,109
2020,47,14,"Ardahan",41.1105,42.7022,12.4428571428571,0.328571428571429,1.141,82.2285714285714,26.89,22.5771428571429,173,9,7,16,5,83,164,76
2020,48,14,"Ardahan",41.1105,42.7022,13.1142857142857,-3.64285714285714,0.104571428571429,74.0142857142857,32.0057142857143,28.0657142857143,199,0,0,35,41,262,199,262
2020,49,14,"Ardahan",41.1105,42.7022,11.5,-1.74285714285714,0.00471428571428572,82.7,39.0842857142857,25.5585714285714,207,31,28,55,24,116,176,88
2020,50,14,"Ardahan",41.1105,42.7022,9.08571428571429,-3.64285714285714,0.412714285714286,87.5,54.8,32.15,181,52,14,111,63,98,129,84
2020,51,14,"Ardahan",41.1105,42.7022,11.8142857142857,-1.25714285714286,0.623142857142857,85.8571428571429,57.24,33.1514285714286,171,0,0,86,47,90,171,90
2020,52,14,"Ardahan",41.1105,42.7022,11.5571428571429,-8.42857142857143,1.24985714285714,81.0571428571428,45.5814285714286,27.2985714285714,203,4,3,148,73,113,199,110
2020,53,14,"Ardahan",41.1105,42.7022,10.025,-12.475,0,78.975,125.015,62.4625,122,0,0,92,110,111,122,111
2017,1,15,"Artvin",41.182,41.8191,37.0714285714286,8.31428571428571,0.6,46.9571428571429,28.9942857142857,12.5485714285714,563,4,0,0,0,847,559,847
2017,2,15,"Artvin",41.182,41.8191,32.5,6.1,0.657714285714286,55.9571428571429,23.3414285714286,11.1928571428571,757,29,120,336,517,1214,728,1094
2017,3,15,"Artvin",41.182,41.8191,28.0428571428571,4.71428571428571,0.400714285714286,64.3285714285714,24.24,12.6128571428571,762,2,0,198,274,1449,760,1449
2017,4,15,"Artvin",41.182,41.8191,26.4857142857143,1.44285714285714,1.58614285714286,71.0714285714286,20.0471428571429,9.52571428571428,639,12,71,240,316,889,627,818
2017,5,15,"Artvin",41.182,41.8191,36.8714285714286,0.457142857142857,2.51442857142857,72.0571428571429,28.8642857142857,14.7171428571429,588,6,1,91,395,1163,582,1162
2017,6,15,"Artvin",41.182,41.8191,31.2285714285714,6.01428571428571,0.486,68.7714285714286,21.41,10.2842857142857,736,0,0,104,178,1519,736,1519
2017,7,15,"Artvin",41.182,41.8191,31.5,0.328571428571429,3.17157142857143,72.1285714285714,15.3142857142857,8.65285714285714,492,54,112,299,490,717,438,605
2017,8,15,"Artvin",41.182,41.8191,37.9142857142857,8.05714285714286,2.41414285714286,51.9714285714286,26.02,12.9428571428571,739,1,3,95,195,1747,738,1744
2017,9,15,"Artvin",41.182,41.8191,28.7,10.3,0.228571428571429,56.7714285714286,35.0371428571429,10.57,574,4,3,212,314,866,570,863
2017,10,15,"Artvin",41.182,41.8191,40.4714285714286,14.1857142857143,0.0428571428571429,35.5142857142857,31.9871428571429,6.12142857142857,712,8,4,0,0,1043,704,1039
2017,11,15,"Artvin",41.182,41.8191,28.3285714285714,8.48571428571429,2.14285714285714,67,16.8757142857143,6.82142857142857,525,4,4,203,328,725,521,721
2017,12,15,"Artvin",41.182,41.8191,26.7,6.37142857142857,0.8,62.8,26.8342857142857,12.6757142857143,589,248,384,0,0,1077,341,693
2017,13,15,"Artvin",41.182,41.8191,33.6142857142857,8.32857142857143,1.47142857142857,63.0428571428571,23.8814285714286,9.10714285714286,574,36,56,106,195,887,538,831
2017,14,15,"Artvin",41.182,41.8191,32.9285714285714,11.8285714285714,1.14285714285714,56.5285714285714,21.0428571428571,6.99,639,227,597,168,335,1336,412,739
2017,15,15,"Artvin",41.182,41.8191,24.8428571428571,10.9285714285714,0.771428571428571,63.5571428571429,16.4557142857143,6.61571428571429,587,228,478,85,118,1187,359,709
2017,16,15,"Artvin",41.182,41.8191,36.8285714285714,13.8142857142857,0.657142857142857,56.8857142857143,19.6757142857143,5.14,717,32,45,187,150,920,685,875
2017,17,15,"Artvin",41.182,41.8191,23.6142857142857,13.5857142857143,0.385857142857143,49.9428571428571,21.0285714285714,4.62857142857143,731,116,249,5,30,1478,615,1229
2017,18,15,"Artvin",41.182,41.8191,25.4428571428571,16.8714285714286,1.62857142857143,61.6,31.0642857142857,4.72285714285714,506,9,20,86,178,923,497,903
2017,19,15,"Artvin",41.182,41.8191,36.0428571428571,17.1571428571429,3.943,63.3285714285714,17.88,3.56857142857143,471,62,87,31,48,966,409,879
2017,20,15,"Artvin",41.182,41.8191,23.3285714285714,13.3285714285714,5.42914285714286,82.1142857142857,11.1028571428571,3.12428571428571,472,76,120,169,721,1205,396,1085
2017,21,15,"Artvin",41.182,41.8191,25.7285714285714,15.1142857142857,4.72871428571429,68.7714285714286,11.8957142857143,3.40714285714286,448,22,3,101,257,849,426,846
2017,22,15,"Artvin",41.182,41.8191,21.9571428571429,18.2142857142857,0.685714285714286,67.7714285714286,20.3157142857143,3.59285714285714,522,110,315,15,30,1015,412,700
2017,23,15,"Artvin",41.182,41.8191,25.4428571428571,20.9,1.17157142857143,67.4714285714286,21.2742857142857,4.17857142857143,578,90,145,63,200,1388,488,1243
2017,24,15,"Artvin",41.182,41.8191,24.1142857142857,18.1285714285714,3.18585714285714,71.2857142857143,17.198,3.268,552,72,176,91,204,1139,480,963
2017,25,15,"Artvin",41.182,41.8191,26.9857142857143,19.3,0.828571428571429,67.2714285714286,16.2557142857143,3.08285714285714,584,205,422,63,85,1041,379,619
2017,26,15,"Artvin",41.182,41.8191,24.6714285714286,23.5714285714286,0.0857142857142857,64.3857142857143,25.5871428571429,3.45571428571429,564,226,423,0,0,971,338,548
2017,27,15,"Artvin",41.182,41.8191,25.1571428571429,22.4714285714286,1.48642857142857,69.3571428571429,28.4916666666667,2.68857142857143,511,25,101,217,250,642,486,541
2017,28,15,"Artvin",41.182,41.8191,24.8714285714286,21.9571428571429,1.22857142857143,68.9142857142857,19.9771428571429,2.57428571428571,481,102,119,0,0,864,379,745
2017,29,15,"Artvin",41.182,41.8191,22.7285714285714,23.1428571428571,1.12857142857143,77.3285714285714,17.9928571428571,2.14571428571429,532,0,0,79,151,1272,532,1272
2017,30,15,"Artvin",41.182,41.8191,30.4285714285714,24.8714285714286,1.81428571428571,61.7571428571429,23.9885714285714,2.39285714285714,531,161,366,0,0,928,370,562
2017,31,15,"Artvin",41.182,41.8191,23.2857142857143,24.2714285714286,0.8,73.5571428571429,23.0914285714286,2.91142857142857,559,287,384,0,0,1047,272,663
2017,32,15,"Artvin",41.182,41.8191,23.5428571428571,26.9571428571429,0.514285714285714,70.9571428571429,31.0728571428571,2.58285714285714,567,275,593,0,0,1092,292,499
2017,33,15,"Artvin",41.182,41.8191,25.0857142857143,25.4285714285714,1.85714285714286,69.3857142857143,20.89,2.48714285714286,596,177,323,0,0,1199,419,876
2017,34,15,"Artvin",41.182,41.8191,22.2571428571429,23.2857142857143,0.343428571428571,74.4285714285714,16.81,2.29166666666667,601,60,44,178,372,1280,541,1236
2017,35,15,"Artvin",41.182,41.8191,24.8714285714286,21.9714285714286,1.42871428571429,74.8571428571429,14.9714285714286,2.49333333333333,493,45,152,29,113,1014,448,862
2017,36,15,"Artvin",41.182,41.8191,29.9714285714286,21.8,2.44328571428571,64.5857142857143,15.4728571428571,2.83,507,81,225,69,170,1321,426,1096
2017,37,15,"Artvin",41.182,41.8191,32.0714285714286,23.7714285714286,0,52.7,40.2914285714286,NA,589,52,278,0,0,1138,537,860
2017,38,15,"Artvin",41.182,41.8191,29.3428571428571,23.8142857142857,0.0721428571428571,63.5285714285714,45.8357142857143,NA,671,22,71,121,371,1312,649,1241
2017,39,15,"Artvin",41.182,41.8191,21.4571428571429,18.5571428571429,4.12885714285714,79.0571428571429,18.2757142857143,4.2975,782,40,236,0,0,1630,742,1394
2017,40,15,"Artvin",41.182,41.8191,31.3714285714286,15.6142857142857,1.22928571428571,64.1857142857143,14.3828571428571,4.40285714285714,543,23,89,32,17,1137,520,1048
2017,41,15,"Artvin",41.182,41.8191,23.9285714285714,14.4285714285714,2.47228571428571,78.5857142857143,15.3257142857143,4.59142857142857,487,1,0,182,371,843,486,843
2017,42,15,"Artvin",41.182,41.8191,39.4428571428571,12.9285714285714,5.75714285714286,69.3857142857143,24.2442857142857,8.46571428571429,530,0,0,144,215,815,530,815
2017,43,15,"Artvin",41.182,41.8191,34.5571428571429,16.6285714285714,2.97142857142857,60.3857142857143,51.24,7.39428571428571,506,14,19,118,197,919,492,900
2017,44,15,"Artvin",41.182,41.8191,33.7,9.97142857142857,3.22914285714286,70.0857142857143,15.5414285714286,7.54285714285714,561,117,134,46,111,1102,444,968
2017,45,15,"Artvin",41.182,41.8191,19.8714285714286,12.7,1.22857142857143,77.2142857142857,33.9928571428571,12.1071428571429,577,80,68,160,171,829,497,761
2017,46,15,"Artvin",41.182,41.8191,33.0714285714286,13.2142857142857,0.0428571428571429,55.9,45.0185714285714,12.8242857142857,587,81,151,0,0,1085,506,934
2017,47,15,"Artvin",41.182,41.8191,40.2571428571429,7.17142857142857,5.90028571428571,69.9285714285714,27.9485714285714,12.3828571428571,418,0,0,114,243,804,418,804
2017,48,15,"Artvin",41.182,41.8191,42.6285714285714,8.27142857142857,0.642857142857143,58.5285714285714,23.7271428571429,12.8985714285714,386,17,47,43,50,619,369,572
2017,49,15,"Artvin",41.182,41.8191,42,7.1,9.98557142857143,70.5142857142857,28.3714285714286,15.1671428571429,407,8,46,166,217,645,399,599
2017,50,15,"Artvin",41.182,41.8191,39.6571428571429,8.7,0.0144285714285714,54.5428571428571,25.8042857142857,15.6442857142857,346,16,79,0,0,442,330,363
2017,51,15,"Artvin",41.182,41.8191,28.0285714285714,8.45714285714286,1.729,74.6571428571429,38.2042857142857,15.4514285714286,386,1,0,233,169,349,385,349
2017,52,15,"Artvin",41.182,41.8191,34.5,10.0125,0.525,56.3875,34.4725,14.35375,528,33,126,0,0,507,495,381
2018,1,15,"Artvin",41.182,41.8191,32.6125,8.4,3.175375,71.1125,21.5085714285714,11.2928571428571,618,8,13,97,138,914,610,901
2018,2,15,"Artvin",41.182,41.8191,28.8285714285714,7.28571428571429,6.52857142857143,70.2571428571429,24.68,13.7071428571429,624,21,22,106,104,1309,603,1287
2018,3,15,"Artvin",41.182,41.8191,39.0142857142857,7.04285714285714,1.25728571428571,64.6428571428571,14.0542857142857,7.78285714285714,639,20,21,194,117,655,619,634
2018,4,15,"Artvin",41.182,41.8191,21.2142857142857,6.12857142857143,1.01428571428571,70.9857142857143,24.07,10.5057142857143,604,3,0,253,283,764,601,764
2018,5,15,"Artvin",41.182,41.8191,40.2571428571429,5.72857142857143,7.143,68.5142857142857,29.7714285714286,16.4385714285714,670,29,80,0,0,819,641,739
2018,6,15,"Artvin",41.182,41.8191,31.5285714285714,9.55714285714286,1.41428571428571,65.0285714285714,36.9671428571429,13.5971428571429,704,219,402,0,0,1022,485,620
2018,7,15,"Artvin",41.182,41.8191,29.9428571428571,9.21428571428572,2.51457142857143,67.9285714285714,19.1628571428571,10.2328571428571,478,5,2,167,178,557,473,555
2018,8,15,"Artvin",41.182,41.8191,16.3142857142857,8.48571428571429,0.571571428571429,69.6571428571429,26.9571428571429,13.7828571428571,711,208,315,0,0,1321,503,1006
2018,9,15,"Artvin",41.182,41.8191,38.1428571428571,9.2,0.657571428571429,61.9285714285714,13.6642857142857,7.91714285714286,621,15,48,136,221,956,606,908
2018,10,15,"Artvin",41.182,41.8191,27.5714285714286,9.72857142857143,1.24357142857143,71.3,24.7285714285714,11.3485714285714,556,99,195,103,255,1330,457,1135
2018,11,15,"Artvin",41.182,41.8191,30.4571428571429,12,1.81442857142857,60.9285714285714,22.4316666666667,8.58571428571429,551,97,144,129,511,1426,454,1282
2018,12,15,"Artvin",41.182,41.8191,36.7857142857143,14.6857142857143,0.943,55.3142857142857,44.1442857142857,7.57285714285714,425,60,177,113,312,1187,365,1010
2018,13,15,"Artvin",41.182,41.8191,28.5714285714286,14.0857142857143,1.18571428571429,59.5571428571429,35.9028571428571,5.55428571428571,356,64,87,91,125,428,292,341
2018,14,15,"Artvin",41.182,41.8191,31,13.0857142857143,1.77142857142857,50.7857142857143,20.5085714285714,6.79,407,121,269,0,0,486,286,217
2018,15,15,"Artvin",41.182,41.8191,18.0571428571429,14.9714285714286,0.442857142857143,61.6714285714286,32.3514285714286,6.36,374,0,0,14,52,450,374,450
2018,16,15,"Artvin",41.182,41.8191,23.5571428571429,11.3857142857143,0.643,60.4285714285714,22.7257142857143,6.84714285714286,411,87,164,45,59,648,324,484
2018,17,15,"Artvin",41.182,41.8191,24.8857142857143,15.9714285714286,0.0571428571428571,52.9857142857143,27.1528571428571,8.602,419,30,47,50,44,652,389,605
2018,18,15,"Artvin",41.182,41.8191,20.7142857142857,19.9714285714286,0.742857142857143,60.4142857142857,26.6514285714286,9.94571428571428,303,38,90,37,33,474,265,384
2018,19,15,"Artvin",41.182,41.8191,23.5142857142857,15.8428571428571,2.02871428571429,75.9428571428572,22.1585714285714,9.59285714285714,275,42,111,90,96,467,233,356
2018,20,15,"Artvin",41.182,41.8191,19.3428571428571,18.9857142857143,1.14285714285714,63.5857142857143,21.2866666666667,9.77,204,87,122,15,5,306,117,184
2018,21,15,"Artvin",41.182,41.8191,19,19.9714285714286,2.48585714285714,74.4714285714286,21.16,5.38428571428571,252,78,96,38,67,281,174,185
2018,22,15,"Artvin",41.182,41.8191,24.0714285714286,19.4285714285714,3.41442857142857,75.1142857142857,22.0457142857143,4.19428571428571,249,15,26,11,36,427,234,401
2018,23,15,"Artvin",41.182,41.8191,21.7142857142857,20.4857142857143,0.985714285714286,66.0857142857143,18.3857142857143,4.46428571428571,267,60,206,14,48,812,207,606
2018,24,15,"Artvin",41.182,41.8191,27.7571428571429,22.3714285714286,1.35714285714286,62.6,21.3928571428571,4,267,113,158,27,15,448,154,290
2018,25,15,"Artvin",41.182,41.8191,21.9571428571429,22,0.828571428571429,71.6571428571429,15.4771428571429,4.092,358,144,145,0,0,518,214,373
2018,26,15,"Artvin",41.182,41.8191,23.5428571428571,25.8428571428571,2.17142857142857,70.5,21.6571428571429,5.45285714285714,355,7,0,3,0,587,348,587
2018,27,15,"Artvin",41.182,41.8191,23.5857142857143,21.8571428571429,2.6,76.0285714285714,18.7771428571429,4.15428571428571,342,6,16,42,66,418,336,402
2018,28,15,"Artvin",41.182,41.8191,23.3285714285714,23.2142857142857,1.92857142857143,75.2857142857143,22.4457142857143,5.26857142857143,286,90,144,21,43,585,196,441
2018,29,15,"Artvin",41.182,41.8191,25.4428571428571,22.3428571428571,0.928714285714286,66.1285714285714,15.6071428571429,5.26428571428571,260,89,323,1,0,756,171,433
2018,30,15,"Artvin",41.182,41.8191,23.0285714285714,25.7714285714286,0.714285714285714,67.8571428571429,21.7142857142857,2.51333333333333,265,56,156,44,287,822,209,666
2018,31,15,"Artvin",41.182,41.8191,25.9142857142857,24.4142857142857,1.77142857142857,74.2571428571429,20.5971428571429,4.28,267,40,15,10,21,499,227,484
2018,32,15,"Artvin",41.182,41.8191,27.5571428571429,22.5285714285714,2.14342857142857,75.9571428571429,19.8171428571429,4.58,297,35,41,121,147,403,262,362
2018,33,15,"Artvin",41.182,41.8191,25.0428571428571,22.7857142857143,1.22857142857143,70.6285714285714,20.6142857142857,4.82666666666667,216,127,220,0,0,332,89,112
2018,34,15,"Artvin",41.182,41.8191,23.0285714285714,23.9571428571429,2.11442857142857,71.2142857142857,22.29,4.58428571428571,144,98,140,6,35,227,46,87
2018,35,15,"Artvin",41.182,41.8191,24.5714285714286,24.2571428571429,1.74285714285714,69.8285714285714,23.8885714285714,6.49714285714286,201,50,124,0,0,314,151,190
2018,36,15,"Artvin",41.182,41.8191,30.9428571428571,22.5571428571429,3.11428571428571,67.3142857142857,22.8428571428571,5.00142857142857,341,54,54,0,0,370,287,316
2018,37,15,"Artvin",41.182,41.8191,26.4285714285714,20.7857142857143,1.90028571428571,70.2571428571429,21.7785714285714,4.79428571428571,241,10,33,0,0,419,231,386
2018,38,15,"Artvin",41.182,41.8191,17.4428571428571,16.9,1.35728571428571,80.4428571428571,20.0128571428571,5.45285714285714,189,0,0,0,0,344,189,344
2018,39,15,"Artvin",41.182,41.8191,20.8428571428571,18.0714285714286,0.514857142857143,71.0285714285714,15.5757142857143,6.52714285714286,180,10,59,66,154,353,170,294
2018,40,15,"Artvin",41.182,41.8191,31.1285714285714,17.9428571428571,4.92914285714286,69.8285714285714,17.4457142857143,7.15142857142857,191,17,74,0,0,341,174,267
2018,41,15,"Artvin",41.182,41.8191,16.9,18.8857142857143,0.385714285714286,72.6857142857143,27.4157142857143,8.49285714285714,187,98,181,0,0,422,89,241
2018,42,15,"Artvin",41.182,41.8191,25.6,18.4714285714286,0.128571428571429,62.5428571428571,39.4357142857143,8.70142857142857,168,16,12,0,0,381,152,369
2018,43,15,"Artvin",41.182,41.8191,34.4,14.0571428571429,3.30071428571429,72.7714285714286,16.2442857142857,8.30714285714286,187,7,38,30,126,402,180,364
2018,44,15,"Artvin",41.182,41.8191,30.2,14.4571428571429,0.0285714285714286,56.0285714285714,19.0914285714286,10.1971428571429,196,3,21,0,0,264,193,243
2018,45,15,"Artvin",41.182,41.8191,29.2142857142857,11.9571428571429,0.242857142857143,63.4428571428571,25.8471428571429,14.0814285714286,231,4,1,0,0,473,227,472
2018,46,15,"Artvin",41.182,41.8191,27.0571428571429,8.28571428571428,4.21485714285714,80.5428571428571,25.3942857142857,17.3885714285714,230,2,5,0,0,465,228,460
2018,47,15,"Artvin",41.182,41.8191,27.5142857142857,9.58571428571429,3.77214285714286,78.8,35.2028571428571,21.5585714285714,270,17,81,18,8,499,253,418
2018,48,15,"Artvin",41.182,41.8191,31.2714285714286,12.5285714285714,2.05728571428571,66.7285714285714,25.8128571428571,16.9757142857143,245,23,68,48,47,201,222,133
2018,49,15,"Artvin",41.182,41.8191,27.5142857142857,8.92857142857143,0.586,74.0428571428571,21.9085714285714,14.9857142857143,257,68,155,55,136,420,189,265
2018,50,15,"Artvin",41.182,41.8191,33.6428571428571,7.7,3.586,70.1571428571429,23.6414285714286,15.0685714285714,256,32,97,9,5,305,224,208
2018,51,15,"Artvin",41.182,41.8191,34.4714285714286,9.72857142857143,0.800142857142857,67.2,29.2528571428571,15.3071428571429,250,10,13,34,54,248,240,235
2018,52,15,"Artvin",41.182,41.8191,29.9285714285714,4.67142857142857,4.04342857142857,76.3142857142857,16.2525,10.885,244,20,72,78,92,273,224,201
2019,1,15,"Artvin",41.182,41.8191,27.5,8.6625,2.3375,65.775,NA,24.925,343,73,153,26,44,784,270,631
2019,2,15,"Artvin",41.182,41.8191,39.1285714285714,6.38571428571429,1.87142857142857,59.5285714285714,18.2266666666667,10.1966666666667,255,14,42,86,91,208,241,166
2019,3,15,"Artvin",41.182,41.8191,32.3428571428571,5.95714285714286,1.22871428571429,57.8428571428571,18.5528571428571,8.52142857142857,192,9,10,18,8,198,183,188
2019,4,15,"Artvin",41.182,41.8191,37.1,9.57142857142857,0.542857142857143,46.2285714285714,35.9642857142857,11.5628571428571,308,19,149,0,0,314,289,165
2019,5,15,"Artvin",41.182,41.8191,31.5285714285714,8.7,2.05728571428571,58.2,32.9428571428571,12.5185714285714,253,7,6,50,23,143,246,137
2019,6,15,"Artvin",41.182,41.8191,25.9857142857143,9.75714285714286,0.300142857142857,54.7571428571429,19.7757142857143,9.53571428571428,276,4,1,8,6,127,272,126
2019,7,15,"Artvin",41.182,41.8191,25.4714285714286,6.37142857142857,0.985857142857143,68.8,18.3585714285714,9.93285714285714,325,1,16,136,54,234,324,218
2019,8,15,"Artvin",41.182,41.8191,37.0857142857143,6.25714285714286,2.05714285714286,64.2571428571429,24.8985714285714,11.0714285714286,305,2,1,105,70,219,303,218
2019,9,15,"Artvin",41.182,41.8191,23.5142857142857,4.04285714285714,5.34314285714286,81.1714285714286,17.9828571428571,11.3333333333333,331,0,0,82,115,310,331,310
2019,10,15,"Artvin",41.182,41.8191,33.6285714285714,8.31428571428571,0.428571428571429,58.0714285714286,20.8114285714286,10.3114285714286,359,8,25,48,36,252,351,227
2019,11,15,"Artvin",41.182,41.8191,28.6428571428571,10.6,1.75714285714286,64.5857142857143,22.5742857142857,8.78285714285714,373,0,0,85,87,400,373,400
2019,12,15,"Artvin",41.182,41.8191,22.6285714285714,6.34285714285714,1.62857142857143,68.2428571428571,17.93,9.305,343,4,257,195,94,416,339,159
2019,13,15,"Artvin",41.182,41.8191,17.4571428571429,5.4,0.228571428571429,73.9142857142857,21.1666666666667,14.3071428571429,256,58,51,2,51,194,198,143
2019,14,15,"Artvin",41.182,41.8191,20.9428571428571,8.6,0.614285714285714,74.5428571428571,23.1957142857143,15.0185714285714,365,74,48,183,83,208,291,160
2019,15,15,"Artvin",41.182,41.8191,32.5428571428571,15.5142857142857,0.742857142857143,49.3142857142857,17.6842857142857,9.26857142857143,359,15,30,43,4,183,344,153
2019,16,15,"Artvin",41.182,41.8191,18.4857142857143,8.8,6.45742857142857,80.9428571428572,12.1585714285714,7.48142857142857,318,0,0,22,29,208,318,208
2019,17,15,"Artvin",41.182,41.8191,22.4428571428571,11.8428571428571,0.814428571428571,59.0142857142857,16.5328571428571,9.86428571428571,412,206,183,7,2,313,206,130
2019,18,15,"Artvin",41.182,41.8191,27.5714285714286,16.5428571428571,2.25714285714286,61.1142857142857,21.7285714285714,7.46142857142857,523,153,70,143,65,353,370,283
2019,19,15,"Artvin",41.182,41.8191,28.9,17.2428571428571,0.842857142857143,61.3285714285714,26.1785714285714,5.29714285714286,452,6,4,41,51,386,446,382
2019,20,15,"Artvin",41.182,41.8191,27.3142857142857,20.7,0.0857142857142857,49.2,22.3542857142857,5.85285714285714,454,153,136,44,31,389,301,253
2019,21,15,"Artvin",41.182,41.8191,30.1857142857143,18.3714285714286,3.68571428571429,72.1428571428571,21.648,5.41,457,146,100,1,2,413,311,313
2019,22,15,"Artvin",41.182,41.8191,24.9428571428571,21.4,0,52.9285714285714,22.0566666666667,5.53333333333333,453,155,146,0,0,323,298,177
2019,23,15,"Artvin",41.182,41.8191,23.5857142857143,22.7857142857143,0.414285714285714,75.2714285714286,24.5014285714286,NA,378,59,121,2,0,532,319,411
2019,24,15,"Artvin",41.182,41.8191,22.9857142857143,23.7,1.62857142857143,66.1714285714286,24.6071428571429,NA,378,96,72,1,0,244,282,172
2019,25,15,"Artvin",41.182,41.8191,24.1,23.3142857142857,1.62857142857143,70.3571428571429,20.4028571428571,NA,306,112,141,0,0,325,194,184
2019,26,15,"Artvin",41.182,41.8191,23.8571428571429,22.1857142857143,1.515,75.2142857142857,19.5057142857143,NA,377,0,0,61,41,342,377,342
2019,27,15,"Artvin",41.182,41.8191,26.4714285714286,20.8,0.171428571428571,67.9428571428572,18.8,4.04,456,73,20,0,0,222,383,202
2019,28,15,"Artvin",41.182,41.8191,22.7714285714286,21.7,2.20057142857143,69.1285714285714,17.66,4.04142857142857,398,187,166,110,77,421,211,255
2019,29,15,"Artvin",41.182,41.8191,25.9142857142857,21.4857142857143,1.77142857142857,74.7714285714286,15.9457142857143,4.87,453,128,60,65,24,203,325,143
2019,30,15,"Artvin",41.182,41.8191,23.8428571428571,21.1142857142857,1.32914285714286,73.8,23.99,5.14428571428571,456,134,100,0,0,335,322,235
2019,31,15,"Artvin",41.182,41.8191,26.2142857142857,24.5285714285714,0.0572857142857143,62.9857142857143,NA,5.73,334,124,139,0,0,375,210,236
2019,32,15,"Artvin",41.182,41.8191,25.3,21.0285714285714,1.12914285714286,72.1714285714286,NA,5.09857142857143,346,136,114,51,37,395,210,281
2019,33,15,"Artvin",41.182,41.8191,22.5142857142857,23.8857142857143,0.928571428571429,72.2571428571429,NA,6.21142857142857,337,134,162,2,1,531,203,369
2019,34,15,"Artvin",41.182,41.8191,22.8571428571429,23.3,1.42871428571429,78.2,NA,4.82571428571429,299,50,90,124,124,345,249,255
2019,35,15,"Artvin",41.182,41.8191,24.4142857142857,22.8857142857143,4.31442857142857,75.2571428571429,NA,5.28714285714286,307,162,229,0,0,415,145,186
2019,36,15,"Artvin",41.182,41.8191,22.4857142857143,20.8142857142857,3.22857142857143,76.1,NA,6.51,171,55,48,0,0,67,116,19
2019,37,15,"Artvin",41.182,41.8191,24.3142857142857,19.8714285714286,1.20028571428571,71.9142857142857,NA,6.886,218,160,29,0,0,55,58,26
2019,38,15,"Artvin",41.182,41.8191,29.8857142857143,17.6714285714286,4.08657142857143,72.6714285714286,NA,7.8175,266,60,14,35,16,91,206,77
2019,39,15,"Artvin",41.182,41.8191,28.6428571428571,17.9428571428571,1.31485714285714,66.3285714285714,NA,NA,237,16,15,1,0,79,221,64
2019,40,15,"Artvin",41.182,41.8191,33.1142857142857,20.1285714285714,1.44285714285714,56.6285714285714,NA,NA,241,9,22,35,7,111,232,89
2019,41,15,"Artvin",41.182,41.8191,25.6571428571429,16.8285714285714,0.514857142857143,72.1714285714286,NA,7.25666666666667,416,80,124,84,77,448,336,324
2019,42,15,"Artvin",41.182,41.8191,24.3714285714286,17.9142857142857,0.9,61.0285714285714,NA,8.48,356,101,113,0,0,408,255,295
2019,43,15,"Artvin",41.182,41.8191,22.4714285714286,16.6714285714286,0.385714285714286,76.4857142857143,NA,10.5414285714286,306,70,101,49,15,300,236,199
2019,44,15,"Artvin",41.182,41.8191,27.8142857142857,12.6571428571429,1.88657142857143,76.9142857142857,NA,12.0771428571429,350,56,45,42,33,250,294,205
2019,45,15,"Artvin",41.182,41.8191,40.2285714285714,14.2571428571429,0,45.6857142857143,NA,15.1957142857143,417,15,27,0,0,328,402,301
2019,46,15,"Artvin",41.182,41.8191,38.5714285714286,13.8428571428571,0,39.4142857142857,NA,15.9885714285714,401,26,39,0,0,337,375,298
2019,47,15,"Artvin",41.182,41.8191,31.0142857142857,9.97142857142857,0.214285714285714,52.4714285714286,NA,17.2457142857143,391,11,33,0,0,339,380,306
2019,48,15,"Artvin",41.182,41.8191,33.9571428571429,12.0428571428571,1.3,59.5428571428571,NA,16.1042857142857,320,24,32,0,0,251,296,219
2019,49,15,"Artvin",41.182,41.8191,30.3142857142857,5.5,1.029,72.6428571428571,NA,15.8342857142857,393,15,15,3,1,274,378,259
2019,50,15,"Artvin",41.182,41.8191,35.4428571428571,9.54285714285714,0.642857142857143,52.0142857142857,NA,21.6428571428571,218,10,4,0,0,119,208,115
2019,51,15,"Artvin",41.182,41.8191,38.1714285714286,8.84285714285714,1.31442857142857,57.8,NA,22.865,361,11,16,54,9,488,350,472
2019,52,15,"Artvin",41.182,41.8191,33.5,12.8857142857143,1.38571428571429,46.5285714285714,NA,9.33714285714286,279,11,18,35,16,281,268,263
2020,1,15,"Artvin",41.182,41.8191,21.5,5.46,1.6204,77.48,NA,19.402,160,2,0,53,64,126,158,126
2020,2,15,"Artvin",41.182,41.8191,31.6714285714286,6.28571428571429,3.21428571428571,66.2285714285714,NA,21.02,240,14,8,26,45,173,226,165
2020,3,15,"Artvin",41.182,41.8191,30.3571428571429,3.88571428571429,2.58585714285714,67.3285714285714,NA,21.3242857142857,270,1,0,27,23,382,269,382
2020,4,15,"Artvin",41.182,41.8191,33.2857142857143,2.91428571428571,6.95714285714286,76.5857142857143,NA,30.8883333333333,358,3,2,99,81,295,355,293
2020,5,15,"Artvin",41.182,41.8191,37.4,5.98571428571429,3.47128571428571,63.9285714285714,NA,24.9014285714286,331,9,8,33,24,272,322,264
2020,6,15,"Artvin",41.182,41.8191,37.5142857142857,5.57142857142857,5.22914285714286,72.3571428571429,NA,17.5042857142857,343,16,16,87,65,267,327,251
2020,7,15,"Artvin",41.182,41.8191,38.4428571428571,1.25714285714286,4.67171428571429,64.5142857142857,NA,33.1314285714286,341,10,4,45,48,338,331,334
2020,8,15,"Artvin",41.182,41.8191,20.7285714285714,6.74285714285714,0.4,65.8142857142857,NA,27.9228571428571,283,32,18,0,0,187,251,169
2020,9,15,"Artvin",41.182,41.8191,39.9857142857143,8.22857142857143,1.74314285714286,60.4142857142857,NA,26.78,393,16,39,118,139,528,377,489
2020,10,15,"Artvin",41.182,41.8191,35.5142857142857,13.1428571428571,0.0428571428571429,42.7285714285714,NA,NA,205,16,19,12,12,210,189,191
2020,11,15,"Artvin",41.182,41.8191,28.9714285714286,14.5428571428571,0.4,54.8285714285714,NA,NA,115,6,1,16,11,94,109,93
2020,12,15,"Artvin",41.182,41.8191,19.2857142857143,5.5,2.22885714285714,78.7714285714286,NA,NA,117,56,60,14,7,118,61,58
2020,13,15,"Artvin",41.182,41.8191,16.5714285714286,11.0142857142857,1.05714285714286,71.7714285714286,28.73,NA,136,11,8,16,10,92,125,84
2020,14,15,"Artvin",41.182,41.8191,23.5714285714286,10.5285714285714,4.07171428571429,72.7714285714286,20.6457142857143,NA,155,40,13,55,44,121,115,108
2020,15,15,"Artvin",41.182,41.8191,20.0428571428571,8.85714285714286,0.357142857142857,75.6428571428571,23.3028571428571,NA,133,18,18,22,13,118,115,100
2020,16,15,"Artvin",41.182,41.8191,27.9285714285714,12.6428571428571,0.114285714285714,56.5428571428571,22.9857142857143,NA,141,25,16,0,0,106,116,90
2020,17,15,"Artvin",41.182,41.8191,22.0428571428571,9.78571428571429,3.7,74.9571428571429,17.1528571428571,NA,137,27,18,19,17,123,110,105
2020,18,15,"Artvin",41.182,41.8191,25.6571428571429,14.8142857142857,1.41428571428571,59.9714285714286,21.7814285714286,NA,146,50,42,0,0,164,96,122
2020,19,15,"Artvin",41.182,41.8191,24.8857142857143,13.3714285714286,7.05728571428571,78.7857142857143,13.7828571428571,NA,137,21,16,77,103,157,116,141
2020,20,15,"Artvin",41.182,41.8191,34.0428571428571,18.8285714285714,0.157142857142857,52.4857142857143,35.77,NA,164,20,39,29,27,164,144,125
2020,21,15,"Artvin",41.182,41.8191,34,17.8142857142857,2.12857142857143,60.2857142857143,27.83,NA,146,15,8,68,71,96,131,88
2020,22,15,"Artvin",41.182,41.8191,23.1571428571429,16.8428571428571,3.3,72.5428571428571,18.3214285714286,NA,118,6,2,26,34,100,112,98
2020,23,15,"Artvin",41.182,41.8191,26.8428571428571,20.1,1.54285714285714,62.8857142857143,20.3185714285714,NA,112,7,18,0,0,70,105,52
2020,24,15,"Artvin",41.182,41.8191,22.7428571428571,23.7142857142857,0.328571428571429,59.9428571428571,27.56,10.09,140,54,71,9,1,150,86,79
2020,25,15,"Artvin",41.182,41.8191,24.0571428571429,22.2,4.42842857142857,66.5428571428571,19.4914285714286,9.75714285714286,137,32,26,6,1,108,105,82
2020,26,15,"Artvin",41.182,41.8191,24.4571428571429,22.4285714285714,0.586142857142857,69.0714285714286,20.5414285714286,9.02714285714286,173,50,45,32,25,133,123,88
2020,27,15,"Artvin",41.182,41.8191,22.2571428571429,24.0428571428571,1.35714285714286,70.4714285714286,21.6216666666667,9.14833333333333,113,32,51,17,9,113,81,62
2020,28,15,"Artvin",41.182,41.8191,23.0285714285714,23.8857142857143,0.943142857142857,72.8857142857143,19.2414285714286,8.53714285714286,164,40,13,0,0,122,124,109
2020,29,15,"Artvin",41.182,41.8191,24.0571428571429,23.2,5.64285714285714,73.5571428571429,16.9371428571429,8.57,186,38,37,25,14,111,148,74
2020,30,15,"Artvin",41.182,41.8191,24.2428571428571,23.3857142857143,1.57171428571429,75.5285714285714,16.1657142857143,8.09714285714286,190,70,21,91,107,142,120,121
2020,31,15,"Artvin",41.182,41.8191,21.6142857142857,23.3428571428571,1.81457142857143,77.1714285714286,16.5885714285714,8.21714285714286,150,44,43,26,19,127,106,84
2020,32,15,"Artvin",41.182,41.8191,23.3142857142857,23.4571428571429,0.614428571428571,69.0428571428571,16.8757142857143,8.35285714285714,146,114,90,0,0,107,32,17
2020,33,15,"Artvin",41.182,41.8191,25.3142857142857,21.6571428571429,3.71442857142857,73.0285714285714,15.795,8.60142857142857,183,49,20,0,0,83,134,63
2020,34,15,"Artvin",41.182,41.8191,23.5428571428571,21.7428571428571,2.80042857142857,72.6714285714286,15.3642857142857,8.70142857142857,197,94,33,0,0,97,103,64
2020,35,15,"Artvin",41.182,41.8191,26.6,22.5428571428571,0.171428571428571,66.8857142857143,19.6571428571429,9.51857142857143,164,52,71,0,0,157,112,86
2020,36,15,"Artvin",41.182,41.8191,23.3428571428571,25.7142857142857,0.385714285714286,59.9714285714286,24.05,10.6071428571429,179,12,12,56,41,112,167,100
2020,37,15,"Artvin",41.182,41.8191,20.3,23.0285714285714,0.0574285714285714,70.7428571428571,17.4557142857143,9.28285714285714,193,97,59,0,0,91,96,32
2020,38,15,"Artvin",41.182,41.8191,21.4285714285714,22.3714285714286,3.60014285714286,74.4,20.7714285714286,9.60285714285714,235,99,77,0,0,157,136,80
2020,39,15,"Artvin",41.182,41.8191,23.0571428571429,21.6428571428571,0.528571428571429,70.2,14.7528571428571,9.81,220,111,67,0,0,129,109,62
2020,40,15,"Artvin",41.182,41.8191,27.4285714285714,20.9714285714286,0.600714285714286,67.7285714285714,13.2157142857143,10.1628571428571,187,37,45,0,0,154,150,109
2020,41,15,"Artvin",41.182,41.8191,32.5714285714286,20.1285714285714,0.757142857142857,49.5142857142857,11.4228571428571,10.9428571428571,182,32,22,0,0,127,150,105
2020,42,15,"Artvin",41.182,41.8191,31.4,20.2571428571429,0.0142857142857143,52.3714285714286,24.3414285714286,12.4942857142857,177,21,8,0,0,111,156,103
2020,43,15,"Artvin",41.182,41.8191,27.5714285714286,16.8857142857143,2.27185714285714,64.2142857142857,14.3642857142857,12.8457142857143,194,9,1,0,0,161,185,160
2020,44,15,"Artvin",41.182,41.8191,33.8,19.1142857142857,0.3,47.9714285714286,34.42,15.0157142857143,255,25,34,0,0,233,230,199
2020,45,15,"Artvin",41.182,41.8191,26.7285714285714,13.9714285714286,1.20057142857143,78.8142857142857,21.8557142857143,15.7742857142857,156,30,23,42,26,103,126,80
2020,46,15,"Artvin",41.182,41.8191,28.2142857142857,10.7428571428571,0.143,71.5428571428571,27.4157142857143,20.1771428571429,208,7,0,0,0,109,201,109
2020,47,15,"Artvin",41.182,41.8191,25.0428571428571,9.21428571428571,0.728857142857143,78.8857142857143,27.2214285714286,20.6128571428571,173,9,16,14,8,83,164,67
2020,48,15,"Artvin",41.182,41.8191,31.5428571428571,7.55714285714286,3.07142857142857,64.8,29.29,20.6228571428571,199,7,29,23,25,262,192,233
2020,49,15,"Artvin",41.182,41.8191,31.4,9.35714285714286,0.428571428571429,54.3428571428571,40.6771428571429,25.0671428571429,207,14,29,0,0,116,193,87
2020,50,15,"Artvin",41.182,41.8191,37.1857142857143,10.0714285714286,0.428571428571429,50.4571428571429,35.16,22.3285714285714,181,36,12,0,0,98,145,86
2020,51,15,"Artvin",41.182,41.8191,32.5142857142857,9.74285714285714,1.50085714285714,69.7857142857143,34.9842857142857,23.5685714285714,171,12,9,43,19,90,159,81
2020,52,15,"Artvin",41.182,41.8191,34.8428571428571,5.64285714285714,1.78571428571429,66.5857142857143,28.48,23.1214285714286,203,18,7,34,34,113,185,106
2020,53,15,"Artvin",41.182,41.8191,40.6,9.675,0,42.3,27.525,26.2025,122,20,7,0,0,111,102,104
2017,1,16,"Aydin",37.8444,27.8452,24.2857142857143,6.47142857142857,9.639,72.1571428571429,67.0885714285714,NA,563,147,204,153,257,847,416,643
2017,2,16,"Aydin",37.8444,27.8452,24.7,6.4,3.317,79.5571428571429,58.4314285714286,NA,757,261,433,0,0,1214,496,781
2017,3,16,"Aydin",37.8444,27.8452,20.3714285714286,8.8,2.78685714285714,79.7285714285714,45.2957142857143,NA,762,126,140,54,87,1449,636,1309
2017,4,16,"Aydin",37.8444,27.8452,24.6285714285714,5.41428571428571,0.980142857142857,66.2,46.7242857142857,NA,639,28,4,197,228,889,611,885
2017,5,16,"Aydin",37.8444,27.8452,19.2428571428571,6.72857142857143,1.31814285714286,70,79.6385714285714,NA,588,176,228,0,0,1163,412,935
2017,6,16,"Aydin",37.8444,27.8452,21.1428571428571,11.7,2.17114285714286,70.4285714285714,48.8528571428571,NA,736,245,370,127,389,1519,491,1149
2017,7,16,"Aydin",37.8444,27.8452,26.4714285714286,6.97142857142857,0,52.2,49.7528571428571,NA,492,134,113,44,51,717,358,604
2017,8,16,"Aydin",37.8444,27.8452,18.8,12.1,0,75.6571428571429,42.07,NA,739,203,376,146,347,1747,536,1371
2017,9,16,"Aydin",37.8444,27.8452,15.7571428571429,12.6857142857143,0.000428571428571429,78.8714285714286,71.37,NA,574,118,175,92,95,866,456,691
2017,10,16,"Aydin",37.8444,27.8452,20.8,12.4571428571429,3.67042857142857,78.1,NA,NA,712,248,411,160,210,1043,464,632
2017,11,16,"Aydin",37.8444,27.8452,20.2,9.24285714285714,0.00242857142857143,68.6714285714286,NA,NA,525,68,137,94,81,725,457,588
2017,12,16,"Aydin",37.8444,27.8452,29.4285714285714,14.7571428571429,0,69.0571428571428,60.97,NA,589,0,0,89,128,1077,589,1077
2017,13,16,"Aydin",37.8444,27.8452,22.5,14.7428571428571,0.592285714285714,68.7,53.5314285714286,NA,574,83,163,294,420,887,491,724
2017,14,16,"Aydin",37.8444,27.8452,22.5857142857143,15.0285714285714,0.310714285714286,63.0142857142857,39.9385714285714,NA,639,50,105,443,847,1336,589,1231
2017,15,16,"Aydin",37.8444,27.8452,20.2571428571429,15.9428571428571,0.0375714285714286,59.1571428571429,33.6885714285714,NA,587,94,248,40,173,1187,493,939
2017,16,16,"Aydin",37.8444,27.8452,20.3714285714286,14.6,3.34185714285714,71.3,30.0228571428571,NA,717,300,351,219,237,920,417,569
2017,17,16,"Aydin",37.8444,27.8452,19.2428571428571,17.1142857142857,0,57.6571428571429,38.3857142857143,NA,731,0,0,194,328,1478,731,1478
2017,18,16,"Aydin",37.8444,27.8452,21.8428571428571,20.3142857142857,0,64.6857142857143,45.6785714285714,NA,506,14,7,356,616,923,492,916
2017,19,16,"Aydin",37.8444,27.8452,24.9,21.4,0,56.8857142857143,37.4,NA,471,77,125,204,464,966,394,841
2017,20,16,"Aydin",37.8444,27.8452,26.2714285714286,20.3428571428571,0.276714285714286,58.0285714285714,32.3042857142857,NA,472,56,227,192,445,1205,416,978
2017,21,16,"Aydin",37.8444,27.8452,19.9428571428571,19.9142857142857,0.839285714285714,59.4714285714286,19.9171428571429,NA,448,60,152,243,435,849,388,697
2017,22,16,"Aydin",37.8444,27.8452,18.7571428571429,21.7714285714286,0.253571428571429,66.5571428571428,26.6257142857143,NA,522,0,0,213,532,1015,522,1015
2017,23,16,"Aydin",37.8444,27.8452,26.2,24.2428571428571,0.416142857142857,60.2428571428571,28.5085714285714,NA,578,0,0,454,1094,1388,578,1388
2017,24,16,"Aydin",37.8444,27.8452,23.7,24.6428571428571,1.04585714285714,57.5571428571429,38.8928571428571,NA,552,0,0,202,319,1139,552,1139
2017,25,16,"Aydin",37.8444,27.8452,21.9285714285714,25.7,0,48.2714285714286,29.0357142857143,NA,584,0,0,262,527,1041,584,1041
2017,26,16,"Aydin",37.8444,27.8452,19.0285714285714,29.8714285714286,0,46.2428571428571,46.0914285714286,NA,564,0,0,371,718,971,564,971
2017,27,16,"Aydin",37.8444,27.8452,27.5142857142857,28.7714285714286,0,42.4857142857143,45.0757142857143,NA,511,0,0,333,412,642,511,642
2017,28,16,"Aydin",37.8444,27.8452,23.4571428571429,29.3285714285714,0,45.8428571428571,49.2314285714286,NA,481,0,0,255,384,864,481,864
2017,29,16,"Aydin",37.8444,27.8452,28.6142857142857,27.5857142857143,0,55.3428571428571,46.5042857142857,NA,532,0,0,265,556,1272,532,1272
2017,30,16,"Aydin",37.8444,27.8452,27.1428571428571,28.0857142857143,0,48.7142857142857,41.7071428571429,NA,531,0,0,298,588,928,531,928
2017,31,16,"Aydin",37.8444,27.8452,28.5,29.0142857142857,0.137142857142857,51.3571428571429,49.0971428571429,NA,559,0,0,347,723,1047,559,1047
2017,32,16,"Aydin",37.8444,27.8452,23.0142857142857,29.6,0,56.3571428571429,48.7342857142857,NA,567,0,0,455,849,1092,567,1092
2017,33,16,"Aydin",37.8444,27.8452,22.4857142857143,28.3428571428571,0,53.4,47.2685714285714,NA,596,0,0,477,969,1199,596,1199
2017,34,16,"Aydin",37.8444,27.8452,24.2285714285714,26.8,0.000142857142857143,54.7285714285714,43.1,NA,601,0,0,277,472,1280,601,1280
2017,35,16,"Aydin",37.8444,27.8452,20.6142857142857,25.2857142857143,0,56.4571428571429,39.5871428571429,NA,493,0,0,486,1011,1014,493,1014
2017,36,16,"Aydin",37.8444,27.8452,23.5428571428571,23.8857142857143,0,48.5857142857143,37.8571428571429,NA,507,0,0,358,933,1321,507,1321
2017,37,16,"Aydin",37.8444,27.8452,22.7571428571429,24.8714285714286,0,59.9285714285714,54.0771428571429,NA,589,0,0,451,917,1138,589,1138
2017,38,16,"Aydin",37.8444,27.8452,24.8142857142857,23.4571428571429,0,52.2428571428571,41.1071428571429,NA,671,0,0,249,635,1312,671,1312
2017,39,16,"Aydin",37.8444,27.8452,25.3285714285714,21.0714285714286,0.156714285714286,62.5428571428571,39.9785714285714,NA,782,0,0,392,829,1630,782,1630
2017,40,16,"Aydin",37.8444,27.8452,21.5142857142857,19.9142857142857,0.640428571428571,53.6,37.1228571428571,NA,543,155,365,80,166,1137,388,772
2017,41,16,"Aydin",37.8444,27.8452,20,18.0714285714286,0,47.2285714285714,32.9214285714286,NA,487,0,0,120,179,843,487,843
2017,42,16,"Aydin",37.8444,27.8452,22.8571428571429,18.9142857142857,0,56.8285714285714,43.2771428571429,NA,530,0,0,264,387,815,530,815
2017,43,16,"Aydin",37.8444,27.8452,21.3428571428571,16.6285714285714,3.10885714285714,73.5285714285714,33.1957142857143,NA,506,193,325,86,192,919,313,594
2017,44,16,"Aydin",37.8444,27.8452,17.6714285714286,12.4571428571429,0.24,59.9,49.194,NA,561,0,0,153,284,1102,561,1102
2017,45,16,"Aydin",37.8444,27.8452,16.1428571428571,13.1857142857143,0,70.3571428571429,58.8983333333333,NA,577,88,141,83,115,829,489,688
2017,46,16,"Aydin",37.8444,27.8452,18.5714285714286,15.4285714285714,5.34185714285714,76.3285714285714,60.1916666666667,NA,587,248,383,0,0,1085,339,702
2017,47,16,"Aydin",37.8444,27.8452,18.8,10.0857142857143,1.25371428571429,70.6142857142857,51.4485714285714,NA,418,54,219,133,167,804,364,585
2017,48,16,"Aydin",37.8444,27.8452,20.5285714285714,13.7285714285714,1.44957142857143,74.9571428571429,47.3914285714286,NA,386,223,347,0,0,619,163,272
2017,49,16,"Aydin",37.8444,27.8452,19.9,9.95714285714286,1.724,71.2857142857143,48.6185714285714,NA,407,120,154,72,118,645,287,491
2017,50,16,"Aydin",37.8444,27.8452,20.2,13.1714285714286,2.01471428571429,79.8285714285714,58.77,NA,346,146,183,0,0,442,200,259
2017,51,16,"Aydin",37.8444,27.8452,23.4,9.61428571428571,2.846,74.0428571428571,40.5014285714286,NA,386,106,116,121,110,349,280,233
2017,52,16,"Aydin",37.8444,27.8452,20.2,8.4375,5.36,75.1,63.2625,NA,528,130,190,40,48,507,398,317
2018,1,16,"Aydin",37.8444,27.8452,17.75,8.5625,2.22475,78.975,66.2685714285714,NA,618,102,251,72,61,914,516,663
2018,2,16,"Aydin",37.8444,27.8452,16.6285714285714,10.2142857142857,5.57542857142857,81.9571428571429,67.67,NA,624,95,199,80,22,1309,529,1110
2018,3,16,"Aydin",37.8444,27.8452,21.0571428571429,9.17142857142857,3.61571428571429,71.7714285714286,47.51,NA,639,294,483,0,0,655,345,172
2018,4,16,"Aydin",37.8444,27.8452,28.0428571428571,7.25714285714286,2.81985714285714,57.4857142857143,44.5642857142857,NA,604,2,1,401,459,764,602,763
2018,5,16,"Aydin",37.8444,27.8452,18.0714285714286,10.3,0.180428571428571,73.2,69.1414285714286,NA,670,275,440,0,0,819,395,379
2018,6,16,"Aydin",37.8444,27.8452,24.1714285714286,13.2714285714286,1.53557142857143,74.7,66.6185714285714,NA,704,303,404,0,0,1022,401,618
2018,7,16,"Aydin",37.8444,27.8452,18.9428571428571,10.4571428571429,7.81285714285714,75.1,36.9914285714286,NA,478,88,139,171,165,557,390,418
2018,8,16,"Aydin",37.8444,27.8452,16.0857142857143,11.2714285714286,6.08414285714286,80.9428571428571,46.09,NA,711,186,415,104,300,1321,525,906
2018,9,16,"Aydin",37.8444,27.8452,22.6714285714286,11.9285714285714,4.34071428571429,75.5857142857143,50.4771428571429,NA,621,360,589,0,0,956,261,367
2018,10,16,"Aydin",37.8444,27.8452,22.5,14.7714285714286,0.157142857142857,71.8285714285714,71.188,NA,556,58,231,81,148,1330,498,1099
2018,11,16,"Aydin",37.8444,27.8452,22.4714285714286,14.2142857142857,0.176857142857143,70.6857142857143,NA,NA,551,337,615,0,0,1426,214,811
2018,12,16,"Aydin",37.8444,27.8452,26.1714285714286,15.1285714285714,2.62328571428571,64.0428571428571,NA,NA,425,190,547,0,0,1187,235,640
2018,13,16,"Aydin",37.8444,27.8452,26.4714285714286,14.1428571428571,0.420857142857143,68.2142857142857,3.70666666666667,NA,356,187,214,90,147,428,169,214
2018,14,16,"Aydin",37.8444,27.8452,25.2571428571429,15.6,0.378,64.7857142857143,3.96,NA,407,0,0,56,54,486,407,486
2018,15,16,"Aydin",37.8444,27.8452,18.9,17.6857142857143,0.215,72.1142857142857,17.3616666666667,NA,374,8,1,225,326,450,366,449
2018,16,16,"Aydin",37.8444,27.8452,26.3,18.9857142857143,0.00242857142857143,55.1857142857143,20.2628571428571,NA,411,0,0,252,421,648,411,648
2018,17,16,"Aydin",37.8444,27.8452,22.2,20.4285714285714,0,58.0428571428571,19.7328571428571,NA,419,0,0,357,556,652,419,652
2018,18,16,"Aydin",37.8444,27.8452,20.6,22.3857142857143,3.46557142857143,57.7857142857143,20.0371428571429,NA,303,10,54,124,168,474,293,420
2018,19,16,"Aydin",37.8444,27.8452,27.6142857142857,20.1857142857143,0.429571428571429,61.1571428571429,12.5585714285714,NA,275,25,132,111,121,467,250,335
2018,20,16,"Aydin",37.8444,27.8452,14.8142857142857,25.0142857142857,0,43.7571428571429,14.2357142857143,NA,204,35,54,41,79,306,169,252
2018,21,16,"Aydin",37.8444,27.8452,14.1857142857143,24.2428571428571,1.17157142857143,61.3142857142857,24.5685714285714,NA,252,69,70,0,0,281,183,211
2018,22,16,"Aydin",37.8444,27.8452,13.0714285714286,24.1142857142857,1.47085714285714,60.0285714285714,25.35,NA,249,7,16,0,0,427,242,411
2018,23,16,"Aydin",37.8444,27.8452,14.3428571428571,27.2571428571429,0,45.8142857142857,40.3085714285714,NA,267,15,59,18,28,812,252,753
2018,24,16,"Aydin",37.8444,27.8452,12.6714285714286,25.3714285714286,3.213,58.5428571428571,29.2542857142857,NA,267,46,116,0,0,448,221,332
2018,25,16,"Aydin",37.8444,27.8452,13.0857142857143,24.9571428571429,0.000142857142857143,65.4142857142857,26.3985714285714,NA,358,110,153,0,0,518,248,365
2018,26,16,"Aydin",37.8444,27.8452,15.0714285714286,25.0571428571429,0.642857142857143,63.2428571428571,22.6014285714286,NA,355,0,0,33,82,587,355,587
2018,27,16,"Aydin",37.8444,27.8452,11.5428571428571,30.2285714285714,0,41.1285714285714,32.5828571428571,NA,342,43,46,103,123,418,299,372
2018,28,16,"Aydin",37.8444,27.8452,20.1,29.2285714285714,0,51.1857142857143,34.8514285714286,NA,286,0,0,67,112,585,286,585
2018,29,16,"Aydin",37.8444,27.8452,19.7571428571429,29.1857142857143,0,46.6571428571429,33.4742857142857,NA,260,0,0,89,242,756,260,756
2018,30,16,"Aydin",37.8444,27.8452,13.2714285714286,27.6142857142857,0.857,58.9428571428571,34.6428571428571,NA,265,26,18,0,0,822,239,804
2018,31,16,"Aydin",37.8444,27.8452,16.9571428571429,29.1,0.0714285714285714,59.5857142857143,38.7414285714286,NA,267,6,15,0,0,499,261,484
2018,32,16,"Aydin",37.8444,27.8452,15.1142857142857,29.8857142857143,0,47.7,38.02,NA,297,73,120,0,0,403,224,283
2018,33,16,"Aydin",37.8444,27.8452,16.8428571428571,27.2857142857143,2.28471428571429,60.1428571428571,43.9542857142857,NA,216,64,118,0,0,332,152,214
2018,34,16,"Aydin",37.8444,27.8452,9.17142857142857,27.3714285714286,0,62.9428571428571,34.2842857142857,NA,144,82,82,0,0,227,62,145
2018,35,16,"Aydin",37.8444,27.8452,14.3142857142857,27.6571428571429,0,61.9,43.8514285714286,NA,201,88,163,0,0,314,113,151
2018,36,16,"Aydin",37.8444,27.8452,18.4285714285714,26.3285714285714,0,58.4285714285714,41.1114285714286,NA,341,1,2,16,16,370,340,368
2018,37,16,"Aydin",37.8444,27.8452,18.6142857142857,24.7142857142857,1.00985714285714,48.6857142857143,37.4342857142857,NA,241,24,53,65,80,419,217,366
2018,38,16,"Aydin",37.8444,27.8452,21.7142857142857,24.9571428571429,0,54.7285714285714,42.1642857142857,NA,189,0,0,56,141,344,189,344
2018,39,16,"Aydin",37.8444,27.8452,23.2857142857143,22.7,1.28571428571429,57.5857142857143,43.97,NA,180,42,78,1,1,353,138,275
2018,40,16,"Aydin",37.8444,27.8452,14.0285714285714,20.7714285714286,0.228857142857143,65.9,35.732,NA,191,53,71,24,54,341,138,270
2018,41,16,"Aydin",37.8444,27.8452,15.0285714285714,20.1428571428571,0.171285714285714,66.8,40.85,NA,187,65,147,30,95,422,122,275
2018,42,16,"Aydin",37.8444,27.8452,13.4142857142857,20.3571428571429,0,73.8285714285714,NA,NA,168,40,34,0,0,381,128,347
2018,43,16,"Aydin",37.8444,27.8452,12.2142857142857,15.7571428571429,0.314714285714286,62.5571428571429,30.945,NA,187,8,13,15,24,402,179,389
2018,44,16,"Aydin",37.8444,27.8452,11.6285714285714,17.4428571428571,0,55.6285714285714,43.2485714285714,NA,196,0,0,0,0,264,196,264
2018,45,16,"Aydin",37.8444,27.8452,11.2,15.4714285714286,0,65.8714285714286,49.5885714285714,NA,231,6,16,0,0,473,225,457
2018,46,16,"Aydin",37.8444,27.8452,19.3571428571429,12.5571428571429,5.80114285714286,64.2,43.2185714285714,NA,230,2,27,1,0,465,228,438
2018,47,16,"Aydin",37.8444,27.8452,13.6571428571429,14.6142857142857,2.05657142857143,78.1571428571429,46.7842857142857,NA,270,51,195,0,0,499,219,304
2018,48,16,"Aydin",37.8444,27.8452,16.7,11.9285714285714,14.869,85.2,54.4942857142857,NA,245,81,65,10,9,201,164,136
2018,49,16,"Aydin",37.8444,27.8452,15.9714285714286,9.97142857142857,0.736285714285714,75.5428571428571,65.2071428571429,NA,257,0,0,58,137,420,257,420
2018,50,16,"Aydin",37.8444,27.8452,14.9714285714286,9.68571428571429,5.98642857142857,85.0857142857143,42.9214285714286,NA,256,1,0,0,0,305,255,305
2018,51,16,"Aydin",37.8444,27.8452,14.1428571428571,7.87142857142857,2.643,86.1428571428571,55.4671428571429,NA,250,59,89,78,90,248,191,159
2018,52,16,"Aydin",37.8444,27.8452,12.3142857142857,6.4,4.627,71.6571428571429,40.3725,NA,244,42,52,0,0,273,202,221
2019,1,16,"Aydin",37.8444,27.8452,10.6875,7.7875,7.788,84.2625,39.99,NA,343,57,108,0,0,784,286,676
2019,2,16,"Aydin",37.8444,27.8452,13.1428571428571,7.57142857142857,2.57814285714286,74.0428571428571,31.665,NA,255,28,33,1,1,208,227,175
2019,3,16,"Aydin",37.8444,27.8452,13.5571428571429,7.4,3.51614285714286,74.9428571428571,46.3385714285714,NA,192,0,0,25,33,198,192,198
2019,4,16,"Aydin",37.8444,27.8452,15.4285714285714,10.4428571428571,9.03357142857143,83.1714285714286,53.674,NA,308,0,0,0,0,314,308,314
2019,5,16,"Aydin",37.8444,27.8452,18.5428571428571,10.7428571428571,10.3707142857143,78.8714285714286,39.1585714285714,NA,253,59,18,0,0,143,194,125
2019,6,16,"Aydin",37.8444,27.8452,14.3714285714286,10.9142857142857,0.586571428571429,72.5571428571428,43.4785714285714,NA,276,36,19,76,60,127,240,108
2019,7,16,"Aydin",37.8444,27.8452,14.8428571428571,10.8857142857143,0.501571428571429,69.1,33.9685714285714,NA,325,76,33,33,27,234,249,201
2019,8,16,"Aydin",37.8444,27.8452,11.1285714285714,10.4285714285714,1.61385714285714,73.8,53.1657142857143,NA,305,83,26,0,0,219,222,193
2019,9,16,"Aydin",37.8444,27.8452,13.5285714285714,9.75714285714286,0.272142857142857,68.0285714285714,37.0542857142857,NA,331,1,0,50,3,310,330,310
2019,10,16,"Aydin",37.8444,27.8452,12.7285714285714,12.9714285714286,0,66.8857142857143,26.125,NA,359,61,66,51,18,252,298,186
2019,11,16,"Aydin",37.8444,27.8452,14.1142857142857,12.7285714285714,3.07557142857143,70.8714285714286,28.0471428571429,NA,373,0,0,0,0,400,373,400
2019,12,16,"Aydin",37.8444,27.8452,16.4,14.7285714285714,0,60.7857142857143,34.8266666666667,NA,343,0,0,57,56,416,343,416
2019,13,16,"Aydin",37.8444,27.8452,22.6857142857143,13.0285714285714,0.628857142857143,51.4142857142857,30.814,NA,256,54,38,0,0,194,202,156
2019,14,16,"Aydin",37.8444,27.8452,14.3428571428571,14.6714285714286,1.37171428571429,64.1714285714286,29.16,NA,365,187,113,0,0,208,178,95
2019,15,16,"Aydin",37.8444,27.8452,16.7,15.3285714285714,6.17328571428571,75.3142857142857,22.9442857142857,NA,359,134,61,0,0,183,225,122
2019,16,16,"Aydin",37.8444,27.8452,11.0428571428571,12.7285714285714,1.28528571428571,60.5571428571429,20.71,NA,318,6,6,133,104,208,312,202
2019,17,16,"Aydin",37.8444,27.8452,11.0142857142857,18.9142857142857,0,47.9571428571429,62.405,NA,412,1,1,66,55,313,411,312
2019,18,16,"Aydin",37.8444,27.8452,14.1,18.7142857142857,1.31385714285714,62.6,30.9957142857143,NA,523,0,0,41,124,353,523,353
2019,19,16,"Aydin",37.8444,27.8452,14.6142857142857,17.7571428571429,0.428571428571429,62.8857142857143,21.7516666666667,NA,452,38,39,7,6,386,414,347
2019,20,16,"Aydin",37.8444,27.8452,15.4142857142857,22.4285714285714,0,54.1428571428571,26.7385714285714,NA,454,51,44,0,0,389,403,345
2019,21,16,"Aydin",37.8444,27.8452,14.7142857142857,22.6142857142857,0.0142857142857143,57.0714285714286,23.004,NA,457,4,3,0,0,413,453,410
2019,22,16,"Aydin",37.8444,27.8452,15.8571428571429,24.8714285714286,0,52.1428571428571,29.33,NA,453,166,113,0,0,323,287,210
2019,23,16,"Aydin",37.8444,27.8452,12.3857142857143,25.1428571428571,0,51.9571428571429,23.5157142857143,NA,378,53,86,60,133,532,325,446
2019,24,16,"Aydin",37.8444,27.8452,10.8428571428571,25.4142857142857,2.67114285714286,61.3571428571429,29.32,NA,378,114,95,50,11,244,264,149
2019,25,16,"Aydin",37.8444,27.8452,12.1857142857143,26.5,1.68485714285714,62.7714285714286,25.15,NA,306,93,79,46,21,325,213,246
2019,26,16,"Aydin",37.8444,27.8452,17.6428571428571,30.2,0,45.3285714285714,36.2571428571429,NA,377,40,30,0,0,342,337,312
2019,27,16,"Aydin",37.8444,27.8452,20.4,28.7285714285714,0,43.5428571428571,32.6742857142857,NA,456,0,0,2,1,222,456,222
2019,28,16,"Aydin",37.8444,27.8452,25.0428571428571,27.2714285714286,0.128857142857143,49.0714285714286,35.576,NA,398,51,63,2,2,421,347,358
2019,29,16,"Aydin",37.8444,27.8452,17.0857142857143,26.4428571428571,0.0717142857142857,55.7428571428571,28.57,NA,453,63,5,6,1,203,390,198
2019,30,16,"Aydin",37.8444,27.8452,17.9857142857143,29.0571428571429,0,44.4714285714286,33.4085714285714,NA,456,81,38,61,58,335,375,297
2019,31,16,"Aydin",37.8444,27.8452,18.4571428571429,29.0857142857143,0,52.2142857142857,34.6785714285714,NA,334,40,45,14,8,375,294,330
2019,32,16,"Aydin",37.8444,27.8452,18.0857142857143,29.0285714285714,0,41.7285714285714,34.1842857142857,NA,346,0,0,60,49,395,346,395
2019,33,16,"Aydin",37.8444,27.8452,16.1571428571429,28.3285714285714,0,52.0714285714286,30.5057142857143,NA,337,2,5,99,210,531,335,526
2019,34,16,"Aydin",37.8444,27.8452,18.7714285714286,29.4857142857143,0,44.3571428571429,32.1628571428571,NA,299,0,0,0,0,345,299,345
2019,35,16,"Aydin",37.8444,27.8452,13.8571428571429,28.4142857142857,0,53.2285714285714,38.9385714285714,NA,307,36,7,139,217,415,271,408
2019,36,16,"Aydin",37.8444,27.8452,16.3428571428571,26.1571428571429,0.000142857142857143,60.9142857142857,34.1814285714286,NA,171,23,24,0,0,67,148,43
2019,37,16,"Aydin",37.8444,27.8452,21.4714285714286,24.6142857142857,1.51371428571429,59.7857142857143,30.3085714285714,NA,218,0,0,2,11,55,218,55
2019,38,16,"Aydin",37.8444,27.8452,15.7,23.0714285714286,0,53.8,29.7457142857143,NA,266,90,52,0,0,91,176,39
2019,39,16,"Aydin",37.8444,27.8452,12.8,22.5285714285714,0.717571428571429,64.2714285714286,23.5728571428571,NA,237,60,9,22,10,79,177,70
2019,40,16,"Aydin",37.8444,27.8452,13.4285714285714,23.4428571428571,1.42871428571429,58.1285714285714,23.018,NA,241,48,12,0,0,111,193,99
2019,41,16,"Aydin",37.8444,27.8452,11.1142857142857,21.1285714285714,0.873,72.5,37.5014285714286,NA,416,153,215,0,0,448,263,233
2019,42,16,"Aydin",37.8444,27.8452,11.7714285714286,21.9571428571429,0.185714285714286,72.7714285714286,53.7028571428571,NA,356,104,97,0,0,408,252,311
2019,43,16,"Aydin",37.8444,27.8452,11.6,20.4571428571429,0,57.2,49.5585714285714,NA,306,93,116,0,0,300,213,184
2019,44,16,"Aydin",37.8444,27.8452,9.91428571428571,17.4285714285714,0.000428571428571429,67.3571428571429,42.6628571428571,NA,350,26,30,0,0,250,324,220
2019,45,16,"Aydin",37.8444,27.8452,13.2714285714286,18.8571428571429,0.715142857142857,67.7,41.6114285714286,NA,417,0,0,0,0,328,417,328
2019,46,16,"Aydin",37.8444,27.8452,13.3714285714286,17.1571428571429,0.157428571428571,66.7,55.7828571428571,NA,401,0,0,0,0,337,401,337
2019,47,16,"Aydin",37.8444,27.8452,11.4285714285714,14.8428571428571,0.857142857142857,67.2714285714286,61.2842857142857,NA,391,0,0,0,0,339,391,339
2019,48,16,"Aydin",37.8444,27.8452,10.3714285714286,14.5428571428571,5.787,87.9714285714286,43.2542857142857,NA,320,0,0,0,0,251,320,251
2019,49,16,"Aydin",37.8444,27.8452,11.1285714285714,8.87142857142857,0.857142857142857,73.1714285714286,57.5957142857143,NA,393,1,0,0,0,274,392,274
2019,50,16,"Aydin",37.8444,27.8452,14.0857142857143,11.8142857142857,5.08585714285714,80.4142857142857,50.7842857142857,NA,218,0,0,0,0,119,218,119
2019,51,16,"Aydin",37.8444,27.8452,10.5857142857143,11.3,0,76.3142857142857,75.9728571428571,NA,361,0,0,0,0,488,361,488
2019,52,16,"Aydin",37.8444,27.8452,8.68571428571429,9.22857142857143,6.85842857142857,81.9285714285714,44.2728571428571,NA,279,63,47,0,0,281,216,234
2020,1,16,"Aydin",37.8444,27.8452,12.58,7.22,0.7998,68.5,52.666,NA,160,0,0,0,0,126,160,126
2020,2,16,"Aydin",37.8444,27.8452,13.8428571428571,7.45714285714286,4.94285714285714,74.7428571428571,54.6428571428571,NA,240,0,0,0,0,173,240,173
2020,3,16,"Aydin",37.8444,27.8452,11.3571428571429,7.5,0,70.6142857142857,81.3957142857143,NA,270,5,4,0,0,382,265,378
2020,4,16,"Aydin",37.8444,27.8452,13.9428571428571,6.18571428571429,0,56.1285714285714,56.8142857142857,NA,358,0,0,36,25,295,358,295
2020,5,16,"Aydin",37.8444,27.8452,13.1571428571429,10.0857142857143,7.71242857142857,77,52.2971428571429,NA,331,67,89,0,0,272,264,183
2020,6,16,"Aydin",37.8444,27.8452,14.1428571428571,8.87142857142857,6.89857142857143,71.6285714285714,30.4457142857143,NA,343,65,77,34,6,267,278,190
2020,7,16,"Aydin",37.8444,27.8452,13.6857142857143,10.0428571428571,4.94271428571429,76.1571428571429,56.0442857142857,NA,341,5,7,0,0,338,336,331
2020,8,16,"Aydin",37.8444,27.8452,14.3857142857143,10.1428571428571,3.856,74.1857142857143,43.3142857142857,NA,283,0,0,34,18,187,283,187
2020,9,16,"Aydin",37.8444,27.8452,14.8428571428571,11.7,2.14228571428571,68.6714285714286,37.7257142857143,NA,393,143,245,0,0,528,250,283
2020,10,16,"Aydin",37.8444,27.8452,14.8571428571429,13.7857142857143,3.801,69.2142857142857,36.2571428571429,NA,205,15,15,0,0,210,190,195
2020,11,16,"Aydin",37.8444,27.8452,12.4571428571429,15.2714285714286,1.21557142857143,72.1857142857143,38.2871428571429,NA,115,45,26,0,0,94,70,68
2020,12,16,"Aydin",37.8444,27.8452,13.6428571428571,10.2857142857143,1.31385714285714,55.2,27.8971428571429,NA,117,13,17,56,58,118,104,101
2020,13,16,"Aydin",37.8444,27.8452,10.9142857142857,13.9285714285714,3.27114285714286,78.8428571428571,43.6171428571429,NA,136,17,15,0,0,92,119,77
2020,14,16,"Aydin",37.8444,27.8452,11.4,14.1571428571429,1.829,72.5428571428571,37.5514285714286,NA,155,17,14,0,0,121,138,107
2020,15,16,"Aydin",37.8444,27.8452,12.5571428571429,15.3714285714286,2.48514285714286,68.7714285714286,34.3028571428571,NA,133,61,28,0,0,118,72,90
2020,16,16,"Aydin",37.8444,27.8452,17,16.6857142857143,1.28571428571429,62.9571428571429,35.76,NA,141,22,13,45,45,106,119,93
2020,17,16,"Aydin",37.8444,27.8452,20.3857142857143,16.8857142857143,0.0857142857142857,63.9,30.0314285714286,NA,137,36,18,46,28,123,101,105
2020,18,16,"Aydin",37.8444,27.8452,16.8714285714286,17.6571428571429,1.35685714285714,68.9,37.2028571428571,NA,146,55,40,0,0,164,91,124
2020,19,16,"Aydin",37.8444,27.8452,17.5714285714286,17.7571428571429,2.57071428571429,65.7428571428571,36.24,NA,137,10,6,76,40,157,127,151
2020,20,16,"Aydin",37.8444,27.8452,14.4142857142857,24.8428571428571,0,49.9,65.0814285714286,NA,164,38,58,35,31,164,126,106
2020,21,16,"Aydin",37.8444,27.8452,20.4285714285714,24.2428571428571,0.157428571428571,47.2285714285714,59.5771428571429,NA,146,27,7,94,77,96,119,89
2020,22,16,"Aydin",37.8444,27.8452,17.8714285714286,18.9714285714286,0.685857142857143,61.7428571428571,18.3028571428571,NA,118,63,32,12,29,100,55,68
2020,23,16,"Aydin",37.8444,27.8452,18.6571428571429,21.2857142857143,0.186285714285714,57.7857142857143,26.9014285714286,NA,112,3,3,6,7,70,109,67
2020,24,16,"Aydin",37.8444,27.8452,16.7571428571429,24.2285714285714,0.0285714285714286,55.6142857142857,29.3142857142857,NA,140,9,6,1,0,150,131,144
2020,25,16,"Aydin",37.8444,27.8452,15.5,26.3142857142857,0.000428571428571429,53.1142857142857,31.6628571428571,NA,137,0,0,30,20,108,137,108
2020,26,16,"Aydin",37.8444,27.8452,17.5714285714286,27.0571428571429,2.71314285714286,58.0571428571429,36.3357142857143,NA,173,0,0,0,0,133,173,133
2020,27,16,"Aydin",37.8444,27.8452,17.4714285714286,29.7857142857143,0,49.1142857142857,49.4842857142857,NA,113,0,0,24,7,113,113,113
2020,28,16,"Aydin",37.8444,27.8452,19.8285714285714,28.8142857142857,0,59.5571428571429,45.1042857142857,NA,164,0,0,30,9,122,164,122
2020,29,16,"Aydin",37.8444,27.8452,18.5571428571429,27.3714285714286,0,52.3142857142857,38.7828571428571,NA,186,46,19,0,0,111,140,92
2020,30,16,"Aydin",37.8444,27.8452,18.7142857142857,29.1428571428571,0,51.0857142857143,48.9457142857143,NA,190,34,10,0,0,142,156,132
2020,31,16,"Aydin",37.8444,27.8452,13.7714285714286,30.9142857142857,0,43.6714285714286,47.5257142857143,NA,150,55,28,24,37,127,95,99
2020,32,16,"Aydin",37.8444,27.8452,17.2571428571429,28.0142857142857,0,57.2428571428571,44.1,NA,146,1,1,0,0,107,145,106
2020,33,16,"Aydin",37.8444,27.8452,17.7857142857143,29.0428571428571,0.128714285714286,46.2285714285714,36.1842857142857,NA,183,28,13,55,20,83,155,70
2020,34,16,"Aydin",37.8444,27.8452,18.1571428571429,27.8285714285714,0,47.8428571428571,40.2014285714286,NA,197,0,0,17,8,97,197,97
2020,35,16,"Aydin",37.8444,27.8452,15.3,28.3285714285714,0,50.6285714285714,49.0057142857143,NA,164,20,13,0,0,157,144,144
2020,36,16,"Aydin",37.8444,27.8452,17.9285714285714,28.2,0,47.3142857142857,46.5442857142857,NA,179,0,0,23,16,112,179,112
2020,37,16,"Aydin",37.8444,27.8452,17.2714285714286,27.4,0,55.7285714285714,50.4985714285714,NA,193,46,11,28,8,91,147,80
2020,38,16,"Aydin",37.8444,27.8452,15.1142857142857,26.4571428571429,0,64.1571428571429,48.8585714285714,NA,235,0,0,0,0,157,235,157
2020,39,16,"Aydin",37.8444,27.8452,15.8428571428571,24.7571428571429,0,61.8857142857143,36.8542857142857,NA,220,30,23,0,0,129,190,106
2020,40,16,"Aydin",37.8444,27.8452,14.4857142857143,23,0,51.0285714285714,37.2857142857143,NA,187,33,43,0,0,154,154,111
2020,41,16,"Aydin",37.8444,27.8452,14.0285714285714,23.2571428571429,1.14242857142857,55.5857142857143,54.855,NA,182,37,20,0,0,127,145,107
2020,42,16,"Aydin",37.8444,27.8452,14.3285714285714,21.4714285714286,0.214857142857143,65.9857142857143,31.1128571428571,NA,177,21,16,0,0,111,156,95
2020,43,16,"Aydin",37.8444,27.8452,13.5285714285714,19.7142857142857,0.0285714285714286,67.8571428571429,42.0057142857143,NA,194,0,0,0,0,161,194,161
2020,44,16,"Aydin",37.8444,27.8452,10.4142857142857,17.3,4.77142857142857,79.3,30.5514285714286,NA,255,0,0,39,10,233,255,233
2020,45,16,"Aydin",37.8444,27.8452,14.7142857142857,16.1571428571429,0,55.5428571428571,32.74,NA,156,17,8,32,23,103,139,95
2020,46,16,"Aydin",37.8444,27.8452,8.87142857142857,14.9285714285714,0.0142857142857143,62.3714285714286,50.7814285714286,NA,208,0,0,30,20,109,208,109
2020,47,16,"Aydin",37.8444,27.8452,10.8,12.8,0.0714285714285714,66.8714285714286,44.2457142857143,NA,173,1,0,0,0,83,172,83
2020,48,16,"Aydin",37.8444,27.8452,15.2285714285714,11.4428571428571,0,49.9285714285714,43.0942857142857,NA,199,0,0,0,0,262,199,262
2020,49,16,"Aydin",37.8444,27.8452,10.3142857142857,12.7285714285714,0.0434285714285714,68.5857142857143,45.9085714285714,NA,207,34,36,0,0,116,173,80
2020,50,16,"Aydin",37.8444,27.8452,12.1857142857143,12.9714285714286,11.8185714285714,86.0571428571429,27.5342857142857,NA,181,2,2,0,0,98,179,96
2020,51,16,"Aydin",37.8444,27.8452,10.3285714285714,11.5,0.886,82.6142857142857,33.71,NA,171,13,3,5,0,90,158,87
2020,52,16,"Aydin",37.8444,27.8452,10.3285714285714,10.7285714285714,0,74.7142857142857,37.2042857142857,NA,203,23,18,0,0,113,180,95
2020,53,16,"Aydin",37.8444,27.8452,14.375,12.675,0.804,83.275,24.3875,NA,122,0,0,0,0,111,122,111
2017,1,17,"Balikesir",39.6484,27.8826,21.0714285714286,0.971428571428571,9.95971428571429,88.3571428571429,58.6671428571429,NA,563,179,249,200,390,847,384,598
2017,2,17,"Balikesir",39.6484,27.8826,19.5,1.92857142857143,6.92814285714286,84.9285714285714,47.275,NA,757,77,159,111,237,1214,680,1055
2017,3,17,"Balikesir",39.6484,27.8826,26.1571428571429,5.22857142857143,5.11085714285714,86.9142857142857,22.4675,NA,762,0,0,342,823,1449,762,1449
2017,4,17,"Balikesir",39.6484,27.8826,23.8142857142857,0.514285714285714,0.997428571428571,82.3428571428571,44.0028571428571,NA,639,0,0,351,537,889,639,889
2017,5,17,"Balikesir",39.6484,27.8826,17.7714285714286,3.62857142857143,0.283857142857143,75.3571428571429,69.38,NA,588,22,81,95,294,1163,566,1082
2017,6,17,"Balikesir",39.6484,27.8826,30.4714285714286,7.67142857142857,0.0104285714285714,73.7857142857143,35.72,NA,736,115,210,287,784,1519,621,1309
2017,7,17,"Balikesir",39.6484,27.8826,28.0428571428571,2.98571428571429,0.0305714285714286,70.8142857142857,46.5414285714286,NA,492,23,23,175,275,717,469,694
2017,8,17,"Balikesir",39.6484,27.8826,22.2428571428571,9.91428571428571,6.686,80.7142857142857,52.9457142857143,NA,739,89,209,195,407,1747,650,1538
2017,9,17,"Balikesir",39.6484,27.8826,14.7857142857143,10.1285714285714,0.769,79.0142857142857,54.5,NA,574,0,0,204,288,866,574,866
2017,10,17,"Balikesir",39.6484,27.8826,25.7,10.3285714285714,3.30871428571429,82.6285714285714,43.7985714285714,NA,712,0,0,173,296,1043,712,1043
2017,11,17,"Balikesir",39.6484,27.8826,15.6,5.75714285714286,2.78942857142857,84.2,43.0557142857143,NA,525,94,90,234,302,725,431,635
2017,12,17,"Balikesir",39.6484,27.8826,20.0857142857143,11.2857142857143,0.114,74,59.8571428571429,NA,589,81,166,168,304,1077,508,911
2017,13,17,"Balikesir",39.6484,27.8826,28.8142857142857,9.9,0.115,69.0714285714286,38.2242857142857,NA,574,0,0,364,591,887,574,887
2017,14,17,"Balikesir",39.6484,27.8826,17.6428571428571,11.7571428571429,3.125,74.2571428571429,48.57,NA,639,0,0,442,835,1336,639,1336
2017,15,17,"Balikesir",39.6484,27.8826,21.1142857142857,12.2428571428571,0,65.0142857142857,43.7785714285714,NA,587,0,0,214,566,1187,587,1187
2017,16,17,"Balikesir",39.6484,27.8826,24.5714285714286,11.7571428571429,1.49557142857143,73.1857142857143,28.2342857142857,NA,717,0,0,281,448,920,717,920
2017,17,17,"Balikesir",39.6484,27.8826,16.0714285714286,14.6,0.00157142857142857,59.7428571428571,45.3171428571429,NA,731,0,0,475,969,1478,731,1478
2017,18,17,"Balikesir",39.6484,27.8826,23.0857142857143,16.7,0.285714285714286,71.4571428571429,49.6785714285714,NA,506,0,0,288,591,923,506,923
2017,19,17,"Balikesir",39.6484,27.8826,24.0857142857143,19.2285714285714,0.144857142857143,63.0714285714286,43.555,NA,471,0,0,119,262,966,471,966
2017,20,17,"Balikesir",39.6484,27.8826,28.0285714285714,15.8142857142857,0.430714285714286,70.9285714285714,26.6316666666667,NA,472,0,0,192,443,1205,472,1205
2017,21,17,"Balikesir",39.6484,27.8826,23.5428571428571,16.6,2.86757142857143,73.3571428571429,29.7457142857143,NA,448,0,0,243,497,849,448,849
2017,22,17,"Balikesir",39.6484,27.8826,15.3571428571429,20.3428571428571,2.21428571428571,74.8,37.1,NA,522,0,0,242,571,1015,522,1015
2017,23,17,"Balikesir",39.6484,27.8826,18.4,20.9428571428571,2.758,75.4,33.4014285714286,NA,578,0,0,461,1093,1388,578,1388
2017,24,17,"Balikesir",39.6484,27.8826,23.0285714285714,21.6714285714286,0.0582857142857143,64.5428571428571,29.0757142857143,NA,552,0,0,457,1020,1139,552,1139
2017,25,17,"Balikesir",39.6484,27.8826,24.1,23.4428571428571,0.00385714285714286,58.8,28.4885714285714,NA,584,0,0,369,755,1041,584,1041
2017,26,17,"Balikesir",39.6484,27.8826,21.4714285714286,28.0428571428571,0,52.0142857142857,37.0771428571429,NA,564,0,0,323,600,971,564,971
2017,27,17,"Balikesir",39.6484,27.8826,35.4571428571429,24.3714285714286,0,57.4285714285714,31.7985714285714,NA,511,0,0,199,293,642,511,642
2017,28,17,"Balikesir",39.6484,27.8826,33.3714285714286,25.7428571428571,0,57.9571428571429,29.5742857142857,NA,481,0,0,230,439,864,481,864
2017,29,17,"Balikesir",39.6484,27.8826,35.4142857142857,24.3857142857143,0.00728571428571429,63.1,27.5842857142857,NA,532,0,0,340,878,1272,532,1272
2017,30,17,"Balikesir",39.6484,27.8826,29.0285714285714,25.7857142857143,1.23071428571429,54.2714285714286,41.4828571428571,NA,531,0,0,153,281,928,531,928
2017,31,17,"Balikesir",39.6484,27.8826,37.2714285714286,26.2285714285714,0,62.0857142857143,36.0242857142857,NA,559,0,0,229,644,1047,559,1047
2017,32,17,"Balikesir",39.6484,27.8826,33.3857142857143,26.9285714285714,0,64.1571428571429,38.4557142857143,NA,567,0,0,266,581,1092,567,1092
2017,33,17,"Balikesir",39.6484,27.8826,31.5714285714286,25.4,0.061,64.7285714285714,33.5285714285714,NA,596,0,0,368,923,1199,596,1199
2017,34,17,"Balikesir",39.6484,27.8826,32.3,22.8285714285714,0.873857142857143,65.5714285714286,29.5683333333333,NA,601,0,0,334,1009,1280,601,1280
2017,35,17,"Balikesir",39.6484,27.8826,29.7,22.6142857142857,0,56.0428571428571,NA,NA,493,0,0,261,659,1014,493,1014
2017,36,17,"Balikesir",39.6484,27.8826,21.8571428571429,22.4857142857143,0,49.5571428571429,44.424,NA,507,0,0,319,754,1321,507,1321
2017,37,17,"Balikesir",39.6484,27.8826,22.9571428571429,24.5857142857143,0,56.4,47.2814285714286,NA,589,0,0,344,781,1138,589,1138
2017,38,17,"Balikesir",39.6484,27.8826,22.7714285714286,21.7285714285714,0,50.9285714285714,49.3785714285714,NA,671,0,0,307,744,1312,671,1312
2017,39,17,"Balikesir",39.6484,27.8826,27.5142857142857,18.3,0.654571428571429,71.8285714285714,39.0742857142857,NA,782,0,0,428,894,1630,782,1630
2017,40,17,"Balikesir",39.6484,27.8826,26.7,15.8142857142857,0.0134285714285714,66.7,42.1757142857143,NA,543,26,52,296,702,1137,517,1085
2017,41,17,"Balikesir",39.6484,27.8826,28.0571428571429,13.2285714285714,0.000571428571428571,65.0714285714286,60.83,NA,487,0,0,329,585,843,487,843
2017,42,17,"Balikesir",39.6484,27.8826,20.0142857142857,15.7714285714286,0,63.4428571428571,128.99,NA,530,0,0,469,747,815,530,815
2017,43,17,"Balikesir",39.6484,27.8826,15.8142857142857,13.6428571428571,4.85442857142857,79.2857142857143,93.91,NA,506,105,82,204,513,919,401,837
2017,44,17,"Balikesir",39.6484,27.8826,20.4285714285714,8.97142857142857,0.118571428571429,69.7571428571429,113.685714285714,NA,561,0,0,227,480,1102,561,1102
2017,45,17,"Balikesir",39.6484,27.8826,10.3857142857143,10.6857142857143,0.00157142857142857,78.8571428571429,153.872857142857,NA,577,0,0,286,296,829,577,829
2017,46,17,"Balikesir",39.6484,27.8826,13.2142857142857,12.8571428571429,0.276714285714286,79.4285714285714,179.97,NA,587,0,0,192,435,1085,587,1085
2017,47,17,"Balikesir",39.6484,27.8826,11.2142857142857,6.75714285714286,3.84314285714286,81.7428571428571,220.13,NA,418,6,5,133,167,804,412,799
2017,48,17,"Balikesir",39.6484,27.8826,21.8714285714286,12.4571428571429,2.88442857142857,74.7,80.1814285714286,NA,386,198,346,0,0,619,188,273
2017,49,17,"Balikesir",39.6484,27.8826,21.1428571428571,7.27142857142857,3.40057142857143,78.1142857142857,109.665714285714,NA,407,98,124,103,153,645,309,521
2017,50,17,"Balikesir",39.6484,27.8826,19.0428571428571,10.6571428571429,0.346857142857143,80.8,126.215714285714,NA,346,84,108,0,0,442,262,334
2017,51,17,"Balikesir",39.6484,27.8826,24.1,5.61428571428571,8.15742857142857,85.3571428571429,45.3485714285714,NA,386,0,0,274,267,349,386,349
2017,52,17,"Balikesir",39.6484,27.8826,15.6625,6.95,0.639875,80.725,119.372,NA,528,215,222,26,31,507,313,285
2018,1,17,"Balikesir",39.6484,27.8826,11.3,4.7,0.233,89.875,75.73,38.74,618,6,5,349,519,914,612,909
2018,2,17,"Balikesir",39.6484,27.8826,14.1285714285714,6.35714285714286,1.31671428571429,91.6857142857143,110.536,NA,624,0,0,182,669,1309,624,1309
2018,3,17,"Balikesir",39.6484,27.8826,20.6857142857143,5.78571428571429,2.48714285714286,81.9285714285714,82.2342857142857,NA,639,249,344,202,122,655,390,311
2018,4,17,"Balikesir",39.6484,27.8826,33.5857142857143,3.4,0.638571428571429,73.9571428571429,44.8971428571429,NA,604,0,0,372,446,764,604,764
2018,5,17,"Balikesir",39.6484,27.8826,17.9857142857143,7.78571428571429,0.0924285714285714,76,126.804285714286,NA,670,101,104,30,29,819,569,715
2018,6,17,"Balikesir",39.6484,27.8826,17.0428571428571,8.91428571428571,4.87271428571429,84.8285714285714,67.05,NA,704,0,0,205,218,1022,704,1022
2018,7,17,"Balikesir",39.6484,27.8826,22.5428571428571,7.9,0.938428571428572,83.0714285714286,36.3085714285714,NA,478,48,79,267,305,557,430,478
2018,8,17,"Balikesir",39.6484,27.8826,18.2714285714286,8.21428571428571,1.64,86.0285714285714,39.6357142857143,NA,711,0,0,428,477,1321,711,1321
2018,9,17,"Balikesir",39.6484,27.8826,24.2857142857143,8.31428571428571,5.081,79.2142857142857,45.5671428571429,NA,621,97,158,199,242,956,524,798
2018,10,17,"Balikesir",39.6484,27.8826,18.2571428571429,12.2428571428571,1.07357142857143,78.4428571428572,55.98,NA,556,0,0,53,126,1330,556,1330
2018,11,17,"Balikesir",39.6484,27.8826,21.8857142857143,12.5285714285714,3.76014285714286,73.6142857142857,44.7371428571429,NA,551,146,377,0,0,1426,405,1049
2018,12,17,"Balikesir",39.6484,27.8826,20.6285714285714,12.0428571428571,4.59514285714286,75,36.27,NA,425,66,62,38,54,1187,359,1125
2018,13,17,"Balikesir",39.6484,27.8826,19.4142857142857,12.0571428571429,0.687428571428571,71.1571428571429,71.912,NA,356,55,55,124,191,428,301,373
2018,14,17,"Balikesir",39.6484,27.8826,15.3714285714286,12.2,2.80457142857143,74.1857142857143,50.212,NA,407,0,0,247,316,486,407,486
2018,15,17,"Balikesir",39.6484,27.8826,11.7,15.6,0,78.2142857142857,61.4885714285714,NA,374,0,0,218,357,450,374,450
2018,16,17,"Balikesir",39.6484,27.8826,20.2,13.7571428571429,0.171285714285714,72.8142857142857,44.3114285714286,NA,411,0,0,287,364,648,411,648
2018,17,17,"Balikesir",39.6484,27.8826,18.2857142857143,17.8857142857143,0,64.4428571428571,46.8842857142857,NA,419,0,0,220,204,652,419,652
2018,18,17,"Balikesir",39.6484,27.8826,16.5714285714286,17.8428571428571,0.264428571428571,75.8857142857143,47.6685714285714,NA,303,0,0,182,270,474,303,474
2018,19,17,"Balikesir",39.6484,27.8826,17.9714285714286,16.9142857142857,2.16914285714286,77.4142857142857,33.4057142857143,NA,275,0,0,160,258,467,275,467
2018,20,17,"Balikesir",39.6484,27.8826,13.2714285714286,21.7571428571429,0.000142857142857143,60.0857142857143,37.2428571428571,NA,204,0,0,78,98,306,204,306
2018,21,17,"Balikesir",39.6484,27.8826,23.2714285714286,20.4,1.84657142857143,77.0857142857143,31.94,NA,252,0,0,213,265,281,252,281
2018,22,17,"Balikesir",39.6484,27.8826,25.4857142857143,20.5285714285714,0.000571428571428571,65.5714285714286,35.1042857142857,NA,249,0,0,159,306,427,249,427
2018,23,17,"Balikesir",39.6484,27.8826,14.8285714285714,23.8142857142857,0.2,62.3714285714286,48.1457142857143,NA,267,0,0,154,533,812,267,812
2018,24,17,"Balikesir",39.6484,27.8826,22.7571428571429,23.6857142857143,1.44471428571429,59.0571428571429,31.7257142857143,NA,267,67,182,93,181,448,200,266
2018,25,17,"Balikesir",39.6484,27.8826,23.5285714285714,22.8,5.41514285714286,74.4285714285714,28.8142857142857,NA,358,0,0,69,133,518,358,518
2018,26,17,"Balikesir",39.6484,27.8826,21.2428571428571,22.7714285714286,6.85057142857143,70.4428571428572,24.0142857142857,NA,355,0,0,141,270,587,355,587
2018,27,17,"Balikesir",39.6484,27.8826,22.9857142857143,26.1,0,56.4428571428571,34.75,NA,342,0,0,203,261,418,342,418
2018,28,17,"Balikesir",39.6484,27.8826,27.5285714285714,26.5142857142857,0,61.1428571428571,29.5885714285714,NA,286,0,0,147,322,585,286,585
2018,29,17,"Balikesir",39.6484,27.8826,19.8142857142857,26.0142857142857,0,55.6714285714286,34.1714285714286,NA,260,0,0,126,366,756,260,756
2018,30,17,"Balikesir",39.6484,27.8826,18.9428571428571,24.9857142857143,6.50328571428571,69,33.19,NA,265,39,59,139,516,822,226,763
2018,31,17,"Balikesir",39.6484,27.8826,33.6142857142857,27.5571428571429,0,65.7142857142857,31.7071428571429,NA,267,0,0,162,130,499,267,499
2018,32,17,"Balikesir",39.6484,27.8826,37.0714285714286,26.4285714285714,0,59.0714285714286,31.1085714285714,NA,297,0,0,141,223,403,297,403
2018,33,17,"Balikesir",39.6484,27.8826,29.6571428571429,25.6285714285714,0,62.1857142857143,34.1257142857143,NA,216,0,0,142,185,332,216,332
2018,34,17,"Balikesir",39.6484,27.8826,27.8714285714286,26.0571428571429,0,60.5285714285714,30.4228571428571,NA,144,0,0,123,194,227,144,227
2018,35,17,"Balikesir",39.6484,27.8826,29.7285714285714,26.3857142857143,0.085,65.4714285714286,38.1271428571429,NA,201,0,0,184,247,314,201,314
2018,36,17,"Balikesir",39.6484,27.8826,22.3857142857143,23.7142857142857,2.19842857142857,67.1857142857143,42.3,NA,341,0,0,247,253,370,341,370
2018,37,17,"Balikesir",39.6484,27.8826,22.9571428571429,20.6571428571429,0.628,69,33.3457142857143,NA,241,0,0,158,247,419,241,419
2018,38,17,"Balikesir",39.6484,27.8826,28.6428571428571,21.5714285714286,0,68.2571428571429,29.1233333333333,NA,189,0,0,117,194,344,189,344
2018,39,17,"Balikesir",39.6484,27.8826,32.3285714285714,18.5142857142857,0.885714285714286,68.3571428571429,30.16,NA,180,0,0,73,129,353,180,353
2018,40,17,"Balikesir",39.6484,27.8826,24.6285714285714,18.1714285714286,1.31257142857143,72.6714285714286,32.7571428571429,NA,191,0,0,117,198,341,191,341
2018,41,17,"Balikesir",39.6484,27.8826,31.2857142857143,18.0857142857143,0.453714285714286,75.3285714285714,33.2416666666667,NA,187,0,0,137,321,422,187,422
2018,42,17,"Balikesir",39.6484,27.8826,21.7142857142857,18.5142857142857,0.287571428571429,79.5,52.5,NA,168,0,0,160,355,381,168,381
2018,43,17,"Balikesir",39.6484,27.8826,18.8,12.8714285714286,0.882285714285714,72.0428571428571,48.6771428571429,43.2733333333333,187,5,2,52,71,402,182,400
2018,44,17,"Balikesir",39.6484,27.8826,16.7,14.3428571428571,0,71.3428571428571,49.0275,42.1171428571429,196,0,0,56,85,264,196,264
2018,45,17,"Balikesir",39.6484,27.8826,22.2142857142857,13.1714285714286,0,80.1142857142857,34.5942857142857,18.1657142857143,231,0,0,112,154,473,231,473
2018,46,17,"Balikesir",39.6484,27.8826,25.9714285714286,10.0714285714286,3.09828571428571,78.0285714285714,27.7757142857143,15.7971428571429,230,0,0,90,159,465,230,465
2018,47,17,"Balikesir",39.6484,27.8826,19.1142857142857,11.6142857142857,4.549,86.8857142857143,42.4885714285714,24.9628571428571,270,77,59,58,176,499,193,440
2018,48,17,"Balikesir",39.6484,27.8826,30.7142857142857,9.9,4.693,83.6285714285714,30.9133333333333,25.925,245,46,11,35,44,201,199,190
2018,49,17,"Balikesir",39.6484,27.8826,17.2,6.12857142857143,3.20842857142857,86.4428571428571,51.6385714285714,37.6528571428571,257,0,0,185,347,420,257,420
2018,50,17,"Balikesir",39.6484,27.8826,11.1285714285714,5.35714285714286,6.34542857142857,94.5857142857143,67.5571428571429,48.8614285714286,256,0,0,144,180,305,256,305
2018,51,17,"Balikesir",39.6484,27.8826,16.7571428571429,5.5,3.17657142857143,91.8,50.34,28.1057142857143,250,91,96,129,137,248,159,152
2018,52,17,"Balikesir",39.6484,27.8826,14.7857142857143,3.17142857142857,3.28385714285714,87.8571428571429,51.5185714285714,33.28,244,20,12,145,171,273,224,261
2019,1,17,"Balikesir",39.6484,27.8826,21.75,3.6125,3.835375,89.875,29.72875,26.43125,343,47,42,171,410,784,296,742
2019,2,17,"Balikesir",39.6484,27.8826,26.2285714285714,4.27142857142857,13.659,84.5857142857143,23.6842857142857,25.1685714285714,255,129,80,93,118,208,126,128
2019,3,17,"Balikesir",39.6484,27.8826,12.9857142857143,4.64285714285714,0.745428571428571,84.6714285714286,44.1714285714286,42.4071428571429,192,88,112,67,41,198,104,86
2019,4,17,"Balikesir",39.6484,27.8826,19.8142857142857,8.41428571428571,1.69585714285714,85.1142857142857,40.538,36.5,308,77,86,114,100,314,231,228
2019,5,17,"Balikesir",39.6484,27.8826,19.0142857142857,9.87142857142857,1.57471428571429,76.0142857142857,33.6842857142857,32.05,253,111,64,0,0,143,142,79
2019,6,17,"Balikesir",39.6484,27.8826,19.8142857142857,7.55714285714286,1.281,84.0857142857143,40.1314285714286,26.94,276,0,0,174,95,127,276,127
2019,7,17,"Balikesir",39.6484,27.8826,35.9714285714286,6.64285714285714,4.32128571428571,77.6857142857143,25.0142857142857,15.1871428571429,325,67,24,73,20,234,258,210
2019,8,17,"Balikesir",39.6484,27.8826,14.6285714285714,4.87142857142857,0.274714285714286,85.0571428571429,59.1757142857143,33.5285714285714,305,0,0,268,178,219,305,219
2019,9,17,"Balikesir",39.6484,27.8826,25.3857142857143,6.18571428571429,0.373,77.4571428571429,34.6314285714286,28.0214285714286,331,0,0,216,263,310,331,310
2019,10,17,"Balikesir",39.6484,27.8826,15.5714285714286,10.2142857142857,0,71.4714285714286,52.71,42.6485714285714,359,0,0,55,15,252,359,252
2019,11,17,"Balikesir",39.6484,27.8826,19.3142857142857,9.81428571428571,3.467,79,29.2666666666667,25.3557142857143,373,68,36,164,246,400,305,364
2019,12,17,"Balikesir",39.6484,27.8826,32.8142857142857,10.3714285714286,0,66.9,33.8614285714286,23.8971428571429,343,0,0,189,344,416,343,416
2019,13,17,"Balikesir",39.6484,27.8826,38.1428571428571,8.3,0,60.3285714285714,27.8428571428571,16.6328571428571,256,0,0,142,105,194,256,194
2019,14,17,"Balikesir",39.6484,27.8826,20.9285714285714,10.3285714285714,0.883714285714286,75.0571428571428,37.61,25.5514285714286,365,0,0,177,133,208,365,208
2019,15,17,"Balikesir",39.6484,27.8826,20.0857142857143,13.6142857142857,9.95185714285714,83.3,23.4157142857143,24.7085714285714,359,113,86,1,0,183,246,97
2019,16,17,"Balikesir",39.6484,27.8826,27.8428571428571,9.15714285714286,0.0868571428571429,72.2714285714286,21.66,17.72,318,0,0,136,151,208,318,208
2019,17,17,"Balikesir",39.6484,27.8826,14.6,14.7428571428571,0.114857142857143,66.8571428571429,44.8842857142857,36.4957142857143,412,64,71,175,113,313,348,242
2019,18,17,"Balikesir",39.6484,27.8826,22.7,16.3714285714286,1.93685714285714,68.2142857142857,29.3971428571429,20.2142857142857,523,103,37,0,0,353,420,316
2019,19,17,"Balikesir",39.6484,27.8826,17.6857142857143,15.3428571428571,1.34942857142857,72.9285714285714,22.5085714285714,15.5657142857143,452,0,0,151,114,386,452,386
2019,20,17,"Balikesir",39.6484,27.8826,12.3714285714286,19.9,0.0851428571428571,71.5571428571429,29.3442857142857,17.1942857142857,454,0,0,137,126,389,454,389
2019,21,17,"Balikesir",39.6484,27.8826,22.7571428571429,20.8285714285714,1.59228571428571,66.0571428571428,28.698,21.048,457,72,32,136,151,413,385,381
2019,22,17,"Balikesir",39.6484,27.8826,18.8,23.4,0.001,60,29.1514285714286,19.3657142857143,453,0,0,269,226,323,453,323
2019,23,17,"Balikesir",39.6484,27.8826,25.1142857142857,22.9142857142857,0,56.8714285714286,19.9828571428571,9.51571428571429,378,0,0,178,166,532,378,532
2019,24,17,"Balikesir",39.6484,27.8826,28.1,24.7142857142857,0.00171428571428571,65.9285714285714,23.9414285714286,7.80571428571429,378,0,0,275,200,244,378,244
2019,25,17,"Balikesir",39.6484,27.8826,28.0285714285714,24.5285714285714,2.15285714285714,69.0571428571428,25.7885714285714,13.5928571428571,306,0,0,71,150,325,306,325
2019,26,17,"Balikesir",39.6484,27.8826,38.9,26.1,0,55.7714285714286,24.8,7.33166666666667,377,0,0,36,31,342,377,342
2019,27,17,"Balikesir",39.6484,27.8826,32.5285714285714,25.5857142857143,0,56.5142857142857,23.1585714285714,7.31714285714286,456,0,0,170,124,222,456,222
2019,28,17,"Balikesir",39.6484,27.8826,21.7285714285714,23.1571428571429,3.84885714285714,65.1,23.1614285714286,18.4085714285714,398,0,0,140,194,421,398,421
2019,29,17,"Balikesir",39.6484,27.8826,31.5142857142857,23.4142857142857,0.0282857142857143,65.3428571428571,21.1042857142857,9.00666666666667,453,0,0,49,16,203,453,203
2019,30,17,"Balikesir",39.6484,27.8826,33.4,24.7714285714286,0,60.3,20.8571428571429,6.44666666666667,456,0,0,111,92,335,456,335
2019,31,17,"Balikesir",39.6484,27.8826,25.4285714285714,26.8571428571429,0.000428571428571429,59.2142857142857,24.48,12.0371428571429,334,30,39,140,154,375,304,336
2019,32,17,"Balikesir",39.6484,27.8826,35.4571428571429,24.9857142857143,0,56.5428571428571,20.4342857142857,7.70333333333333,346,0,0,148,173,395,346,395
2019,33,17,"Balikesir",39.6484,27.8826,31.2,24.9428571428571,0.0122857142857143,65.5428571428571,19.9942857142857,3.825,337,0,0,206,271,531,337,531
2019,34,17,"Balikesir",39.6484,27.8826,38.5857142857143,25.3285714285714,0,66,26.5671428571429,4.16285714285714,299,0,0,39,24,345,299,345
2019,35,17,"Balikesir",39.6484,27.8826,37.0857142857143,25.3428571428571,0,62.5142857142857,25.8642857142857,2.6125,307,0,0,131,198,415,307,415
2019,36,17,"Balikesir",39.6484,27.8826,36.2571428571429,24.1857142857143,0,61.7571428571429,23.5357142857143,3.47142857142857,171,0,0,134,50,67,171,67
2019,37,17,"Balikesir",39.6484,27.8826,40.2285714285714,23.1428571428571,0.000142857142857143,62.5428571428571,24.6371428571429,4.60714285714286,218,0,0,97,30,55,218,55
2019,38,17,"Balikesir",39.6484,27.8826,27.4857142857143,19.5285714285714,0.00157142857142857,59.4571428571429,27.3985714285714,20.6585714285714,266,0,0,120,31,91,266,91
2019,39,17,"Balikesir",39.6484,27.8826,20.2857142857143,19.4428571428571,0.058,66.1,28.8442857142857,29.5342857142857,237,0,0,128,31,79,237,79
2019,40,17,"Balikesir",39.6484,27.8826,20.8571428571429,20.4571428571429,1.44214285714286,63.5285714285714,30.6171428571429,35.0285714285714,241,3,2,67,33,111,238,109
2019,41,17,"Balikesir",39.6484,27.8826,19.5428571428571,17.3428571428571,4.22914285714286,80.8714285714286,26.25,20.7,416,0,0,320,348,448,416,448
2019,42,17,"Balikesir",39.6484,27.8826,10.3285714285714,17.4142857142857,0.000142857142857143,86.8428571428571,58.6671428571429,34.4771428571429,356,0,0,300,324,408,356,408
2019,43,17,"Balikesir",39.6484,27.8826,29.3571428571429,16.9857142857143,0,76.7285714285714,31.7685714285714,14.13,306,0,0,236,256,300,306,300
2019,44,17,"Balikesir",39.6484,27.8826,16.9285714285714,12.8857142857143,1.14028571428571,82.2285714285714,34.6157142857143,28.1314285714286,350,0,0,200,160,250,350,250
2019,45,17,"Balikesir",39.6484,27.8826,20.1,16.6428571428571,0.708571428571429,75.9857142857143,41.89,36.6628571428571,417,74,75,0,0,328,343,253
2019,46,17,"Balikesir",39.6484,27.8826,7.47142857142857,11.8571428571429,0.511571428571429,94.0142857142857,66.7428571428571,45.5257142857143,401,124,134,118,58,337,277,203
2019,47,17,"Balikesir",39.6484,27.8826,6.95714285714286,10.1571428571429,0.0587142857142857,86.8,77.9271428571429,50.5085714285714,391,6,0,3,3,339,385,339
2019,48,17,"Balikesir",39.6484,27.8826,15.8714285714286,11.8142857142857,5.99985714285714,89.8428571428571,35.6142857142857,28.6485714285714,320,39,16,87,92,251,281,235
2019,49,17,"Balikesir",39.6484,27.8826,14.9,5.4,2.49185714285714,89.2857142857143,45.13,34.9242857142857,393,0,0,133,76,274,393,274
2019,50,17,"Balikesir",39.6484,27.8826,9.54285714285714,5.94285714285714,0.841428571428571,95.2571428571429,64.6585714285714,38.8642857142857,218,104,55,22,19,119,114,64
2019,51,17,"Balikesir",39.6484,27.8826,11.8428571428571,7.4,0.0284285714285714,88.8857142857143,84.4871428571429,41.5585714285714,361,93,182,5,6,488,268,306
2019,52,17,"Balikesir",39.6484,27.8826,24.0571428571429,7.41428571428571,4.28657142857143,85.8428571428571,19.8242857142857,26.5857142857143,279,47,64,209,206,281,232,217
2020,1,17,"Balikesir",39.6484,27.8826,29.68,4.4,0.0442,82.62,30.998,28.614,160,0,0,47,45,126,160,126
2020,2,17,"Balikesir",39.6484,27.8826,25.2142857142857,3.61428571428571,3.12871428571429,88.7857142857143,36.9857142857143,31.0528571428571,240,0,0,118,83,173,240,173
2020,3,17,"Balikesir",39.6484,27.8826,21.8,4.4,0.00242857142857143,86.7285714285714,39.2057142857143,31.3928571428571,270,0,0,67,54,382,270,382
2020,4,17,"Balikesir",39.6484,27.8826,20.4,3.02857142857143,0.313714285714286,75.4142857142857,43.25,42.2585714285714,358,7,2,188,121,295,351,293
2020,5,17,"Balikesir",39.6484,27.8826,16.6428571428571,7.97142857142857,4.226,83.3571428571429,44.3871428571429,46.41,331,160,119,40,26,272,171,153
2020,6,17,"Balikesir",39.6484,27.8826,26.1428571428571,5.94285714285714,2.26428571428571,79.2714285714286,27.4785714285714,28.9071428571429,343,181,142,108,78,267,162,125
2020,7,17,"Balikesir",39.6484,27.8826,20.4428571428571,6.77142857142857,3.30942857142857,78.1,42.0071428571429,42.4728571428571,341,0,0,177,117,338,341,338
2020,8,17,"Balikesir",39.6484,27.8826,23.0428571428571,6.55714285714286,0.772,77.1285714285714,39.4142857142857,34.7642857142857,283,0,0,173,111,187,283,187
2020,9,17,"Balikesir",39.6484,27.8826,24.8857142857143,8.74285714285714,2.97142857142857,71.6285714285714,37.6057142857143,37.5628571428571,393,22,4,127,217,528,371,524
2020,10,17,"Balikesir",39.6484,27.8826,19.3857142857143,11.9714285714286,2.96842857142857,73.7714285714286,39.97,38.4,205,11,3,0,0,210,194,207
2020,11,17,"Balikesir",39.6484,27.8826,23.1,10.6714285714286,0.993857142857143,79.9714285714286,40.4557142857143,32.2228571428571,115,0,0,71,40,94,115,94
2020,12,17,"Balikesir",39.6484,27.8826,29.8571428571429,6.25714285714286,0.311857142857143,68.5285714285714,27.4442857142857,25.5628571428571,117,10,5,61,36,118,107,113
2020,13,17,"Balikesir",39.6484,27.8826,22.7714285714286,9.22857142857143,1.20128571428571,84.0714285714286,28.4885714285714,15.4057142857143,136,0,0,92,37,92,136,92
2020,14,17,"Balikesir",39.6484,27.8826,22.5571428571429,9.04285714285714,4.12814285714286,83.8428571428571,29.1485714285714,21.2385714285714,155,3,1,122,97,121,152,120
2020,15,17,"Balikesir",39.6484,27.8826,33.3428571428571,9.92857142857143,1.483,68.5285714285714,26.7842857142857,16.2785714285714,133,0,0,103,52,118,133,118
2020,16,17,"Balikesir",39.6484,27.8826,20.9142857142857,12.8142857142857,0.889142857142857,65.9285714285714,29.5885714285714,20.6542857142857,141,0,0,57,66,106,141,106
2020,17,17,"Balikesir",39.6484,27.8826,29.3714285714286,11.8857142857143,0.0567142857142857,67.9,23.59,13.1628571428571,137,0,0,77,87,123,137,123
2020,18,17,"Balikesir",39.6484,27.8826,18.2285714285714,15.6428571428571,1.61314285714286,71.2,26.4714285714286,22.4214285714286,146,0,0,37,75,164,146,164
2020,19,17,"Balikesir",39.6484,27.8826,19.0571428571429,14.4285714285714,1.84342857142857,71.3285714285714,18.5771428571429,15.2642857142857,137,0,0,77,73,157,137,157
2020,20,17,"Balikesir",39.6484,27.8826,18.5571428571429,22.0857142857143,0,61.1714285714286,39.8971428571429,24.2514285714286,164,0,0,111,101,164,164,164
2020,21,17,"Balikesir",39.6484,27.8826,29.3857142857143,19.3142857142857,2.13742857142857,68.2571428571429,31.9542857142857,14.6328571428571,146,0,0,88,50,96,146,96
2020,22,17,"Balikesir",39.6484,27.8826,23.8428571428571,15.7142857142857,3.57857142857143,72.8714285714286,16.22,11.8385714285714,118,0,0,48,51,100,118,100
2020,23,17,"Balikesir",39.6484,27.8826,17.6857142857143,19,2.21871428571429,66.6857142857143,22.3228571428571,20.6057142857143,112,10,1,38,18,70,102,69
2020,24,17,"Balikesir",39.6484,27.8826,16.6285714285714,21.9714285714286,5.80942857142857,66.8714285714286,24.2414285714286,19.69,140,0,0,46,61,150,140,150
2020,25,17,"Balikesir",39.6484,27.8826,20.6428571428571,23.1142857142857,0.823714285714286,66.3714285714286,24.4414285714286,18.4357142857143,137,23,14,19,30,108,114,94
2020,26,17,"Balikesir",39.6484,27.8826,29.1,22.7285714285714,0.943285714285714,70.3571428571429,23.2442857142857,13.2,173,0,0,81,72,133,173,133
2020,27,17,"Balikesir",39.6484,27.8826,30.6714285714286,25.8857142857143,0,62.6571428571429,25.2642857142857,12.4742857142857,113,0,0,60,49,113,113,113
2020,28,17,"Balikesir",39.6484,27.8826,35.4714285714286,25.2142857142857,0,63.7285714285714,21.2271428571429,6.59,164,0,0,89,80,122,164,122
2020,29,17,"Balikesir",39.6484,27.8826,31.2142857142857,23.1285714285714,0,64.3285714285714,17.8157142857143,7.74142857142857,186,0,0,84,53,111,186,111
2020,30,17,"Balikesir",39.6484,27.8826,32.0285714285714,25.5428571428571,0.085,59.9142857142857,23.7442857142857,8.22,190,0,0,116,84,142,190,142
2020,31,17,"Balikesir",39.6484,27.8826,35.7142857142857,26.7428571428571,0,56.1,22.8242857142857,9.37142857142857,150,0,0,47,58,127,150,127
2020,32,17,"Balikesir",39.6484,27.8826,27.2714285714286,25.9857142857143,0.000285714285714286,62.7,23.3542857142857,8.52714285714286,146,0,0,110,95,107,146,107
2020,33,17,"Balikesir",39.6484,27.8826,35.9714285714286,25.4428571428571,0,55.4714285714286,22.6242857142857,9.22428571428572,183,0,0,82,57,83,183,83
2020,34,17,"Balikesir",39.6484,27.8826,30.9714285714286,24.1857142857143,0.000428571428571429,60.5428571428571,23.7528571428571,13.2185714285714,197,0,0,115,58,97,197,97
2020,35,17,"Balikesir",39.6484,27.8826,25.9428571428571,25.2428571428571,0,61.3714285714286,42.8971428571429,15.1285714285714,164,0,0,93,117,157,164,157
2020,36,17,"Balikesir",39.6484,27.8826,27.5428571428571,24.7142857142857,0,61.8428571428571,56.66,18.8342857142857,179,0,0,109,74,112,179,112
2020,37,17,"Balikesir",39.6484,27.8826,37.0428571428571,24.5,0.00128571428571429,66.3571428571429,49.39,9.16857142857143,193,0,0,124,51,91,193,91
2020,38,17,"Balikesir",39.6484,27.8826,34.0714285714286,23.7,0,66,48.8185714285714,9.75142857142857,235,0,0,116,102,157,235,157
2020,39,17,"Balikesir",39.6484,27.8826,20.4,22.7285714285714,0.00185714285714286,60.8,56.5114285714286,23.7671428571429,220,21,6,112,68,129,199,123
2020,40,17,"Balikesir",39.6484,27.8826,18,20.4,0.004,52.7428571428571,65.0342857142857,36.2071428571429,187,31,43,20,8,154,156,111
2020,41,17,"Balikesir",39.6484,27.8826,15.8428571428571,20.9142857142857,1.93671428571429,62.3428571428571,86.4657142857143,38.1114285714286,182,0,0,57,32,127,182,127
2020,42,17,"Balikesir",39.6484,27.8826,20.5857142857143,18.6142857142857,1.01971428571429,71.4,71.4557142857143,35.8057142857143,177,0,0,12,16,111,177,111
2020,43,17,"Balikesir",39.6484,27.8826,20.2142857142857,17.3142857142857,0.199428571428571,75.7428571428571,69.3457142857143,27.7685714285714,194,0,0,95,111,161,194,161
2020,44,17,"Balikesir",39.6484,27.8826,15.5857142857143,14.8428571428571,0.122571428571429,75.0285714285714,75.1128571428571,36.2557142857143,255,34,13,194,202,233,221,220
2020,45,17,"Balikesir",39.6484,27.8826,27.7714285714286,12.5,0.794571428571429,73.5428571428571,56.3757142857143,24.4114285714286,156,0,0,83,56,103,156,103
2020,46,17,"Balikesir",39.6484,27.8826,24.1,11.1857142857143,3.18071428571429,83.4857142857143,65.3757142857143,27.88,208,0,0,146,91,109,208,109
2020,47,17,"Balikesir",39.6484,27.8826,29.6142857142857,9.6,0.00614285714285714,77.0285714285714,65.5085714285714,21.5685714285714,173,0,0,64,9,83,173,83
2020,48,17,"Balikesir",39.6484,27.8826,20.9857142857143,6.25714285714286,0.0288571428571429,75.5857142857143,110.064285714286,40.4414285714286,199,0,0,72,108,262,199,262
2020,49,17,"Balikesir",39.6484,27.8826,15.9142857142857,7.75714285714286,0.000285714285714286,81.3857142857143,127.095714285714,35.6342857142857,207,0,0,188,107,116,207,116
2020,50,17,"Balikesir",39.6484,27.8826,20.3285714285714,10.9857142857143,4.00657142857143,79.1857142857143,80.4114285714286,37.3657142857143,181,41,52,23,6,98,140,46
2020,51,17,"Balikesir",39.6484,27.8826,21.1714285714286,9.07142857142857,0.586428571428571,86.3,51.4457142857143,21.4714285714286,171,0,0,104,50,90,171,90
2020,52,17,"Balikesir",39.6484,27.8826,20.0428571428571,8.37142857142857,0.0285714285714286,77.4571428571429,87.9285714285714,35.6585714285714,203,88,46,44,25,113,115,67
2020,53,17,"Balikesir",39.6484,27.8826,24.475,11.525,0.9025,75.2,56.0525,36.535,122,92,51,0,0,111,30,60
2017,1,18,"Bartin",41.6358,32.3375,8.45714285714286,3.82857142857143,3.82857142857143,79.1285714285714,77.6042857142857,NA,563,139,224,1,10,847,424,623
2017,2,18,"Bartin",41.6358,32.3375,10.3714285714286,4.05714285714286,1.51428571428571,70.9857142857143,84.7257142857143,NA,757,187,249,168,238,1214,570,965
2017,3,18,"Bartin",41.6358,32.3375,9.37142857142857,5.18571428571429,0.971428571428571,85.3142857142857,70.0685714285714,NA,762,134,219,99,120,1449,628,1230
2017,4,18,"Bartin",41.6358,32.3375,5.51428571428571,0.857142857142857,6.89985714285714,88.4571428571429,83.8171428571429,NA,639,198,181,227,308,889,441,708
2017,5,18,"Bartin",41.6358,32.3375,7.62857142857143,1.62857142857143,1.51428571428571,76.3857142857143,93.9571428571429,NA,588,355,544,0,0,1163,233,619
2017,6,18,"Bartin",41.6358,32.3375,12.7428571428571,6.78571428571429,1.08571428571429,75.4142857142857,64.9957142857143,NA,736,323,642,1,10,1519,413,877
2017,7,18,"Bartin",41.6358,32.3375,9.08571428571429,2.07142857142857,2.62842857142857,76.1857142857143,67.4757142857143,NA,492,0,0,106,156,717,492,717
2017,8,18,"Bartin",41.6358,32.3375,10.1714285714286,8.6,2,69.9857142857143,81.9642857142857,NA,739,0,0,600,1394,1747,739,1747
2017,9,18,"Bartin",41.6358,32.3375,11.1428571428571,8.9,0.0714285714285714,78.1,84.2614285714286,NA,574,0,0,350,574,866,574,866
2017,10,18,"Bartin",41.6358,32.3375,10.6857142857143,10.2428571428571,0.0285714285714286,68.2571428571429,80.7114285714286,NA,712,0,0,384,674,1043,712,1043
2017,11,18,"Bartin",41.6358,32.3375,14.6714285714286,6.65714285714286,6.74314285714286,83.9,50.9814285714286,NA,525,0,0,184,329,725,525,725
2017,12,18,"Bartin",41.6358,32.3375,10.8857142857143,8.1,1.17157142857143,74.4428571428571,57.4442857142857,NA,589,0,0,396,570,1077,589,1077
2017,13,18,"Bartin",41.6358,32.3375,12.7428571428571,7.9,1.97142857142857,73.9,55.7328571428571,NA,574,0,0,322,559,887,574,887
2017,14,18,"Bartin",41.6358,32.3375,13.7857142857143,8.78571428571429,1.78571428571429,79.1142857142857,58.8385714285714,NA,639,0,0,455,1036,1336,639,1336
2017,15,18,"Bartin",41.6358,32.3375,10.6857142857143,10.4857142857143,0.5,70.7428571428571,48.4671428571429,NA,587,0,0,369,750,1187,587,1187
2017,16,18,"Bartin",41.6358,32.3375,14.0714285714286,10.6571428571429,5.37185714285714,74.1857142857143,35.4957142857143,NA,717,0,0,196,281,920,717,920
2017,17,18,"Bartin",41.6358,32.3375,12.2285714285714,14.3142857142857,1.8,55.0285714285714,46.5828571428571,NA,731,33,9,85,150,1478,698,1469
2017,18,18,"Bartin",41.6358,32.3375,10.1714285714286,14.1714285714286,4.02842857142857,84.2571428571429,49.9414285714286,NA,506,69,113,402,698,923,437,810
2017,19,18,"Bartin",41.6358,32.3375,9.28571428571429,16.8,2.28585714285714,73.5428571428571,36.7928571428571,NA,471,94,156,228,472,966,377,810
2017,20,18,"Bartin",41.6358,32.3375,14.0714285714286,14.4142857142857,4.19985714285714,76.7142857142857,32.8814285714286,NA,472,0,0,181,555,1205,472,1205
2017,21,18,"Bartin",41.6358,32.3375,11.9714285714286,14.9857142857143,1.943,76.0857142857143,29.7942857142857,NA,448,0,0,225,470,849,448,849
2017,22,18,"Bartin",41.6358,32.3375,14.8714285714286,20.4428571428571,0.542857142857143,71.8142857142857,31.39,NA,522,0,0,80,88,1015,522,1015
2017,23,18,"Bartin",41.6358,32.3375,10.2142857142857,20.1714285714286,4.41414285714286,80.9142857142857,31.1528571428571,NA,578,13,6,252,626,1388,565,1382
2017,24,18,"Bartin",41.6358,32.3375,10.2714285714286,19.3142857142857,0.0857142857142857,70.7428571428571,26.5985714285714,NA,552,0,0,210,419,1139,552,1139
2017,25,18,"Bartin",41.6358,32.3375,12.5571428571429,22.1714285714286,5.44385714285714,74.8285714285714,26.3314285714286,NA,584,0,0,96,147,1041,584,1041
2017,26,18,"Bartin",41.6358,32.3375,11.0571428571429,25.7428571428571,0,67.6714285714286,34.4485714285714,NA,564,151,181,251,493,971,413,790
2017,27,18,"Bartin",41.6358,32.3375,15.8142857142857,22.9714285714286,0.628714285714286,69.1714285714286,25.1228571428571,NA,511,0,0,123,140,642,511,642
2017,28,18,"Bartin",41.6358,32.3375,17.0428571428571,23.6428571428571,0,71.9285714285714,28.4657142857143,NA,481,0,0,76,232,864,481,864
2017,29,18,"Bartin",41.6358,32.3375,14.3857142857143,23.3285714285714,0.571428571428571,77.3857142857143,30.6157142857143,NA,532,0,0,92,228,1272,532,1272
2017,30,18,"Bartin",41.6358,32.3375,12.7428571428571,24.1571428571429,1.42842857142857,66.5,41.6642857142857,NA,531,0,0,292,502,928,531,928
2017,31,18,"Bartin",41.6358,32.3375,12.7428571428571,24.2428571428571,0,75.8571428571429,35.146,NA,559,0,0,366,679,1047,559,1047
2017,32,18,"Bartin",41.6358,32.3375,12.5714285714286,26.4142857142857,0,75.6285714285714,47.41,NA,567,0,0,294,581,1092,567,1092
2017,33,18,"Bartin",41.6358,32.3375,13.9571428571429,24.4571428571429,0.228571428571429,75.4142857142857,39.8314285714286,NA,596,0,0,222,487,1199,596,1199
2017,34,18,"Bartin",41.6358,32.3375,15.8428571428571,21.7285714285714,10.429,74.2571428571429,26.9914285714286,NA,601,29,47,85,116,1280,572,1233
2017,35,18,"Bartin",41.6358,32.3375,13.0285714285714,20.4571428571429,0,69.6285714285714,24.2857142857143,NA,493,42,68,0,0,1014,451,946
2017,36,18,"Bartin",41.6358,32.3375,11.4428571428571,20.5,1.42871428571429,74.8142857142857,30.0585714285714,NA,507,0,0,165,468,1321,507,1321
2017,37,18,"Bartin",41.6358,32.3375,9.14285714285714,23.0142857142857,0,75.5428571428571,47.1128571428571,NA,589,0,0,323,495,1138,589,1138
2017,38,18,"Bartin",41.6358,32.3375,8.77142857142857,20.7285714285714,0.614571428571429,83.0428571428571,36.7728571428571,NA,671,0,0,320,494,1312,671,1312
2017,39,18,"Bartin",41.6358,32.3375,16.3857142857143,16.8857142857143,0.728571428571429,85.7857142857143,38.4471428571429,NA,782,0,0,0,0,1630,782,1630
2017,40,18,"Bartin",41.6358,32.3375,12.7714285714286,14.3285714285714,3.17128571428571,79.4571428571429,42.1528571428571,NA,543,48,83,200,475,1137,495,1054
2017,41,18,"Bartin",41.6358,32.3375,6.4,11.1285714285714,1.343,91.2428571428571,42.7528571428571,NA,487,187,137,107,156,843,300,706
2017,42,18,"Bartin",41.6358,32.3375,6.71428571428571,12.6428571428571,0.442857142857143,87.1571428571429,55.4671428571429,NA,530,22,14,281,400,815,508,801
2017,43,18,"Bartin",41.6358,32.3375,6.6,14.4285714285714,6.8,89.8,52.3971428571429,NA,506,83,54,1,1,919,423,865
2017,44,18,"Bartin",41.6358,32.3375,6.8,7.4,5.81428571428571,89.6857142857143,52.4271428571429,NA,561,175,374,16,14,1102,386,728
2017,45,18,"Bartin",41.6358,32.3375,10.0285714285714,10.9571428571429,1.97157142857143,93.0428571428571,59.965,NA,577,197,437,75,111,829,380,392
2017,46,18,"Bartin",41.6358,32.3375,9.41428571428571,12.0857142857143,0.0285714285714286,87.8142857142857,84.7066666666667,NA,587,183,372,188,338,1085,404,713
2017,47,18,"Bartin",41.6358,32.3375,6.34285714285714,7.7,16.4707142857143,92.8,45.4514285714286,NA,418,42,104,133,167,804,376,700
2017,48,18,"Bartin",41.6358,32.3375,5.25714285714286,10.3571428571429,1.47157142857143,83.2142857142857,74.6928571428572,NA,386,169,271,11,3,619,217,348
2017,49,18,"Bartin",41.6358,32.3375,8.24285714285714,6.27142857142857,11.5431428571429,91.5714285714286,54.4914285714286,NA,407,80,135,73,166,645,327,510
2017,50,18,"Bartin",41.6358,32.3375,12.4571428571429,9.37142857142857,0.128571428571429,83.9285714285714,83.7814285714286,NA,346,344,431,0,0,442,2,11
2017,51,18,"Bartin",41.6358,32.3375,14.6285714285714,6.05714285714286,9.81485714285714,93.5142857142857,37.7033333333333,NA,386,157,119,105,90,349,229,230
2017,52,18,"Bartin",41.6358,32.3375,17.3875,8.375,1.9875,75.3625,76.52625,NA,528,242,204,0,0,507,286,303
2018,1,18,"Bartin",41.6358,32.3375,7.85,7.4125,2.2875,88.05,66.15875,33.07,618,149,188,73,71,914,469,726
2018,2,18,"Bartin",41.6358,32.3375,11.5714285714286,6.7,1.5,91.7285714285714,65.9457142857143,NA,624,189,289,0,0,1309,435,1020
2018,3,18,"Bartin",41.6358,32.3375,23.0571428571429,6.28571428571429,4.64271428571429,78.3142857142857,49.7471428571429,NA,639,340,416,11,12,655,299,239
2018,4,18,"Bartin",41.6358,32.3375,17.1571428571429,3.98571428571429,2.12871428571429,79.1,54.4085714285714,NA,604,258,301,70,72,764,346,463
2018,5,18,"Bartin",41.6358,32.3375,9.02857142857143,8.3,0.0714285714285714,75.9,88.7971428571429,NA,670,97,102,376,436,819,573,717
2018,6,18,"Bartin",41.6358,32.3375,7.68571428571429,7.71428571428571,1.68571428571429,90.9714285714286,66.4471428571429,NA,704,57,73,181,229,1022,647,949
2018,7,18,"Bartin",41.6358,32.3375,8.25714285714286,6.8,0.471428571428571,88.3571428571429,57.0228571428571,NA,478,83,123,112,83,557,395,434
2018,8,18,"Bartin",41.6358,32.3375,14.0714285714286,6.95714285714286,2.12871428571429,90.5142857142857,50.7857142857143,NA,711,0,0,4,1,1321,711,1321
2018,9,18,"Bartin",41.6358,32.3375,12.9857142857143,5.35714285714286,8.98571428571429,92.4571428571429,47.4342857142857,NA,621,0,0,325,451,956,621,956
2018,10,18,"Bartin",41.6358,32.3375,7.68571428571429,9.71428571428572,6.12842857142857,89.2571428571429,58.1157142857143,NA,556,188,566,238,455,1330,368,764
2018,11,18,"Bartin",41.6358,32.3375,13.3,13.6857142857143,4.99985714285714,71.6714285714286,58.2785714285714,NA,551,41,133,0,0,1426,510,1293
2018,12,18,"Bartin",41.6358,32.3375,9.91428571428571,10.1,0.342857142857143,87,64.076,NA,425,0,0,177,621,1187,425,1187
2018,13,18,"Bartin",41.6358,32.3375,9.34285714285714,12.4571428571429,4.22871428571429,75.8714285714286,60.6166666666667,NA,356,0,0,123,185,428,356,428
2018,14,18,"Bartin",41.6358,32.3375,12.2714285714286,11.8571428571429,0.328571428571429,73.5,45.2942857142857,NA,407,0,0,173,266,486,407,486
2018,15,18,"Bartin",41.6358,32.3375,14.1285714285714,12.0285714285714,0,84.2571428571429,61.1385714285714,NA,374,0,0,247,361,450,374,450
2018,16,18,"Bartin",41.6358,32.3375,9.65714285714286,11.7714285714286,1.61428571428571,77.7142857142857,48.9,NA,411,71,91,241,415,648,340,557
2018,17,18,"Bartin",41.6358,32.3375,13.6,18.1857142857143,0,59,51.9757142857143,35.1766666666667,419,173,195,51,83,652,246,457
2018,18,18,"Bartin",41.6358,32.3375,8.31428571428571,14.6857142857143,0.571428571428572,90.4571428571429,38.5414285714286,45.3166666666667,303,0,0,296,463,474,303,474
2018,19,18,"Bartin",41.6358,32.3375,10.6142857142857,15.6714285714286,5.05728571428571,88.6714285714286,37,NA,275,0,0,58,75,467,275,467
2018,20,18,"Bartin",41.6358,32.3375,9.4,18.9571428571429,1.02871428571429,74.9714285714286,38.665,NA,204,26,78,102,131,306,178,228
2018,21,18,"Bartin",41.6358,32.3375,12.2285714285714,19.5714285714286,0.1,87.4714285714286,31.07,20.81,252,0,0,57,138,281,252,281
2018,22,18,"Bartin",41.6358,32.3375,11.7142857142857,18.9571428571429,0.742857142857143,82.5,31.96,22.374,249,0,0,58,115,427,249,427
2018,23,18,"Bartin",41.6358,32.3375,15.8571428571429,21.5857142857143,0,70.4285714285714,34.25,35.1728571428571,267,0,0,104,368,812,267,812
2018,24,18,"Bartin",41.6358,32.3375,16.8857142857143,22.8,0.628571428571429,67.2,29.3442857142857,41.49,267,52,174,41,25,448,215,274
2018,25,18,"Bartin",41.6358,32.3375,13.5142857142857,22.5142857142857,13.8564285714286,78.9,23.8485714285714,23.0285714285714,358,0,0,170,195,518,358,518
2018,26,18,"Bartin",41.6358,32.3375,11.2,23.1714285714286,0.385714285714286,78.3,27.8457142857143,NA,355,0,0,191,379,587,355,587
2018,27,18,"Bartin",41.6358,32.3375,12.4857142857143,22.1571428571429,0,73.0714285714286,24.9214285714286,NA,342,0,0,46,80,418,342,418
2018,28,18,"Bartin",41.6358,32.3375,10.1714285714286,24.0857142857143,1.25714285714286,80.9285714285714,25.86,NA,286,0,0,65,118,585,286,585
2018,29,18,"Bartin",41.6358,32.3375,14.6285714285714,23.7,0.800142857142857,74.1285714285714,24.5514285714286,22.485,260,12,36,22,72,756,248,720
2018,30,18,"Bartin",41.6358,32.3375,13,24.1714285714286,1.57185714285714,76.9285714285714,25.8528571428571,25.4671428571429,265,0,0,0,0,822,265,822
2018,31,18,"Bartin",41.6358,32.3375,13.6142857142857,25.8428571428571,0,74.1857142857143,27.488,20.01,267,0,0,0,0,499,267,499
2018,32,18,"Bartin",41.6358,32.3375,16.4285714285714,23.2571428571429,0.642857142857143,72.9857142857143,28.1042857142857,24.2214285714286,297,0,0,2,3,403,297,403
2018,33,18,"Bartin",41.6358,32.3375,14.1714285714286,23.1714285714286,0,72.8428571428571,29.4014285714286,29.54,216,0,0,49,76,332,216,332
2018,34,18,"Bartin",41.6358,32.3375,17.2714285714286,25.0714285714286,0.0142857142857143,68.5571428571428,25.3542857142857,NA,144,0,0,0,0,227,144,227
2018,35,18,"Bartin",41.6358,32.3375,12.2142857142857,25.3857142857143,0.657142857142857,75.3857142857143,26.7728571428571,NA,201,0,0,32,60,314,201,314
2018,36,18,"Bartin",41.6358,32.3375,14.3714285714286,22.8,8.79957142857143,79.6142857142857,25.935,NA,341,7,26,53,73,370,334,344
2018,37,18,"Bartin",41.6358,32.3375,15.9142857142857,19.6,7.75742857142857,83.1428571428571,20.115,NA,241,22,45,0,0,419,219,374
2018,38,18,"Bartin",41.6358,32.3375,18.2571428571429,19.7285714285714,0.457142857142857,80.3,21.88,27.6,189,0,0,28,46,344,189,344
2018,39,18,"Bartin",41.6358,32.3375,20.0857142857143,18.0428571428571,0.786142857142857,78.0857142857143,21.83,24.73,180,13,14,31,58,353,167,339
2018,40,18,"Bartin",41.6358,32.3375,11.6428571428571,17.0571428571429,3.28557142857143,82.7857142857143,25.4871428571429,27.4985714285714,191,89,176,0,0,341,102,165
2018,41,18,"Bartin",41.6358,32.3375,9.65714285714286,16.3428571428571,0.0428571428571429,89.8571428571429,33.1366666666667,25.9066666666667,187,0,0,40,142,422,187,422
2018,42,18,"Bartin",41.6358,32.3375,8.28571428571428,17.6285714285714,2.57142857142857,93.4857142857143,55.7028571428571,26.5033333333333,168,0,0,105,314,381,168,381
2018,43,18,"Bartin",41.6358,32.3375,18.6571428571429,14.1142857142857,9.22828571428571,84.2714285714286,41.99,28.635,187,54,85,33,43,402,133,317
2018,44,18,"Bartin",41.6358,32.3375,9.6,14.3428571428571,0,79.2142857142857,58.1771428571429,34.7642857142857,196,148,184,0,0,264,48,80
2018,45,18,"Bartin",41.6358,32.3375,9.02857142857143,12.8,0,87.0571428571429,46.7471428571429,25.4042857142857,231,4,30,13,78,473,227,443
2018,46,18,"Bartin",41.6358,32.3375,12.6571428571429,8.78571428571429,3.15728571428571,90.3285714285714,38.5842857142857,25.8575,230,108,211,0,0,465,122,254
2018,47,18,"Bartin",41.6358,32.3375,9.68571428571429,10.0285714285714,2.157,91.4285714285714,49.2542857142857,24.18,270,147,79,37,55,499,123,420
2018,48,18,"Bartin",41.6358,32.3375,8.12857142857143,8.84285714285714,4.872,94.6285714285714,57.31,30.8714285714286,245,82,66,1,1,201,163,135
2018,49,18,"Bartin",41.6358,32.3375,4.68571428571429,6.27142857142857,2.27157142857143,93.6857142857143,62.8928571428571,30.2885714285714,257,28,112,38,56,420,229,308
2018,50,18,"Bartin",41.6358,32.3375,8.7,6.41428571428571,12.6427142857143,93.6,76.9028571428571,39.0285714285714,256,43,56,46,63,305,213,249
2018,51,18,"Bartin",41.6358,32.3375,8.25714285714286,7.87142857142857,2.84285714285714,94.1285714285714,62.8528571428571,34.02,250,0,0,19,19,248,250,248
2018,52,18,"Bartin",41.6358,32.3375,7.57142857142857,3.9,6.31457142857143,95.9285714285714,54.5171428571429,30.844,244,102,104,28,1,273,142,169
2019,1,18,"Bartin",41.6358,32.3375,13.2375,4.3625,4.97525,94.175,58.10625,30.9875,343,192,507,21,80,784,151,277
2019,2,18,"Bartin",41.6358,32.3375,6.34285714285714,4.05714285714286,5.47157142857143,88.2428571428571,51.42,40.1942857142857,255,90,84,1,0,208,165,124
2019,3,18,"Bartin",41.6358,32.3375,10.8714285714286,5.02857142857143,6.79985714285714,85.8571428571429,67.506,36.058,192,137,153,28,33,198,55,45
2019,4,18,"Bartin",41.6358,32.3375,22.0714285714286,10.5428571428571,0.8,67.9428571428572,NA,NA,308,135,184,48,43,314,173,130
2019,5,18,"Bartin",41.6358,32.3375,16.0857142857143,9.95714285714286,2.15714285714286,73.5571428571429,51.025,39.6825,253,185,105,0,0,143,68,38
2019,6,18,"Bartin",41.6358,32.3375,7.87142857142857,7.44285714285714,1.84285714285714,91.8571428571429,36.85,27.8471428571429,276,51,14,87,64,127,225,113
2019,7,18,"Bartin",41.6358,32.3375,11.4,6.55714285714286,0.0857142857142857,81.7857142857143,28.6571428571429,23.8814285714286,325,0,0,60,10,234,325,234
2019,8,18,"Bartin",41.6358,32.3375,8.88571428571429,4.81428571428571,0.200285714285714,89.7714285714286,55.8866666666667,36.0466666666667,305,0,0,188,134,219,305,219
2019,9,18,"Bartin",41.6358,32.3375,12.2285714285714,4.95714285714286,3.02857142857143,88.0428571428571,38.1933333333333,32.0366666666667,331,48,3,133,166,310,283,307
2019,10,18,"Bartin",41.6358,32.3375,9.34285714285714,8.28571428571429,1,77.4571428571429,49.2228571428571,43.8657142857143,359,52,44,195,124,252,307,208
2019,11,18,"Bartin",41.6358,32.3375,16.1714285714286,9.64285714285714,3.3,77.4857142857143,33.8157142857143,29.2785714285714,373,71,40,161,112,400,302,360
2019,12,18,"Bartin",41.6358,32.3375,9.85714285714286,7.57142857142857,0,78.1714285714286,36.5057142857143,30.225,343,0,0,176,335,416,343,416
2019,13,18,"Bartin",41.6358,32.3375,16.4285714285714,5.68571428571429,0,75.9857142857143,31.6028571428571,27.2885714285714,256,0,0,77,60,194,256,194
2019,14,18,"Bartin",41.6358,32.3375,10.1142857142857,8.78571428571429,0,81.8142857142857,45.5885714285714,30.2571428571429,365,0,0,218,155,208,365,208
2019,15,18,"Bartin",41.6358,32.3375,9.4,13.8857142857143,3.8,82.6857142857143,31.0471428571429,29.5871428571429,359,54,15,242,142,183,305,168
2019,16,18,"Bartin",41.6358,32.3375,9.6,8.15714285714286,5.04285714285714,90.3428571428571,22.2942857142857,20.7875,318,0,0,169,88,208,318,208
2019,17,18,"Bartin",41.6358,32.3375,10.6857142857143,11.1428571428571,0,78.5,32.534,23.518,412,52,18,178,119,313,360,295
2019,18,18,"Bartin",41.6358,32.3375,11.9714285714286,16.8,0.385714285714286,69.7714285714286,35.2728571428571,26.5885714285714,523,0,0,141,94,353,523,353
2019,19,18,"Bartin",41.6358,32.3375,9.91428571428571,14.5571428571429,4.957,83.0142857142857,22.885,20.4083333333333,452,0,0,405,330,386,452,386
2019,20,18,"Bartin",41.6358,32.3375,12.2285714285714,18.4142857142857,5.12885714285714,79.4428571428571,NA,NA,454,4,1,68,37,389,450,388
2019,21,18,"Bartin",41.6358,32.3375,14.6857142857143,20.8285714285714,1.90014285714286,71.6857142857143,40.318,19.4725,457,183,162,0,0,413,274,251
2019,22,18,"Bartin",41.6358,32.3375,16.4857142857143,23.0857142857143,0.214285714285714,65.7571428571429,37.8585714285714,26.1514285714286,453,88,68,1,0,323,365,255
2019,23,18,"Bartin",41.6358,32.3375,11.2,22.1,0,80.7142857142857,30.3728571428571,17.9657142857143,378,0,0,144,172,532,378,532
2019,24,18,"Bartin",41.6358,32.3375,12.2571428571429,22.9857142857143,1.71414285714286,83.8714285714286,29.8614285714286,18.2628571428571,378,0,0,127,91,244,378,244
2019,25,18,"Bartin",41.6358,32.3375,9.6,22.9714285714286,4.029,88.9285714285714,30.58,19.28,306,0,0,97,65,325,306,325
2019,26,18,"Bartin",41.6358,32.3375,11.7142857142857,22.4857142857143,2.257,80.2428571428571,25.9114285714286,16.12,377,0,0,24,9,342,377,342
2019,27,18,"Bartin",41.6358,32.3375,12.2285714285714,22.4857142857143,0.0142857142857143,77.3428571428571,25.3057142857143,18.1714285714286,456,0,0,8,2,222,456,222
2019,28,18,"Bartin",41.6358,32.3375,12.5714285714286,22.1142857142857,6.18657142857143,76.1857142857143,21.2914285714286,19.7614285714286,398,56,25,110,121,421,342,396
2019,29,18,"Bartin",41.6358,32.3375,17.1714285714286,22.5428571428571,1.70042857142857,76.9857142857143,24.9842857142857,17.0471428571429,453,0,0,0,0,203,453,203
2019,30,18,"Bartin",41.6358,32.3375,14.5857142857143,23.9714285714286,0.285857142857143,73.8714285714286,33.6028571428571,20.2471428571429,456,44,46,64,29,335,412,289
2019,31,18,"Bartin",41.6358,32.3375,11.4571428571429,23.8285714285714,0.871571428571429,81.7714285714286,37.2828571428571,25.2342857142857,334,0,0,181,220,375,334,375
2019,32,18,"Bartin",41.6358,32.3375,15.2571428571429,21.1714285714286,0.714285714285714,76.1142857142857,24.9885714285714,22.9457142857143,346,0,0,65,52,395,346,395
2019,33,18,"Bartin",41.6358,32.3375,15.7,23.2,1.65728571428571,79.7142857142857,40.0271428571429,29.3971428571429,337,55,131,104,156,531,282,400
2019,34,18,"Bartin",41.6358,32.3375,14.3142857142857,23.2428571428571,3.458,85.2285714285714,37.0814285714286,21.5271428571429,299,0,0,0,0,345,299,345
2019,35,18,"Bartin",41.6358,32.3375,16.9142857142857,23.5,0,75.7,36.87,18.2471428571429,307,0,0,0,0,415,307,415
2019,36,18,"Bartin",41.6358,32.3375,15.7142857142857,21.8857142857143,0,75.2,NA,18.5557142857143,171,0,0,0,0,67,171,67
2019,37,18,"Bartin",41.6358,32.3375,14.8,20.8285714285714,0,76.5285714285714,28.505,18.0016666666667,218,0,0,0,0,55,218,55
2019,38,18,"Bartin",41.6358,32.3375,11.4571428571429,16.9714285714286,1.71457142857143,79.0428571428571,32.4371428571429,17.91,266,55,36,42,7,91,211,55
2019,39,18,"Bartin",41.6358,32.3375,7.94285714285714,16.8142857142857,2.64285714285714,87.4571428571429,35.2171428571429,27.1828571428571,237,21,9,89,31,79,216,70
2019,40,18,"Bartin",41.6358,32.3375,8.77142857142857,17.4,10.2574285714286,85.3571428571429,41.5071428571429,33.7228571428571,241,0,0,87,22,111,241,111
2019,41,18,"Bartin",41.6358,32.3375,14.8714285714286,16.3285714285714,1.62857142857143,84.4571428571429,35.6942857142857,25.76,416,138,216,0,0,448,278,232
2019,42,18,"Bartin",41.6358,32.3375,9.42857142857143,17.5285714285714,0.0285714285714286,91.1857142857143,59.4057142857143,31.415,356,153,217,0,0,408,203,191
2019,43,18,"Bartin",41.6358,32.3375,9.6,15.0428571428571,0,92.3285714285714,55.1428571428571,27.31,306,6,14,34,79,300,300,286
2019,44,18,"Bartin",41.6358,32.3375,7.68571428571429,11.7,0.414285714285714,91.1571428571429,53.8228571428571,25.7028571428571,350,68,34,64,75,250,282,216
2019,45,18,"Bartin",41.6358,32.3375,3.95714285714286,13.7285714285714,0,84.6428571428571,105.07,43.3042857142857,417,122,117,32,7,328,295,211
2019,46,18,"Bartin",41.6358,32.3375,4.71428571428571,12.6428571428571,0,83.7285714285714,106.601428571429,45.7485714285714,401,32,22,138,144,337,369,315
2019,47,18,"Bartin",41.6358,32.3375,3.91428571428571,8.25714285714286,0,85.1571428571429,110.418571428571,44.0871428571429,391,0,0,202,171,339,391,339
2019,48,18,"Bartin",41.6358,32.3375,6.6,10.6142857142857,8.2,95.8428571428571,106.695714285714,39.0842857142857,320,35,17,155,113,251,285,234
2019,49,18,"Bartin",41.6358,32.3375,6.6,4.47142857142857,1.67157142857143,91.4285714285714,69.6914285714286,30.53,393,92,63,0,0,274,301,211
2019,50,18,"Bartin",41.6358,32.3375,4.74285714285714,7.17142857142857,1.1,92.1571428571429,131.708571428571,40.09,218,83,50,41,30,119,135,69
2019,51,18,"Bartin",41.6358,32.3375,3.84285714285714,6.47142857142857,0.0142857142857143,89.0857142857143,149.982857142857,42.9885714285714,361,247,402,0,0,488,114,86
2019,52,18,"Bartin",41.6358,32.3375,16.6714285714286,8.94285714285714,14.0718571428571,88.9714285714286,62.9214285714286,35.9628571428571,279,13,13,86,41,281,266,268
2020,1,18,"Bartin",41.6358,32.3375,5.12,4.12,7.5598,96.28,65.328,32.5,160,37,24,0,0,126,123,102
2020,2,18,"Bartin",41.6358,32.3375,5.35714285714286,4.17142857142857,3.05757142857143,98,83.9557142857143,36.5571428571429,240,115,37,45,32,173,125,136
2020,3,18,"Bartin",41.6358,32.3375,9.71428571428572,4.51428571428571,0.628571428571429,94.4,87.45,31.21,270,77,142,2,1,382,193,240
2020,4,18,"Bartin",41.6358,32.3375,17.4571428571429,4.22857142857143,3.47142857142857,86.8857142857143,77.9457142857143,38.9614285714286,358,67,64,98,54,295,291,231
2020,5,18,"Bartin",41.6358,32.3375,18.6714285714286,8.55714285714286,4,83.9,85.6642857142857,44.5728571428571,331,66,65,0,0,272,265,207
2020,6,18,"Bartin",41.6358,32.3375,20.9714285714286,7.82857142857143,11.5854285714286,81.4571428571429,46.7885714285714,31.5614285714286,343,18,13,87,65,267,325,254
2020,7,18,"Bartin",41.6358,32.3375,16.4285714285714,6.75714285714286,5.89985714285714,81.1857142857143,77.2971428571429,51.9442857142857,341,132,75,0,0,338,209,263
2020,8,18,"Bartin",41.6358,32.3375,9.34285714285714,6.5,0.543,89.0571428571428,77.8471428571429,46.7771428571429,283,186,97,0,0,187,97,90
2020,9,18,"Bartin",41.6358,32.3375,15.3,10.1857142857143,2.643,75.9714285714286,64.87,42.1285714285714,393,153,132,0,0,528,240,396
2020,10,18,"Bartin",41.6358,32.3375,15.1,14.2428571428571,0,60.7428571428571,82.1214285714286,53.654,205,125,147,0,0,210,80,63
2020,11,18,"Bartin",41.6358,32.3375,10.9285714285714,11.2428571428571,0.914428571428571,82.5571428571428,66.5828571428572,37.205,115,0,0,31,23,94,115,94
2020,12,18,"Bartin",41.6358,32.3375,17.3857142857143,5.72857142857143,3.47142857142857,82.1714285714286,42.7657142857143,34.6042857142857,117,0,0,14,14,118,117,118
2020,13,18,"Bartin",41.6358,32.3375,20.6285714285714,9.18571428571429,0.642857142857143,88.9857142857143,65.4585714285714,26.8685714285714,136,0,0,14,22,92,136,92
2020,14,18,"Bartin",41.6358,32.3375,27.2,9.92857142857143,3.21414285714286,86.9714285714286,59.0957142857143,21.506,155,0,0,0,0,121,155,121
2020,15,18,"Bartin",41.6358,32.3375,24.8142857142857,9.48571428571429,0.571428571428572,73.7857142857143,43.8171428571429,22.2557142857143,133,0,0,25,11,118,133,118
2020,16,18,"Bartin",41.6358,32.3375,12.8142857142857,11.5857142857143,0.314285714285714,73.8,53.0442857142857,33.6285714285714,141,23,11,25,6,106,118,95
2020,17,18,"Bartin",41.6358,32.3375,21.2285714285714,10.7714285714286,0.228571428571429,76.4714285714286,38.0871428571429,23.1242857142857,137,0,0,16,16,123,137,123
2020,18,18,"Bartin",41.6358,32.3375,13.2571428571429,14.3428571428571,0.0142857142857143,76.9857142857143,40.4885714285714,27.8285714285714,146,73,52,0,0,164,73,112
2020,19,18,"Bartin",41.6358,32.3375,15.4285714285714,13.7571428571429,4.67128571428571,82.3857142857143,33.9842857142857,24.15,137,18,52,31,28,157,119,105
2020,20,18,"Bartin",41.6358,32.3375,14.6571428571429,19.1142857142857,0,73.7714285714286,50.6071428571429,31.4466666666667,164,20,33,14,3,164,144,131
2020,21,18,"Bartin",41.6358,32.3375,18.9857142857143,16.6285714285714,1.50028571428571,81.1714285714286,43.1257142857143,23.7642857142857,146,11,4,21,22,96,135,92
2020,22,18,"Bartin",41.6358,32.3375,17.2857142857143,14.9571428571429,5.88571428571429,83.2428571428571,26.5485714285714,20.0714285714286,118,18,14,16,7,100,100,86
2020,23,18,"Bartin",41.6358,32.3375,12.4142857142857,18.8,1.129,78.9,33.4714285714286,27.4228571428571,112,17,14,32,19,70,95,56
2020,24,18,"Bartin",41.6358,32.3375,10.1714285714286,20.4571428571429,1.68571428571429,84.3571428571429,40.7528571428571,30.186,140,4,11,88,109,150,136,139
2020,25,18,"Bartin",41.6358,32.3375,9.65714285714286,21.2285714285714,3,85.1285714285714,32.6542857142857,17.315,137,0,0,65,58,108,137,108
2020,26,18,"Bartin",41.6358,32.3375,12.4857142857143,22.7428571428571,0.885857142857143,77.9428571428572,30.1285714285714,31.31,173,0,0,21,4,133,173,133
2020,27,18,"Bartin",41.6358,32.3375,11.2,24.8428571428571,0,73.6428571428571,36.2971428571429,24.88,113,0,0,17,34,113,113,113
2020,28,18,"Bartin",41.6358,32.3375,13.5142857142857,23.9571428571429,7.42828571428571,77.4857142857143,30.3471428571429,32.984,164,0,0,30,49,122,164,122
2020,29,18,"Bartin",41.6358,32.3375,13.0857142857143,22.9285714285714,0.757142857142857,77.1714285714286,29.1871428571429,27.6716666666667,186,0,0,67,53,111,186,111
2020,30,18,"Bartin",41.6358,32.3375,17,24.4714285714286,0.214285714285714,72.4714285714286,33.2728571428571,27.216,190,0,0,85,76,142,190,142
2020,31,18,"Bartin",41.6358,32.3375,14.0142857142857,24.9428571428571,0,74.2714285714286,30.4685714285714,28.505,150,0,0,68,63,127,150,127
2020,32,18,"Bartin",41.6358,32.3375,19.7428571428571,25.2857142857143,0,64.1857142857143,29.6471428571429,32.3566666666667,146,0,0,0,0,107,146,107
2020,33,18,"Bartin",41.6358,32.3375,16.4571428571429,24.5857142857143,0,66.2428571428571,26.2714285714286,25.1485714285714,183,0,0,9,10,83,183,83
2020,34,18,"Bartin",41.6358,32.3375,14.7142857142857,24.3428571428571,0.642857142857143,68.5857142857143,29.9971428571429,27.5728571428571,197,0,0,26,12,97,197,97
2020,35,18,"Bartin",41.6358,32.3375,13.2857142857143,25.5857142857143,0,64.1142857142857,30.22,30.6985714285714,164,2,2,10,25,157,162,155
2020,36,18,"Bartin",41.6358,32.3375,13.7428571428571,24.1,7.74285714285714,81.2285714285714,35.0142857142857,26.9442857142857,179,0,0,13,22,112,179,112
2020,37,18,"Bartin",41.6358,32.3375,14.9428571428571,23.6571428571429,0.185714285714286,79.0428571428571,35.5271428571429,22.39,193,0,0,0,0,91,193,91
2020,38,18,"Bartin",41.6358,32.3375,22.1142857142857,22.8571428571429,0.0428571428571429,75.4142857142857,35.7428571428571,19.0371428571429,235,0,0,0,0,157,235,157
2020,39,18,"Bartin",41.6358,32.3375,13.8857142857143,21.7714285714286,0,72.3714285714286,35.4514285714286,29.1816666666667,220,41,14,30,13,129,179,115
2020,40,18,"Bartin",41.6358,32.3375,13.0714285714286,20.4571428571429,2.94328571428571,71.9142857142857,36.6542857142857,31.4242857142857,187,77,63,22,12,154,110,91
2020,41,18,"Bartin",41.6358,32.3375,13.7571428571429,21.6714285714286,3.72928571428571,70.1285714285714,53.3571428571429,34.8357142857143,182,102,74,0,0,127,80,53
2020,42,18,"Bartin",41.6358,32.3375,9.91428571428571,20.4714285714286,1,69.4142857142857,46.7642857142857,33.08,177,111,94,0,0,111,66,17
2020,43,18,"Bartin",41.6358,32.3375,12.2571428571429,17.5714285714286,7.58557142857143,81.4285714285714,41.9228571428571,26.7671428571429,194,56,35,0,0,161,138,126
2020,44,18,"Bartin",41.6358,32.3375,12.4285714285714,16.5428571428571,16.9138571428571,84.5428571428571,55.0214285714286,26.3757142857143,255,53,25,0,0,233,202,208
2020,45,18,"Bartin",41.6358,32.3375,11.2285714285714,13.0142857142857,3.07142857142857,88.5142857142857,55.1128571428571,25.794,156,91,69,0,0,103,65,34
2020,46,18,"Bartin",41.6358,32.3375,12.2285714285714,12.0142857142857,0.714428571428571,88.1142857142857,64.0757142857143,23.3085714285714,208,133,91,0,0,109,75,18
2020,47,18,"Bartin",41.6358,32.3375,13.7571428571429,9.92857142857143,0.285714285714286,82.8285714285714,50.35,22.18,173,113,43,0,0,83,60,40
2020,48,18,"Bartin",41.6358,32.3375,13.3142857142857,8.01428571428571,0.485714285714286,81.8428571428571,85.9,31.0242857142857,199,133,172,0,0,262,66,90
2020,49,18,"Bartin",41.6358,32.3375,9.8,10.1857142857143,0.143,80.9857142857143,97.2,32.3714285714286,207,59,20,0,0,116,148,96
2020,50,18,"Bartin",41.6358,32.3375,17.7285714285714,12.4285714285714,0.957142857142857,78.9714285714286,121.898571428571,33.9271428571429,181,130,82,0,0,98,51,16
2020,51,18,"Bartin",41.6358,32.3375,10.8142857142857,10.8428571428571,3.37142857142857,88.9,85.8042857142857,29.3285714285714,171,27,15,36,16,90,144,75
2020,52,18,"Bartin",41.6358,32.3375,16.1142857142857,9.21428571428571,1.6,79.2714285714286,81.015,31.3914285714286,203,128,76,0,0,113,75,37
2020,53,18,"Bartin",41.6358,32.3375,18.475,12.675,0,63.2,116.6,43.305,122,86,96,0,0,111,36,15
2017,1,19,"Batman",37.8812,41.1351,13.7714285714286,2.48571428571429,0.614142857142857,85.2,70.9714285714286,NA,563,242,376,144,204,847,321,471
2017,2,19,"Batman",37.8812,41.1351,14.2857142857143,2.64285714285714,0.0588571428571429,76.8285714285714,71.95,NA,757,267,490,295,470,1214,490,724
2017,3,19,"Batman",37.8812,41.1351,11.4285714285714,2.44285714285714,0.00171428571428571,74.7857142857143,74.8528571428571,NA,762,182,406,232,421,1449,580,1043
2017,4,19,"Batman",37.8812,41.1351,15.0428571428571,1.44285714285714,5.88614285714286,78.7857142857143,37.39,NA,639,179,309,110,144,889,460,580
2017,5,19,"Batman",37.8812,41.1351,13.0285714285714,-7.48571428571429,1.39471428571429,87.8428571428571,58.9471428571429,NA,588,142,187,267,613,1163,446,976
2017,6,19,"Batman",37.8812,41.1351,9.37142857142857,-1.9,0.287714285714286,92.9428571428571,82.0357142857143,NA,736,122,287,203,510,1519,614,1232
2017,7,19,"Batman",37.8812,41.1351,21.0857142857143,1.12857142857143,0.164428571428571,64.1571428571429,39.1485714285714,NA,492,193,194,55,103,717,299,523
2017,8,19,"Batman",37.8812,41.1351,12.9571428571429,5.78571428571429,0.000285714285714286,61.1142857142857,82.7285714285714,NA,739,420,971,218,582,1747,319,776
2017,9,19,"Batman",37.8812,41.1351,16.6,9.52857142857143,4.09457142857143,73.1142857142857,66.1228571428571,NA,574,432,575,32,61,866,142,291
2017,10,19,"Batman",37.8812,41.1351,20.6428571428571,11.5428571428571,0.317857142857143,58.7142857142857,58.4185714285714,NA,712,332,535,93,113,1043,380,508
2017,11,19,"Batman",37.8812,41.1351,19,8.28571428571428,11.6212857142857,84.7,23.4357142857143,NA,525,250,340,162,242,725,275,385
2017,12,19,"Batman",37.8812,41.1351,17.4714285714286,8.17142857142857,1.77385714285714,74.2571428571429,61.414,NA,589,415,782,166,293,1077,174,295
2017,13,19,"Batman",37.8812,41.1351,21.4285714285714,12.7857142857143,2.90214285714286,71.8142857142857,46.5328571428571,NA,574,186,330,97,132,887,388,557
2017,14,19,"Batman",37.8812,41.1351,19.8,11.9285714285714,1.91314285714286,73.1571428571429,35.6,NA,639,371,733,175,376,1336,268,603
2017,15,19,"Batman",37.8812,41.1351,17.1142857142857,12.7142857142857,4.52457142857143,76.0142857142857,35.4257142857143,NA,587,74,415,228,279,1187,513,772
2017,16,19,"Batman",37.8812,41.1351,20.8571428571429,15.5714285714286,3.74885714285714,73.9857142857143,46.3185714285714,NA,717,457,625,39,37,920,260,295
2017,17,19,"Batman",37.8812,41.1351,18.7285714285714,15.4,0.092,59.4714285714286,37.6342857142857,NA,731,206,492,179,199,1478,525,986
2017,18,19,"Batman",37.8812,41.1351,17.1142857142857,16.1,3.45371428571429,79.1,37.9657142857143,NA,506,450,759,0,0,923,56,164
2017,19,19,"Batman",37.8812,41.1351,18.9142857142857,19.7857142857143,0.024,65.5,47.6242857142857,NA,471,201,371,155,315,966,270,595
2017,20,19,"Batman",37.8812,41.1351,19.4571428571429,20.3285714285714,0.798571428571428,58.7428571428571,39.2971428571429,NA,472,167,535,150,187,1205,305,670
2017,21,19,"Batman",37.8812,41.1351,20.6142857142857,18.8428571428571,1.72671428571429,61.7285714285714,28.9757142857143,NA,448,164,237,192,352,849,284,612
2017,22,19,"Batman",37.8812,41.1351,22.6285714285714,21.7571428571429,0.000142857142857143,51,41.9157142857143,NA,522,73,117,109,209,1015,449,898
2017,23,19,"Batman",37.8812,41.1351,16.9142857142857,25.8857142857143,0,45.1857142857143,48.4142857142857,NA,578,80,202,236,504,1388,498,1186
2017,24,19,"Batman",37.8812,41.1351,18.2142857142857,25.0428571428571,0,42.9714285714286,34.98,NA,552,0,0,523,1110,1139,552,1139
2017,25,19,"Batman",37.8812,41.1351,21.6714285714286,25.3142857142857,0,44.1285714285714,37.7328571428571,NA,584,62,76,430,724,1041,522,965
2017,26,19,"Batman",37.8812,41.1351,17.1714285714286,29.8857142857143,0,36.7,59.14,NA,564,116,127,4,48,971,448,844
2017,27,19,"Batman",37.8812,41.1351,16.3142857142857,29.4714285714286,0,39.5,64.8228571428571,NA,511,67,89,291,321,642,444,553
2017,28,19,"Batman",37.8812,41.1351,17.1857142857143,29.6428571428571,0,37.3142857142857,66.39,NA,481,90,109,71,188,864,391,755
2017,29,19,"Batman",37.8812,41.1351,17.3428571428571,29.7714285714286,0,37.6571428571429,66.5842857142857,NA,532,0,0,266,691,1272,532,1272
2017,30,19,"Batman",37.8812,41.1351,15.5,29.1428571428571,0,38.1285714285714,56.8342857142857,NA,531,11,23,298,599,928,520,905
2017,31,19,"Batman",37.8812,41.1351,16.0714285714286,29.4857142857143,0,38.8285714285714,67.36,NA,559,0,0,217,478,1047,559,1047
2017,32,19,"Batman",37.8812,41.1351,19.7142857142857,29.8714285714286,0,35.9428571428571,66.5714285714286,NA,567,49,93,137,345,1092,518,999
2017,33,19,"Batman",37.8812,41.1351,17.6714285714286,29.9714285714286,0.000285714285714286,37.6428571428571,58.9014285714286,NA,596,91,161,114,310,1199,505,1038
2017,34,19,"Batman",37.8812,41.1351,13.2142857142857,28.1285714285714,0,36.5571428571429,63.2942857142857,NA,601,159,234,158,266,1280,442,1046
2017,35,19,"Batman",37.8812,41.1351,19,27.0571428571429,0,34.6714285714286,58.1442857142857,NA,493,60,47,209,525,1014,433,967
2017,36,19,"Batman",37.8812,41.1351,16.4,25.0428571428571,0,32.2,72.5242857142857,NA,507,47,173,145,397,1321,460,1148
2017,37,19,"Batman",37.8812,41.1351,13.2571428571429,25.2285714285714,0,28.5571428571429,108.297142857143,NA,589,173,285,18,28,1138,416,853
2017,38,19,"Batman",37.8812,41.1351,15.4142857142857,25.6714285714286,0,33,112.367142857143,NA,671,183,296,281,523,1312,488,1016
2017,39,19,"Batman",37.8812,41.1351,14.5428571428571,22.7857142857143,0,38,94.67,NA,782,278,593,142,199,1630,504,1037
2017,40,19,"Batman",37.8812,41.1351,16.6714285714286,17.7857142857143,0.113571428571429,41.3,84.3014285714286,NA,543,215,390,159,330,1137,328,747
2017,41,19,"Batman",37.8812,41.1351,15.8,17.2857142857143,0,44.0714285714286,72.4971428571428,NA,487,118,85,168,361,843,369,758
2017,42,19,"Batman",37.8812,41.1351,13.8,14.8714285714286,0,37.9714285714286,77.4825,NA,530,262,339,64,120,815,268,476
2017,43,19,"Batman",37.8812,41.1351,16.5857142857143,16.2571428571429,1.049,48.8285714285714,96.5771428571429,NA,506,344,568,44,76,919,162,351
2017,44,19,"Batman",37.8812,41.1351,13.2857142857143,13.1,2.36814285714286,75.2285714285714,57.1257142857143,NA,561,224,378,220,426,1102,337,724
2017,45,19,"Batman",37.8812,41.1351,15.0714285714286,12.4857142857143,0.210857142857143,85.1142857142857,96.6928571428572,NA,577,210,172,119,116,829,367,657
2017,46,19,"Batman",37.8812,41.1351,13.3,10.2857142857143,1.14357142857143,77.2428571428571,104.574285714286,NA,587,335,648,89,156,1085,252,437
2017,47,19,"Batman",37.8812,41.1351,15.6,8.1,0.599142857142857,71.9571428571429,29.0566666666667,NA,418,157,378,162,297,804,261,426
2017,48,19,"Batman",37.8812,41.1351,12.9571428571429,6.6,0.504142857142857,86.0571428571429,53.4657142857143,NA,386,241,363,100,138,619,145,256
2017,49,19,"Batman",37.8812,41.1351,16.4571428571429,4.4,3.26128571428571,80.7428571428571,67.8428571428571,NA,407,247,337,5,10,645,160,308
2017,50,19,"Batman",37.8812,41.1351,11.1571428571429,3.38571428571429,0.00142857142857143,81.7,95.5128571428571,NA,346,208,261,33,13,442,138,181
2017,51,19,"Batman",37.8812,41.1351,18.2,9.07142857142857,1.92742857142857,85.7571428571429,74.2142857142857,NA,386,354,295,0,0,349,32,54
2017,52,19,"Batman",37.8812,41.1351,13.925,6.1875,0.3635,88.0625,69.1125,NA,528,300,337,70,37,507,228,170
2018,1,19,"Batman",37.8812,41.1351,13.45,6.05,2.263,89.275,40.9328571428571,NA,618,341,467,188,324,914,277,447
2018,2,19,"Batman",37.8812,41.1351,14.3428571428571,4.04285714285714,0.285714285714286,78.2714285714286,69.7371428571429,NA,624,574,1194,0,0,1309,50,115
2018,3,19,"Batman",37.8812,41.1351,22.2714285714286,5.87142857142857,2.21828571428571,87.1857142857143,52.47,NA,639,303,496,92,40,655,336,159
2018,4,19,"Batman",37.8812,41.1351,22.6142857142857,6.88571428571429,4.49942857142857,83.6142857142857,56.0585714285714,NA,604,453,580,0,0,764,151,184
2018,5,19,"Batman",37.8812,41.1351,10.6571428571429,3.91428571428571,0,76.2571428571429,49.2942857142857,NA,670,269,341,211,155,819,401,478
2018,6,19,"Batman",37.8812,41.1351,11.6714285714286,6.95714285714286,0.0147142857142857,76.2285714285714,73.0928571428571,NA,704,450,627,6,0,1022,254,395
2018,7,19,"Batman",37.8812,41.1351,17.9,9.05714285714286,3.75485714285714,83.8857142857143,30.8742857142857,NA,478,244,274,11,15,557,234,283
2018,8,19,"Batman",37.8812,41.1351,18.2142857142857,8.77142857142857,1.71842857142857,84.0714285714286,24.96,NA,711,407,644,42,140,1321,304,677
2018,9,19,"Batman",37.8812,41.1351,15.8571428571429,10.2714285714286,2.15842857142857,82.8714285714286,24.2857142857143,NA,621,305,530,98,190,956,316,426
2018,10,19,"Batman",37.8812,41.1351,17.4857142857143,11.4,0.0917142857142857,77.6714285714286,53.4042857142857,NA,556,215,511,152,485,1330,341,819
2018,11,19,"Batman",37.8812,41.1351,18.9571428571429,11.6285714285714,4.83157142857143,68.8285714285714,33.9357142857143,NA,551,291,866,103,247,1426,260,560
2018,12,19,"Batman",37.8812,41.1351,22.7714285714286,15.0714285714286,0,56.6857142857143,64.9385714285714,NA,425,185,722,3,1,1187,240,465
2018,13,19,"Batman",37.8812,41.1351,17.4714285714286,13.4571428571429,0.163571428571429,68.7,54.7842857142857,NA,356,192,204,5,32,428,164,224
2018,14,19,"Batman",37.8812,41.1351,14.2857142857143,14.0857142857143,0,53.4142857142857,25.38,NA,407,172,313,35,45,486,235,173
2018,15,19,"Batman",37.8812,41.1351,21.3857142857143,15.9285714285714,7.09428571428571,71.7285714285714,27.705,NA,374,143,149,69,88,450,231,301
2018,16,19,"Batman",37.8812,41.1351,20.8285714285714,15.5571428571429,0.0434285714285714,59.6,27.3714285714286,NA,411,299,353,23,17,648,112,295
2018,17,19,"Batman",37.8812,41.1351,19.5571428571429,16.7857142857143,0.440428571428571,65.9714285714286,28.3428571428571,NA,419,112,108,111,140,652,307,544
2018,18,19,"Batman",37.8812,41.1351,22.1428571428571,18.2571428571429,3.064,76.9428571428571,27.2,NA,303,270,399,0,0,474,33,75
2018,19,19,"Batman",37.8812,41.1351,23.6142857142857,15.8857142857143,4.88514285714286,85.8714285714286,20.1271428571429,NA,275,171,342,37,36,467,104,125
2018,20,19,"Batman",37.8812,41.1351,12.9428571428571,20.6571428571429,1.74,63.7571428571429,27.23,NA,204,39,19,19,48,306,165,287
2018,21,19,"Batman",37.8812,41.1351,20.0571428571429,23.4428571428571,4.73128571428571,55.8571428571429,40.3914285714286,NA,252,56,77,61,96,281,196,204
2018,22,19,"Batman",37.8812,41.1351,24.3142857142857,23.7428571428571,1.54685714285714,55.2428571428571,32.3542857142857,NA,249,71,97,113,229,427,178,330
2018,23,19,"Batman",37.8812,41.1351,19.0142857142857,25.0571428571429,0.0142857142857143,47.0714285714286,24.3257142857143,NA,267,35,62,175,573,812,232,750
2018,24,19,"Batman",37.8812,41.1351,24.1142857142857,26.4428571428571,1.00042857142857,44.8571428571429,44.4785714285714,NA,267,55,29,139,162,448,212,419
2018,25,19,"Batman",37.8812,41.1351,16.9428571428571,27.6142857142857,0.0105714285714286,41.4142857142857,41.1228571428571,NA,358,0,0,341,501,518,358,518
2018,26,19,"Batman",37.8812,41.1351,17.9,29.6142857142857,0,37.3428571428571,55.7933333333333,NA,355,0,0,205,354,587,355,587
2018,27,19,"Batman",37.8812,41.1351,16.9428571428571,30.7571428571429,0,35.1,NA,NA,342,0,0,282,313,418,342,418
2018,28,19,"Batman",37.8812,41.1351,17.7285714285714,30.5285714285714,0.0142857142857143,36.3714285714286,64.6533333333333,NA,286,25,69,146,321,585,261,516
2018,29,19,"Batman",37.8812,41.1351,17.5714285714286,28.7571428571429,0.0148571428571429,38.6428571428571,37.8942857142857,NA,260,30,157,197,493,756,230,599
2018,30,19,"Batman",37.8812,41.1351,17.6428571428571,29.3285714285714,0,37.2142857142857,46.5471428571429,NA,265,0,0,204,688,822,265,822
2018,31,19,"Batman",37.8812,41.1351,18.1857142857143,30.7714285714286,0.00142857142857143,39.4428571428571,48.23,NA,267,0,0,177,273,499,267,499
2018,32,19,"Batman",37.8812,41.1351,16,29.9142857142857,0,36.0714285714286,36.9585714285714,NA,297,0,0,224,300,403,297,403
2018,33,19,"Batman",37.8812,41.1351,16.7571428571429,29.8142857142857,0,34.9714285714286,47.9542857142857,NA,216,0,0,160,234,332,216,332
2018,34,19,"Batman",37.8812,41.1351,14.7285714285714,29.8571428571429,0,34.6714285714286,42.0242857142857,NA,144,0,0,77,140,227,144,227
2018,35,19,"Batman",37.8812,41.1351,20.3,29.2857142857143,0,34.0571428571429,54.1483333333333,NA,201,0,0,147,293,314,201,314
2018,36,19,"Batman",37.8812,41.1351,21.6,27.1428571428571,0.142857142857143,35.2142857142857,58,NA,341,51,42,132,144,370,290,328
2018,37,19,"Batman",37.8812,41.1351,18.2285714285714,25.2142857142857,0,39.8428571428571,60.9528571428571,NA,241,17,30,116,254,419,224,389
2018,38,19,"Batman",37.8812,41.1351,17.3285714285714,24.7428571428571,0,33.7285714285714,58.1457142857143,NA,189,39,15,41,103,344,150,329
2018,39,19,"Batman",37.8812,41.1351,12.9571428571429,23.4714285714286,0,32.4142857142857,68.0785714285714,NA,180,40,22,26,117,353,140,331
2018,40,19,"Batman",37.8812,41.1351,15.3142857142857,22.5857142857143,0,36.2571428571429,54.9371428571429,NA,191,43,37,52,94,341,148,304
2018,41,19,"Batman",37.8812,41.1351,17.8571428571429,20.9857142857143,1.877,58.1857142857143,119.545714285714,NA,187,71,149,38,96,422,116,273
2018,42,19,"Batman",37.8812,41.1351,19.0714285714286,20.2571428571429,0.609714285714286,57.6428571428571,67.16,NA,168,78,135,15,6,381,90,246
2018,43,19,"Batman",37.8812,41.1351,17.6857142857143,15.0857142857143,11.9964285714286,81.4714285714286,31.3114285714286,NA,187,63,124,76,108,402,124,278
2018,44,19,"Batman",37.8812,41.1351,8.81428571428571,13.1,0.0287142857142857,74.1714285714286,74.35,NA,196,56,59,94,148,264,140,205
2018,45,19,"Batman",37.8812,41.1351,9.85714285714286,12.1428571428571,2.58414285714286,88.0285714285714,40.4285714285714,NA,231,126,264,33,34,473,105,209
2018,46,19,"Batman",37.8812,41.1351,13.2285714285714,10.3428571428571,3.68828571428571,83.6,43.6114285714286,NA,230,36,74,121,202,465,194,391
2018,47,19,"Batman",37.8812,41.1351,10.4285714285714,9,2.177,91.7571428571429,43.36,NA,270,158,92,0,0,499,112,407
2018,48,19,"Batman",37.8812,41.1351,16.4142857142857,10.2285714285714,5.77942857142857,93.0857142857143,34.8342857142857,NA,245,138,76,64,28,201,107,125
2018,49,19,"Batman",37.8812,41.1351,13.0428571428571,9.28571428571429,1.10057142857143,91.7,28.6842857142857,NA,257,173,211,6,10,420,84,209
2018,50,19,"Batman",37.8812,41.1351,19.3142857142857,7.55714285714286,4.363,86.3142857142857,32.7428571428571,NA,256,67,43,75,71,305,189,262
2018,51,19,"Batman",37.8812,41.1351,13.8,7.17142857142857,0.618285714285714,92.7571428571429,36.5142857142857,NA,250,178,117,27,35,248,72,131
2018,52,19,"Batman",37.8812,41.1351,22.2285714285714,5.87142857142857,2.72614285714286,82.9857142857143,21.6825,NA,244,91,67,58,39,273,153,206
2019,1,19,"Batman",37.8812,41.1351,20.45,6.575,1.338125,85.0375,29.565,NA,343,217,503,1,1,784,126,281
2019,2,19,"Batman",37.8812,41.1351,19.9714285714286,2.5,3.19042857142857,82.5285714285714,37.0983333333333,NA,255,51,30,85,50,208,204,178
2019,3,19,"Batman",37.8812,41.1351,16,3.57142857142857,2.06,84.4714285714286,55.1157142857143,NA,192,9,10,91,77,198,183,188
2019,4,19,"Batman",37.8812,41.1351,14.5714285714286,6.18571428571429,0.003,80.3,101.574285714286,NA,308,79,161,126,92,314,229,153
2019,5,19,"Batman",37.8812,41.1351,15.9285714285714,6.74285714285714,3.69928571428571,84.6571428571429,36.6,NA,253,95,41,106,70,143,158,102
2019,6,19,"Batman",37.8812,41.1351,15.9857142857143,5.2,4.00114285714286,83.2285714285714,29.8242857142857,NA,276,132,51,103,43,127,144,76
2019,7,19,"Batman",37.8812,41.1351,14.7428571428571,5.58571428571429,2.05285714285714,81.8428571428571,28.6785714285714,NA,325,180,32,90,132,234,145,202
2019,8,19,"Batman",37.8812,41.1351,13.2285714285714,5.91428571428571,0.257571428571429,76.9428571428572,32.56,NA,305,245,134,3,10,219,60,85
2019,9,19,"Batman",37.8812,41.1351,17.3571428571429,6.58571428571429,6.00885714285714,77.9428571428571,7.36,NA,331,99,191,93,44,310,232,119
2019,10,19,"Batman",37.8812,41.1351,15.1,7.61428571428571,1.73285714285714,81.1714285714286,5.34,NA,359,44,31,105,152,252,315,221
2019,11,19,"Batman",37.8812,41.1351,21.1285714285714,10.3571428571429,3.51642857142857,77.0428571428571,NA,NA,373,196,223,14,1,400,177,177
2019,12,19,"Batman",37.8812,41.1351,18.4857142857143,8.35714285714286,3.708,69.9857142857143,NA,NA,343,145,57,46,37,416,198,359
2019,13,19,"Batman",37.8812,41.1351,19.7857142857143,10.0571428571429,6.89657142857143,87.4571428571429,NA,NA,256,132,46,0,0,194,124,148
2019,14,19,"Batman",37.8812,41.1351,19.8857142857143,11.6428571428571,7.75342857142857,85.9714285714286,NA,NA,365,301,145,0,0,208,64,63
2019,15,19,"Batman",37.8812,41.1351,16.1142857142857,14.2285714285714,3.14128571428571,76.4,NA,NA,359,149,60,53,39,183,210,123
2019,16,19,"Batman",37.8812,41.1351,22.1285714285714,11.4428571428571,8.56814285714286,83.6142857142857,NA,NA,318,112,68,134,75,208,206,140
2019,17,19,"Batman",37.8812,41.1351,13.4714285714286,12.2428571428571,0.250857142857143,71.1,NA,NA,412,225,118,69,67,313,187,195
2019,18,19,"Batman",37.8812,41.1351,20.1428571428571,15.6428571428571,4.389,79.4,NA,NA,523,237,131,4,1,353,286,222
2019,19,19,"Batman",37.8812,41.1351,16.3714285714286,17.9714285714286,0.329142857142857,68.5571428571428,NA,NA,452,252,205,142,110,386,200,181
2019,20,19,"Batman",37.8812,41.1351,15.6857142857143,22,0,59.0428571428571,NA,NA,454,223,182,5,2,389,231,207
2019,21,19,"Batman",37.8812,41.1351,16.7857142857143,22.6285714285714,0,52.9571428571429,NA,NA,457,130,53,6,14,413,327,360
2019,22,19,"Batman",37.8812,41.1351,14.7714285714286,25.6571428571429,0,39.9142857142857,NA,NA,453,216,148,15,31,323,237,175
2019,23,19,"Batman",37.8812,41.1351,15.9714285714286,27.4428571428571,0,39.9,13.1057142857143,NA,378,103,165,8,7,532,275,367
2019,24,19,"Batman",37.8812,41.1351,22.6714285714286,27.2857142857143,0.0434285714285714,39.7571428571429,10.7114285714286,NA,378,150,81,113,140,244,228,163
2019,25,19,"Batman",37.8812,41.1351,17.5857142857143,27.4,0.0988571428571428,43.8857142857143,12.6671428571429,NA,306,42,28,138,230,325,264,297
2019,26,19,"Batman",37.8812,41.1351,17.8714285714286,29.5142857142857,0,39.0714285714286,13.5428571428571,NA,377,62,32,243,253,342,315,310
2019,27,19,"Batman",37.8812,41.1351,15.9571428571429,27.8428571428571,0,36.3142857142857,12.0357142857143,NA,456,50,74,88,33,222,406,148
2019,28,19,"Batman",37.8812,41.1351,18.7285714285714,28.4,0,40.4857142857143,9.38142857142857,NA,398,0,0,280,294,421,398,421
2019,29,19,"Batman",37.8812,41.1351,15.7714285714286,27.7857142857143,0,44.9142857142857,31.2971428571429,NA,453,0,0,208,138,203,453,203
2019,30,19,"Batman",37.8812,41.1351,15.8285714285714,28.9714285714286,0,41.5,40.0742857142857,NA,456,0,0,207,129,335,456,335
2019,31,19,"Batman",37.8812,41.1351,15.0857142857143,29.8571428571429,0,40.2714285714286,38.0471428571429,NA,334,45,89,110,111,375,289,286
2019,32,19,"Batman",37.8812,41.1351,16.1285714285714,28.7285714285714,0.0108571428571429,39.4714285714286,36.3271428571429,NA,346,0,0,204,235,395,346,395
2019,33,19,"Batman",37.8812,41.1351,15.6,30.0714285714286,0,42.6571428571429,47.742,NA,337,84,126,137,176,531,253,405
2019,34,19,"Batman",37.8812,41.1351,14.6857142857143,28.4857142857143,0,43.4571428571429,38.7383333333333,NA,299,46,34,41,71,345,253,311
2019,35,19,"Batman",37.8812,41.1351,19.3428571428571,27.8571428571429,0.0455714285714286,41.8428571428571,38.3614285714286,NA,307,140,157,82,117,415,167,258
2019,36,19,"Batman",37.8812,41.1351,13.9714285714286,26.0571428571429,0,39.2428571428571,35.2671428571429,NA,171,0,0,91,18,67,171,67
2019,37,19,"Batman",37.8812,41.1351,14.6857142857143,24.4,0.0424285714285714,38.4428571428571,39.1414285714286,NA,218,63,9,69,16,55,155,46
2019,38,19,"Batman",37.8812,41.1351,16.6714285714286,23.1428571428571,0,41.5857142857143,43.0314285714286,NA,266,29,7,130,63,91,237,84
2019,39,19,"Batman",37.8812,41.1351,14.9285714285714,21.7857142857143,0,39.4142857142857,44.08,NA,237,90,31,49,20,79,147,48
2019,40,19,"Batman",37.8812,41.1351,16.5285714285714,21.8857142857143,0,40.4,55.6671428571429,NA,241,87,12,18,9,111,154,99
2019,41,19,"Batman",37.8812,41.1351,14.7428571428571,21.8142857142857,0,43.6714285714286,61.3957142857143,NA,416,302,336,7,1,448,114,112
2019,42,19,"Batman",37.8812,41.1351,11.3285714285714,19.1142857142857,0.0337142857142857,45.2428571428571,60.76,NA,356,122,109,76,118,408,234,299
2019,43,19,"Batman",37.8812,41.1351,14.7,16.4428571428571,3.11714285714286,69.8428571428571,40.7071428571429,NA,306,181,173,49,15,300,125,127
2019,44,19,"Batman",37.8812,41.1351,12.8428571428571,13.8,2.92071428571429,81.0142857142857,86.29,NA,350,136,133,125,49,250,214,117
2019,45,19,"Batman",37.8812,41.1351,7.74285714285714,10.7714285714286,0,75.4571428571429,104.23,NA,417,67,40,275,190,328,350,288
2019,46,19,"Batman",37.8812,41.1351,9.21428571428572,9.84285714285714,0,72.8,103.642857142857,NA,401,156,171,116,45,337,245,166
2019,47,19,"Batman",37.8812,41.1351,12.3142857142857,6.38571428571429,0,58.4857142857143,95.4357142857143,NA,391,170,169,128,107,339,221,170
2019,48,19,"Batman",37.8812,41.1351,14.8142857142857,10.0571428571429,0.728571428571429,78.0142857142857,68.3014285714286,NA,320,199,139,34,14,251,121,112
2019,49,19,"Batman",37.8812,41.1351,10.8714285714286,7.82857142857143,4.73014285714286,89.2571428571429,32.3842857142857,NA,393,193,109,119,96,274,200,165
2019,50,19,"Batman",37.8812,41.1351,13.8428571428571,7.52857142857143,3.08457142857143,93.9142857142857,30.6957142857143,NA,218,208,115,0,0,119,10,4
2019,51,19,"Batman",37.8812,41.1351,9.12857142857143,4.94285714285714,0.00285714285714286,88.9142857142857,75.5285714285714,NA,361,142,272,160,109,488,219,216
2019,52,19,"Batman",37.8812,41.1351,22.5571428571429,8.55714285714286,15.6871428571429,73.4857142857143,44.66,NA,279,127,138,0,0,281,152,143
2020,1,19,"Batman",37.8812,41.1351,14.4,5.2,3.1504,92.84,24.012,NA,160,125,100,0,0,126,35,26
2020,2,19,"Batman",37.8812,41.1351,14.2142857142857,5.1,0.666142857142857,82.8142857142857,26.0428571428571,NA,240,120,84,50,32,173,120,89
2020,3,19,"Batman",37.8812,41.1351,15.8714285714286,2.57142857142857,2.50085714285714,81.9,38.5171428571429,NA,270,110,146,123,155,382,160,236
2020,4,19,"Batman",37.8812,41.1351,16.0857142857143,2.68571428571429,1.92714285714286,79.1857142857143,27.7014285714286,NA,358,143,113,107,97,295,215,182
2020,5,19,"Batman",37.8812,41.1351,15.1428571428571,3.05714285714286,5.92871428571429,86.7714285714286,41.4357142857143,NA,331,258,222,0,0,272,73,50
2020,6,19,"Batman",37.8812,41.1351,21.4,4.01428571428571,3.99357142857143,82.6428571428571,29.2314285714286,NA,343,190,140,73,41,267,153,127
2020,7,19,"Batman",37.8812,41.1351,14.5571428571429,-1.91428571428571,0.564285714285714,81.3571428571429,27.4385714285714,NA,341,110,133,121,131,338,231,205
2020,8,19,"Batman",37.8812,41.1351,15.3714285714286,8.05714285714286,4.282,86.3285714285714,38.8542857142857,NA,283,169,83,69,72,187,114,104
2020,9,19,"Batman",37.8812,41.1351,17.7285714285714,8.81428571428571,5.49685714285714,72.8142857142857,28.37,NA,393,304,497,3,0,528,89,31
2020,10,19,"Batman",37.8812,41.1351,16.1428571428571,10.3285714285714,0.0142857142857143,69.0857142857143,33.4171428571429,NA,205,71,50,53,82,210,134,160
2020,11,19,"Batman",37.8812,41.1351,18.9428571428571,13.7428571428571,1.05228571428571,65.7428571428571,36.09,NA,115,71,68,2,0,94,44,26
2020,12,19,"Batman",37.8812,41.1351,24.5571428571429,9.91428571428571,7.15442857142857,82.8857142857143,14.6871428571429,NA,117,54,79,5,4,118,63,39
2020,13,19,"Batman",37.8812,41.1351,22.2142857142857,11.7571428571429,8.135,81.9428571428571,24.93,NA,136,77,72,29,9,92,59,20
2020,14,19,"Batman",37.8812,41.1351,17.4285714285714,10.9571428571429,5.31242857142857,84.8571428571429,NA,NA,155,53,34,27,30,121,102,87
2020,15,19,"Batman",37.8812,41.1351,19,13.4142857142857,1.29428571428571,76.2142857142857,NA,NA,133,81,85,0,0,118,52,33
2020,16,19,"Batman",37.8812,41.1351,14.8285714285714,14.3857142857143,1.29585714285714,70.7285714285714,NA,NA,141,77,63,3,1,106,64,43
2020,17,19,"Batman",37.8812,41.1351,24.7285714285714,16.2142857142857,5.63942857142857,75.3857142857143,NA,NA,137,69,63,26,30,123,68,60
2020,18,19,"Batman",37.8812,41.1351,21.8857142857143,15.2142857142857,1.56571428571429,74.7714285714286,NA,NA,146,82,117,51,41,164,64,47
2020,19,19,"Batman",37.8812,41.1351,18.5,16.9142857142857,4.28642857142857,76.4428571428572,NA,NA,137,42,41,37,80,157,95,116
2020,20,19,"Batman",37.8812,41.1351,9.9,20.1,0.001,64.5142857142857,37.62,NA,164,40,21,19,45,164,124,143
2020,21,19,"Batman",37.8812,41.1351,14.8857142857143,22.7,4.54271428571429,53.6142857142857,30.67,NA,146,49,31,16,22,96,97,65
2020,22,19,"Batman",37.8812,41.1351,14.3857142857143,19.7428571428571,0.476857142857143,62.8142857142857,NA,NA,118,39,52,26,22,100,79,48
2020,23,19,"Batman",37.8812,41.1351,14.2428571428571,22.3428571428571,0.000428571428571429,50.9142857142857,29.605,NA,112,29,12,17,4,70,83,58
2020,24,19,"Batman",37.8812,41.1351,18.9857142857143,25.4285714285714,0,45.0142857142857,NA,NA,140,33,52,53,36,150,107,98
2020,25,19,"Batman",37.8812,41.1351,17.9428571428571,25.7285714285714,0,47.4714285714286,NA,NA,137,1,0,62,64,108,136,108
2020,26,19,"Batman",37.8812,41.1351,14.7142857142857,26.8,0.00228571428571429,43.9714285714286,NA,NA,173,2,0,67,69,133,171,133
2020,27,19,"Batman",37.8812,41.1351,24.4714285714286,28.5857142857143,0.0742857142857143,42.6714285714286,NA,NA,113,45,27,4,2,113,68,86
2020,28,19,"Batman",37.8812,41.1351,16.5571428571429,29.3142857142857,0,44.6142857142857,NA,NA,164,14,0,111,99,122,150,122
2020,29,19,"Batman",37.8812,41.1351,19.2285714285714,29.1285714285714,0.00485714285714286,43.5142857142857,NA,NA,186,48,20,78,60,111,138,91
2020,30,19,"Batman",37.8812,41.1351,16.8428571428571,29.9285714285714,0,40.6,89.21,NA,190,33,10,103,108,142,157,132
2020,31,19,"Batman",37.8812,41.1351,16.8714285714286,30.3285714285714,0,40.8428571428571,82.16,NA,150,41,49,39,23,127,109,78
2020,32,19,"Batman",37.8812,41.1351,13.0428571428571,29.0714285714286,0,42.2714285714286,71.3642857142857,NA,146,24,10,50,65,107,122,97
2020,33,19,"Batman",37.8812,41.1351,17.4571428571429,28.2,0,43.6857142857143,66.2942857142857,NA,183,18,2,137,64,83,165,81
2020,34,19,"Batman",37.8812,41.1351,17.4,27.1714285714286,0.00342857142857143,41.6285714285714,79.0285714285714,NA,197,36,12,1,1,97,161,85
2020,35,19,"Batman",37.8812,41.1351,13.1857142857143,26.4285714285714,0,39.8857142857143,80.8528571428571,NA,164,57,38,9,36,157,107,119
2020,36,19,"Batman",37.8812,41.1351,17.3142857142857,27.9142857142857,0.0568571428571429,35.6428571428571,131.6375,NA,179,51,21,16,2,112,128,91
2020,37,19,"Batman",37.8812,41.1351,15.5428571428571,26.6714285714286,0,36.3,150.532857142857,NA,193,34,10,50,27,91,159,81
2020,38,19,"Batman",37.8812,41.1351,13.7571428571429,25.1714285714286,0,37.1142857142857,172.36,NA,235,45,26,44,34,157,190,131
2020,39,19,"Batman",37.8812,41.1351,13.1,24.4142857142857,0,42.6285714285714,151.72,NA,220,28,1,34,22,129,192,128
2020,40,19,"Batman",37.8812,41.1351,14.0428571428571,22.5,0,39.6285714285714,152.407142857143,NA,187,56,14,36,51,154,131,140
2020,41,19,"Batman",37.8812,41.1351,13.5428571428571,18.8,0,39.0428571428571,130.101428571429,NA,182,36,20,56,33,127,146,107
2020,42,19,"Batman",37.8812,41.1351,10.1571428571429,18.3571428571429,0,38.5,210.017142857143,NA,177,52,19,3,5,111,125,92
2020,43,19,"Batman",37.8812,41.1351,9.87142857142857,17.1428571428571,0,43.8285714285714,211.817142857143,NA,194,102,53,5,0,161,92,108
2020,44,19,"Batman",37.8812,41.1351,14.6571428571429,17.6285714285714,0,35.1571428571429,285.26,NA,255,100,124,0,0,233,155,109
2020,45,19,"Batman",37.8812,41.1351,19.2857142857143,15.1857142857143,3.22871428571429,74.2714285714286,118.614285714286,NA,156,31,28,0,0,103,125,75
2020,46,19,"Batman",37.8812,41.1351,9.14285714285714,11.4714285714286,0.00585714285714286,74.4142857142857,165.525,NA,208,18,2,51,30,109,190,107
2020,47,19,"Batman",37.8812,41.1351,10.5857142857143,8.28571428571428,0.374714285714286,83.0857142857143,137.834285714286,NA,173,65,34,53,16,83,108,49
2020,48,19,"Batman",37.8812,41.1351,11.3857142857143,6.67142857142857,0.187428571428571,76.8285714285714,134.682857142857,NA,199,65,74,76,85,262,134,188
2020,49,19,"Batman",37.8812,41.1351,11.2428571428571,5.71428571428571,0.458,91.1714285714286,163.172857142857,NA,207,109,41,58,60,116,98,75
2020,50,19,"Batman",37.8812,41.1351,11.9571428571429,5.64285714285714,0.913,90.7285714285714,127.182857142857,NA,181,106,39,18,36,98,75,59
2020,51,19,"Batman",37.8812,41.1351,15.9428571428571,6.82857142857143,1.58128571428571,91.8857142857143,90.4714285714286,NA,171,60,28,84,57,90,111,62
2020,52,19,"Batman",37.8812,41.1351,11.6857142857143,2.72857142857143,2.79085714285714,83.0285714285714,118.405714285714,NA,203,73,47,63,44,113,130,66
2020,53,19,"Batman",37.8812,41.1351,10.025,2.45,0,85.625,193.5025,NA,122,54,32,33,15,111,68,79
2017,1,20,"Bayburt",40.2585,40.228,11.6571428571429,-5.45714285714286,0.242857142857143,68.8714285714286,38.9071428571429,48.2728571428571,563,330,498,0,0,847,233,349
2017,2,20,"Bayburt",40.2585,40.228,10.4,-6.82857142857143,0.4,69.0714285714286,34.3128571428571,41.2557142857143,757,427,706,105,125,1214,330,508
2017,3,20,"Bayburt",40.2585,40.228,7.18571428571429,-6.75714285714286,0.0714285714285714,71,44.1342857142857,45.7657142857143,762,301,425,133,493,1449,461,1024
2017,4,20,"Bayburt",40.2585,40.228,12.5142857142857,-9.98571428571429,2.673,74.5571428571428,32.1328571428571,30.8285714285714,639,300,410,95,120,889,339,479
2017,5,20,"Bayburt",40.2585,40.228,12.5571428571429,-10.3428571428571,0.285714285714286,67.9571428571429,34.0914285714286,41.26,588,258,327,193,563,1163,330,836
2017,6,20,"Bayburt",40.2585,40.228,6.8,-5.02857142857143,0.0857142857142857,76.7142857142857,43.4642857142857,48.0942857142857,736,543,1081,1,1,1519,193,438
2017,7,20,"Bayburt",40.2585,40.228,9,-11.1142857142857,0.271428571428571,68.9285714285714,38.42,26.8671428571429,492,121,113,62,133,717,371,604
2017,8,20,"Bayburt",40.2585,40.228,6.94285714285714,-4.8,0.614142857142857,65.1285714285714,50.2342857142857,43.9028571428571,739,549,1217,4,10,1747,190,530
2017,9,20,"Bayburt",40.2585,40.228,7.05714285714286,0.542857142857143,1.84257142857143,74.3285714285714,42.3257142857143,42.0871428571429,574,342,566,0,0,866,232,300
2017,10,20,"Bayburt",40.2585,40.228,11.6428571428571,2.7,0.0142857142857143,58.9285714285714,57.6666666666667,25.9514285714286,712,506,775,0,0,1043,206,268
2017,11,20,"Bayburt",40.2585,40.228,11.7142857142857,1.2,1.61442857142857,67.5857142857143,18.6916666666667,19.1371428571429,525,21,19,22,76,725,504,706
2017,12,20,"Bayburt",40.2585,40.228,13.0428571428571,1.2,0.899857142857143,60.1857142857143,21.8685714285714,19.82,589,75,90,271,589,1077,514,987
2017,13,20,"Bayburt",40.2585,40.228,14.0714285714286,4.97142857142857,1.48571428571429,57.4857142857143,16.8614285714286,18.1442857142857,574,2,0,89,150,887,572,887
2017,14,20,"Bayburt",40.2585,40.228,14.8428571428571,5.47142857142857,1.58571428571429,56.9,15.6314285714286,21.0328571428571,639,32,137,6,4,1336,607,1199
2017,15,20,"Bayburt",40.2585,40.228,10.9428571428571,5.25714285714286,2.272,64.5285714285714,12.3485714285714,20.4085714285714,587,41,175,330,597,1187,546,1012
2017,16,20,"Bayburt",40.2585,40.228,14.2571428571429,9.71428571428572,1.357,55.8714285714286,10.9042857142857,18.9914285714286,717,2,0,106,75,920,715,920
2017,17,20,"Bayburt",40.2585,40.228,12.8428571428571,8.18571428571429,0.0571428571428571,44.8714285714286,8.02714285714286,18.7942857142857,731,520,1201,4,30,1478,211,277
2017,18,20,"Bayburt",40.2585,40.228,12.5285714285714,11.8428571428571,2.428,58.1285714285714,10.4971428571429,19.0257142857143,506,129,186,18,32,923,377,737
2017,19,20,"Bayburt",40.2585,40.228,13.8142857142857,11.8285714285714,5.41357142857143,62.9428571428571,10.2514285714286,19.4371428571429,471,73,153,119,263,966,398,813
2017,20,20,"Bayburt",40.2585,40.228,11.5571428571429,10.8142857142857,10.1558571428571,68.6142857142857,6.76,16.2042857142857,472,53,42,141,442,1205,419,1163
2017,21,20,"Bayburt",40.2585,40.228,11.0428571428571,9.91428571428571,6.55628571428571,66.3285714285714,5.54857142857143,15.5242857142857,448,59,157,21,103,849,389,692
2017,22,20,"Bayburt",40.2585,40.228,13.7714285714286,13.6571428571429,0.185714285714286,57.2142857142857,6.89714285714286,15.32,522,0,0,4,6,1015,522,1015
2017,23,20,"Bayburt",40.2585,40.228,11.9714285714286,17.7571428571429,2.70014285714286,54.6857142857143,8.23,13.8842857142857,578,100,196,57,197,1388,478,1192
2017,24,20,"Bayburt",40.2585,40.228,11.9571428571429,14.7142857142857,2.01428571428571,59.7571428571429,15.6414285714286,14.8157142857143,552,73,161,14,48,1139,479,978
2017,25,20,"Bayburt",40.2585,40.228,15.3142857142857,15.2428571428571,4.65642857142857,58.8,27.11,14.1571428571429,584,0,0,195,310,1041,584,1041
2017,26,20,"Bayburt",40.2585,40.228,14.3285714285714,20.7714285714286,0,50,35.3628571428571,16.0028571428571,564,102,201,0,0,971,462,770
2017,27,20,"Bayburt",40.2585,40.228,18.2714285714286,19.6,0.485571428571429,52.7428571428571,36.0514285714286,13.6057142857143,511,0,0,106,179,642,511,642
2017,28,20,"Bayburt",40.2585,40.228,19.5571428571429,19.5142857142857,0,51.7142857142857,41.2557142857143,18.6257142857143,481,0,0,83,118,864,481,864
2017,29,20,"Bayburt",40.2585,40.228,19.8571428571429,22.4285714285714,0,50.0142857142857,57.6516666666667,22.2033333333333,532,70,214,124,259,1272,462,1058
2017,30,20,"Bayburt",40.2585,40.228,13.5142857142857,20.9857142857143,0.114285714285714,46.6714285714286,43.8766666666667,18.512,531,74,85,0,0,928,457,843
2017,31,20,"Bayburt",40.2585,40.228,14.0714285714286,24.4142857142857,0.0857142857142857,36.1857142857143,47.7757142857143,27.55,559,261,403,49,59,1047,298,644
2017,32,20,"Bayburt",40.2585,40.228,16.9,24.5142857142857,0,38.6142857142857,47.9257142857143,24.2442857142857,567,63,165,0,0,1092,504,927
2017,33,20,"Bayburt",40.2585,40.228,15.9142857142857,21.1285714285714,1.61442857142857,57.5714285714286,44.1257142857143,18.9928571428571,596,148,223,1,18,1199,448,976
2017,34,20,"Bayburt",40.2585,40.228,16.6714285714286,20.4857142857143,0,53.3428571428571,40.0114285714286,16.14,601,0,0,5,2,1280,601,1280
2017,35,20,"Bayburt",40.2585,40.228,14.8,19.1571428571429,0.3,55.3857142857143,36.0871428571429,15.1171428571429,493,0,0,97,164,1014,493,1014
2017,36,20,"Bayburt",40.2585,40.228,13.7714285714286,18.9714285714286,0.114285714285714,42.1714285714286,45.4085714285714,21.8142857142857,507,57,101,20,57,1321,450,1220
2017,37,20,"Bayburt",40.2585,40.228,13.7714285714286,19.7,0,35.3714285714286,66.8442857142857,24.8628571428571,589,143,142,0,0,1138,446,996
2017,38,20,"Bayburt",40.2585,40.228,12.8857142857143,18.9142857142857,0,36.8571428571429,78.6366666666667,28.7266666666667,671,250,506,0,0,1312,421,806
2017,39,20,"Bayburt",40.2585,40.228,11.0428571428571,14.4571428571429,0.0714285714285714,56.2142857142857,NA,22.3433333333333,782,180,212,0,0,1630,602,1418
2017,40,20,"Bayburt",40.2585,40.228,9.38571428571429,8.51428571428571,2.52857142857143,55.8142857142857,53.6925,24.8966666666667,543,189,410,39,121,1137,354,727
2017,41,20,"Bayburt",40.2585,40.228,11.4,8.92857142857143,2.25685714285714,64.8714285714286,39.62,21.42,487,91,85,26,52,843,396,758
2017,42,20,"Bayburt",40.2585,40.228,9.58571428571429,6.75714285714286,0.142857142857143,59.4571428571429,56.7357142857143,24.7557142857143,530,183,240,165,262,815,347,575
2017,43,20,"Bayburt",40.2585,40.228,13.2857142857143,10.0857142857143,0.2,52.8428571428571,91.7671428571429,38.1675,506,161,257,0,0,919,345,662
2017,44,20,"Bayburt",40.2585,40.228,10.3,4.35714285714286,1.09985714285714,57.9,45.3328571428571,38.6166666666667,561,243,561,87,94,1102,318,541
2017,45,20,"Bayburt",40.2585,40.228,6.81428571428571,6.42857142857143,0.0571428571428571,66.3857142857143,92.9114285714286,38.5271428571429,577,182,247,14,23,829,395,582
2017,46,20,"Bayburt",40.2585,40.228,7.91428571428571,5.5,0.0714285714285714,58.3428571428571,85.5242857142857,43.1671428571429,587,459,884,0,0,1085,128,201
2017,47,20,"Bayburt",40.2585,40.228,11.5,-1.18571428571429,1.957,70.6142857142857,29.4528571428571,24.5757142857143,418,20,106,230,450,804,398,698
2017,48,20,"Bayburt",40.2585,40.228,8.14285714285714,0.714285714285714,1.18585714285714,68.8428571428571,53.1014285714286,36.3757142857143,386,229,389,48,56,619,157,230
2017,49,20,"Bayburt",40.2585,40.228,11.8571428571429,-2.42857142857143,1.40028571428571,73.3428571428571,NA,27.8157142857143,407,156,248,113,142,645,251,397
2017,50,20,"Bayburt",40.2585,40.228,6.64285714285714,-3.21428571428571,0.0285714285714286,71.3142857142857,83.1925,50.4485714285714,346,331,379,0,0,442,15,63
2017,51,20,"Bayburt",40.2585,40.228,10.1428571428571,2.61428571428571,2.11485714285714,78.4714285714286,74.4385714285714,36.5857142857143,386,125,164,41,38,349,261,185
2017,52,20,"Bayburt",40.2585,40.228,9.975,-0.1625,0.750125,68.1375,57.5925,41.7975,528,238,285,66,35,507,290,222
2018,1,20,"Bayburt",40.2585,40.228,10.0625,0.0499999999999999,0.874875,73.025,30.6528571428571,19.7442857142857,618,87,148,72,59,914,531,766
2018,2,20,"Bayburt",40.2585,40.228,8.75714285714286,-0.785714285714286,0.414285714285714,71.7714285714286,35.3542857142857,22.2957142857143,624,222,286,82,83,1309,402,1023
2018,3,20,"Bayburt",40.2585,40.228,10.7571428571429,-0.9,1.68571428571429,73.6285714285714,20.9028571428571,20.9857142857143,639,55,59,112,250,655,584,596
2018,4,20,"Bayburt",40.2585,40.228,9.18571428571429,-1.81428571428571,2.82814285714286,75.7571428571429,29.7433333333333,18.1528571428571,604,60,105,1,0,764,544,659
2018,5,20,"Bayburt",40.2585,40.228,8.4,-5.14285714285714,0.714428571428571,73.5571428571428,NA,25.6814285714286,670,366,526,289,223,819,304,293
2018,6,20,"Bayburt",40.2585,40.228,9.44285714285714,0.9,0.2,66.5857142857143,86.3733333333333,35.3,704,417,690,0,0,1022,287,332
2018,7,20,"Bayburt",40.2585,40.228,10.7285714285714,2.78571428571429,1.05714285714286,61.6857142857143,54.0957142857143,29.3357142857143,478,83,152,0,0,557,395,405
2018,8,20,"Bayburt",40.2585,40.228,8.51428571428571,2.72857142857143,0.185714285714286,62.2285714285714,45.6357142857143,28.2485714285714,711,110,129,58,162,1321,601,1192
2018,9,20,"Bayburt",40.2585,40.228,12.2571428571429,1.82857142857143,1.00028571428571,68.6428571428571,53.4542857142857,30.1085714285714,621,53,110,97,158,956,568,846
2018,10,20,"Bayburt",40.2585,40.228,10.6857142857143,4.41428571428571,4.91371428571429,70.7285714285714,47.5371428571429,27.14,556,8,24,119,328,1330,548,1306
2018,11,20,"Bayburt",40.2585,40.228,11.1714285714286,5.05714285714286,3.657,64.8857142857143,40.3742857142857,25.5571428571429,551,68,125,50,100,1426,483,1301
2018,12,20,"Bayburt",40.2585,40.228,16.3142857142857,9.04285714285714,0.357285714285714,49.7142857142857,94.9414285714286,23.47,425,0,0,125,284,1187,425,1187
2018,13,20,"Bayburt",40.2585,40.228,15.4857142857143,7.82857142857143,0.985857142857143,56.0285714285714,69.6942857142857,25.8514285714286,356,3,21,0,0,428,353,407
2018,14,20,"Bayburt",40.2585,40.228,11.9571428571429,7.22857142857143,0.585857142857143,49.7857142857143,40.9442857142857,23.6071428571429,407,121,246,1,0,486,286,240
2018,15,20,"Bayburt",40.2585,40.228,15.7571428571429,10.0142857142857,0.157142857142857,53.0857142857143,41.78,21.8685714285714,374,145,257,0,0,450,229,193
2018,16,20,"Bayburt",40.2585,40.228,18.5285714285714,7.44285714285714,0.328571428571429,50.0571428571429,28.4757142857143,18.0614285714286,411,0,0,5,1,648,411,648
2018,17,20,"Bayburt",40.2585,40.228,16.1714285714286,10.7142857142857,0.128571428571429,54.6,37.7642857142857,23.4471428571429,419,52,49,0,0,652,367,603
2018,18,20,"Bayburt",40.2585,40.228,10.6857142857143,12.4857142857143,1.87114285714286,64.9571428571429,30.5942857142857,33.0885714285714,303,81,143,0,0,474,222,331
2018,19,20,"Bayburt",40.2585,40.228,11.8571428571429,9.77142857142857,5.72814285714286,74.3,21.9857142857143,27.0714285714286,275,5,21,0,0,467,270,446
2018,20,20,"Bayburt",40.2585,40.228,12.2285714285714,12.4571428571429,4.24242857142857,66.1857142857143,22.7914285714286,27.4257142857143,204,102,112,0,0,306,102,194
2018,21,20,"Bayburt",40.2585,40.228,11.8571428571429,14.2428571428571,3.32942857142857,66.9142857142857,35.9457142857143,28.5885714285714,252,85,107,0,0,281,167,174
2018,22,20,"Bayburt",40.2585,40.228,10.6857142857143,13.4857142857143,3.87242857142857,69.9,30.19,35.2257142857143,249,89,180,0,0,427,160,247
2018,23,20,"Bayburt",40.2585,40.228,10.7285714285714,14.4571428571429,1.42842857142857,62.8714285714286,24.8033333333333,37.9171428571429,267,84,357,48,143,812,183,455
2018,24,20,"Bayburt",40.2585,40.228,11.2,15.5571428571429,2.01442857142857,63.5857142857143,33.87,39.9185714285714,267,143,162,18,14,448,124,286
2018,25,20,"Bayburt",40.2585,40.228,11.4571428571429,15.7714285714286,4.71385714285714,67.7428571428571,31.1057142857143,20.1071428571429,358,116,110,25,22,518,242,408
2018,26,20,"Bayburt",40.2585,40.228,10.4,21.4142857142857,0.899857142857143,50.5857142857143,44.6314285714286,18.1014285714286,355,94,116,0,0,587,261,471
2018,27,20,"Bayburt",40.2585,40.228,13.8571428571429,19.5428571428571,0,60.8714285714286,33.3557142857143,12.0071428571429,342,0,0,0,0,418,342,418
2018,28,20,"Bayburt",40.2585,40.228,13.9,21.3,2.99957142857143,57.7714285714286,46.3085714285714,17.8328571428571,286,88,169,0,0,585,198,416
2018,29,20,"Bayburt",40.2585,40.228,15.5714285714286,17.3857142857143,1.57128571428571,60.7285714285714,31.2614285714286,16.6728571428571,260,0,0,0,0,756,260,756
2018,30,20,"Bayburt",40.2585,40.228,15.5,21.8714285714286,0.0571428571428571,46.6285714285714,46.4571428571429,18.1528571428571,265,10,32,4,10,822,255,790
2018,31,20,"Bayburt",40.2585,40.228,17.2,21.0714285714286,0.0571428571428571,59.1571428571429,37.6314285714286,16.5657142857143,267,0,0,1,0,499,267,499
2018,32,20,"Bayburt",40.2585,40.228,19.0428571428571,19.0857142857143,0.428571428571429,60.3714285714286,34.6257142857143,17.2128571428571,297,0,0,14,19,403,297,403
2018,33,20,"Bayburt",40.2585,40.228,21.4428571428571,19.4714285714286,0,54.8714285714286,36.4975,24.1814285714286,216,0,0,15,74,332,216,332
2018,34,20,"Bayburt",40.2585,40.228,17.7142857142857,20.5857142857143,0.485571428571429,55.4428571428571,35.6571428571429,25.5357142857143,144,3,2,18,35,227,141,225
2018,35,20,"Bayburt",40.2585,40.228,13.4428571428571,20.3857142857143,0.385714285714286,51.3285714285714,47.2828571428571,28.0771428571429,201,75,80,0,0,314,126,234
2018,36,20,"Bayburt",40.2585,40.228,18.0142857142857,17.9142857142857,1.07142857142857,58.3142857142857,41.2742857142857,22.51,341,1,0,61,128,370,340,370
2018,37,20,"Bayburt",40.2585,40.228,10.9857142857143,15.5285714285714,1.086,61.0857142857143,47.3728571428571,25.9571428571429,241,55,107,0,0,419,186,312
2018,38,20,"Bayburt",40.2585,40.228,14.6857142857143,14.8428571428571,0.000142857142857143,58.3285714285714,47.8228571428571,25.7614285714286,189,16,8,0,0,344,173,336
2018,39,20,"Bayburt",40.2585,40.228,10.4571428571429,14.7571428571429,0,53.0428571428571,49.5,23.0385714285714,180,43,58,10,29,353,137,295
2018,40,20,"Bayburt",40.2585,40.228,13.2285714285714,12.4714285714286,0.0714285714285714,54.8428571428571,47.2971428571429,23.5185714285714,191,100,156,0,0,341,91,185
2018,41,20,"Bayburt",40.2585,40.228,10.0857142857143,13.2142857142857,1.22871428571429,58.8428571428571,70.6642857142857,25.5614285714286,187,116,208,0,0,422,71,214
2018,42,20,"Bayburt",40.2585,40.228,7.72857142857143,12.4428571428571,0.628571428571429,53.0571428571429,103.465,20.8316666666667,168,113,319,0,0,381,55,62
2018,43,20,"Bayburt",40.2585,40.228,12.7142857142857,7.11428571428571,5.30014285714286,73.1857142857143,39.6742857142857,19.25,187,30,55,36,135,402,157,347
2018,44,20,"Bayburt",40.2585,40.228,9.42857142857143,6.67142857142857,0.0428571428571429,53.2571428571429,68.5557142857143,25.4985714285714,196,144,185,0,0,264,52,79
2018,45,20,"Bayburt",40.2585,40.228,7.05714285714286,4.67142857142857,0.0714285714285714,60.5714285714286,64.368,28.7542857142857,231,171,350,0,0,473,60,123
2018,46,20,"Bayburt",40.2585,40.228,7.21428571428571,-0.857142857142857,7.21414285714286,78.0571428571428,50.2975,25.2514285714286,230,54,107,45,58,465,176,358
2018,47,20,"Bayburt",40.2585,40.228,6.58571428571429,0.0285714285714287,1.17128571428571,81.2857142857143,68.0728571428571,27.6842857142857,270,139,97,10,50,499,131,402
2018,48,20,"Bayburt",40.2585,40.228,10.5571428571429,3.75714285714286,5.35685714285714,80.4571428571429,38.4614285714286,24.2014285714286,245,74,97,0,0,201,171,104
2018,49,20,"Bayburt",40.2585,40.228,6.9,0.728571428571429,0.271428571428571,82.4,37.315,28.9083333333333,257,174,265,0,0,420,83,155
2018,50,20,"Bayburt",40.2585,40.228,10.8571428571429,-0.442857142857143,2.85757142857143,79.6285714285714,37.6114285714286,42.5514285714286,256,57,97,28,34,305,199,208
2018,51,20,"Bayburt",40.2585,40.228,8.4,1,0.257142857142857,79.0428571428571,38.6428571428571,40.8257142857143,250,105,114,10,49,248,145,134
2018,52,20,"Bayburt",40.2585,40.228,10.5142857142857,-4.74285714285714,3.94342857142857,78.1285714285714,22.41,36.3725,244,72,66,22,32,273,172,207
2019,1,20,"Bayburt",40.2585,40.228,12.5625,-0.95,1.612625,74.175,29.94,25.565,343,127,209,0,0,784,216,575
2019,2,20,"Bayburt",40.2585,40.228,13.5428571428571,-7.85714285714286,2.52842857142857,72.3,45.365,39.5316666666667,255,169,117,50,21,208,86,91
2019,3,20,"Bayburt",40.2585,40.228,14,-4.94285714285714,1.05714285714286,67.8142857142857,40.9171428571429,35.2557142857143,192,77,90,9,35,198,115,108
2019,4,20,"Bayburt",40.2585,40.228,13.4,-0.814285714285715,0.442857142857143,65.8428571428571,68.852,41.052,308,82,194,0,0,314,226,120
2019,5,20,"Bayburt",40.2585,40.228,9.28571428571428,-0.6,0.343,73.8857142857143,51.12,38.4557142857143,253,49,15,38,40,143,204,128
2019,6,20,"Bayburt",40.2585,40.228,8.4,-0.357142857142857,1.77128571428571,68.9571428571429,55.4316666666667,41.5785714285714,276,178,74,0,0,127,98,53
2019,7,20,"Bayburt",40.2585,40.228,9.28571428571429,-0.8,0.242857142857143,66.8,NA,32.9428571428571,325,10,27,77,113,234,315,207
2019,8,20,"Bayburt",40.2585,40.228,12.2714285714286,0.214285714285714,0.285714285714286,60.2142857142857,38.605,28.6228571428571,305,83,91,42,48,219,222,128
2019,9,20,"Bayburt",40.2585,40.228,11.4571428571429,-1.11428571428571,2.48571428571429,67.1142857142857,28.7028571428571,23.27,331,0,0,92,106,310,331,310
2019,10,20,"Bayburt",40.2585,40.228,9.7,-0.757142857142857,1.04271428571429,63,41.2571428571429,25.0542857142857,359,146,126,0,0,252,213,126
2019,11,20,"Bayburt",40.2585,40.228,15.0285714285714,4.31428571428571,1.91414285714286,65.8,40.0883333333333,NA,373,13,73,19,26,400,360,327
2019,12,20,"Bayburt",40.2585,40.228,13.5142857142857,1.27142857142857,1.714,55.3714285714286,29.2742857142857,NA,343,0,0,92,71,416,343,416
2019,13,20,"Bayburt",40.2585,40.228,10.9714285714286,1.7,1.74257142857143,66.8571428571429,33.25,NA,256,80,46,28,73,194,176,148
2019,14,20,"Bayburt",40.2585,40.228,7.42857142857143,4.81428571428571,2.514,69.1714285714286,42.5033333333333,27.6733333333333,365,137,80,45,37,208,228,128
2019,15,20,"Bayburt",40.2585,40.228,11.7142857142857,7.78571428571429,1.97114285714286,60.2428571428571,38.3028571428571,27.5942857142857,359,136,66,0,0,183,223,117
2019,16,20,"Bayburt",40.2585,40.228,13.5,4.07142857142857,5.17157142857143,73.6714285714286,21.2557142857143,19.3185714285714,318,31,12,8,2,208,287,196
2019,17,20,"Bayburt",40.2585,40.228,12.0571428571429,6.05714285714286,0.757,53.9142857142857,25.8528571428571,23.4566666666667,412,79,78,1,35,313,333,235
2019,18,20,"Bayburt",40.2585,40.228,10.4714285714286,9.77142857142857,4.69942857142857,64.9857142857143,38.6575,24.3685714285714,523,0,0,10,2,353,523,353
2019,19,20,"Bayburt",40.2585,40.228,13.9142857142857,11.9428571428571,0.828428571428572,54.0857142857143,NA,18.5014285714286,452,7,4,99,84,386,445,382
2019,20,20,"Bayburt",40.2585,40.228,14.6714285714286,16.5714285714286,0.614142857142857,41.2714285714286,NA,23.4314285714286,454,91,64,70,56,389,363,325
2019,21,20,"Bayburt",40.2585,40.228,13.4,14.0714285714286,1.52842857142857,59.9428571428571,NA,18.306,457,4,5,23,42,413,453,408
2019,22,20,"Bayburt",40.2585,40.228,12.8428571428571,16.4857142857143,1.14271428571429,45.6428571428571,36.275,21.2642857142857,453,29,67,0,0,323,424,256
2019,23,20,"Bayburt",40.2585,40.228,13,20.2714285714286,0.128571428571429,47.3,33.6357142857143,15.2871428571429,378,62,132,0,0,532,316,400
2019,24,20,"Bayburt",40.2585,40.228,13.8142857142857,19.4142857142857,2.714,52.1,26.3575,18.025,378,61,27,5,3,244,317,217
2019,25,20,"Bayburt",40.2585,40.228,15.6142857142857,18.5,7.18571428571429,64.5857142857143,NA,18.1742857142857,306,235,266,0,0,325,71,59
2019,26,20,"Bayburt",40.2585,40.228,17.4571428571429,19.3857142857143,0.0571428571428571,59.7285714285714,NA,14.8514285714286,377,0,0,0,0,342,377,342
2019,27,20,"Bayburt",40.2585,40.228,16.3285714285714,16.9285714285714,0,52.1428571428571,NA,16.2471428571429,456,114,90,0,0,222,342,132
2019,28,20,"Bayburt",40.2585,40.228,12.6285714285714,17.8714285714286,1.75671428571429,55.9714285714286,13.7175,16.825,398,31,90,0,0,421,367,331
2019,29,20,"Bayburt",40.2585,40.228,14.5142857142857,19.3571428571429,0.314285714285714,51.5,25.6485714285714,19.8157142857143,453,1,0,0,0,203,452,203
2019,30,20,"Bayburt",40.2585,40.228,19.0428571428571,18.9714285714286,1.571,57.5571428571429,18.44,22.2928571428571,456,0,0,25,25,335,456,335
2019,31,20,"Bayburt",40.2585,40.228,17.2428571428571,21.6,0.0571428571428571,49.1571428571429,30.7683333333333,21.6183333333333,334,0,0,89,96,375,334,375
2019,32,20,"Bayburt",40.2585,40.228,20.6714285714286,17.8142857142857,0.0857142857142857,56.9857142857143,26.3085714285714,40.74,346,0,0,5,10,395,346,395
2019,33,20,"Bayburt",40.2585,40.228,15.1,22.1142857142857,0,47.2571428571429,40.6257142857143,24.82,337,52,87,3,11,531,285,444
2019,34,20,"Bayburt",40.2585,40.228,15.0571428571429,20.6,3.51385714285714,57.3428571428571,35.8,19.9266666666667,299,0,0,125,145,345,299,345
2019,35,20,"Bayburt",40.2585,40.228,14.0285714285714,19.0285714285714,3.58485714285714,60.9,27.4116666666667,22.4066666666667,307,85,110,0,0,415,222,305
2019,36,20,"Bayburt",40.2585,40.228,17.9714285714286,16.8,0.1,60.0285714285714,22.845,17.8433333333333,171,0,0,11,9,67,171,67
2019,37,20,"Bayburt",40.2585,40.228,14.2857142857143,14.7,0.200142857142857,62.5857142857143,23.5228571428571,16.8942857142857,218,27,8,0,0,55,191,47
2019,38,20,"Bayburt",40.2585,40.228,12.1714285714286,14.4285714285714,2.18542857142857,53.7857142857143,22.942,16.556,266,0,0,14,25,91,266,91
2019,39,20,"Bayburt",40.2585,40.228,9.91428571428571,14.4714285714286,0.228571428571429,47.8857142857143,27.3942857142857,23.5666666666667,237,0,0,54,27,79,237,79
2019,40,20,"Bayburt",40.2585,40.228,12.2714285714286,14.7142857142857,0.857142857142857,45.9714285714286,38.1628571428571,29.6357142857143,241,71,17,41,8,111,170,94
2019,41,20,"Bayburt",40.2585,40.228,13.1714285714286,13.7285714285714,0.728428571428572,51.4428571428571,33.5314285714286,31.1816666666667,416,73,125,139,169,448,343,323
2019,42,20,"Bayburt",40.2585,40.228,7.32857142857143,13.2428571428571,0.314571428571429,39.7142857142857,21.165,35.7466666666667,356,294,338,0,0,408,62,70
2019,43,20,"Bayburt",40.2585,40.228,8.61428571428571,9.94285714285714,1.157,68.8285714285714,12.29,27.8785714285714,306,167,130,0,0,300,139,170
2019,44,20,"Bayburt",40.2585,40.228,7.57142857142857,5.72857142857143,1.586,67.2,12.5214285714286,29.7757142857143,350,168,148,23,13,250,182,102
2019,45,20,"Bayburt",40.2585,40.228,6.9,4.2,0,48.7428571428571,12.5385714285714,41.5414285714286,417,416,327,0,0,328,1,1
2019,46,20,"Bayburt",40.2585,40.228,6.44285714285714,4.17142857142857,0,44.5428571428571,13.4442857142857,44.4928571428571,401,387,321,0,0,337,14,16
2019,47,20,"Bayburt",40.2585,40.228,7.37142857142857,1.57142857142857,0,48.5428571428571,56.755,39.31,391,263,271,7,6,339,128,68
2019,48,20,"Bayburt",40.2585,40.228,12.0142857142857,2.98571428571429,2.57185714285714,68.3285714285714,49.02,36.252,320,19,35,54,75,251,301,216
2019,49,20,"Bayburt",40.2585,40.228,8.5,-2.54285714285714,2.04257142857143,75.0428571428571,34.295,31.5485714285714,393,259,184,63,55,274,134,90
2019,50,20,"Bayburt",40.2585,40.228,7.35714285714286,0.6,0.185714285714286,73.3,46.4885714285714,48.2371428571429,218,136,95,41,7,119,82,24
2019,51,20,"Bayburt",40.2585,40.228,8.41428571428571,1.04285714285714,0.0572857142857143,62.9428571428571,50.1857142857143,36.4785714285714,361,243,410,4,3,488,118,78
2019,52,20,"Bayburt",40.2585,40.228,13.9,3.35714285714286,0.685571428571429,59.1285714285714,35.53,22.3785714285714,279,66,52,0,0,281,213,229
2020,1,20,"Bayburt",40.2585,40.228,7.72,-2.04,3.7998,80.44,31.662,26.17,160,82,46,0,0,126,78,80
2020,2,20,"Bayburt",40.2585,40.228,13.0571428571429,-2.94285714285714,0.485571428571429,72.8,33.4185714285714,30.3828571428571,240,45,57,7,3,173,195,116
2020,3,20,"Bayburt",40.2585,40.228,11.2285714285714,-7.2,0.0571428571428571,68.4571428571429,45.4971428571429,40.0171428571429,270,174,281,28,40,382,96,101
2020,4,20,"Bayburt",40.2585,40.228,15.7857142857143,-6.72857142857143,0.242857142857143,66.8571428571429,34.65,32.5314285714286,358,50,82,101,59,295,308,213
2020,5,20,"Bayburt",40.2585,40.228,12.0571428571429,-3.45714285714286,3.243,70.5142857142857,36.7614285714286,34.3928571428571,331,155,172,135,78,272,176,100
2020,6,20,"Bayburt",40.2585,40.228,15.7428571428571,-2.81428571428571,2.41428571428571,73.3714285714286,22.8883333333333,21.3485714285714,343,11,2,35,33,267,332,265
2020,7,20,"Bayburt",40.2585,40.228,8.18571428571429,-11.2428571428571,1.42871428571429,72.1571428571429,34.3314285714286,35.0585714285714,341,174,151,45,90,338,167,187
2020,8,20,"Bayburt",40.2585,40.228,9.41428571428571,-0.657142857142857,0.157142857142857,72.8428571428571,49.57,51.8557142857143,283,155,61,55,40,187,128,126
2020,9,20,"Bayburt",40.2585,40.228,11.2285714285714,-0.728571428571429,3.25685714285714,67.4714285714286,33.88,31.1675,393,131,163,0,0,528,262,365
2020,10,20,"Bayburt",40.2585,40.228,9.8,3.42857142857143,0.0571428571428571,51.6142857142857,40.3342857142857,31.4516666666667,205,141,118,9,12,210,64,92
2020,11,20,"Bayburt",40.2585,40.228,13.1428571428571,7.78571428571429,0.271428571428571,58.9571428571429,40.0142857142857,26.41,115,59,66,8,1,94,56,28
2020,12,20,"Bayburt",40.2585,40.228,9.17142857142857,-0.128571428571428,3.39971428571429,74.8571428571429,19.5414285714286,19.8171428571429,117,40,34,6,4,118,77,84
2020,13,20,"Bayburt",40.2585,40.228,10.8285714285714,5.42857142857143,1.91442857142857,68.1,27.9714285714286,16.5828571428571,136,93,64,0,0,92,43,28
2020,14,20,"Bayburt",40.2585,40.228,9.58571428571429,4.74285714285714,4.39957142857143,70.4285714285714,17.09,5.925,155,36,15,37,49,121,119,106
2020,15,20,"Bayburt",40.2585,40.228,16.0571428571429,4.81428571428571,0.585714285714286,59.8857142857143,22.8233333333333,5.3075,133,49,20,11,6,118,84,98
2020,16,20,"Bayburt",40.2585,40.228,14.0571428571429,8.04285714285714,2.49957142857143,51.4428571428571,22.5685714285714,11.7314285714286,141,13,3,18,24,106,128,103
2020,17,20,"Bayburt",40.2585,40.228,12.7857142857143,5.87142857142857,6.54214285714286,71.0142857142857,14.7914285714286,10.7728571428571,137,20,35,51,40,123,117,88
2020,18,20,"Bayburt",40.2585,40.228,12.8428571428571,8.54285714285714,3.24242857142857,65.0142857142857,18.93,12.31,146,6,4,33,27,164,140,160
2020,19,20,"Bayburt",40.2585,40.228,14.6428571428571,8.2,11.2274285714286,71.8571428571429,14.6228571428571,NA,137,19,5,20,34,157,118,152
2020,20,20,"Bayburt",40.2585,40.228,19.6142857142857,13.4142857142857,0,53.1,35.9228571428571,NA,164,0,0,28,59,164,164,164
2020,21,20,"Bayburt",40.2585,40.228,16.1,13.1428571428571,2.314,52.2142857142857,30.96,NA,146,4,6,1,1,96,142,90
2020,22,20,"Bayburt",40.2585,40.228,13.0428571428571,13.4285714285714,3.31385714285714,52.7571428571429,20.9928571428571,NA,118,13,30,28,22,100,105,70
2020,23,20,"Bayburt",40.2585,40.228,13.7857142857143,16.3571428571429,3.61371428571429,42.3428571428571,21.6871428571429,NA,112,2,13,17,14,70,110,57
2020,24,20,"Bayburt",40.2585,40.228,13.7142857142857,18.2,1.68542857142857,43.2285714285714,30.2275,NA,140,48,93,1,0,150,92,57
2020,25,20,"Bayburt",40.2585,40.228,14.0285714285714,15.5857142857143,4.671,63.0571428571429,20.3533333333333,7.14666666666667,137,33,9,2,0,108,104,99
2020,26,20,"Bayburt",40.2585,40.228,15.1428571428571,17.5857142857143,0.714142857142857,54.4428571428571,24.2757142857143,6.40571428571429,173,80,87,0,0,133,93,46
2020,27,20,"Bayburt",40.2585,40.228,17.3428571428571,18.9428571428571,2.39957142857143,55.5,24.87,8.36571428571429,113,41,84,0,0,113,72,29
2020,28,20,"Bayburt",40.2585,40.228,13.2857142857143,19.6714285714286,0.585714285714286,57.3285714285714,22.6328571428571,7.85285714285714,164,50,40,0,0,122,114,82
2020,29,20,"Bayburt",40.2585,40.228,16.1285714285714,19.8428571428571,5.42728571428571,57.2714285714286,26.3042857142857,9.30142857142857,186,0,0,2,0,111,186,111
2020,30,20,"Bayburt",40.2585,40.228,17.2,21.4571428571429,0,53.2428571428571,31.08,14.4685714285714,190,20,19,1,1,142,170,123
2020,31,20,"Bayburt",40.2585,40.228,20.0285714285714,20.6285714285714,1.02857142857143,56.0142857142857,28.5585714285714,13.9128571428571,150,0,0,7,3,127,150,127
2020,32,20,"Bayburt",40.2585,40.228,19.5571428571429,19.9428571428571,0,52.3142857142857,28.5642857142857,20.1257142857143,146,12,3,0,0,107,134,104
2020,33,20,"Bayburt",40.2585,40.228,19.6,17.3142857142857,0.542714285714286,59.9714285714286,26.59,12.8085714285714,183,0,0,2,0,83,183,83
2020,34,20,"Bayburt",40.2585,40.228,19.3428571428571,17.7571428571429,1.51414285714286,59.0571428571429,24.7242857142857,14.8528571428571,197,0,0,12,6,97,197,97
2020,35,20,"Bayburt",40.2585,40.228,16.3857142857143,17.7,0,50.3,28.2228571428571,23.6414285714286,164,32,26,0,0,157,132,131
2020,36,20,"Bayburt",40.2585,40.228,14.8428571428571,21.4,0.0857142857142857,35.3142857142857,35.7333333333333,22.7566666666667,179,74,44,14,22,112,105,68
2020,37,20,"Bayburt",40.2585,40.228,14.3714285714286,19.1285714285714,0.399857142857143,48.7142857142857,30.2628571428571,22.3314285714286,193,38,26,8,1,91,155,65
2020,38,20,"Bayburt",40.2585,40.228,16.1285714285714,18.5,0,50.5857142857143,36.5514285714286,25.8814285714286,235,19,20,0,0,157,216,137
2020,39,20,"Bayburt",40.2585,40.228,11.9142857142857,16.7714285714286,0.942714285714286,53.7428571428571,32.8885714285714,24.5314285714286,220,30,13,10,7,129,190,116
2020,40,20,"Bayburt",40.2585,40.228,13.7714285714286,15.4714285714286,0.285714285714286,52.7571428571429,34.8942857142857,23.1171428571429,187,20,9,23,6,154,167,145
2020,41,20,"Bayburt",40.2585,40.228,11.1714285714286,12.0142857142857,0,43.2142857142857,32.1842857142857,29.94,182,114,78,18,11,127,68,49
2020,42,20,"Bayburt",40.2585,40.228,7.98571428571429,14.2,0,32.8428571428571,48.8057142857143,32.6357142857143,177,105,76,0,0,111,72,35
2020,43,20,"Bayburt",40.2585,40.228,8.41428571428571,11.0285714285714,2.771,52.7142857142857,39.2828571428571,15.6614285714286,194,99,99,0,0,161,95,62
2020,44,20,"Bayburt",40.2585,40.228,14.2142857142857,12.2857142857143,0.0571428571428571,34.3571428571429,53.1785714285714,11.9742857142857,255,59,123,0,0,233,196,110
2020,45,20,"Bayburt",40.2585,40.228,12.7714285714286,7.27142857142857,3.07285714285714,74.6714285714286,25.7642857142857,12.57,156,49,37,25,10,103,107,66
2020,46,20,"Bayburt",40.2585,40.228,8.71428571428571,3.7,0,61.9,43.1571428571429,28.715,208,118,60,0,0,109,90,49
2020,47,20,"Bayburt",40.2585,40.228,11.0714285714286,1.98571428571429,0.471571428571429,71.4285714285714,29.2757142857143,24.7485714285714,173,8,4,16,7,83,165,79
2020,48,20,"Bayburt",40.2585,40.228,9.01428571428571,-0.328571428571429,0.0428571428571429,61.9,34.7157142857143,27.0871428571429,199,106,163,8,20,262,93,99
2020,49,20,"Bayburt",40.2585,40.228,7.4,1.51428571428571,0.0285714285714286,68,32.3985714285714,29.8928571428571,207,124,79,0,0,116,83,37
2020,50,20,"Bayburt",40.2585,40.228,7.2,0.671428571428571,0.371571428571429,71.9,31.955,34.76,181,64,56,0,0,98,117,42
2020,51,20,"Bayburt",40.2585,40.228,8.97142857142857,1.88571428571429,0.985571428571429,73.9857142857143,24.2014285714286,32.3371428571429,171,84,38,30,22,90,87,52
2020,52,20,"Bayburt",40.2585,40.228,8.67142857142857,-7.07142857142857,1.81442857142857,76.3,26.7142857142857,42.0442857142857,203,106,51,30,32,113,97,62
2020,53,20,"Bayburt",40.2585,40.228,8.4,-6.9,0,71.675,48.68,80.515,122,122,111,0,0,111,0,0
2017,1,21,"Bilecik",40.15,29.9833,12.6428571428571,-1.1,2.12714285714286,80.3571428571429,33.8728571428571,NA,563,363,521,175,239,847,200,326
2017,2,21,"Bilecik",40.15,29.9833,15.9142857142857,1.34285714285714,0.873857142857143,73.4857142857143,36.5771428571429,NA,757,614,1076,0,0,1214,143,138
2017,3,21,"Bilecik",40.15,29.9833,8.52857142857143,3.65714285714286,2.742,86.0428571428571,37.3185714285714,NA,762,185,232,344,722,1449,577,1217
2017,4,21,"Bilecik",40.15,29.9833,15.3142857142857,-0.328571428571429,0.929142857142857,82.2,37.25,NA,639,229,336,234,258,889,410,553
2017,5,21,"Bilecik",40.15,29.9833,9.61428571428571,0.357142857142857,0.072,69.4571428571429,52.0042857142857,NA,588,154,190,0,0,1163,434,973
2017,6,21,"Bilecik",40.15,29.9833,11.2571428571429,5.71428571428571,0.317857142857143,78.3285714285714,37.8785714285714,NA,736,272,526,220,494,1519,464,993
2017,7,21,"Bilecik",40.15,29.9833,10.0857142857143,0.685714285714286,0.214428571428571,71.9285714285714,43.4614285714286,NA,492,20,28,228,414,717,472,689
2017,8,21,"Bilecik",40.15,29.9833,12.9571428571429,7.94285714285714,0.286,74.6714285714286,45.4,NA,739,0,0,378,819,1747,739,1747
2017,9,21,"Bilecik",40.15,29.9833,10.2285714285714,10.0142857142857,0.628142857142857,70.2,59.9166666666667,NA,574,86,154,226,279,866,488,712
2017,10,21,"Bilecik",40.15,29.9833,13.2428571428571,11.6428571428571,1.19828571428571,60.8857142857143,44.3714285714286,NA,712,439,571,269,451,1043,273,472
2017,11,21,"Bilecik",40.15,29.9833,12.3857142857143,4.17142857142857,1.08842857142857,83.1428571428571,42.2685714285714,NA,525,0,0,327,407,725,525,725
2017,12,21,"Bilecik",40.15,29.9833,9.58571428571429,11.6,0.142714285714286,58.6857142857143,51.1914285714286,NA,589,0,0,490,778,1077,589,1077
2017,13,21,"Bilecik",40.15,29.9833,12.2,8.72857142857143,0.0292857142857143,66.4285714285714,44.3371428571429,NA,574,0,0,366,542,887,574,887
2017,14,21,"Bilecik",40.15,29.9833,13.2285714285714,10.1714285714286,3.99442857142857,70.5,47.7728571428571,NA,639,0,0,610,1270,1336,639,1336
2017,15,21,"Bilecik",40.15,29.9833,10.4142857142857,11.6857142857143,0.0857142857142857,58.3571428571429,40.8828571428571,NA,587,79,113,302,852,1187,508,1074
2017,16,21,"Bilecik",40.15,29.9833,14.9285714285714,9.27142857142857,4.79585714285714,77.7571428571429,28.5266666666667,NA,717,0,0,277,552,920,717,920
2017,17,21,"Bilecik",40.15,29.9833,11.1857142857143,14.8,0.157571428571429,53.4,47.4228571428571,NA,731,9,3,393,897,1478,722,1475
2017,18,21,"Bilecik",40.15,29.9833,13.8571428571429,17.0857142857143,3.055,66.8857142857143,50.1014285714286,NA,506,0,0,395,729,923,506,923
2017,19,21,"Bilecik",40.15,29.9833,12.7285714285714,18.4714285714286,0.430857142857143,60.1142857142857,51.0928571428571,NA,471,0,0,330,700,966,471,966
2017,20,21,"Bilecik",40.15,29.9833,9.9,13.6714285714286,2.38342857142857,73.9428571428571,34.5214285714286,NA,472,0,0,472,1205,1205,472,1205
2017,21,21,"Bilecik",40.15,29.9833,12.5142857142857,15.1142857142857,1.08528571428571,73.4285714285714,34.5114285714286,NA,448,0,0,424,819,849,448,849
2017,22,21,"Bilecik",40.15,29.9833,12.7,18.6571428571429,6.50357142857143,74.2857142857143,35.4628571428571,NA,522,0,0,487,943,1015,522,1015
2017,23,21,"Bilecik",40.15,29.9833,11.7428571428571,18.7428571428571,3.79914285714286,82.3285714285714,37.3771428571429,NA,578,0,0,496,1020,1388,578,1388
2017,24,21,"Bilecik",40.15,29.9833,11.4428571428571,19.6571428571429,0.031,67.6142857142857,35.7285714285714,NA,552,0,0,529,1134,1139,552,1139
2017,25,21,"Bilecik",40.15,29.9833,11.7285714285714,20.2428571428571,0.652571428571429,71.1285714285714,32.6685714285714,NA,584,0,0,545,959,1041,584,1041
2017,26,21,"Bilecik",40.15,29.9833,11.2,26.3428571428571,0,55.8714285714286,43.8185714285714,NA,564,0,0,564,971,971,564,971
2017,27,21,"Bilecik",40.15,29.9833,13.8428571428571,22.3285714285714,0.115285714285714,64.2571428571429,36.1485714285714,NA,511,0,0,466,618,642,511,642
2017,28,21,"Bilecik",40.15,29.9833,12.9428571428571,23.8,0,60.8,38.5057142857143,NA,481,0,0,413,809,864,481,864
2017,29,21,"Bilecik",40.15,29.9833,12.1,22.5571428571429,0.303571428571429,71.5857142857143,37.0771428571429,NA,532,0,0,504,1202,1272,532,1272
2017,30,21,"Bilecik",40.15,29.9833,14.3857142857143,24.4857142857143,0.573857142857143,57.8285714285714,47.3971428571429,NA,531,0,0,438,778,928,531,928
2017,31,21,"Bilecik",40.15,29.9833,12.2857142857143,23.8285714285714,0.742571428571429,67.3857142857143,42.44,NA,559,0,0,516,973,1047,559,1047
2017,32,21,"Bilecik",40.15,29.9833,11.9714285714286,25.7428571428571,0.285,67.7285714285714,51.3028571428571,NA,567,0,0,555,1072,1092,567,1092
2017,33,21,"Bilecik",40.15,29.9833,12.2285714285714,23.0857142857143,0.00242857142857143,71,43.0228571428571,NA,596,0,0,596,1199,1199,596,1199
2017,34,21,"Bilecik",40.15,29.9833,10.6571428571429,20.5571428571429,1.07214285714286,70.2285714285714,34.9614285714286,NA,601,0,0,463,1165,1280,601,1280
2017,35,21,"Bilecik",40.15,29.9833,10.3285714285714,20.0857142857143,0,61.0714285714286,44.37,NA,493,0,0,389,917,1014,493,1014
2017,36,21,"Bilecik",40.15,29.9833,10.9285714285714,20.4285714285714,0.229285714285714,59.1428571428571,57.735,NA,507,0,0,377,1072,1321,507,1321
2017,37,21,"Bilecik",40.15,29.9833,11.4428571428571,23.6,0,59.6285714285714,64.8857142857143,NA,589,0,0,589,1138,1138,589,1138
2017,38,21,"Bilecik",40.15,29.9833,12.2428571428571,21.8142857142857,0.00271428571428571,49.4428571428571,49.0485714285714,NA,671,0,0,543,1069,1312,671,1312
2017,39,21,"Bilecik",40.15,29.9833,10.4142857142857,16.5714285714286,1.06014285714286,77.8,40.8014285714286,NA,782,0,0,596,1161,1630,782,1630
2017,40,21,"Bilecik",40.15,29.9833,10.8857142857143,13.6571428571429,1.51371428571429,72.2571428571429,39.7471428571429,NA,543,0,0,318,656,1137,543,1137
2017,41,21,"Bilecik",40.15,29.9833,9.34285714285714,11.8,0.286857142857143,67.5714285714286,34.1828571428571,NA,487,0,0,487,843,843,487,843
2017,42,21,"Bilecik",40.15,29.9833,10.1142857142857,15.3428571428571,0,56.2142857142857,45.4257142857143,NA,530,99,188,352,454,815,431,627
2017,43,21,"Bilecik",40.15,29.9833,10.8285714285714,12.7571428571429,2.77642857142857,79.9714285714286,36.6433333333333,NA,506,230,324,108,280,919,276,595
2017,44,21,"Bilecik",40.15,29.9833,8.78571428571429,7.17142857142857,0.785571428571428,67.7428571428571,41.4242857142857,NA,561,26,90,220,483,1102,535,1012
2017,45,21,"Bilecik",40.15,29.9833,7.98571428571429,9.58571428571429,0.000428571428571429,76.4142857142857,56.92,NA,577,275,296,141,155,829,302,533
2017,46,21,"Bilecik",40.15,29.9833,7.67142857142857,12.5142857142857,0,67.7714285714286,75.75,NA,587,410,748,176,336,1085,177,337
2017,47,21,"Bilecik",40.15,29.9833,8.44285714285714,6.3,2.23057142857143,81.0571428571428,46.8628571428571,NA,418,243,546,66,70,804,175,258
2017,48,21,"Bilecik",40.15,29.9833,10.9142857142857,10.5,0.132714285714286,68.4285714285714,36.5742857142857,NA,386,301,442,17,51,619,85,177
2017,49,21,"Bilecik",40.15,29.9833,12.9428571428571,5.9,3.74828571428571,77.0428571428571,38.2333333333333,NA,407,188,268,108,152,645,219,377
2017,50,21,"Bilecik",40.15,29.9833,9.14285714285714,8.61428571428571,0.0428571428571429,77.8,42.0471428571429,NA,346,135,164,47,89,442,211,278
2017,51,21,"Bilecik",40.15,29.9833,12.8,3.85714285714286,7.31,90.4571428571429,23.8714285714286,NA,386,0,0,339,299,349,386,349
2017,52,21,"Bilecik",40.15,29.9833,13.15,4.7,0.039125,76.1,39.45875,NA,528,423,433,16,8,507,105,74
2018,1,21,"Bilecik",40.15,29.9833,9.8,5.0375,0.773875,82.9,43.7825,26.62,618,544,842,72,61,914,74,72
2018,2,21,"Bilecik",40.15,29.9833,10.6,5.04285714285714,1.27085714285714,86.4,46.88,NA,624,310,908,189,152,1309,314,401
2018,3,21,"Bilecik",40.15,29.9833,14.6571428571429,4.11428571428571,1.24642857142857,76.3,35.0914285714286,NA,639,259,294,115,66,655,380,361
2018,4,21,"Bilecik",40.15,29.9833,11.1428571428571,1.01428571428571,0.658,80.7285714285714,33.0957142857143,NA,604,86,169,416,490,764,518,595
2018,5,21,"Bilecik",40.15,29.9833,9.48571428571429,6.65714285714286,0.0152857142857143,71.0857142857143,60.8714285714286,NA,670,156,268,297,218,819,514,551
2018,6,21,"Bilecik",40.15,29.9833,11.3142857142857,8.38571428571429,2.29914285714286,80.5142857142857,54.6785714285714,NA,704,264,327,308,456,1022,440,695
2018,7,21,"Bilecik",40.15,29.9833,8.74285714285714,6.11428571428571,0.043,81.5714285714286,35.6614285714286,NA,478,134,197,281,303,557,344,360
2018,8,21,"Bilecik",40.15,29.9833,9.45714285714286,6.68571428571429,2.57028571428571,83.4714285714286,46.17,NA,711,103,202,354,644,1321,608,1119
2018,9,21,"Bilecik",40.15,29.9833,16.6428571428571,6.41428571428571,4.87271428571429,79.5,37.4057142857143,NA,621,158,224,123,248,956,463,732
2018,10,21,"Bilecik",40.15,29.9833,12.9428571428571,10.9428571428571,0.218857142857143,76.4428571428572,64.1085714285714,NA,556,115,300,213,400,1330,441,1030
2018,11,21,"Bilecik",40.15,29.9833,13.7,11.8,1.45714285714286,69.9857142857143,53.2628571428571,NA,551,118,265,155,226,1426,433,1161
2018,12,21,"Bilecik",40.15,29.9833,16.9571428571429,11.8,0.443571428571429,66.6142857142857,81.4128571428571,NA,425,0,0,160,369,1187,425,1187
2018,13,21,"Bilecik",40.15,29.9833,14.5714285714286,11.4714285714286,1.72757142857143,67.6571428571429,75.6771428571429,NA,356,125,112,127,168,428,231,316
2018,14,21,"Bilecik",40.15,29.9833,13.0714285714286,13.0714285714286,0.999142857142857,60.5,47.7514285714286,NA,407,75,72,194,296,486,332,414
2018,15,21,"Bilecik",40.15,29.9833,9.12857142857143,16.5714285714286,0.128285714285714,66.4428571428571,62.5542857142857,NA,374,0,0,369,429,450,374,450
2018,16,21,"Bilecik",40.15,29.9833,10.4285714285714,13.9857142857143,0.999142857142857,59.8857142857143,48.5557142857143,NA,411,123,134,267,448,648,288,514
2018,17,21,"Bilecik",40.15,29.9833,12,19.3571428571429,0,45.5571428571429,45.0842857142857,NA,419,0,0,336,565,652,419,652
2018,18,21,"Bilecik",40.15,29.9833,15.0571428571429,19.9,2.60114285714286,59.7428571428571,51.3428571428571,NA,303,31,18,211,322,474,272,456
2018,19,21,"Bilecik",40.15,29.9833,11.6714285714286,14.3,7.05585714285714,82.0428571428571,30.05,NA,275,0,0,149,286,467,275,467
2018,20,21,"Bilecik",40.15,29.9833,10.9,20.2714285714286,0.329285714285714,60.6571428571429,43.2042857142857,NA,204,0,0,138,230,306,204,306
2018,21,21,"Bilecik",40.15,29.9833,11.6857142857143,18.8142857142857,0.526571428571428,80.3428571428571,42.6657142857143,NA,252,0,0,228,276,281,252,281
2018,22,21,"Bilecik",40.15,29.9833,10.1714285714286,18.3857142857143,0.000714285714285714,70.5428571428571,36.0157142857143,NA,249,0,0,243,417,427,249,427
2018,23,21,"Bilecik",40.15,29.9833,9.62857142857143,21.8,0.972428571428571,64.9571428571429,39.72,NA,267,42,121,179,586,812,225,691
2018,24,21,"Bilecik",40.15,29.9833,14.3571428571429,21.4857142857143,1.83314285714286,64.9714285714286,33.4142857142857,NA,267,40,19,192,394,448,227,429
2018,25,21,"Bilecik",40.15,29.9833,11.5428571428571,20.8571428571429,2.41528571428571,77.9428571428571,31.9428571428571,NA,358,0,0,237,305,518,358,518
2018,26,21,"Bilecik",40.15,29.9833,14.0142857142857,21.5714285714286,0.422285714285714,73.8285714285714,29.2471428571429,NA,355,0,0,209,453,587,355,587
2018,27,21,"Bilecik",40.15,29.9833,11.5714285714286,23.7285714285714,0,56.0714285714286,34.7985714285714,NA,342,0,0,185,231,418,342,418
2018,28,21,"Bilecik",40.15,29.9833,11.5714285714286,23.6428571428571,0.453142857142857,70.8142857142857,35.6557142857143,NA,286,0,0,286,585,585,286,585
2018,29,21,"Bilecik",40.15,29.9833,11.9571428571429,23.4714285714286,0.433571428571429,62.2142857142857,31.9971428571429,NA,260,0,0,240,711,756,260,756
2018,30,21,"Bilecik",40.15,29.9833,15.6142857142857,23.6,1.32185714285714,67.1571428571429,34.5957142857143,NA,265,0,0,239,766,822,265,822
2018,31,21,"Bilecik",40.15,29.9833,11.1857142857143,24.1,0.912857142857143,71.3571428571429,38.9071428571429,NA,267,0,0,253,377,499,267,499
2018,32,21,"Bilecik",40.15,29.9833,10.9428571428571,23.4571428571429,0.143,64.7571428571429,37.0771428571429,NA,297,0,0,138,208,403,297,403
2018,33,21,"Bilecik",40.15,29.9833,11.6857142857143,23.9285714285714,0,61.8285714285714,39.6114285714286,NA,216,0,0,125,216,332,216,332
2018,34,21,"Bilecik",40.15,29.9833,11.5857142857143,23.8428571428571,0,63.1571428571429,NA,NA,144,0,0,144,227,227,144,227
2018,35,21,"Bilecik",40.15,29.9833,11.3857142857143,24.3428571428571,1.68714285714286,66.9857142857143,39.925,NA,201,0,0,162,257,314,201,314
2018,36,21,"Bilecik",40.15,29.9833,12.1857142857143,21.6714285714286,6.33385714285714,69.3,43.7857142857143,NA,341,0,0,312,327,370,341,370
2018,37,21,"Bilecik",40.15,29.9833,11.8,18.0571428571429,6.15042857142857,74.9,35.9871428571429,NA,241,0,0,214,348,419,241,419
2018,38,21,"Bilecik",40.15,29.9833,16.3714285714286,19.0142857142857,0.0142857142857143,70.9714285714286,39.4414285714286,NA,189,0,0,183,305,344,189,344
2018,39,21,"Bilecik",40.15,29.9833,13.6857142857143,17.0857142857143,0.0871428571428571,68.5,41.8814285714286,NA,180,0,0,160,321,353,180,353
2018,40,21,"Bilecik",40.15,29.9833,14.5714285714286,16.2571428571429,1.42942857142857,69.5428571428571,39.5914285714286,NA,191,0,0,129,225,341,191,341
2018,41,21,"Bilecik",40.15,29.9833,9.4,15.5428571428571,1.041,76.5714285714286,47.4171428571429,NA,187,0,0,187,422,422,187,422
2018,42,21,"Bilecik",40.15,29.9833,9.62857142857143,16.1142857142857,1.41342857142857,83.3571428571429,76.5542857142857,NA,168,0,0,163,379,381,168,381
2018,43,21,"Bilecik",40.15,29.9833,11.0857142857143,11.1571428571429,2.54257142857143,73.0714285714286,49.19,NA,187,54,85,86,117,402,133,317
2018,44,21,"Bilecik",40.15,29.9833,7.41428571428571,13.8571428571429,0,57.4,58.7528571428571,23.635,196,51,91,145,173,264,145,173
2018,45,21,"Bilecik",40.15,29.9833,6.34285714285714,11,0,77.1857142857143,57.9757142857143,24.5,231,0,0,173,385,473,231,473
2018,46,21,"Bilecik",40.15,29.9833,8.81428571428571,7.08571428571429,1.744,79.7714285714286,35.21,19.6471428571429,230,102,166,122,287,465,128,299
2018,47,21,"Bilecik",40.15,29.9833,8.71428571428571,9.6,0.315285714285714,80.1285714285714,49.0114285714286,26.9614285714286,270,139,252,64,113,499,131,247
2018,48,21,"Bilecik",40.15,29.9833,11.5285714285714,7.8,3.69757142857143,80.1142857142857,30.1942857142857,20.5985714285714,245,64,28,100,108,201,181,173
2018,49,21,"Bilecik",40.15,29.9833,11.4714285714286,5.32857142857143,2.61142857142857,80.7,38.5142857142857,25.2971428571429,257,142,146,115,274,420,115,274
2018,50,21,"Bilecik",40.15,29.9833,15.8285714285714,4.68571428571429,2.51442857142857,85.4,34.56,24.34,256,155,123,13,11,305,101,182
2018,51,21,"Bilecik",40.15,29.9833,11.2,4.57142857142857,5.21171428571429,89.6142857142857,49.3014285714286,26.3642857142857,250,38,37,111,105,248,212,211
2018,52,21,"Bilecik",40.15,29.9833,9.54285714285714,0.528571428571429,2.87528571428571,89.4,43.9157142857143,29.3057142857143,244,56,34,119,122,273,188,239
2019,1,21,"Bilecik",40.15,29.9833,13.375,1.7375,4.903875,86.525,33.57625,15.265,343,225,546,30,87,784,118,238
2019,2,21,"Bilecik",40.15,29.9833,11.6428571428571,1.15714285714286,1.33171428571429,78.0571428571428,29.9242857142857,14.9857142857143,255,131,81,91,115,208,124,127
2019,3,21,"Bilecik",40.15,29.9833,11.8571428571429,1.75714285714286,3.569,81.6142857142857,42.8585714285714,27.6128571428571,192,112,131,54,45,198,80,67
2019,4,21,"Bilecik",40.15,29.9833,16.7142857142857,6.85714285714286,0.143142857142857,75.3,46.3728571428571,20.72,308,209,222,0,0,314,99,92
2019,5,21,"Bilecik",40.15,29.9833,14.4285714285714,7.34285714285714,0.441428571428571,68.3285714285714,34.85,21.5785714285714,253,156,95,2,1,143,97,48
2019,6,21,"Bilecik",40.15,29.9833,11.9,5.74285714285714,4.66414285714286,79.0857142857143,27.2414285714286,16.7857142857143,276,87,23,110,69,127,189,104
2019,7,21,"Bilecik",40.15,29.9833,13.2,4.18571428571429,3.91142857142857,80.0285714285714,26.8185714285714,13.39,325,95,129,172,96,234,230,105
2019,8,21,"Bilecik",40.15,29.9833,10.8857142857143,4.68571428571429,0.0727142857142857,72.3714285714286,56.59,29.8142857142857,305,0,0,302,217,219,305,219
2019,9,21,"Bilecik",40.15,29.9833,11.6714285714286,3.24285714285714,1.08528571428571,78.4285714285714,34.6128571428571,20.3414285714286,331,0,0,261,258,310,331,310
2019,10,21,"Bilecik",40.15,29.9833,14.5285714285714,9,0.514571428571429,53.6571428571429,44.12,27.0742857142857,359,99,73,211,149,252,260,179
2019,11,21,"Bilecik",40.15,29.9833,12,8.2,1.53028571428571,72.1285714285714,32.3714285714286,17.0385714285714,373,0,0,262,350,400,373,400
2019,12,21,"Bilecik",40.15,29.9833,10.9142857142857,8.11428571428571,0,63.5571428571429,38.5571428571429,17.8157142857143,343,0,0,236,349,416,343,416
2019,13,21,"Bilecik",40.15,29.9833,12.2285714285714,5.37142857142857,0,60.9428571428571,34.5657142857143,14.8457142857143,256,0,0,194,155,194,256,194
2019,14,21,"Bilecik",40.15,29.9833,11.3857142857143,9,0.057,68.8428571428571,47.0342857142857,18.4742857142857,365,87,34,256,156,208,278,174
2019,15,21,"Bilecik",40.15,29.9833,13.4428571428571,11.8714285714286,3.92657142857143,78.1571428571429,29.9857142857143,15.99,359,163,60,103,60,183,196,123
2019,16,21,"Bilecik",40.15,29.9833,11.4571428571429,6.25714285714286,0.629428571428571,75.7428571428571,24.91,12.8685714285714,318,0,0,317,207,208,318,208
2019,17,21,"Bilecik",40.15,29.9833,8.88571428571429,13.0285714285714,0.214714285714286,58.2857142857143,40.1933333333333,19.3028571428571,412,0,0,271,240,313,412,313
2019,18,21,"Bilecik",40.15,29.9833,15.6285714285714,15.8571428571429,0.203714285714286,59.6714285714286,37.3342857142857,8.46428571428572,523,95,38,311,261,353,428,315
2019,19,21,"Bilecik",40.15,29.9833,14.2857142857143,13.0857142857143,2.19557142857143,72.5428571428571,40.2542857142857,10.7957142857143,452,81,54,181,131,386,371,332
2019,20,21,"Bilecik",40.15,29.9833,13.9285714285714,18.3571428571429,1.34528571428571,68.9,38.2542857142857,12.6628571428571,454,1,0,295,240,389,453,389
2019,21,21,"Bilecik",40.15,29.9833,14.1142857142857,18.9857142857143,0.912285714285714,68.8285714285714,36.8642857142857,9.50714285714286,457,0,0,272,252,413,457,413
2019,22,21,"Bilecik",40.15,29.9833,11.2,22.0285714285714,0.343571428571429,62.6714285714286,41.5385714285714,8.28428571428571,453,54,30,292,215,323,399,293
2019,23,21,"Bilecik",40.15,29.9833,11.5285714285714,20.8857142857143,0.917714285714286,64.8142857142857,33.6057142857143,6,378,0,0,374,529,532,378,532
2019,24,21,"Bilecik",40.15,29.9833,14.4571428571429,20.6285714285714,12.0041428571429,76.7428571428571,34.5542857142857,7.98571428571429,378,0,0,327,205,244,378,244
2019,25,21,"Bilecik",40.15,29.9833,11.1571428571429,21.0285714285714,10.9334285714286,77.0714285714286,35.9157142857143,8.92857142857143,306,0,0,256,312,325,306,325
2019,26,21,"Bilecik",40.15,29.9833,11.5,22.4857142857143,0.00114285714285714,63.3428571428571,37.0571428571429,5.52428571428571,377,0,0,179,254,342,377,342
2019,27,21,"Bilecik",40.15,29.9833,10.3,22.6428571428571,0,59.8428571428571,36.4571428571429,6.36142857142857,456,0,0,403,187,222,456,222
2019,28,21,"Bilecik",40.15,29.9833,10.9428571428571,20.5571428571429,3.71328571428571,66.1,30.47,9.12714285714286,398,0,0,394,417,421,398,421
2019,29,21,"Bilecik",40.15,29.9833,10.8714285714286,20.0428571428571,0.856285714285714,72.9428571428572,31.0242857142857,7.49571428571429,453,0,0,151,46,203,453,203
2019,30,21,"Bilecik",40.15,29.9833,11.5428571428571,21.7714285714286,0.430714285714286,66.3714285714286,36.6257142857143,8.41857142857143,456,0,0,298,267,335,456,335
2019,31,21,"Bilecik",40.15,29.9833,11.2,24.0571428571429,0.114142857142857,63.3857142857143,38.0485714285714,10.0128571428571,334,0,0,297,309,375,334,375
2019,32,21,"Bilecik",40.15,29.9833,10.5714285714286,21.6857142857143,0,59.4857142857143,31.9614285714286,8.70714285714286,346,0,0,201,241,395,346,395
2019,33,21,"Bilecik",40.15,29.9833,15.4428571428571,22.1,0.840428571428571,68.9714285714286,29.8357142857143,7.21571428571429,337,0,0,336,530,531,337,531
2019,34,21,"Bilecik",40.15,29.9833,14.5,21.4571428571429,0.810142857142857,73.1714285714286,37.4271428571429,10.0771428571429,299,0,0,292,337,345,299,345
2019,35,21,"Bilecik",40.15,29.9833,12.7285714285714,21.8142857142857,0,67.1857142857143,40.3628571428571,10.0428571428571,307,0,0,301,401,415,307,415
2019,36,21,"Bilecik",40.15,29.9833,14.1714285714286,20.7428571428571,0,67.1428571428571,37.9442857142857,9.09285714285714,171,0,0,124,49,67,171,67
2019,37,21,"Bilecik",40.15,29.9833,11.8285714285714,19.4571428571429,0.000571428571428571,67.2,34.7957142857143,8.67428571428571,218,0,0,211,53,55,218,55
2019,38,21,"Bilecik",40.15,29.9833,11.3,16.8857142857143,0.429714285714286,63.1142857142857,36.44,12.0114285714286,266,0,0,222,65,91,266,91
2019,39,21,"Bilecik",40.15,29.9833,9.07142857142857,17.1142857142857,0.143571428571429,67.7857142857143,38.3214285714286,14.8971428571429,237,0,0,168,59,79,237,79
2019,40,21,"Bilecik",40.15,29.9833,14.3142857142857,19.5285714285714,1.60142857142857,53.6428571428571,36.1671428571429,13.68,241,0,0,78,16,111,241,111
2019,41,21,"Bilecik",40.15,29.9833,6.58571428571429,15.3714285714286,1.286,75.8571428571429,36.3728571428571,15.3257142857143,416,0,0,310,350,448,416,448
2019,42,21,"Bilecik",40.15,29.9833,8.28571428571429,16.7571428571429,0,67.3,68.5057142857143,25.14,356,73,96,245,242,408,283,312
2019,43,21,"Bilecik",40.15,29.9833,6.95714285714286,13.8571428571429,0,76.5714285714286,46.3528571428571,14.5742857142857,306,0,0,281,289,300,306,300
2019,44,21,"Bilecik",40.15,29.9833,6.75714285714286,10.5714285714286,1.50457142857143,77.7,43.5242857142857,19.8842857142857,350,35,7,214,174,250,315,243
2019,45,21,"Bilecik",40.15,29.9833,9.65714285714286,14.4,0,59.4285714285714,52.5885714285714,25.3642857142857,417,164,106,0,0,328,253,222
2019,46,21,"Bilecik",40.15,29.9833,6.6,14.7428571428571,0.371285714285714,56.4857142857143,57.5614285714286,26.9471428571429,401,198,203,132,63,337,203,134
2019,47,21,"Bilecik",40.15,29.9833,6.35714285714286,10.5428571428571,0.0428571428571429,58.0857142857143,58.1471428571429,29,391,225,146,0,0,339,166,193
2019,48,21,"Bilecik",40.15,29.9833,8.71428571428572,9.77142857142857,4.22928571428571,83.2285714285714,32.7042857142857,23.4742857142857,320,129,66,50,63,251,191,185
2019,49,21,"Bilecik",40.15,29.9833,8.44285714285714,3.02857142857143,3.25671428571429,79.6142857142857,28.7071428571429,9.30571428571429,393,178,86,109,76,274,215,188
2019,50,21,"Bilecik",40.15,29.9833,9.12857142857143,7.41428571428571,0.0864285714285714,76.4571428571429,33.8142857142857,5.07142857142857,218,192,99,0,0,119,26,20
2019,51,21,"Bilecik",40.15,29.9833,10.7571428571429,6.25714285714286,0,73.5571428571428,35.51,6.39428571428571,361,219,279,0,0,488,142,209
2019,52,21,"Bilecik",40.15,29.9833,15.7857142857143,5.85714285714286,2.49042857142857,82.2428571428571,18.9185714285714,2.34,279,49,66,219,206,281,230,215
2020,1,21,"Bilecik",40.15,29.9833,7.48,1.64,0.1224,81.24,30.02,8.47333333333333,160,0,0,98,93,126,160,126
2020,2,21,"Bilecik",40.15,29.9833,7.61428571428571,1.41428571428571,5.32557142857143,82.5571428571428,26.7485714285714,5.02285714285714,240,90,58,98,98,173,150,115
2020,3,21,"Bilecik",40.15,29.9833,2.98571428571429,2.37142857142857,0.285571428571429,78.5857142857143,37.2614285714286,5.42428571428571,270,139,205,104,154,382,131,177
2020,4,21,"Bilecik",40.15,29.9833,6.64285714285714,1.41428571428571,0.244428571428571,71.2857142857143,29.5857142857143,3.64285714285714,358,57,83,99,76,295,301,212
2020,5,21,"Bilecik",40.15,29.9833,7.65714285714286,5.84285714285714,0.972857142857143,73.1428571428571,36.7428571428571,4.84285714285714,331,64,57,3,0,272,267,215
2020,6,21,"Bilecik",40.15,29.9833,12.4571428571429,4.38571428571429,2.78842857142857,75.6142857142857,22.47,1.75166666666667,343,65,77,0,0,267,278,190
2020,7,21,"Bilecik",40.15,29.9833,9.74285714285714,3.27142857142857,2.92714285714286,78.1,29.8242857142857,3.22333333333333,341,162,204,69,71,338,179,134
2020,8,21,"Bilecik",40.15,29.9833,9.24285714285714,4.45714285714286,1.37042857142857,75.8285714285714,33.16,6.72571428571429,283,72,29,143,122,187,211,158
2020,9,21,"Bilecik",40.15,29.9833,17.0571428571429,7.85714285714286,1.91342857142857,63.2285714285714,29.7057142857143,7.46714285714286,393,45,15,156,246,528,348,513
2020,10,21,"Bilecik",40.15,29.9833,8.34285714285714,11.4857142857143,0.714,59.7428571428571,31.8014285714286,6.58428571428571,205,14,7,0,0,210,191,203
2020,11,21,"Bilecik",40.15,29.9833,8.44285714285714,10.5285714285714,0.00128571428571429,67.3285714285714,33.4342857142857,4.53,115,26,11,58,41,94,89,83
2020,12,21,"Bilecik",40.15,29.9833,13.1571428571429,3.62857142857143,0.672428571428571,71.2142857142857,21.9985714285714,1.9,117,0,0,88,79,118,117,118
2020,13,21,"Bilecik",40.15,29.9833,12.9571428571429,7.05714285714286,2.03157142857143,86.2285714285714,27.1542857142857,2.66,136,0,0,60,42,92,136,92
2020,14,21,"Bilecik",40.15,29.9833,17.6571428571429,8.37142857142857,2.49742857142857,80.5,28.86,3.55285714285714,155,29,31,53,40,121,126,90
2020,15,21,"Bilecik",40.15,29.9833,9.82857142857143,8.25714285714286,1.43028571428571,66.2,28.4671428571429,2.26,133,0,0,131,115,118,133,118
2020,16,21,"Bilecik",40.15,29.9833,9.67142857142857,11.9142857142857,0.714142857142857,55.1428571428571,26.8271428571429,NA,141,0,0,124,97,106,141,106
2020,17,21,"Bilecik",40.15,29.9833,13.0142857142857,9.97142857142857,0.0142857142857143,63.8857142857143,25.3885714285714,NA,137,0,0,122,109,123,137,123
2020,18,21,"Bilecik",40.15,29.9833,11.0285714285714,14.0285714285714,2.00042857142857,64.8142857142857,21.3728571428571,NA,146,0,0,116,143,164,146,164
2020,19,21,"Bilecik",40.15,29.9833,11.0571428571429,12.2285714285714,0.463285714285714,70.7142857142857,16.5971428571429,NA,137,0,0,96,147,157,137,157
2020,20,21,"Bilecik",40.15,29.9833,8.5,21.4285714285714,0,50.5428571428571,41.41,NA,164,0,0,122,121,164,164,164
2020,21,21,"Bilecik",40.15,29.9833,12.2,17.7714285714286,1.91514285714286,61.7428571428571,34.4828571428571,NA,146,0,0,126,87,96,146,96
2020,22,21,"Bilecik",40.15,29.9833,11.0571428571429,13.2571428571429,2.87171428571429,75.6428571428572,14.8242857142857,NA,118,0,0,79,49,100,118,100
2020,23,21,"Bilecik",40.15,29.9833,8.97142857142857,17.0428571428571,6.16371428571429,70.5428571428571,22.1685714285714,NA,112,0,0,82,41,70,112,70
2020,24,21,"Bilecik",40.15,29.9833,12.5428571428571,19.5285714285714,3.79514285714286,70.3142857142857,29.3128571428571,8.325,140,0,0,102,92,150,140,150
2020,25,21,"Bilecik",40.15,29.9833,12.6714285714286,20.1,2.50642857142857,70.5571428571428,24.58,4.67142857142857,137,0,0,104,86,108,137,108
2020,26,21,"Bilecik",40.15,29.9833,11.9142857142857,19.6428571428571,6.62957142857143,76.3571428571429,24.1171428571429,4.5,173,0,0,138,112,133,173,133
2020,27,21,"Bilecik",40.15,29.9833,8.57142857142857,23.6571428571429,0,62.5714285714286,30.2071428571429,3.86,113,0,0,87,99,113,113,113
2020,28,21,"Bilecik",40.15,29.9833,14.3428571428571,22.5285714285714,0.171142857142857,69.1285714285714,27.4071428571429,5.53714285714286,164,0,0,137,84,122,164,122
2020,29,21,"Bilecik",40.15,29.9833,12.6714285714286,20.6285714285714,0.000285714285714286,70.3428571428571,25.5914285714286,4.3,186,0,0,160,103,111,186,111
2020,30,21,"Bilecik",40.15,29.9833,10.6857142857143,22.6,0,63.5142857142857,29.8385714285714,4.19857142857143,190,0,0,172,125,142,190,142
2020,31,21,"Bilecik",40.15,29.9833,12.0428571428571,23.5857142857143,0,58.2857142857143,27.6,3.39285714285714,150,0,0,118,119,127,150,127
2020,32,21,"Bilecik",40.15,29.9833,9.84285714285714,23.9285714285714,0,63.0571428571429,30.0728571428571,4.18428571428571,146,0,0,122,72,107,146,107
2020,33,21,"Bilecik",40.15,29.9833,8.92857142857143,22.4285714285714,0.000142857142857143,57.3571428571429,28.0814285714286,3.17857142857143,183,0,0,142,65,83,183,83
2020,34,21,"Bilecik",40.15,29.9833,8.91428571428571,21.5142857142857,0.997428571428571,63.5571428571429,28.0371428571429,4.39,197,0,0,187,95,97,197,97
2020,35,21,"Bilecik",40.15,29.9833,8.44285714285714,23.2285714285714,0,56.4285714285714,30.5642857142857,5.49,164,0,0,158,153,157,164,157
2020,36,21,"Bilecik",40.15,29.9833,10.7428571428571,22.8714285714286,0.0291428571428571,64.4571428571429,37.9185714285714,5.16714285714286,179,0,0,169,107,112,179,112
2020,37,21,"Bilecik",40.15,29.9833,10.2142857142857,21.6571428571429,0.228142857142857,68.5857142857143,36.9557142857143,4.49857142857143,193,0,0,155,78,91,193,91
2020,38,21,"Bilecik",40.15,29.9833,9.65714285714286,20.7714285714286,0.0228571428571429,70.0714285714286,38.0571428571429,5.01142857142857,235,0,0,170,103,157,235,157
2020,39,21,"Bilecik",40.15,29.9833,9.24285714285714,20.2285714285714,0.698857142857143,66.6285714285714,34.8385714285714,6.55714285714286,220,24,8,173,105,129,196,121
2020,40,21,"Bilecik",40.15,29.9833,7.05714285714286,18.0428571428571,0.0152857142857143,59.2571428571429,30.7328571428571,5.82,187,0,0,172,150,154,187,154
2020,41,21,"Bilecik",40.15,29.9833,7.21428571428571,19.4714285714286,1.71571428571429,59.4428571428571,40.82,5.9825,182,0,0,157,107,127,182,127
2020,42,21,"Bilecik",40.15,29.9833,12,17.2857142857143,1.02842857142857,66.4142857142857,32.1014285714286,7.48,177,0,0,71,66,111,177,111
2020,43,21,"Bilecik",40.15,29.9833,7.3,15.1857142857143,1.45085714285714,77.1857142857143,31.9542857142857,10.9683333333333,194,0,0,104,106,161,194,161
2020,44,21,"Bilecik",40.15,29.9833,9.71428571428572,13.2714285714286,0.531857142857143,78.8714285714286,35.1828571428571,9.24857142857143,255,64,64,132,136,233,191,169
2020,45,21,"Bilecik",40.15,29.9833,10.2714285714286,9.55714285714286,0.173428571428571,77.6714285714286,27.34,12.7028571428571,156,0,0,125,82,103,156,103
2020,46,21,"Bilecik",40.15,29.9833,6.64285714285714,9.24285714285714,0.0295714285714286,77.6428571428571,31.3714285714286,15.1585714285714,208,0,0,120,55,109,208,109
2020,47,21,"Bilecik",40.15,29.9833,5.3,6.04285714285714,0.182857142857143,78.3,30.8042857142857,14.6114285714286,173,0,0,76,14,83,173,83
2020,48,21,"Bilecik",40.15,29.9833,7.32857142857143,4.28571428571429,0,68.6142857142857,33.81,15.6242857142857,199,95,101,41,70,262,104,161
2020,49,21,"Bilecik",40.15,29.9833,6.77142857142857,6.47142857142857,0.0154285714285714,72.6714285714286,44.8171428571429,15.1314285714286,207,61,36,91,72,116,146,80
2020,50,21,"Bilecik",40.15,29.9833,13,8.8,0.0147142857142857,68.4714285714286,34.4342857142857,6.37,181,83,41,18,4,98,98,57
2020,51,21,"Bilecik",40.15,29.9833,9.74285714285714,7.55714285714286,0.390571428571429,82,25.8,1.79571428571429,171,41,16,123,70,90,130,74
2020,52,21,"Bilecik",40.15,29.9833,6.54285714285714,5.85714285714286,0,72.9,28.7871428571429,2.03571428571429,203,39,6,57,28,113,164,107
2020,53,21,"Bilecik",40.15,29.9833,13.825,9.15,1.24775,66.25,29.1875,2.5275,122,67,78,25,15,111,55,33
2017,1,22,"Bingol",38.8848,40.4933,8.4,-4.61428571428571,1.04285714285714,79.9,39.2028571428571,NA,563,553,817,0,0,847,10,30
2017,2,22,"Bingol",38.8848,40.4933,11.6428571428571,-5.28571428571429,2.04285714285714,73.4857142857143,32.4957142857143,NA,757,647,1055,0,0,1214,110,159
2017,3,22,"Bingol",38.8848,40.4933,9.05714285714286,-5.57142857142857,0,67.4714285714286,31.3842857142857,NA,762,691,1160,0,0,1449,71,289
2017,4,22,"Bingol",38.8848,40.4933,15.7,-5.92857142857143,5.75714285714286,71,18.8028571428571,NA,639,304,384,10,3,889,335,505
2017,5,22,"Bingol",38.8848,40.4933,11.7857142857143,-9.15714285714286,5.34285714285714,68.4857142857143,29.1814285714286,NA,588,427,837,0,0,1163,161,326
2017,6,22,"Bingol",38.8848,40.4933,9.64285714285714,-4.1,0.114285714285714,73.7,33.0528571428571,NA,736,583,1185,0,0,1519,153,334
2017,7,22,"Bingol",38.8848,40.4933,16.7857142857143,-6.38571428571429,0.257142857142857,55.4714285714286,12.7157142857143,NA,492,114,172,0,0,717,378,545
2017,8,22,"Bingol",38.8848,40.4933,7.75714285714286,-2.21428571428571,0.271428571428571,63.7285714285714,39.5542857142857,NA,739,661,1573,0,0,1747,78,174
2017,9,22,"Bingol",38.8848,40.4933,10.9857142857143,2.78571428571429,1.62857142857143,74.9714285714286,43.2925,NA,574,559,861,0,0,866,15,5
2017,10,22,"Bingol",38.8848,40.4933,14.2142857142857,3.84285714285714,2.21428571428571,66.0142857142857,20.806,NA,712,550,845,0,0,1043,162,198
2017,11,22,"Bingol",38.8848,40.4933,14.8428571428571,2.51428571428571,10.9285714285714,79.8428571428571,12.5842857142857,NA,525,255,290,0,0,725,270,435
2017,12,22,"Bingol",38.8848,40.4933,16.4428571428571,2.78571428571429,0.885714285714286,61,14.1942857142857,NA,589,327,466,0,0,1077,262,611
2017,13,22,"Bingol",38.8848,40.4933,9.74285714285714,7.38571428571429,3.94285714285714,65.3857142857143,12.4828571428571,NA,574,171,304,0,0,887,403,583
2017,14,22,"Bingol",38.8848,40.4933,9.55714285714286,5.82857142857143,4.85714285714286,68.7857142857143,7.97285714285714,NA,639,408,969,0,0,1336,231,367
2017,15,22,"Bingol",38.8848,40.4933,9.61428571428571,7.22857142857143,10.7428571428571,67.6571428571429,9.07833333333333,NA,587,359,672,0,0,1187,228,515
2017,16,22,"Bingol",38.8848,40.4933,14.5857142857143,10.9714285714286,2.98571428571429,70.6285714285714,19.3814285714286,NA,717,284,530,17,20,920,433,390
2017,17,22,"Bingol",38.8848,40.4933,10.4428571428571,11.2142857142857,0.428571428571429,46.9142857142857,23.5471428571429,NA,731,419,934,98,138,1478,312,544
2017,18,22,"Bingol",38.8848,40.4933,8.67142857142857,12.5285714285714,2.95714285714286,72.2857142857143,42.5971428571429,NA,506,407,726,0,0,923,99,197
2017,19,22,"Bingol",38.8848,40.4933,11.2714285714286,15.5857142857143,2.34285714285714,57.7,61.5157142857143,NA,471,205,366,0,0,966,266,600
2017,20,22,"Bingol",38.8848,40.4933,10.8285714285714,14.9571428571429,2.72857142857143,60.9857142857143,51.8957142857143,NA,472,225,555,0,0,1205,247,650
2017,21,22,"Bingol",38.8848,40.4933,17.2142857142857,13.6571428571429,5.45714285714286,62.6285714285714,27.6514285714286,NA,448,253,499,0,0,849,195,350
2017,22,22,"Bingol",38.8848,40.4933,9.58571428571429,16.6142857142857,1.05714285714286,51.3,35.05,NA,522,236,538,0,0,1015,286,477
2017,23,22,"Bingol",38.8848,40.4933,9.08571428571429,20.7285714285714,0.428571428571429,48.4857142857143,35.2,NA,578,414,1078,0,0,1388,164,310
2017,24,22,"Bingol",38.8848,40.4933,9.14285714285714,19.3285714285714,0.185714285714286,47.1285714285714,28.0785714285714,NA,552,320,609,0,0,1139,232,530
2017,25,22,"Bingol",38.8848,40.4933,10.7857142857143,19.8142857142857,0.0714285714285714,45.7571428571429,27.8785714285714,NA,584,10,10,0,0,1041,574,1031
2017,26,22,"Bingol",38.8848,40.4933,12.0428571428571,25.3285714285714,0,32.9285714285714,49.0442857142857,NA,564,259,423,0,0,971,305,548
2017,27,22,"Bingol",38.8848,40.4933,10.9,25.5,0,34.6,57.7314285714286,NA,511,194,305,0,0,642,317,337
2017,28,22,"Bingol",38.8848,40.4933,9.61428571428571,25.7857142857143,0,29.6,43.9328571428571,NA,481,91,239,0,0,864,390,625
2017,29,22,"Bingol",38.8848,40.4933,8.85714285714286,27.5428571428571,0,22.8428571428571,66.5442857142857,NA,532,293,779,0,0,1272,239,493
2017,30,22,"Bingol",38.8848,40.4933,9.64285714285714,26.2285714285714,0,27.4142857142857,53.2814285714286,NA,531,78,124,0,0,928,453,804
2017,31,22,"Bingol",38.8848,40.4933,10.0857142857143,27.9571428571429,0,20.3142857142857,62.5328571428571,NA,559,443,825,0,0,1047,116,222
2017,32,22,"Bingol",38.8848,40.4933,9.12857142857143,27.7571428571429,0,19.3428571428571,58.84,NA,567,396,738,0,0,1092,171,354
2017,33,22,"Bingol",38.8848,40.4933,10.8714285714286,26.1,0,27.3857142857143,57.8733333333333,NA,596,356,687,0,0,1199,240,512
2017,34,22,"Bingol",38.8848,40.4933,10.5142857142857,25.7,0,29.0857142857143,49.9571428571429,NA,601,216,590,0,0,1280,385,690
2017,35,22,"Bingol",38.8848,40.4933,9.48571428571429,24.0571428571429,0,23.7857142857143,50.7628571428571,NA,493,318,674,0,0,1014,175,340
2017,36,22,"Bingol",38.8848,40.4933,9.64285714285714,22.7285714285714,0.0285714285714286,21.1571428571429,44.4785714285714,NA,507,221,442,52,115,1321,286,879
2017,37,22,"Bingol",38.8848,40.4933,9.21428571428571,23.6142857142857,0,18.4285714285714,61.1614285714286,NA,589,350,382,0,0,1138,239,756
2017,38,22,"Bingol",38.8848,40.4933,11.3714285714286,22.2857142857143,0.0142857142857143,23.8,87.6385714285714,NA,671,558,1077,0,0,1312,113,235
2017,39,22,"Bingol",38.8848,40.4933,8.38571428571429,18.6142857142857,0.171428571428571,32.9142857142857,68.5871428571429,NA,782,589,1022,0,0,1630,193,608
2017,40,22,"Bingol",38.8848,40.4933,8.41428571428571,13.3857142857143,0.0285714285714286,39.6142857142857,46.87,NA,543,250,434,0,0,1137,293,703
2017,41,22,"Bingol",38.8848,40.4933,7.35714285714286,12.5285714285714,1.1,53.4,33.5157142857143,NA,487,292,318,0,0,843,195,525
2017,42,22,"Bingol",38.8848,40.4933,8.77142857142857,11.1285714285714,0,41.9714285714286,35.7585714285714,NA,530,267,355,0,0,815,263,460
2017,43,22,"Bingol",38.8848,40.4933,8.01428571428571,11.7714285714286,2.77142857142857,50.2142857142857,81.7042857142857,NA,506,435,840,0,0,919,71,79
2017,44,22,"Bingol",38.8848,40.4933,9.15714285714286,7.91428571428571,3.54285714285714,69.1285714285714,44.7914285714286,NA,561,288,633,0,0,1102,273,469
2017,45,22,"Bingol",38.8848,40.4933,8.28571428571428,8.61428571428571,4.27142857142857,77.8571428571429,96.9,NA,577,527,620,0,0,829,50,209
2017,46,22,"Bingol",38.8848,40.4933,7.75714285714286,7.44285714285714,1.14285714285714,64.7571428571429,65.014,NA,587,553,992,0,0,1085,34,93
2017,47,22,"Bingol",38.8848,40.4933,10.5714285714286,2,5.47142857142857,72.5142857142857,32.7814285714286,NA,418,165,389,0,0,804,253,415
2017,48,22,"Bingol",38.8848,40.4933,8.61428571428571,2.24285714285714,4.24285714285714,76.6285714285714,44.4285714285714,NA,386,267,437,0,0,619,119,182
2017,49,22,"Bingol",38.8848,40.4933,10.6714285714286,-0.5,0.8,72.2285714285714,46.1428571428571,NA,407,253,456,0,0,645,154,189
2017,50,22,"Bingol",38.8848,40.4933,9.01428571428571,-0.771428571428571,0.285714285714286,70.8285714285714,54.4871428571429,NA,346,298,287,0,0,442,48,155
2017,51,22,"Bingol",38.8848,40.4933,9.05714285714286,4.28571428571429,4.5,86.8142857142857,77.6328571428571,NA,386,246,211,10,3,349,140,138
2017,52,22,"Bingol",38.8848,40.4933,9.875,2.575,2.3875,72.2875,42.81625,NA,528,505,486,0,0,507,23,21
2018,1,22,"Bingol",38.8848,40.4933,8.575,1.2875,7.9125,80.8625,31.85,NA,618,333,470,0,0,914,285,444
2018,2,22,"Bingol",38.8848,40.4933,8.4,0.771428571428571,0.285714285714286,70.3285714285714,52.8285714285714,NA,624,507,1077,0,0,1309,117,232
2018,3,22,"Bingol",38.8848,40.4933,12.3285714285714,1.21428571428571,10.1571428571429,79.7,24.5957142857143,NA,639,433,526,0,0,655,206,129
2018,4,22,"Bingol",38.8848,40.4933,12.6571428571429,2.4,10.9142857142857,79.4857142857143,45.6528571428571,NA,604,341,486,0,0,764,263,278
2018,5,22,"Bingol",38.8848,40.4933,10.9428571428571,0.0857142857142857,0.0571428571428571,63.7,31.6528571428571,NA,670,541,590,0,0,819,129,229
2018,6,22,"Bingol",38.8848,40.4933,10.7428571428571,4.25714285714286,0.0285714285714286,60.0285714285714,60.6942857142857,NA,704,571,752,0,0,1022,133,270
2018,7,22,"Bingol",38.8848,40.4933,8.88571428571429,5.37142857142857,6.4,73.8285714285714,41.1171428571429,NA,478,382,435,0,0,557,96,122
2018,8,22,"Bingol",38.8848,40.4933,9.85714285714286,4.74285714285714,1.9,70.8714285714286,29.16,NA,711,582,1112,2,12,1321,129,209
2018,9,22,"Bingol",38.8848,40.4933,9.1,4.88571428571429,3.94285714285714,80.6428571428571,34.1285714285714,NA,621,265,436,8,7,956,356,520
2018,10,22,"Bingol",38.8848,40.4933,11.6,7.84285714285714,4.6,67.5428571428571,59.1128571428571,NA,556,271,692,0,0,1330,285,638
2018,11,22,"Bingol",38.8848,40.4933,10.0428571428571,9.12857142857143,0.657142857142857,61.3571428571429,31.6685714285714,NA,551,183,408,1,0,1426,368,1018
2018,12,22,"Bingol",38.8848,40.4933,12.5571428571429,12.4285714285714,0.0428571428571429,50.6571428571429,90.9085714285714,NA,425,44,359,0,0,1187,381,828
2018,13,22,"Bingol",38.8848,40.4933,9.9,10.6285714285714,1.88571428571429,61.9714285714286,78.63,NA,356,162,232,0,0,428,194,196
2018,14,22,"Bingol",38.8848,40.4933,11.1285714285714,11.7714285714286,0.0428571428571429,41.1142857142857,23.4628571428571,NA,407,251,365,57,49,486,156,121
2018,15,22,"Bingol",38.8848,40.4933,12.8428571428571,13.5428571428571,1.91428571428571,53.5857142857143,36.6314285714286,NA,374,242,301,4,23,450,132,149
2018,16,22,"Bingol",38.8848,40.4933,12.9142857142857,12.1428571428571,0.2,46.3,28.5342857142857,NA,411,219,382,0,0,648,192,266
2018,17,22,"Bingol",38.8848,40.4933,14.6142857142857,14.6428571428571,5.71428571428571,52.5571428571429,32.6957142857143,NA,419,336,516,0,0,652,83,136
2018,18,22,"Bingol",38.8848,40.4933,8.75714285714286,14.8571428571429,0.485714285714286,72,27.8585714285714,NA,303,220,421,0,0,474,83,53
2018,19,22,"Bingol",38.8848,40.4933,6.54285714285714,11.8,13.7285714285714,83.8285714285714,22.1857142857143,NA,275,93,266,0,0,467,182,201
2018,20,22,"Bingol",38.8848,40.4933,9.48571428571429,16.2857142857143,3.45714285714286,65.3857142857143,22.8442857142857,NA,204,145,161,0,0,306,59,145
2018,21,22,"Bingol",38.8848,40.4933,9.25714285714286,18.0142857142857,1.3,63.0571428571429,50.6485714285714,NA,252,156,154,0,0,281,96,127
2018,22,22,"Bingol",38.8848,40.4933,11.4,17.0285714285714,4.94285714285714,67.2571428571429,36.3485714285714,NA,249,164,234,0,0,427,85,193
2018,23,22,"Bingol",38.8848,40.4933,11.1142857142857,19.6142857142857,0.371428571428571,53.4428571428571,21.5428571428571,NA,267,128,430,0,0,812,139,382
2018,24,22,"Bingol",38.8848,40.4933,15.8,19.9142857142857,1.15714285714286,56.8,46.2771428571429,NA,267,185,251,0,0,448,82,197
2018,25,22,"Bingol",38.8848,40.4933,9.07142857142857,21.1142857142857,1.2,52.5857142857143,28.1728571428571,NA,358,201,279,0,0,518,157,239
2018,26,22,"Bingol",38.8848,40.4933,10.2714285714286,25.8714285714286,0,36.3,44.5183333333333,NA,355,242,414,0,0,587,113,173
2018,27,22,"Bingol",38.8848,40.4933,8.31428571428571,26.9428571428571,0,33.1857142857143,50.4885714285714,NA,342,160,232,6,16,418,182,186
2018,28,22,"Bingol",38.8848,40.4933,7.94285714285714,27.0571428571429,0.0571428571428571,33.0428571428571,50.3528571428571,NA,286,180,430,0,0,585,106,155
2018,29,22,"Bingol",38.8848,40.4933,12.4571428571429,24.8857142857143,0.571428571428572,36.4285714285714,27.6985714285714,NA,260,38,76,1,1,756,222,680
2018,30,22,"Bingol",38.8848,40.4933,9.2,25.9,0.285714285714286,26.4571428571429,46.19,NA,265,126,295,0,0,822,139,527
2018,31,22,"Bingol",38.8848,40.4933,9.72857142857143,26.8571428571429,0,36.6714285714286,39.11,NA,267,52,149,1,0,499,215,350
2018,32,22,"Bingol",38.8848,40.4933,10.5,26.4857142857143,0,34,29.04,NA,297,67,134,5,11,403,230,269
2018,33,22,"Bingol",38.8848,40.4933,14.0428571428571,26.6285714285714,0,29.8571428571429,37.3771428571429,NA,216,62,101,1,0,332,154,231
2018,34,22,"Bingol",38.8848,40.4933,8.97142857142857,26.6428571428571,0,29.8714285714286,35.3528571428571,NA,144,99,142,0,0,227,45,85
2018,35,22,"Bingol",38.8848,40.4933,8.61428571428571,26.1857142857143,0,28.3285714285714,51.062,NA,201,87,108,0,0,314,114,206
2018,36,22,"Bingol",38.8848,40.4933,9.58571428571429,23.3714285714286,0.8,38.3,65.5483333333333,NA,341,167,155,0,0,370,174,215
2018,37,22,"Bingol",38.8848,40.4933,8.88571428571429,20.2285714285714,0.785714285714286,45.1285714285714,55.19,NA,241,94,158,0,0,419,147,261
2018,38,22,"Bingol",38.8848,40.4933,13.8571428571429,20.7142857142857,0.0714285714285714,33.6285714285714,36.3,NA,189,85,77,0,0,344,104,267
2018,39,22,"Bingol",38.8848,40.4933,7.7,20.4857142857143,0,30.6285714285714,43.94,NA,180,144,184,0,0,353,36,169
2018,40,22,"Bingol",38.8848,40.4933,13.2428571428571,17.9,0.171428571428571,40.0857142857143,47.83,NA,191,118,183,5,22,341,73,158
2018,41,22,"Bingol",38.8848,40.4933,9.45714285714286,16.9857142857143,1.3,54.7,93.7285714285714,NA,187,125,310,0,0,422,62,112
2018,42,22,"Bingol",38.8848,40.4933,8.34285714285714,15.7571428571429,1.62857142857143,57.3285714285714,123.945714285714,NA,168,157,375,0,0,381,11,6
2018,43,22,"Bingol",38.8848,40.4933,13.0285714285714,10.5142857142857,11.2571428571429,79.6714285714286,49.6857142857143,NA,187,13,46,34,35,402,174,356
2018,44,22,"Bingol",38.8848,40.4933,13.3285714285714,10.8714285714286,0.142857142857143,53.6,30.7985714285714,NA,196,170,183,0,0,264,26,81
2018,45,22,"Bingol",38.8848,40.4933,8.71428571428571,8.28571428571428,1.57142857142857,70.5714285714286,29.5771428571429,NA,231,195,315,0,0,473,36,158
2018,46,22,"Bingol",38.8848,40.4933,7.67142857142857,4.6,4.68571428571429,75.1428571428571,38.8471428571429,NA,230,150,308,12,29,465,80,157
2018,47,22,"Bingol",38.8848,40.4933,8.2,5.02857142857143,1.64285714285714,81.6714285714286,39.862,NA,270,211,240,0,0,499,59,259
2018,48,22,"Bingol",38.8848,40.4933,7.01428571428571,5.62857142857143,14.9857142857143,90.3571428571429,31.2628571428571,NA,245,82,59,0,0,201,163,142
2018,49,22,"Bingol",38.8848,40.4933,8.1,4.27142857142857,6.31428571428571,86.3285714285714,35.4142857142857,NA,257,255,418,0,0,420,2,2
2018,50,22,"Bingol",38.8848,40.4933,11.4857142857143,3.34285714285714,20.6714285714286,84.9142857142857,28.8671428571429,NA,256,127,124,6,5,305,129,181
2018,51,22,"Bingol",38.8848,40.4933,7.94285714285714,2.88571428571429,3.21428571428571,85.9857142857143,47.07,NA,250,185,74,0,0,248,65,174
2018,52,22,"Bingol",38.8848,40.4933,10.2,-0.671428571428571,8.47142857142857,86.9571428571429,42.078,NA,244,131,165,8,30,273,113,108
2019,1,22,"Bingol",38.8848,40.4933,8.025,1.3875,5.3375,85.025,58.325,NA,343,133,237,0,0,784,210,547
2019,2,22,"Bingol",38.8848,40.4933,11.2285714285714,-4.6,13.7,80.4857142857143,36.2328571428571,NA,255,126,79,0,0,208,129,129
2019,3,22,"Bingol",38.8848,40.4933,13.1285714285714,-3.08571428571429,7.47142857142857,77.8,57.8185714285714,NA,192,94,96,5,3,198,98,102
2019,4,22,"Bingol",38.8848,40.4933,9.12857142857143,-1.4,2.78571428571429,81.5571428571428,85.0025,NA,308,211,247,0,0,314,97,67
2019,5,22,"Bingol",38.8848,40.4933,9.87142857142857,1.44285714285714,3.17142857142857,77.5857142857143,NA,NA,253,100,21,10,19,143,153,122
2019,6,22,"Bingol",38.8848,40.4933,10.2285714285714,-0.4,4.3,79.0428571428571,NA,NA,276,233,94,0,0,127,43,33
2019,7,22,"Bingol",38.8848,40.4933,12.1,-0.214285714285714,4.68571428571429,77.2714285714286,42.325,NA,325,284,95,0,0,234,41,139
2019,8,22,"Bingol",38.8848,40.4933,8.71428571428571,-0.1,0.157142857142857,68.0571428571428,52.7785714285714,NA,305,211,163,0,0,219,94,56
2019,9,22,"Bingol",38.8848,40.4933,8.04285714285714,0.142857142857143,5.61428571428571,76.3571428571429,34.4428571428571,NA,331,161,171,32,19,310,170,139
2019,10,22,"Bingol",38.8848,40.4933,15.3428571428571,3.77142857142857,0.771428571428571,68.1285714285714,27.12,NA,359,300,169,0,0,252,59,83
2019,11,22,"Bingol",38.8848,40.4933,11.2285714285714,4.94285714285714,5.94285714285714,77.5714285714286,30.9071428571429,NA,373,128,172,8,28,400,245,228
2019,12,22,"Bingol",38.8848,40.4933,9.52857142857143,4.57142857142857,0.171428571428571,51.8571428571429,18.9771428571429,NA,343,172,53,53,25,416,171,363
2019,13,22,"Bingol",38.8848,40.4933,15.9,5.31428571428571,10.5714285714286,82.4285714285714,14.4871428571429,NA,256,105,60,0,0,194,151,134
2019,14,22,"Bingol",38.8848,40.4933,7.34285714285714,6.82857142857143,2.32857142857143,80.9285714285714,20.6785714285714,NA,365,159,130,0,0,208,206,78
2019,15,22,"Bingol",38.8848,40.4933,7.18571428571429,9.77142857142857,7.5,67.6428571428571,22.5185714285714,NA,359,216,114,0,0,183,143,69
2019,16,22,"Bingol",38.8848,40.4933,7.12857142857143,6.41428571428571,12.4285714285714,84.4571428571429,37.92,NA,318,103,76,0,0,208,215,132
2019,17,22,"Bingol",38.8848,40.4933,8.14285714285714,9.2,0.542857142857143,53.3142857142857,19.6466666666667,NA,412,198,164,0,0,313,214,149
2019,18,22,"Bingol",38.8848,40.4933,10.8714285714286,11.8428571428571,11.1428571428571,74,26.6414285714286,NA,523,97,36,0,0,353,426,317
2019,19,22,"Bingol",38.8848,40.4933,10.2428571428571,14.4857142857143,1,59.5428571428571,25.06,NA,452,14,36,0,0,386,438,350
2019,20,22,"Bingol",38.8848,40.4933,7.84285714285714,19.0857142857143,0.0142857142857143,46.6857142857143,27.95,NA,454,359,297,0,0,389,95,92
2019,21,22,"Bingol",38.8848,40.4933,8.77142857142857,19.1142857142857,0.0285714285714286,47.5142857142857,36.56,NA,457,277,298,1,5,413,180,115
2019,22,22,"Bingol",38.8848,40.4933,10.5428571428571,21.4,0.185714285714286,39.4714285714286,25.3442857142857,NA,453,359,209,0,0,323,94,114
2019,23,22,"Bingol",38.8848,40.4933,8.37142857142857,22.6,0.0142857142857143,37.8285714285714,49.51,NA,378,109,202,0,0,532,269,330
2019,24,22,"Bingol",38.8848,40.4933,9.3,22.5,0.171428571428571,39.8285714285714,36.608,NA,378,183,142,0,0,244,195,102
2019,25,22,"Bingol",38.8848,40.4933,8.47142857142857,23.3428571428571,0.0571428571428571,41.6571428571429,35.6814285714286,NA,306,91,70,0,0,325,215,255
2019,26,22,"Bingol",38.8848,40.4933,10.2,25.8428571428571,0,36.6714285714286,33.124,NA,377,211,132,4,1,342,166,210
2019,27,22,"Bingol",38.8848,40.4933,16.2,23.8571428571429,0,33.8285714285714,35.4183333333333,NA,456,310,172,0,0,222,146,50
2019,28,22,"Bingol",38.8848,40.4933,9.2,24.8,0.0714285714285714,34.7142857142857,28.98,NA,398,78,155,65,39,421,320,266
2019,29,22,"Bingol",38.8848,40.4933,10.9142857142857,25.0285714285714,0,33.1142857142857,38.7228571428571,NA,453,212,124,0,0,203,241,79
2019,30,22,"Bingol",38.8848,40.4933,11.2428571428571,26.1,0,32.7428571428571,39.0057142857143,NA,456,64,29,6,1,335,392,306
2019,31,22,"Bingol",38.8848,40.4933,9.85714285714286,27,0,27.1428571428571,38.2142857142857,NA,334,89,113,4,1,375,245,262
2019,32,22,"Bingol",38.8848,40.4933,11.7857142857143,25.3857142857143,0,33.5571428571429,42.1542857142857,NA,346,127,112,1,1,395,219,283
2019,33,22,"Bingol",38.8848,40.4933,10.8142857142857,27.4285714285714,0,26.1428571428571,49.8157142857143,NA,337,220,344,0,0,531,117,187
2019,34,22,"Bingol",38.8848,40.4933,7.85714285714286,25.5428571428571,0,31.4857142857143,50.7271428571429,NA,299,178,178,0,0,345,121,167
2019,35,22,"Bingol",38.8848,40.4933,9.91428571428571,24.2142857142857,0.714285714285714,37.0285714285714,37.9785714285714,NA,307,234,305,0,0,415,73,110
2019,36,22,"Bingol",38.8848,40.4933,10.5857142857143,22.2428571428571,0,32.3571428571429,32.966,NA,171,56,16,0,0,67,115,51
2019,37,22,"Bingol",38.8848,40.4933,10.7714285714286,20.5142857142857,0.171428571428571,34.5857142857143,38.0357142857143,NA,218,203,47,0,0,55,15,8
2019,38,22,"Bingol",38.8848,40.4933,10.9,18.9571428571429,0.0857142857142857,38.1857142857143,46.9157142857143,NA,266,123,25,0,0,91,143,66
2019,39,22,"Bingol",38.8848,40.4933,9.6,18.4714285714286,0,34.2428571428571,44.4042857142857,NA,237,36,11,1,0,79,201,68
2019,40,22,"Bingol",38.8848,40.4933,9.05714285714286,18.6,0.142857142857143,33.5428571428571,60.2033333333333,NA,241,138,56,0,0,111,103,55
2019,41,22,"Bingol",38.8848,40.4933,8.41428571428571,18,0.0285714285714286,42.9142857142857,56.5485714285714,NA,416,245,338,6,6,448,171,110
2019,42,22,"Bingol",38.8848,40.4933,7.11428571428571,15.6428571428571,2.57142857142857,42.9571428571429,42.9857142857143,NA,356,341,389,0,0,408,15,19
2019,43,22,"Bingol",38.8848,40.4933,8.52857142857143,12.5285714285714,0.385714285714286,63.7571428571429,27.1157142857143,NA,306,281,271,0,0,300,25,29
2019,44,22,"Bingol",38.8848,40.4933,7.77142857142857,8.9,3.4,69.7285714285714,28.9028571428571,NA,350,190,153,42,33,250,160,97
2019,45,22,"Bingol",38.8848,40.4933,7.25714285714286,8.27142857142857,0,54.6857142857143,33.5771428571429,NA,417,409,312,0,0,328,8,16
2019,46,22,"Bingol",38.8848,40.4933,8.22857142857143,8,0,44.0285714285714,45.3866666666667,NA,401,385,316,0,0,337,16,21
2019,47,22,"Bingol",38.8848,40.4933,7.97142857142857,4.5,0,43.0714285714286,50.202,NA,391,321,318,0,0,339,70,21
2019,48,22,"Bingol",38.8848,40.4933,7.72857142857143,5.1,4.71428571428571,78.0714285714286,48.1285714285714,NA,320,225,123,0,0,251,95,128
2019,49,22,"Bingol",38.8848,40.4933,8.7,1.31428571428571,7.84285714285714,76.8571428571429,36.072,NA,393,312,204,0,0,274,81,70
2019,50,22,"Bingol",38.8848,40.4933,5.58571428571429,2.54285714285714,4.31428571428571,89.6714285714286,46.97,NA,218,170,108,0,0,119,48,11
2019,51,22,"Bingol",38.8848,40.4933,8.37142857142857,2.91428571428571,0,64.6142857142857,43.75,NA,361,347,475,0,0,488,14,13
2019,52,22,"Bingol",38.8848,40.4933,9.01428571428571,3.12857142857143,9.87142857142857,78.0428571428571,54.1814285714286,NA,279,102,109,0,0,281,177,172
2020,1,22,"Bingol",38.8848,40.4933,8.12,-0.2,2.9,84.72,43.056,NA,160,148,123,0,0,126,12,3
2020,2,22,"Bingol",38.8848,40.4933,9.72857142857143,-0.928571428571428,1.97142857142857,74.2714285714286,39.5828571428571,NA,240,122,91,0,0,173,118,82
2020,3,22,"Bingol",38.8848,40.4933,10.4714285714286,-2.95714285714286,0.157142857142857,60.2571428571429,35.1214285714286,NA,270,220,309,0,0,382,50,73
2020,4,22,"Bingol",38.8848,40.4933,12.1571428571429,-2.77142857142857,0.285714285714286,61.3142857142857,32.1928571428571,NA,358,260,237,0,0,295,98,58
2020,5,22,"Bingol",38.8848,40.4933,9.65714285714286,-0.785714285714286,10.0142857142857,68.7142857142857,50.55,NA,331,167,170,6,4,272,164,102
2020,6,22,"Bingol",38.8848,40.4933,13.0857142857143,-0.457142857142857,6.67142857142857,77.8571428571429,34.9057142857143,NA,343,13,13,36,6,267,330,254
2020,7,22,"Bingol",38.8848,40.4933,9.75714285714286,-6.37142857142857,1.18571428571429,63.7,35.0957142857143,NA,341,244,220,0,0,338,97,118
2020,8,22,"Bingol",38.8848,40.4933,11.6428571428571,3.05714285714286,3.15714285714286,76.4857142857143,50.3971428571429,NA,283,270,171,0,0,187,13,16
2020,9,22,"Bingol",38.8848,40.4933,10.8,2.94285714285714,4.82857142857143,66.8428571428571,29.0228571428571,NA,393,185,249,52,41,528,208,279
2020,10,22,"Bingol",38.8848,40.4933,9.61428571428571,5.54285714285714,0.0285714285714286,55.0857142857143,39.9242857142857,NA,205,162,138,0,0,210,43,72
2020,11,22,"Bingol",38.8848,40.4933,8.17142857142857,8.68571428571429,3.45714285714286,65.1428571428571,51.3357142857143,NA,115,90,87,0,0,94,25,7
2020,12,22,"Bingol",38.8848,40.4933,11.9285714285714,4.41428571428571,21.3714285714286,83.8428571428571,17.0357142857143,NA,117,64,87,0,0,118,53,31
2020,13,22,"Bingol",38.8848,40.4933,9.77142857142857,6.98571428571429,8.24285714285714,76.8,26.8557142857143,NA,136,118,77,0,0,92,18,15
2020,14,22,"Bingol",38.8848,40.4933,9.28571428571428,5.38571428571429,11.6857142857143,80.1857142857143,20.0271428571429,NA,155,84,58,0,0,121,71,63
2020,15,22,"Bingol",38.8848,40.4933,14.5571428571429,9.05714285714286,0.9,61.2571428571429,32.2428571428571,NA,133,92,95,0,0,118,41,23
2020,16,22,"Bingol",38.8848,40.4933,8.27142857142857,11.3,0.471428571428571,53.2714285714286,28.7257142857143,NA,141,56,43,0,0,106,85,63
2020,17,22,"Bingol",38.8848,40.4933,9.44285714285714,11.3571428571429,7.44285714285714,69.0714285714286,30.5942857142857,NA,137,21,46,5,24,123,116,77
2020,18,22,"Bingol",38.8848,40.4933,9.64285714285714,10.3142857142857,4.47142857142857,73.3857142857143,18.3514285714286,NA,146,64,99,0,0,164,82,65
2020,19,22,"Bingol",38.8848,40.4933,11.2285714285714,11.7428571428571,12.3857142857143,75.6428571428571,41.6466666666667,NA,137,39,32,6,12,157,98,125
2020,20,22,"Bingol",38.8848,40.4933,11.6285714285714,16.9142857142857,0,49.2428571428571,55.57,NA,164,95,71,2,5,164,69,93
2020,21,22,"Bingol",38.8848,40.4933,11.4285714285714,18.4428571428571,2.92857142857143,47.0285714285714,49.9657142857143,NA,146,38,13,0,0,96,108,83
2020,22,22,"Bingol",38.8848,40.4933,9.28571428571428,15.7857142857143,0.942857142857143,56.1,28.1057142857143,NA,118,57,66,0,0,100,61,34
2020,23,22,"Bingol",38.8848,40.4933,9.75714285714286,18.1142857142857,0.0142857142857143,45.1571428571429,37.89,NA,112,40,29,0,0,70,72,41
2020,24,22,"Bingol",38.8848,40.4933,11.1857142857143,20.4571428571429,0,43.9,60.5471428571429,NA,140,59,100,0,0,150,81,50
2020,25,22,"Bingol",38.8848,40.4933,10.5857142857143,20,0.242857142857143,49.5285714285714,46.9471428571429,NA,137,79,48,0,0,108,58,60
2020,26,22,"Bingol",38.8848,40.4933,11.6571428571429,22.9142857142857,1.22857142857143,40.9,35.858,NA,173,102,71,0,0,133,71,62
2020,27,22,"Bingol",38.8848,40.4933,16.7714285714286,23.4857142857143,0.1,42.2714285714286,34.498,NA,113,97,108,0,0,113,16,5
2020,28,22,"Bingol",38.8848,40.4933,14.9571428571429,25.1142857142857,0,42.0285714285714,36.715,NA,164,103,98,0,0,122,61,24
2020,29,22,"Bingol",38.8848,40.4933,11.6571428571429,25.5428571428571,0.285714285714286,35.7571428571429,24.72,NA,186,122,34,0,0,111,64,77
2020,30,22,"Bingol",38.8848,40.4933,15.4428571428571,27.3714285714286,0,29.9714285714286,NA,NA,190,96,33,0,0,142,94,109
2020,31,22,"Bingol",38.8848,40.4933,13.7,26.5,0.3,36.8857142857143,49.95,NA,150,64,53,0,0,127,86,74
2020,32,22,"Bingol",38.8848,40.4933,16.3428571428571,26.1285714285714,0,28.7714285714286,NA,NA,146,99,45,0,0,107,47,62
2020,33,22,"Bingol",38.8848,40.4933,15.2285714285714,25.0142857142857,0,35.1,NA,NA,183,4,1,2,0,83,179,82
2020,34,22,"Bingol",38.8848,40.4933,13.1714285714286,23.9428571428571,0.142857142857143,33.3571428571429,37.355,NA,197,106,40,0,0,97,91,57
2020,35,22,"Bingol",38.8848,40.4933,13.6857142857143,23.3142857142857,0,26.7285714285714,25.882,NA,164,99,79,0,0,157,65,78
2020,36,22,"Bingol",38.8848,40.4933,9.35714285714286,24.7857142857143,0,25.0714285714286,61.2066666666667,NA,179,118,74,0,0,112,61,38
2020,37,22,"Bingol",38.8848,40.4933,10.7571428571429,23.7,0,30.6714285714286,75.78,NA,193,92,35,0,0,91,101,56
2020,38,22,"Bingol",38.8848,40.4933,8.7,22.8142857142857,0,27.3,53.4857142857143,NA,235,166,114,0,0,157,69,43
2020,39,22,"Bingol",38.8848,40.4933,7.87142857142857,20.4285714285714,0.171428571428571,37.2142857142857,50.31,NA,220,127,70,0,0,129,93,59
2020,40,22,"Bingol",38.8848,40.4933,10.0857142857143,19.0857142857143,0,36.6,51.7028571428571,NA,187,99,74,0,0,154,88,80
2020,41,22,"Bingol",38.8848,40.4933,11.4857142857143,15.5,0,35.2428571428571,35.1642857142857,NA,182,148,101,0,0,127,34,26
2020,42,22,"Bingol",38.8848,40.4933,7.72857142857143,16.9714285714286,0,30.1571428571429,48.0014285714286,NA,177,169,106,0,0,111,8,5
2020,43,22,"Bingol",38.8848,40.4933,7.01428571428571,15.2285714285714,0,38.2714285714286,44.8,NA,194,178,160,0,0,161,16,1
2020,44,22,"Bingol",38.8848,40.4933,7.61428571428571,15.3428571428571,0.0857142857142857,32.4714285714286,65.3171428571429,NA,255,168,196,0,0,233,87,37
2020,45,22,"Bingol",38.8848,40.4933,11.7571428571429,10.8428571428571,6.38571428571429,73.8857142857143,54.2514285714286,NA,156,102,71,1,0,103,54,32
2020,46,22,"Bingol",38.8848,40.4933,8.6,8.05714285714286,0,57.5714285714286,27.9228571428571,NA,208,151,83,0,0,109,57,26
2020,47,22,"Bingol",38.8848,40.4933,7.77142857142857,5.18571428571429,1.14285714285714,66.6428571428571,28.7371428571429,NA,173,145,63,0,0,83,28,20
2020,48,22,"Bingol",38.8848,40.4933,9.71428571428571,4,0.128571428571429,55.2428571428571,23.1557142857143,NA,199,137,169,1,1,262,62,93
2020,49,22,"Bingol",38.8848,40.4933,7.71428571428571,3.92857142857143,0.628571428571429,75.0714285714286,31.7057142857143,NA,207,174,101,0,0,116,33,15
2020,50,22,"Bingol",38.8848,40.4933,8.45714285714286,2.11428571428571,1.6,77.1428571428571,34.7628571428571,NA,181,127,50,0,0,98,54,48
2020,51,22,"Bingol",38.8848,40.4933,7.81428571428571,2.85714285714286,2.34285714285714,79.7571428571429,25.7014285714286,NA,171,129,75,0,0,90,42,15
2020,52,22,"Bingol",38.8848,40.4933,8.5,-1.51428571428571,1.67142857142857,68.8857142857143,23.2157142857143,NA,203,155,76,19,25,113,48,37
2020,53,22,"Bingol",38.8848,40.4933,10.8,0.45,0,62.975,29.065,NA,122,120,109,0,0,111,2,2
2017,1,23,"Bitlis",38.393,42.123,5.81428571428571,-4.77142857142857,0.617142857142857,79.5428571428571,38.042,NA,563,38,27,77,127,847,525,820
2017,2,23,"Bitlis",38.393,42.123,8.81428571428571,-5.04285714285714,0.442857142857143,76.7142857142857,36.2233333333333,NA,757,317,457,115,174,1214,440,757
2017,3,23,"Bitlis",38.393,42.123,6.5,-4.52857142857143,0.0714285714285714,75,38.9457142857143,NA,762,509,903,0,0,1449,253,546
2017,4,23,"Bitlis",38.393,42.123,10.9142857142857,-6.12857142857143,7.39171428571429,79.9857142857143,18.1185714285714,NA,639,294,469,173,221,889,345,420
2017,5,23,"Bitlis",38.393,42.123,9.67142857142857,-8.1,2.56457142857143,74.6857142857143,23.0771428571429,NA,588,112,130,153,366,1163,476,1033
2017,6,23,"Bitlis",38.393,42.123,7.6,-3.35714285714286,0.576714285714286,83.4,38.4085714285714,NA,736,338,621,0,0,1519,398,898
2017,7,23,"Bitlis",38.393,42.123,11.4571428571429,-6.84285714285714,2.81014285714286,71.8571428571429,18.05,NA,492,406,566,70,137,717,86,151
2017,8,23,"Bitlis",38.393,42.123,6.77142857142857,-4.11428571428571,0.0331428571428571,70.4142857142857,34.6514285714286,NA,739,156,444,56,162,1747,583,1303
2017,9,23,"Bitlis",38.393,42.123,6.68571428571429,1.57142857142857,1.89171428571429,82.9,32.2171428571429,NA,574,439,687,0,0,866,135,179
2017,10,23,"Bitlis",38.393,42.123,8.34285714285714,1.98571428571429,1.69885714285714,73.4428571428571,21.7742857142857,NA,712,409,485,95,168,1043,303,558
2017,11,23,"Bitlis",38.393,42.123,13.6,2.31428571428571,10.8745714285714,87.1571428571429,23.3366666666667,NA,525,113,194,132,149,725,412,531
2017,12,23,"Bitlis",38.393,42.123,13.2714285714286,3.24285714285714,2.77014285714286,71.3285714285714,18.89,NA,589,165,265,212,373,1077,424,812
2017,13,23,"Bitlis",38.393,42.123,14.9285714285714,7.95714285714286,3.04657142857143,70.1428571428571,18.16,NA,574,0,0,231,417,887,574,887
2017,14,23,"Bitlis",38.393,42.123,17.4285714285714,7.22857142857143,6.15371428571429,68.4142857142857,18.3833333333333,NA,639,146,318,163,255,1336,493,1018
2017,15,23,"Bitlis",38.393,42.123,14.1714285714286,8.71428571428572,8.04785714285714,71.2714285714286,20.0371428571429,NA,587,71,80,205,430,1187,516,1107
2017,16,23,"Bitlis",38.393,42.123,15.5857142857143,11.8714285714286,3.74757142857143,66.4714285714286,20.9328571428571,NA,717,36,81,440,400,920,681,839
2017,17,23,"Bitlis",38.393,42.123,17.8571428571429,12.0285714285714,0.906285714285714,52.5571428571429,14.3728571428571,NA,731,124,272,129,318,1478,607,1206
2017,18,23,"Bitlis",38.393,42.123,13.2142857142857,12.3142857142857,7.616,74.8714285714286,17.3685714285714,NA,506,16,10,45,94,923,490,913
2017,19,23,"Bitlis",38.393,42.123,16.4428571428571,16.4714285714286,1.14657142857143,56.8857142857143,24.3357142857143,NA,471,8,22,269,536,966,463,944
2017,20,23,"Bitlis",38.393,42.123,18.8714285714286,15.5571428571429,3.91071428571429,59.9714285714286,44.144,NA,472,80,280,49,40,1205,392,925
2017,21,23,"Bitlis",38.393,42.123,17.1142857142857,14.2142857142857,2.03642857142857,62.3571428571429,13.48,NA,448,42,146,194,386,849,406,703
2017,22,23,"Bitlis",38.393,42.123,13.5571428571429,17.6,0,49.0857142857143,17.2542857142857,NA,522,58,92,157,159,1015,464,923
2017,23,23,"Bitlis",38.393,42.123,12.3,21.9142857142857,0,42.7571428571429,22.8771428571429,NA,578,103,234,190,555,1388,475,1154
2017,24,23,"Bitlis",38.393,42.123,14.4,20.6857142857143,0.142857142857143,42.9142857142857,19.4628571428571,NA,552,69,106,344,746,1139,483,1033
2017,25,23,"Bitlis",38.393,42.123,16.0571428571429,20.7285714285714,0.299142857142857,45.3571428571429,16.1614285714286,NA,584,0,0,308,466,1041,584,1041
2017,26,23,"Bitlis",38.393,42.123,15.9285714285714,25.5142857142857,0,35.0714285714286,25.1071428571429,NA,564,382,598,0,0,971,182,373
2017,27,23,"Bitlis",38.393,42.123,11.5857142857143,26.4571428571429,0.0571428571428571,30.6142857142857,29.8028571428571,NA,511,93,167,151,101,642,418,475
2017,28,23,"Bitlis",38.393,42.123,12.9714285714286,26.5142857142857,0,29.2,30.4614285714286,NA,481,112,255,59,74,864,369,609
2017,29,23,"Bitlis",38.393,42.123,14.1142857142857,27.5571428571429,0,22.7142857142857,36.94,NA,532,0,0,381,866,1272,532,1272
2017,30,23,"Bitlis",38.393,42.123,14.8714285714286,27.1714285714286,0,24.1,34,NA,531,70,132,237,309,928,461,796
2017,31,23,"Bitlis",38.393,42.123,15.9285714285714,28.0714285714286,0.119714285714286,24.7,31.8514285714286,NA,559,0,0,238,340,1047,559,1047
2017,32,23,"Bitlis",38.393,42.123,14.4857142857143,28.2571428571429,0,20.3,32.72,NA,567,70,188,226,405,1092,497,904
2017,33,23,"Bitlis",38.393,42.123,13.8142857142857,25.7714285714286,0.0331428571428571,33.1285714285714,32.13,NA,596,77,144,471,880,1199,519,1055
2017,34,23,"Bitlis",38.393,42.123,12.8428571428571,25.4857142857143,0,26.1428571428571,38.1985714285714,NA,601,0,0,340,627,1280,601,1280
2017,35,23,"Bitlis",38.393,42.123,18.9428571428571,24.1428571428571,0,24.8714285714286,37.7242857142857,NA,493,0,0,422,872,1014,493,1014
2017,36,23,"Bitlis",38.393,42.123,12.5571428571429,23.0428571428571,0,23.9428571428571,30.7928571428571,NA,507,88,359,157,400,1321,419,962
2017,37,23,"Bitlis",38.393,42.123,10.3857142857143,23.5857142857143,0,22.5571428571429,32.8371428571429,NA,589,142,231,240,337,1138,447,907
2017,38,23,"Bitlis",38.393,42.123,13.3714285714286,22.6428571428571,0.0142857142857143,27.6,45.8428571428571,NA,671,64,71,360,717,1312,607,1241
2017,39,23,"Bitlis",38.393,42.123,14.0285714285714,18.9857142857143,0,34.5571428571429,42.7971428571429,NA,782,0,0,611,1094,1630,782,1630
2017,40,23,"Bitlis",38.393,42.123,14.1285714285714,13.5428571428571,0.116714285714286,45.9571428571429,15.6871428571429,NA,543,168,316,169,342,1137,375,821
2017,41,23,"Bitlis",38.393,42.123,12.2,13.2857142857143,0.0358571428571429,49.4,22.2071428571429,NA,487,99,97,210,497,843,388,746
2017,42,23,"Bitlis",38.393,42.123,17.0142857142857,11.2285714285714,0,38.1428571428571,16.0771428571429,NA,530,176,305,120,169,815,354,510
2017,43,23,"Bitlis",38.393,42.123,11.7,12.2285714285714,4.20742857142857,47.0142857142857,26.83,NA,506,55,211,317,509,919,451,708
2017,44,23,"Bitlis",38.393,42.123,10.9142857142857,9.01428571428571,4.56471428571429,70.5857142857143,26.3885714285714,NA,561,0,0,349,537,1102,561,1102
2017,45,23,"Bitlis",38.393,42.123,7.95714285714286,9.35714285714286,2.59285714285714,78.1428571428571,29.4333333333333,NA,577,0,0,225,390,829,577,829
2017,46,23,"Bitlis",38.393,42.123,6.88571428571429,7.61428571428571,0.0902857142857143,63.1857142857143,28.06,NA,587,213,460,0,0,1085,374,625
2017,47,23,"Bitlis",38.393,42.123,11.6571428571429,0.642857142857143,5.09271428571429,79.7714285714286,19.18,NA,418,18,113,193,355,804,400,691
2017,48,23,"Bitlis",38.393,42.123,8.55714285714286,2.11428571428571,0.915142857142857,80.2714285714286,24.3014285714286,NA,386,142,192,98,142,619,244,427
2017,49,23,"Bitlis",38.393,42.123,11.0857142857143,-0.542857142857143,2.54171428571429,73.8714285714286,25.1685714285714,NA,407,119,308,31,76,645,288,337
2017,50,23,"Bitlis",38.393,42.123,6.87142857142857,-0.742857142857143,0.104,76.7,25.4957142857143,NA,346,239,319,0,0,442,107,123
2017,51,23,"Bitlis",38.393,42.123,12.1285714285714,4.92857142857143,2.45114285714286,80.2857142857143,30.57,NA,386,0,0,239,193,349,386,349
2017,52,23,"Bitlis",38.393,42.123,8.5125,2.7625,1.307125,76.8375,21.46625,NA,528,40,64,168,99,507,488,443
2018,1,23,"Bitlis",38.393,42.123,9.3875,1.45,4.269,83.75,20.18125,NA,618,36,92,386,514,914,582,822
2018,2,23,"Bitlis",38.393,42.123,8.38571428571429,0.0142857142857143,0.285714285714286,75.1428571428571,28.56,NA,624,371,895,206,349,1309,253,414
2018,3,23,"Bitlis",38.393,42.123,11.4,1,6.27014285714286,85.2285714285714,28.38,NA,639,8,11,41,248,655,631,644
2018,4,23,"Bitlis",38.393,42.123,13.7571428571429,1.85714285714286,2.62942857142857,80.6142857142857,49.2271428571429,NA,604,184,194,198,290,764,420,570
2018,5,23,"Bitlis",38.393,42.123,9.25714285714286,-0.471428571428571,0.2,64.2142857142857,34.5157142857143,NA,670,1,1,363,445,819,669,818
2018,6,23,"Bitlis",38.393,42.123,9.05714285714286,3.35714285714286,0.0714285714285714,63.5,43.5966666666667,NA,704,228,358,244,306,1022,476,664
2018,7,23,"Bitlis",38.393,42.123,11.5285714285714,4.71428571428571,8.36942857142857,77.8714285714286,21.0366666666667,NA,478,45,63,298,311,557,433,494
2018,8,23,"Bitlis",38.393,42.123,9.27142857142857,3.54285714285714,2.86814285714286,80.8,27.1585714285714,NA,711,144,371,179,271,1321,567,950
2018,9,23,"Bitlis",38.393,42.123,11.3142857142857,5.47142857142857,5.91,78.4428571428571,27.7971428571429,NA,621,0,0,500,757,956,621,956
2018,10,23,"Bitlis",38.393,42.123,14.5428571428571,7.65714285714286,2.66157142857143,71.8285714285714,42.6342857142857,NA,556,79,32,261,746,1330,477,1298
2018,11,23,"Bitlis",38.393,42.123,16.7428571428571,8.17142857142857,0.278428571428571,63.5,26.9771428571429,NA,551,0,0,350,583,1426,551,1426
2018,12,23,"Bitlis",38.393,42.123,21.1285714285714,11.8428571428571,1.418,50.5714285714286,67.8366666666667,NA,425,0,0,388,890,1187,425,1187
2018,13,23,"Bitlis",38.393,42.123,13.5857142857143,9.92857142857143,1.78,65.7571428571429,35.5825,NA,356,54,66,172,212,428,302,362
2018,14,23,"Bitlis",38.393,42.123,14.4285714285714,11.3142857142857,0,47.2,20.7271428571429,NA,407,55,191,108,52,486,352,295
2018,15,23,"Bitlis",38.393,42.123,15.8857142857143,11.9,4.98942857142857,64.0285714285714,18.22,NA,374,230,184,55,62,450,144,266
2018,16,23,"Bitlis",38.393,42.123,16.5571428571429,10.4571428571429,0.930857142857143,56.9142857142857,22.74,NA,411,82,86,167,283,648,329,562
2018,17,23,"Bitlis",38.393,42.123,13.7428571428571,12.9428571428571,0.972571428571429,60.2857142857143,19.2333333333333,NA,419,44,41,115,189,652,375,611
2018,18,23,"Bitlis",38.393,42.123,14.4857142857143,14.4142857142857,3.46585714285714,70.4285714285714,16.9842857142857,NA,303,126,77,60,118,474,177,397
2018,19,23,"Bitlis",38.393,42.123,17.1857142857143,11.6,10.7091428571429,81.4571428571429,19.7871428571429,NA,275,9,46,133,253,467,266,421
2018,20,23,"Bitlis",38.393,42.123,10.9857142857143,16.0857142857143,0.829,63.1,19.9314285714286,NA,204,46,24,1,0,306,158,282
2018,21,23,"Bitlis",38.393,42.123,13.6285714285714,17.7571428571429,2.92485714285714,63.8857142857143,34.8214285714286,NA,252,91,78,32,31,281,161,203
2018,22,23,"Bitlis",38.393,42.123,17.1571428571429,17.8142857142857,4.46085714285714,64.2714285714286,26.1442857142857,NA,249,52,116,46,100,427,197,311
2018,23,23,"Bitlis",38.393,42.123,11.9714285714286,19.3285714285714,0.179571428571429,53.6857142857143,16.5728571428571,NA,267,83,317,60,181,812,184,495
2018,24,23,"Bitlis",38.393,42.123,15.1714285714286,19.7,3.19242857142857,57.4285714285714,20.4585714285714,NA,267,72,97,39,37,448,195,351
2018,25,23,"Bitlis",38.393,42.123,12.9714285714286,21.7571428571429,0.0764285714285714,47.4571428571429,25.3142857142857,NA,358,49,135,59,64,518,309,383
2018,26,23,"Bitlis",38.393,42.123,13.4857142857143,25.0857142857143,0,38.3,44.4425,NA,355,32,42,169,257,587,323,545
2018,27,23,"Bitlis",38.393,42.123,16.0285714285714,27.0571428571429,0,32.6285714285714,47.8114285714286,NA,342,57,79,115,102,418,285,339
2018,28,23,"Bitlis",38.393,42.123,14.9571428571429,26.9857142857143,0,31.2571428571429,47.3542857142857,NA,286,0,0,109,195,585,286,585
2018,29,23,"Bitlis",38.393,42.123,14.1714285714286,24.4571428571429,0.377571428571429,38.1,33.48,NA,260,0,0,109,198,756,260,756
2018,30,23,"Bitlis",38.393,42.123,15,25.8142857142857,0,28.1142857142857,37.5385714285714,NA,265,0,0,182,637,822,265,822
2018,31,23,"Bitlis",38.393,42.123,15.8428571428571,26.6428571428571,0.19,35.0428571428571,38.9642857142857,NA,267,0,0,204,313,499,267,499
2018,32,23,"Bitlis",38.393,42.123,12.4571428571429,26.4857142857143,0,30.5285714285714,35.2985714285714,NA,297,0,0,152,175,403,297,403
2018,33,23,"Bitlis",38.393,42.123,14.7142857142857,25.9857142857143,0.0285714285714286,34.3285714285714,36.6085714285714,NA,216,69,50,88,97,332,147,282
2018,34,23,"Bitlis",38.393,42.123,8.77142857142857,25.6,0,32.1857142857143,36.0328571428571,NA,144,15,16,51,77,227,129,211
2018,35,23,"Bitlis",38.393,42.123,10.6857142857143,25.1857142857143,0,30.8428571428571,45.2171428571429,NA,201,0,0,138,163,314,201,314
2018,36,23,"Bitlis",38.393,42.123,15.7142857142857,22.8571428571429,0.263285714285714,36.9,32.9871428571429,NA,341,0,0,261,246,370,341,370
2018,37,23,"Bitlis",38.393,42.123,15.2285714285714,20.7,0.0478571428571429,41.7571428571429,30.7914285714286,NA,241,0,0,138,220,419,241,419
2018,38,23,"Bitlis",38.393,42.123,10.8428571428571,20.5285714285714,0.128571428571429,38.2857142857143,22.9414285714286,NA,189,58,97,42,51,344,131,247
2018,39,23,"Bitlis",38.393,42.123,8.97142857142857,19.9,0,31.6857142857143,26.7128571428571,NA,180,18,14,86,77,353,162,339
2018,40,23,"Bitlis",38.393,42.123,12.3285714285714,18.2285714285714,0.0428571428571429,40.3571428571429,28.0428571428571,NA,191,27,46,94,155,341,164,295
2018,41,23,"Bitlis",38.393,42.123,10.2571428571429,16.4428571428571,0.868714285714286,57.4285714285714,45.2985714285714,NA,187,80,152,12,4,422,107,270
2018,42,23,"Bitlis",38.393,42.123,11.0285714285714,15.0285714285714,0.971,60.7285714285714,37.3442857142857,NA,168,0,0,114,281,381,168,381
2018,43,23,"Bitlis",38.393,42.123,17.9857142857143,10.4571428571429,16.025,80.2571428571429,20.702,NA,187,32,74,59,71,402,155,328
2018,44,23,"Bitlis",38.393,42.123,9.95714285714286,9.92857142857143,0.2,60.4571428571429,10.5214285714286,NA,196,88,104,0,0,264,108,160
2018,45,23,"Bitlis",38.393,42.123,7.14285714285714,8.01428571428571,1.53,77.9714285714286,13.185,NA,231,64,35,13,67,473,167,438
2018,46,23,"Bitlis",38.393,42.123,7.44285714285714,5.65714285714286,6.51285714285714,80.4714285714286,20.5285714285714,NA,230,69,154,92,142,465,161,311
2018,47,23,"Bitlis",38.393,42.123,8.75714285714286,4.92857142857143,2.55957142857143,85.0285714285714,20.1228571428571,NA,270,153,137,51,10,499,117,362
2018,48,23,"Bitlis",38.393,42.123,7.1,5.87142857142857,9.10957142857143,88.7142857142857,24.6514285714286,NA,245,5,12,91,31,201,240,189
2018,49,23,"Bitlis",38.393,42.123,7.38571428571429,3.71428571428571,4.39228571428571,90.7428571428571,22.1985714285714,NA,257,162,252,59,43,420,95,168
2018,50,23,"Bitlis",38.393,42.123,14.4714285714286,2.47142857142857,11.6557142857143,85.5857142857143,19.1714285714286,NA,256,15,47,45,68,305,241,258
2018,51,23,"Bitlis",38.393,42.123,6.42857142857143,2.08571428571429,0.833285714285714,87.4285714285714,21.9014285714286,NA,250,151,96,58,68,248,99,152
2018,52,23,"Bitlis",38.393,42.123,10.1,-0.171428571428571,6.85742857142857,86.8285714285714,16.9733333333333,NA,244,18,23,108,126,273,226,250
2019,1,23,"Bitlis",38.393,42.123,9.8,-0.4,2.519,86.1875,23.94875,NA,343,49,79,19,44,784,294,705
2019,2,23,"Bitlis",38.393,42.123,10.7428571428571,-4.67142857142857,5.85157142857143,78.8571428571429,11.495,NA,255,70,37,46,17,208,185,171
2019,3,23,"Bitlis",38.393,42.123,10.2142857142857,-4.14285714285714,2.69157142857143,83.7428571428571,NA,NA,192,92,93,40,10,198,100,105
2019,4,23,"Bitlis",38.393,42.123,7,-1.81428571428571,0.959714285714286,80.6285714285714,NA,NA,308,139,107,42,4,314,169,207
2019,5,23,"Bitlis",38.393,42.123,8.51428571428571,0.114285714285714,12.4154285714286,87.2142857142857,NA,NA,253,84,24,2,0,143,169,119
2019,6,23,"Bitlis",38.393,42.123,7.41428571428571,-1.87142857142857,2.75714285714286,83.1,NA,NA,276,218,85,33,17,127,58,42
2019,7,23,"Bitlis",38.393,42.123,6.92857142857143,-0.3,2.96842857142857,80.4857142857143,NA,NA,325,241,85,60,10,234,84,149
2019,8,23,"Bitlis",38.393,42.123,6.52857142857143,-2.35714285714286,0.376142857142857,74.8,NA,NA,305,168,99,36,15,219,137,120
2019,9,23,"Bitlis",38.393,42.123,10.4285714285714,-0.357142857142857,8.50071428571429,81.4857142857143,NA,NA,331,66,42,68,85,310,265,268
2019,10,23,"Bitlis",38.393,42.123,10.7714285714286,2.68571428571429,1.96485714285714,75.8285714285714,NA,NA,359,91,46,97,33,252,268,206
2019,11,23,"Bitlis",38.393,42.123,14.4714285714286,3.57142857142857,4.74371428571429,79.9,NA,NA,373,69,129,143,119,400,304,271
2019,12,23,"Bitlis",38.393,42.123,15.7428571428571,3.57142857142857,6.85657142857143,65.2428571428571,NA,NA,343,42,10,108,65,416,301,406
2019,13,23,"Bitlis",38.393,42.123,11.0714285714286,5.05714285714286,10.4952857142857,87.4857142857143,NA,NA,256,61,20,36,24,194,195,174
2019,14,23,"Bitlis",38.393,42.123,11.5,7.05714285714286,3.49771428571429,80.4428571428572,NA,NA,365,135,74,48,30,208,230,134
2019,15,23,"Bitlis",38.393,42.123,13.0571428571429,9.84285714285714,3.55157142857143,69.4,NA,NA,359,44,9,103,43,183,315,174
2019,16,23,"Bitlis",38.393,42.123,17.0571428571429,7.21428571428571,11.433,80.7,NA,NA,318,6,13,88,71,208,312,195
2019,17,23,"Bitlis",38.393,42.123,10.4714285714286,8.32857142857143,2.647,60.2142857142857,NA,NA,412,184,104,127,103,313,228,209
2019,18,23,"Bitlis",38.393,42.123,16.5857142857143,12,11.9348571428571,72.4428571428571,NA,NA,523,0,0,261,254,353,523,353
2019,19,23,"Bitlis",38.393,42.123,13.3714285714286,14.4,0.890142857142857,61.8857142857143,14.75,NA,452,0,0,271,224,386,452,386
2019,20,23,"Bitlis",38.393,42.123,10.4142857142857,19,0.012,48.7142857142857,13.2685714285714,NA,454,71,56,94,110,389,383,333
2019,21,23,"Bitlis",38.393,42.123,15.6285714285714,18.9142857142857,0.012,52.4285714285714,20.9266666666667,NA,457,0,0,276,206,413,457,413
2019,22,23,"Bitlis",38.393,42.123,9.65714285714286,20.9,0.0345714285714286,42.9285714285714,10.02,NA,453,231,192,9,7,323,222,131
2019,23,23,"Bitlis",38.393,42.123,11.3857142857143,23.6285714285714,0,39.5285714285714,20.0014285714286,NA,378,59,121,198,264,532,319,411
2019,24,23,"Bitlis",38.393,42.123,15.4428571428571,22.4142857142857,0.367,44.2,14.1428571428571,NA,378,53,41,148,71,244,325,203
2019,25,23,"Bitlis",38.393,42.123,16.3428571428571,23.5428571428571,0.289428571428571,40.7285714285714,17.0028571428571,NA,306,0,0,163,150,325,306,325
2019,26,23,"Bitlis",38.393,42.123,13.9428571428571,26.3857142857143,0,33.6428571428571,22.26,NA,377,53,56,112,55,342,324,286
2019,27,23,"Bitlis",38.393,42.123,15.6142857142857,24.9,0.006,31.3285714285714,18.0371428571429,NA,456,306,163,65,28,222,150,59
2019,28,23,"Bitlis",38.393,42.123,17.2571428571429,25.2714285714286,0.0345714285714286,35.2714285714286,14.3928571428571,NA,398,80,100,210,207,421,318,321
2019,29,23,"Bitlis",38.393,42.123,15.4285714285714,25.4714285714286,0,33.2857142857143,23.3328571428571,NA,453,62,8,357,124,203,391,195
2019,30,23,"Bitlis",38.393,42.123,14.8428571428571,27,0,29,26.3571428571429,NA,456,0,0,354,286,335,456,335
2019,31,23,"Bitlis",38.393,42.123,13.8,27.6285714285714,0,25,28.9671428571429,NA,334,0,0,288,322,375,334,375
2019,32,23,"Bitlis",38.393,42.123,15.5714285714286,26.8571428571429,0,29.2857142857143,26.4042857142857,NA,346,151,173,5,22,395,195,222
2019,33,23,"Bitlis",38.393,42.123,15.2428571428571,28.1285714285714,0,28.3142857142857,25.9642857142857,NA,337,36,53,161,318,531,301,478
2019,34,23,"Bitlis",38.393,42.123,16.0714285714286,26.1,0,29.3285714285714,27.9385714285714,NA,299,0,0,238,253,345,299,345
2019,35,23,"Bitlis",38.393,42.123,18.1428571428571,24.6571428571429,0.479142857142857,33.9285714285714,21.6957142857143,NA,307,149,171,95,157,415,158,244
2019,36,23,"Bitlis",38.393,42.123,13.0714285714286,23.4285714285714,0,31.3142857142857,25.1942857142857,NA,171,24,3,133,32,67,147,64
2019,37,23,"Bitlis",38.393,42.123,10.8428571428571,20.7857142857143,0.0142857142857143,38.9285714285714,13.9614285714286,NA,218,118,13,37,14,55,100,42
2019,38,23,"Bitlis",38.393,42.123,16.7857142857143,20.3571428571429,0,35.6,22.5757142857143,NA,266,8,2,146,44,91,258,89
2019,39,23,"Bitlis",38.393,42.123,15.4285714285714,19.1428571428571,0,32.2142857142857,22.9585714285714,NA,237,0,0,175,57,79,237,79
2019,40,23,"Bitlis",38.393,42.123,13.6,18.8,0.1,34.0714285714286,26.95,NA,241,0,0,232,106,111,241,111
2019,41,23,"Bitlis",38.393,42.123,14.6428571428571,18.6857142857143,0,39.5571428571429,24.8214285714286,NA,416,58,67,100,52,448,358,381
2019,42,23,"Bitlis",38.393,42.123,7.74285714285714,15.7857142857143,1.02328571428571,43.4714285714286,16.93,NA,356,129,142,99,117,408,227,266
2019,43,23,"Bitlis",38.393,42.123,9.77142857142857,12.3285714285714,0.794857142857143,69.5428571428571,15.2457142857143,NA,306,79,99,62,57,300,227,201
2019,44,23,"Bitlis",38.393,42.123,9.64285714285714,9.34285714285714,7.99514285714286,76.7,13.6328571428571,NA,350,78,51,106,50,250,272,199
2019,45,23,"Bitlis",38.393,42.123,6.6,8.14285714285714,0,63.1285714285714,18.5042857142857,NA,417,337,216,0,0,328,80,112
2019,46,23,"Bitlis",38.393,42.123,8.71428571428572,7.64285714285714,0,54.2714285714286,18.5942857142857,NA,401,307,270,0,0,337,94,67
2019,47,23,"Bitlis",38.393,42.123,7.55714285714286,4.17142857142857,0,45.4428571428571,26.4757142857143,NA,391,70,78,103,106,339,321,261
2019,48,23,"Bitlis",38.393,42.123,8.72857142857143,5.2,4.09985714285714,76.9857142857143,28.2585714285714,NA,320,0,0,119,69,251,320,251
2019,49,23,"Bitlis",38.393,42.123,9.6,3.07142857142857,2.96657142857143,85.0428571428571,16.2285714285714,NA,393,78,34,22,10,274,315,240
2019,50,23,"Bitlis",38.393,42.123,6.85714285714286,2.87142857142857,3.28271428571429,92.3428571428571,31.1814285714286,NA,218,0,0,59,14,119,218,119
2019,51,23,"Bitlis",38.393,42.123,8.38571428571429,3.14285714285714,0,73.8428571428571,16.22,NA,361,209,280,1,0,488,152,208
2019,52,23,"Bitlis",38.393,42.123,13.3428571428571,3.24285714285714,3.12942857142857,76.1,31.3985714285714,NA,279,2,1,112,94,281,277,280
2020,1,23,"Bitlis",38.393,42.123,7.58,-0.48,2.2016,90.64,20.226,NA,160,82,41,0,0,126,78,85
2020,2,23,"Bitlis",38.393,42.123,8.01428571428571,-2.75714285714286,0.543714285714286,85.1857142857143,19.6,NA,240,165,133,0,0,173,75,40
2020,3,23,"Bitlis",38.393,42.123,8.5,-4.55714285714286,1.40757142857143,81.6142857142857,21.7671428571429,NA,270,264,381,0,0,382,6,1
2020,4,23,"Bitlis",38.393,42.123,9.98571428571429,-4.5,3.68085714285714,77.9,18.302,NA,358,278,239,0,0,295,80,56
2020,5,23,"Bitlis",38.393,42.123,10.4,-3.75714285714286,14.4317142857143,81.0571428571429,15.7528571428571,NA,331,70,78,49,33,272,261,194
2020,6,23,"Bitlis",38.393,42.123,12.7,-1.22857142857143,9.68314285714286,81.5142857142857,23.638,NA,343,0,0,219,154,267,343,267
2020,7,23,"Bitlis",38.393,42.123,9.12857142857143,-7.67142857142857,1.58742857142857,76.6,NA,NA,341,177,153,74,47,338,164,185
2020,8,23,"Bitlis",38.393,42.123,9.18571428571429,1.47142857142857,3.25385714285714,86.5428571428571,32.85,NA,283,202,136,29,1,187,81,51
2020,9,23,"Bitlis",38.393,42.123,11.1571428571429,2.2,8.03085714285714,75.0285714285714,22.0442857142857,NA,393,38,30,129,223,528,355,498
2020,10,23,"Bitlis",38.393,42.123,8.25714285714286,2.6,0.2,74.8714285714286,17.23,NA,205,152,171,0,0,210,53,39
2020,11,23,"Bitlis",38.393,42.123,9.18571428571429,6.24285714285714,2.65728571428571,73.4857142857143,18.46,NA,115,58,70,8,3,94,57,24
2020,12,23,"Bitlis",38.393,42.123,15.6142857142857,5.08571428571429,18.1687142857143,85.0142857142857,14.5416666666667,NA,117,49,69,14,16,118,68,49
2020,13,23,"Bitlis",38.393,42.123,13.6857142857143,6.8,5.71842857142857,75.7428571428571,12.2933333333333,NA,136,64,58,27,5,92,72,34
2020,14,23,"Bitlis",38.393,42.123,13.6142857142857,6.48571428571429,8.50185714285714,80.0571428571428,10.405,NA,155,44,18,49,30,121,111,103
2020,15,23,"Bitlis",38.393,42.123,12.2428571428571,9.1,2.76914285714286,68.2285714285714,10.2614285714286,NA,133,80,81,18,3,118,53,37
2020,16,23,"Bitlis",38.393,42.123,13.4142857142857,10.9,1.25071428571429,58.5,11.2428571428571,NA,141,6,1,57,43,106,135,105
2020,17,23,"Bitlis",38.393,42.123,13.8714285714286,11.6571428571429,8.16371428571429,74.0428571428571,14.395,NA,137,0,0,54,44,123,137,123
2020,18,23,"Bitlis",38.393,42.123,15.6857142857143,11.1428571428571,1.96814285714286,70.5142857142857,6.18142857142857,NA,146,14,9,71,104,164,132,155
2020,19,23,"Bitlis",38.393,42.123,18.2714285714286,12.6571428571429,5.40457142857143,73.2857142857143,6.55,NA,137,11,5,48,53,157,126,152
2020,20,23,"Bitlis",38.393,42.123,11.2428571428571,17.0142857142857,0.578142857142857,51.2142857142857,NA,NA,164,58,39,11,7,164,106,125
2020,21,23,"Bitlis",38.393,42.123,15,19.2285714285714,1.51071428571429,48.7428571428571,12.04,NA,146,68,40,26,29,96,78,56
2020,22,23,"Bitlis",38.393,42.123,14.0285714285714,17.1,1.11971428571429,53.8857142857143,8.88714285714286,NA,118,20,32,69,46,100,98,68
2020,23,23,"Bitlis",38.393,42.123,14.4,19.8142857142857,0.214571428571429,40.6857142857143,12.8957142857143,NA,112,0,0,71,45,70,112,70
2020,24,23,"Bitlis",38.393,42.123,15.7857142857143,22.6857142857143,0.012,36.2142857142857,15.8271428571429,NA,140,21,10,56,28,150,119,140
2020,25,23,"Bitlis",38.393,42.123,15.4142857142857,21.9,1.63914285714286,45.0285714285714,16.3416666666667,NA,137,33,32,52,26,108,104,76
2020,26,23,"Bitlis",38.393,42.123,11.8857142857143,24.2714285714286,0.166,37.0285714285714,15.9957142857143,NA,173,20,3,94,98,133,153,130
2020,27,23,"Bitlis",38.393,42.123,16.1,24.3285714285714,0.361428571428571,44.7,12.2171428571429,NA,113,72,32,2,1,113,41,81
2020,28,23,"Bitlis",38.393,42.123,15.5142857142857,26.4285714285714,0.648428571428571,39.7142857142857,10.9157142857143,NA,164,57,43,30,9,122,107,79
2020,29,23,"Bitlis",38.393,42.123,13,26.4428571428571,1.00371428571429,39.1,18.0442857142857,NA,186,53,22,92,47,111,133,89
2020,30,23,"Bitlis",38.393,42.123,16.1571428571429,28.5142857142857,0,30.1428571428571,24.9185714285714,NA,190,0,0,107,76,142,190,142
2020,31,23,"Bitlis",38.393,42.123,15.9428571428571,28.1285714285714,0.006,32.6857142857143,20.05,NA,150,23,36,69,48,127,127,91
2020,32,23,"Bitlis",38.393,42.123,11.9857142857143,26.9285714285714,0,30.8142857142857,13.1442857142857,NA,146,91,54,0,0,107,55,53
2020,33,23,"Bitlis",38.393,42.123,14.7285714285714,26.2571428571429,0,33.9714285714286,18.5771428571429,NA,183,11,7,50,21,83,172,76
2020,34,23,"Bitlis",38.393,42.123,13.8714285714286,24.9285714285714,0.492285714285714,34.3714285714286,19.3328571428571,NA,197,36,10,85,28,97,161,87
2020,35,23,"Bitlis",38.393,42.123,10.6857142857143,24.0714285714286,0,32.2571428571429,11.4271428571429,NA,164,76,59,0,0,157,88,98
2020,36,23,"Bitlis",38.393,42.123,14.7,25.8571428571429,0,29.3857142857143,21.2142857142857,NA,179,66,45,29,24,112,113,67
2020,37,23,"Bitlis",38.393,42.123,13.8285714285714,25.2285714285714,0,26.3428571428571,24.5985714285714,NA,193,67,21,66,41,91,126,70
2020,38,23,"Bitlis",38.393,42.123,10.1857142857143,24.2,0,25.3142857142857,29.6028571428571,NA,235,40,41,127,71,157,195,116
2020,39,23,"Bitlis",38.393,42.123,13.4428571428571,21.6428571428571,0.0598571428571429,35.8285714285714,25.4375,NA,220,0,0,94,74,129,220,129
2020,40,23,"Bitlis",38.393,42.123,14.8,20.0571428571429,0,36.6857142857143,28.3725,NA,187,39,12,74,54,154,148,142
2020,41,23,"Bitlis",38.393,42.123,12.1,16.0571428571429,0,40.6142857142857,11.59,NA,182,85,58,1,3,127,97,69
2020,42,23,"Bitlis",38.393,42.123,7.48571428571429,17.7714285714286,0,29.8857142857143,23.4614285714286,NA,177,28,9,63,60,111,149,102
2020,43,23,"Bitlis",38.393,42.123,8.81428571428571,15.7142857142857,0,34.6142857142857,21.3442857142857,NA,194,25,14,111,112,161,169,147
2020,44,23,"Bitlis",38.393,42.123,11.0285714285714,16.0428571428571,0,28.4142857142857,33.7528571428571,NA,255,11,7,105,100,233,244,226
2020,45,23,"Bitlis",38.393,42.123,11.6428571428571,11.2,6.50571428571429,75.4428571428571,15.465,NA,156,76,57,0,0,103,80,46
2020,46,23,"Bitlis",38.393,42.123,6.62857142857143,8.67142857142857,0.0497142857142857,66.1571428571429,15.6242857142857,NA,208,174,90,2,0,109,34,19
2020,47,23,"Bitlis",38.393,42.123,8.31428571428571,5.75714285714286,0.403714285714286,73.7,17.1814285714286,NA,173,85,49,0,0,83,88,34
2020,48,23,"Bitlis",38.393,42.123,8.17142857142857,4.17142857142857,0.115714285714286,66.5857142857143,12.8242857142857,NA,199,136,177,0,0,262,63,85
2020,49,23,"Bitlis",38.393,42.123,8.84285714285714,3.75714285714286,0.095,79.7285714285714,18.55,NA,207,84,41,9,2,116,123,75
2020,50,23,"Bitlis",38.393,42.123,6.68571428571429,3.05714285714286,0.676714285714286,82.4857142857143,22.2071428571429,NA,181,54,44,20,6,98,127,54
2020,51,23,"Bitlis",38.393,42.123,9.52857142857143,4.17142857142857,0.563714285714286,84.7857142857143,18.3657142857143,NA,171,36,14,14,13,90,135,76
2020,52,23,"Bitlis",38.393,42.123,7.18571428571429,-2.81428571428571,2.97042857142857,79.7571428571429,22.775,NA,203,132,63,0,0,113,71,50
2020,53,23,"Bitlis",38.393,42.123,7.85,-2.7,0,80.525,18.6275,NA,122,119,111,0,0,111,3,0
2017,1,24,"Karacayir",40.735,31.606,10.3714285714286,-0.228571428571429,1.41471428571429,79.0285714285714,44.8342857142857,NA,563,66,99,262,411,847,497,748
2017,2,24,"Karacayir",40.735,31.606,12.6714285714286,0.528571428571428,0.257142857142857,67.7285714285714,22.9414285714286,NA,757,352,703,82,105,1214,405,511
2017,3,24,"Karacayir",40.735,31.606,8.08571428571429,2.28571428571429,0.885857142857143,87.1142857142857,19.6914285714286,NA,762,156,235,166,272,1449,606,1214
2017,4,24,"Karacayir",40.735,31.606,7.68571428571429,-1.25714285714286,0.743285714285714,85.4142857142857,33.9557142857143,NA,639,265,355,177,190,889,374,534
2017,5,24,"Karacayir",40.735,31.606,9.47142857142857,-0.9,0.0428571428571429,70.1428571428571,44.24,NA,588,244,688,0,0,1163,344,475
2017,6,24,"Karacayir",40.735,31.606,8.95714285714286,3.2,1.71414285714286,80.9857142857143,36.3685714285714,NA,736,328,722,115,345,1519,408,797
2017,7,24,"Karacayir",40.735,31.606,10.0571428571429,-1.57142857142857,0.971571428571429,71.4857142857143,22.74,NA,492,101,135,222,375,717,391,582
2017,8,24,"Karacayir",40.735,31.606,10.7285714285714,5.3,0.543,71.7428571428571,NA,NA,739,18,93,96,195,1747,721,1654
2017,9,24,"Karacayir",40.735,31.606,9.14285714285714,7.71428571428571,0.257142857142857,69.8857142857143,34.18,NA,574,305,384,0,0,866,269,482
2017,10,24,"Karacayir",40.735,31.606,10.4285714285714,9.68571428571429,0.0571428571428571,59.6857142857143,47.7157142857143,NA,712,294,454,0,0,1043,418,589
2017,11,24,"Karacayir",40.735,31.606,10.9142857142857,1.85714285714286,1.60057142857143,84.3857142857143,22.2828571428571,NA,525,79,133,70,73,725,446,592
2017,12,24,"Karacayir",40.735,31.606,11.9714285714286,7.98571428571429,1.81414285714286,66.7857142857143,34.87,NA,589,3,3,26,93,1077,586,1074
2017,13,24,"Karacayir",40.735,31.606,12.2285714285714,7.84285714285714,0.642857142857143,69.3714285714286,34.5985714285714,NA,574,73,102,0,0,887,501,785
2017,14,24,"Karacayir",40.735,31.606,11.9714285714286,7.7,2.84271428571429,71.4857142857143,32.2285714285714,NA,639,117,251,28,19,1336,522,1085
2017,15,24,"Karacayir",40.735,31.606,12.1142857142857,8.24285714285714,0.142857142857143,64.6142857142857,33.4685714285714,NA,587,164,386,75,101,1187,423,801
2017,16,24,"Karacayir",40.735,31.606,11.4571428571429,7.94285714285714,4.772,74.4,18.5928571428571,NA,717,133,180,0,0,920,584,740
2017,17,24,"Karacayir",40.735,31.606,10.5714285714286,12.0714285714286,0.143,56.8428571428571,38.4714285714286,NA,731,102,161,0,0,1478,629,1317
2017,18,24,"Karacayir",40.735,31.606,14.0714285714286,14.9571428571429,2.857,70.7571428571429,37.0142857142857,NA,506,91,208,0,0,923,415,715
2017,19,24,"Karacayir",40.735,31.606,13,16.0428571428571,1.48614285714286,68.9571428571429,29.33,NA,471,0,0,0,0,966,471,966
2017,20,24,"Karacayir",40.735,31.606,9.4,12.7428571428571,2.58571428571429,77.6714285714286,17.2585714285714,NA,472,53,71,0,0,1205,419,1134
2017,21,24,"Karacayir",40.735,31.606,11.1428571428571,12.2714285714286,1.31414285714286,76.9428571428571,21.3085714285714,NA,448,111,244,79,121,849,337,605
2017,22,24,"Karacayir",40.735,31.606,9.6,17.0428571428571,2.39971428571429,78.1714285714286,24.7414285714286,NA,522,225,523,0,0,1015,297,492
2017,23,24,"Karacayir",40.735,31.606,12.4857142857143,18.0714285714286,4.98585714285714,80.8,22.8971428571429,NA,578,136,303,0,0,1388,442,1085
2017,24,24,"Karacayir",40.735,31.606,10.8857142857143,17.9714285714286,0.714142857142857,70.2285714285714,21.8942857142857,NA,552,180,376,33,38,1139,372,763
2017,25,24,"Karacayir",40.735,31.606,12.4857142857143,17.8142857142857,1.95842857142857,74.4428571428571,21.8028571428571,NA,584,39,110,3,26,1041,545,931
2017,26,24,"Karacayir",40.735,31.606,12.7428571428571,23.3714285714286,0,64.7714285714286,31.36,NA,564,18,111,0,0,971,546,860
2017,27,24,"Karacayir",40.735,31.606,13.2571428571429,19.9857142857143,0.200142857142857,69.7285714285714,23.3357142857143,NA,511,0,0,66,66,642,511,642
2017,28,24,"Karacayir",40.735,31.606,13,20.6714285714286,0.114285714285714,70.0714285714286,25.98,NA,481,74,94,0,0,864,407,770
2017,29,24,"Karacayir",40.735,31.606,12.4857142857143,20.7285714285714,0.600285714285714,75.8,26.4985714285714,NA,532,54,125,96,178,1272,478,1147
2017,30,24,"Karacayir",40.735,31.606,10.6857142857143,21.7142857142857,1.62842857142857,64.2285714285714,29.9385714285714,NA,531,76,160,28,20,928,455,768
2017,31,24,"Karacayir",40.735,31.606,11.2,20.7142857142857,1.28542857142857,74.7857142857143,32.0771428571429,NA,559,83,216,110,195,1047,476,831
2017,32,24,"Karacayir",40.735,31.606,12.4857142857143,23.2142857142857,0,72.5285714285714,35.8742857142857,NA,567,68,122,0,0,1092,499,970
2017,33,24,"Karacayir",40.735,31.606,13.2571428571429,20.9571428571429,0.0714285714285714,72.0285714285714,27.9757142857143,NA,596,62,84,16,10,1199,534,1115
2017,34,24,"Karacayir",40.735,31.606,11.9714285714286,17.9285714285714,3.67185714285714,74.7,20.2214285714286,NA,601,102,171,0,0,1280,499,1109
2017,35,24,"Karacayir",40.735,31.606,11.4571428571429,17.0714285714286,1.17142857142857,69.9,16.9542857142857,NA,493,200,368,96,153,1014,293,646
2017,36,24,"Karacayir",40.735,31.606,10.6857142857143,17.3,0.486,68.0142857142857,20.5585714285714,NA,507,71,169,94,244,1321,436,1152
2017,37,24,"Karacayir",40.735,31.606,10.4285714285714,21.4571428571429,0,61.9857142857143,37.5114285714286,NA,589,363,711,0,0,1138,226,427
2017,38,24,"Karacayir",40.735,31.606,10.9857142857143,18.3571428571429,0.143285714285714,62.7142857142857,26.5557142857143,NA,671,269,563,23,52,1312,402,749
2017,39,24,"Karacayir",40.735,31.606,9.18571428571429,14.4285714285714,4.79942857142857,81.2285714285714,24.4685714285714,NA,782,179,398,233,687,1630,603,1232
2017,40,24,"Karacayir",40.735,31.606,9.8,11.1,5.55685714285714,74.7,26.1014285714286,NA,543,122,449,38,113,1137,421,688
2017,41,24,"Karacayir",40.735,31.606,8.45714285714286,8.34285714285714,1.01428571428571,76.7142857142857,22.355,NA,487,186,244,65,118,843,301,599
2017,42,24,"Karacayir",40.735,31.606,8.45714285714286,10.5571428571429,0,69.7,NA,NA,530,254,461,0,0,815,276,354
2017,43,24,"Karacayir",40.735,31.606,10.6714285714286,10.6,3.84371428571429,79.1857142857143,21.6066666666667,NA,506,212,359,0,0,919,294,560
2017,44,24,"Karacayir",40.735,31.606,9.22857142857143,3.57142857142857,0.8,75.6857142857143,33.2528571428571,NA,561,298,631,28,31,1102,263,471
2017,45,24,"Karacayir",40.735,31.606,8.31428571428571,7.72857142857143,0.557285714285714,83.0571428571428,39.0642857142857,NA,577,0,0,21,24,829,577,829
2017,46,24,"Karacayir",40.735,31.606,5.25714285714286,10.5285714285714,0,75.3428571428571,61.4628571428571,NA,587,409,717,0,0,1085,178,368
2017,47,24,"Karacayir",40.735,31.606,10.1857142857143,3.27142857142857,7.44271428571429,89.3857142857143,27.1757142857143,NA,418,102,305,41,37,804,316,499
2017,48,24,"Karacayir",40.735,31.606,11.4571428571429,7.88571428571429,0.528857142857143,70.6857142857143,35.4985714285714,NA,386,252,407,0,0,619,134,212
2017,49,24,"Karacayir",40.735,31.606,9.6,4.01428571428571,5.501,84.5571428571428,29.1457142857143,NA,407,3,4,64,42,645,404,641
2017,50,24,"Karacayir",40.735,31.606,7.55714285714286,6.87142857142857,0.0714285714285714,78.4571428571429,48.4114285714286,NA,346,115,232,12,22,442,231,210
2017,51,24,"Karacayir",40.735,31.606,7,2.68571428571429,6.01485714285714,91.5,21.4442857142857,NA,386,178,149,0,0,349,208,200
2017,52,24,"Karacayir",40.735,31.606,7.225,4,0.75,80.0875,67.145,NA,528,136,108,76,47,507,392,399
2018,1,24,"Karacayir",40.735,31.606,5.775,4.3625,0.374875,81.0625,35.7225,39.97,618,40,29,131,189,914,578,885
2018,2,24,"Karacayir",40.735,31.606,5.82857142857143,4.5,1.61414285714286,88.4857142857143,51.3042857142857,NA,624,349,958,0,0,1309,275,351
2018,3,24,"Karacayir",40.735,31.606,8.77142857142857,2.68571428571429,3.48585714285714,79.1428571428571,27.01,NA,639,0,0,162,352,655,639,655
2018,4,24,"Karacayir",40.735,31.606,9.8,0.414285714285714,0.471857142857143,77.5,19.01,NA,604,83,140,63,71,764,521,624
2018,5,24,"Karacayir",40.735,31.606,10.3714285714286,5.81428571428571,0.0142857142857143,68.9857142857143,56.01,NA,670,14,70,100,82,819,656,749
2018,6,24,"Karacayir",40.735,31.606,9.28571428571429,7.21428571428571,0.557285714285714,80.0571428571429,NA,NA,704,55,89,106,148,1022,649,933
2018,7,24,"Karacayir",40.735,31.606,8.25714285714286,4.95714285714286,0.242857142857143,81.7571428571429,NA,NA,478,126,164,0,0,557,352,393
2018,8,24,"Karacayir",40.735,31.606,7.82857142857143,4.98571428571429,3.67142857142857,84.3285714285714,NA,NA,711,258,354,63,230,1321,453,967
2018,9,24,"Karacayir",40.735,31.606,11.9714285714286,5.11428571428571,5.35728571428571,79.1,NA,NA,621,86,143,96,156,956,535,813
2018,10,24,"Karacayir",40.735,31.606,10.3714285714286,9.01428571428571,1.44328571428571,76.9857142857143,NA,NA,556,0,0,0,0,1330,556,1330
2018,11,24,"Karacayir",40.735,31.606,10.1714285714286,10.8857142857143,4.57128571428571,68.1142857142857,NA,NA,551,33,141,38,77,1426,518,1285
2018,12,24,"Karacayir",40.735,31.606,13.7571428571429,10.8142857142857,0.200285714285714,68.9,NA,NA,425,0,0,0,0,1187,425,1187
2018,13,24,"Karacayir",40.735,31.606,10.5285714285714,9.45714285714286,3.00028571428571,68.8857142857143,NA,NA,356,113,101,41,68,428,243,327
2018,14,24,"Karacayir",40.735,31.606,9.08571428571429,11.6571428571429,0.428714285714286,64.4714285714286,NA,NA,407,67,45,7,0,486,340,441
2018,15,24,"Karacayir",40.735,31.606,11.2,13.4142857142857,1.5,73.9571428571429,NA,NA,374,115,104,41,20,450,259,346
2018,16,24,"Karacayir",40.735,31.606,11.0857142857143,10.9285714285714,0.328857142857143,66.3142857142857,NA,NA,411,82,105,69,122,648,329,543
2018,17,24,"Karacayir",40.735,31.606,11.2,16.6714285714286,0,57.8571428571429,NA,NA,419,62,247,74,153,652,357,405
2018,18,24,"Karacayir",40.735,31.606,10.6857142857143,17.5285714285714,1.27142857142857,67.9142857142857,NA,NA,303,1,33,26,14,474,302,441
2018,19,24,"Karacayir",40.735,31.606,10.4285714285714,13.4,4.75842857142857,84.9,NA,NA,275,0,0,47,152,467,275,467
2018,20,24,"Karacayir",40.735,31.606,10.1714285714286,17.0857142857143,0.657285714285714,69.8571428571429,NA,NA,204,75,135,0,0,306,129,171
2018,21,24,"Karacayir",40.735,31.606,10.4285714285714,18.6714285714286,3.65657142857143,80.9857142857143,NA,NA,252,37,41,0,0,281,215,240
2018,22,24,"Karacayir",40.735,31.606,11.9714285714286,17.4285714285714,3.28557142857143,80.4714285714286,NA,NA,249,86,166,18,11,427,163,261
2018,23,24,"Karacayir",40.735,31.606,9.91428571428571,20.2857142857143,1.62828571428571,67.9571428571429,NA,NA,267,3,32,0,0,812,264,780
2018,24,24,"Karacayir",40.735,31.606,12.4857142857143,20.2714285714286,1.64342857142857,68.5428571428571,NA,NA,267,0,0,22,9,448,267,448
2018,25,24,"Karacayir",40.735,31.606,11.9714285714286,19.5714285714286,7.19928571428571,80.0571428571428,NA,NA,358,102,174,104,121,518,256,344
2018,26,24,"Karacayir",40.735,31.606,12.7857142857143,20.1285714285714,4.80028571428571,74.0714285714286,NA,21.215,355,83,181,0,0,587,272,406
2018,27,24,"Karacayir",40.735,31.606,12.4857142857143,21.1428571428571,0.0142857142857143,63.1857142857143,21.125,24.24,342,0,0,65,70,418,342,418
2018,28,24,"Karacayir",40.735,31.606,11.8142857142857,21.0428571428571,1.45714285714286,76,20.4585714285714,21.17,286,8,10,7,5,585,278,575
2018,29,24,"Karacayir",40.735,31.606,11.4571428571429,19.0571428571429,1.27228571428571,75.8571428571429,19.746,26.4916666666667,260,0,0,37,97,756,260,756
2018,30,24,"Karacayir",40.735,31.606,12.7857142857143,20.0142857142857,1.386,76.8857142857143,24.432,31.335,265,34,34,0,0,822,231,788
2018,31,24,"Karacayir",40.735,31.606,10.1714285714286,21.5571428571429,1.514,76.8857142857143,25.8457142857143,24.615,267,3,2,35,26,499,264,497
2018,32,24,"Karacayir",40.735,31.606,9.65714285714286,19.9428571428571,0.185714285714286,71.6428571428571,20.5771428571429,25.4142857142857,297,57,31,1,1,403,240,372
2018,33,24,"Karacayir",40.735,31.606,11.2,20.4714285714286,0.6,67.8714285714286,34.0042857142857,28.622,216,75,72,8,32,332,141,260
2018,34,24,"Karacayir",40.735,31.606,13.2571428571429,21.3,0,68.0857142857143,29.37,NA,144,23,42,0,0,227,121,185
2018,35,24,"Karacayir",40.735,31.606,11.7142857142857,21.6,2.69971428571429,73.2285714285714,28.6471428571429,NA,201,40,69,0,0,314,161,245
2018,36,24,"Karacayir",40.735,31.606,14.0285714285714,18.3142857142857,0.986571428571429,76.8,29.7971428571429,31.235,341,1,0,0,0,370,340,370
2018,37,24,"Karacayir",40.735,31.606,12.2285714285714,15.6571428571429,1.68642857142857,81.6428571428571,21.7057142857143,26.11,241,18,47,10,30,419,223,372
2018,38,24,"Karacayir",40.735,31.606,11.0857142857143,16.3285714285714,0.2,74.8,32.2442857142857,27.4983333333333,189,99,170,3,2,344,90,174
2018,39,24,"Karacayir",40.735,31.606,10.8857142857143,14.3285714285714,1.057,75.1,29.5085714285714,24.77,180,47,147,2,2,353,133,206
2018,40,24,"Karacayir",40.735,31.606,9.65714285714286,13.6714285714286,1.243,79.9,31.5542857142857,27.6828571428571,191,74,146,0,0,341,117,195
2018,41,24,"Karacayir",40.735,31.606,8.05714285714286,13.8571428571429,0.428571428571429,82.3,44.9914285714286,28.66,187,100,269,30,95,422,87,153
2018,42,24,"Karacayir",40.735,31.606,7.68571428571429,15.0285714285714,4.21385714285714,87.7571428571429,67.7885714285714,25.484,168,111,275,0,0,381,57,106
2018,43,24,"Karacayir",40.735,31.606,10.9714285714286,8.54285714285714,1.91514285714286,79.9285714285714,43.0428571428571,29.3142857142857,187,89,163,28,39,402,98,239
2018,44,24,"Karacayir",40.735,31.606,7.37142857142857,9.95714285714286,0,65.3857142857143,70.6185714285714,40.9085714285714,196,196,264,0,0,264,0,0
2018,45,24,"Karacayir",40.735,31.606,6.65714285714286,8.48571428571429,0,82.1714285714286,64.7214285714286,36.2814285714286,231,219,418,0,0,473,12,55
2018,46,24,"Karacayir",40.735,31.606,6.34285714285714,5.42857142857143,1.07142857142857,81.2714285714286,29.6528571428571,34.17,230,24,52,37,74,465,206,413
2018,47,24,"Karacayir",40.735,31.606,6.91428571428571,7.41428571428571,1.74271428571429,88.8714285714286,47.6957142857143,29.1,270,159,302,0,0,499,111,197
2018,48,24,"Karacayir",40.735,31.606,8.8,6.12857142857143,2.81442857142857,86.5857142857143,31.6342857142857,32.4442857142857,245,96,36,16,36,201,149,165
2018,49,24,"Karacayir",40.735,31.606,9.57142857142857,3.28571428571429,1.98628571428571,87.3285714285714,57.6171428571429,32.8771428571429,257,139,140,25,105,420,118,280
2018,50,24,"Karacayir",40.735,31.606,10.9571428571429,3.45714285714286,0.771571428571429,87.7142857142857,51.0971428571429,35.45,256,153,164,0,0,305,103,141
2018,51,24,"Karacayir",40.735,31.606,7.25714285714286,5.1,1,92.0857142857143,69.23,30.86,250,99,89,0,0,248,151,159
2018,52,24,"Karacayir",40.735,31.606,5.82857142857143,1.15714285714286,3.92928571428571,92.4285714285714,40.3214285714286,36.6285714285714,244,0,0,50,56,273,244,273
2019,1,24,"Karacayir",40.735,31.606,5.725,1.6,3.0625,93.7,49.17875,40.40875,343,40,184,0,0,784,303,600
2019,2,24,"Karacayir",40.735,31.606,8.51428571428571,2.11428571428571,1.529,80.0142857142857,27.0285714285714,32.7485714285714,255,28,33,47,5,208,227,175
2019,3,24,"Karacayir",40.735,31.606,8.28571428571429,0.242857142857143,5.32857142857143,87.7285714285714,97.94,55.0871428571429,192,98,125,1,0,198,94,73
2019,4,24,"Karacayir",40.735,31.606,9.02857142857143,7.91428571428571,0.599857142857143,70.1428571428571,80.0671428571429,38.546,308,157,183,0,0,314,151,131
2019,5,24,"Karacayir",40.735,31.606,7.74285714285714,8.3,1.04285714285714,67.7571428571429,49.26,31.6,253,92,42,0,0,143,161,101
2019,6,24,"Karacayir",40.735,31.606,5.2,7.02857142857143,2.743,78.4714285714286,45.7342857142857,37.8442857142857,276,65,12,34,9,127,211,115
2019,7,24,"Karacayir",40.735,31.606,8,5.87142857142857,2.58542857142857,76.2857142857143,24.7571428571429,28.1842857142857,325,44,112,76,44,234,281,122
2019,8,24,"Karacayir",40.735,31.606,10.9428571428571,4.65714285714286,0.414285714285714,73.0857142857143,60.5628571428571,34.76,305,0,0,41,11,219,305,219
2019,9,24,"Karacayir",40.735,31.606,11.7142857142857,3.47142857142857,1.15757142857143,80.3714285714286,34.54,NA,331,0,0,0,0,310,331,310
2019,10,24,"Karacayir",40.735,31.606,9.34285714285714,7.58571428571429,1.28557142857143,65.3571428571429,NA,NA,359,19,9,1,0,252,340,243
2019,11,24,"Karacayir",40.735,31.606,8.97142857142857,6.92857142857143,2.90028571428571,77.8571428571429,NA,32.146,373,0,0,149,217,400,373,400
2019,12,24,"Karacayir",40.735,31.606,11.2,6.01428571428571,0.0142857142857143,67.9571428571429,NA,29.0328571428571,343,63,297,107,46,416,280,119
2019,13,24,"Karacayir",40.735,31.606,13.5142857142857,4.62857142857143,0,61.4142857142857,NA,30.3014285714286,256,52,70,2,0,194,204,124
2019,14,24,"Karacayir",40.735,31.606,11.7142857142857,8.72857142857143,0.0142857142857143,69.6428571428571,NA,34.3571428571429,365,52,48,45,37,208,313,160
2019,15,24,"Karacayir",40.735,31.606,11.4571428571429,10.7571428571429,2.61457142857143,79.0571428571429,NA,33.4342857142857,359,38,5,57,27,183,321,178
2019,16,24,"Karacayir",40.735,31.606,10.8857142857143,5.48571428571429,1.34371428571429,78.9428571428571,NA,23.5271428571429,318,0,0,120,94,208,318,208
2019,17,24,"Karacayir",40.735,31.606,11.4571428571429,10.0285714285714,0.357142857142857,63.9285714285714,NA,33.15,412,65,56,0,0,313,347,257
2019,18,24,"Karacayir",40.735,31.606,13.2571428571429,13.7714285714286,2.64328571428571,64.7857142857143,NA,25.4257142857143,523,12,4,0,0,353,511,349
2019,19,24,"Karacayir",40.735,31.606,10.7285714285714,10.8,2.31471428571429,77.7142857142857,NA,21.9128571428571,452,13,4,2,3,386,439,382
2019,20,24,"Karacayir",40.735,31.606,12.5285714285714,16.5285714285714,9.88428571428572,69.7142857142857,NA,29.9314285714286,454,256,197,1,1,389,198,192
2019,21,24,"Karacayir",40.735,31.606,10.0571428571429,17.0857142857143,3.04271428571429,74.1428571428571,NA,27.6171428571429,457,179,160,0,0,413,278,253
2019,22,24,"Karacayir",40.735,31.606,9.6,20.8714285714286,1.88542857142857,66.6428571428571,NA,27.4,453,115,131,0,0,323,338,192
2019,23,24,"Karacayir",40.735,31.606,10.3714285714286,19.1,0.428571428571429,76.1,NA,20.3885714285714,378,59,121,0,0,532,319,411
2019,24,24,"Karacayir",40.735,31.606,10.1142857142857,18.7714285714286,6.357,81.5428571428571,NA,24.0957142857143,378,56,64,58,19,244,322,180
2019,25,24,"Karacayir",40.735,31.606,12.5285714285714,18.6142857142857,11.1567142857143,84.5714285714286,NA,24.0028571428571,306,86,78,92,43,325,220,247
2019,26,24,"Karacayir",40.735,31.606,11.2,20.7,3.64285714285714,72.8714285714286,NA,21.48,377,1,2,170,99,342,376,340
2019,27,24,"Karacayir",40.735,31.606,11.2,21.4,0.0142857142857143,68.2857142857143,NA,24.1357142857143,456,196,72,66,23,222,260,150
2019,28,24,"Karacayir",40.735,31.606,10.6857142857143,18.1,1.95814285714286,73,NA,21.6742857142857,398,2,1,127,121,421,396,420
2019,29,24,"Karacayir",40.735,31.606,10.4285714285714,17.7,5.92842857142857,81.2428571428571,NA,20.9757142857143,453,147,64,49,18,203,306,139
2019,30,24,"Karacayir",40.735,31.606,11.2,19.2428571428571,0.157142857142857,72.2,NA,22.5428571428571,456,192,187,0,0,335,264,148
2019,31,24,"Karacayir",40.735,31.606,11.7142857142857,21.7428571428571,1.34314285714286,72.8285714285714,NA,22.9628571428571,334,57,30,49,31,375,277,345
2019,32,24,"Karacayir",40.735,31.606,10.4285714285714,19.4857142857143,0.114285714285714,67.4714285714286,NA,22.17,346,107,110,0,0,395,239,285
2019,33,24,"Karacayir",40.735,31.606,9.18571428571429,20.6571428571429,5.10014285714286,75.7,NA,21.7071428571429,337,98,93,149,293,531,239,438
2019,34,24,"Karacayir",40.735,31.606,9.6,20.0428571428571,3.94285714285714,77.1571428571429,NA,23.0642857142857,299,0,0,47,18,345,299,345
2019,35,24,"Karacayir",40.735,31.606,10.9428571428571,20.2285714285714,0.0428571428571429,74.1714285714286,NA,26.75,307,35,77,6,1,415,272,338
2019,36,24,"Karacayir",40.735,31.606,10.4285714285714,18.3142857142857,0.0142857142857143,74.6428571428571,NA,26.6185714285714,171,55,29,0,0,67,116,38
2019,37,24,"Karacayir",40.735,31.606,11.4571428571429,17.4571428571429,0,73.4285714285714,NA,28.4557142857143,218,0,0,0,0,55,218,55
2019,38,24,"Karacayir",40.735,31.606,9.7,14.0285714285714,0.714428571428572,69.0714285714286,NA,29.5642857142857,266,115,31,0,0,91,151,60
2019,39,24,"Karacayir",40.735,31.606,9.65714285714286,14.4571428571429,0.128571428571429,74.4142857142857,NA,28.2342857142857,237,61,26,0,0,79,176,53
2019,40,24,"Karacayir",40.735,31.606,8.88571428571429,17.5571428571429,3.81428571428571,68.8714285714286,37.3425,33.7883333333333,241,38,33,21,5,111,203,78
2019,41,24,"Karacayir",40.735,31.606,5.57142857142857,14.3,1.18585714285714,82.2428571428571,28.66,29.202,416,184,219,0,0,448,232,229
2019,42,24,"Karacayir",40.735,31.606,7.17142857142857,15.1285714285714,0.0428571428571429,73.3,53.616,36.385,356,283,378,0,0,408,73,30
2019,43,24,"Karacayir",40.735,31.606,6.22857142857143,13,0.0857142857142857,79.2,50.9857142857143,34.9585714285714,306,170,153,0,0,300,136,147
2019,44,24,"Karacayir",40.735,31.606,5.45714285714286,10.7714285714286,1.62842857142857,80.6857142857143,48.7371428571429,36.7428571428571,350,54,56,0,0,250,296,194
2019,45,24,"Karacayir",40.735,31.606,4.88571428571429,13.4428571428571,0,65.9571428571429,65.4357142857143,43.5271428571429,417,158,139,0,0,328,259,189
2019,46,24,"Karacayir",40.735,31.606,2.31428571428571,12.8285714285714,0.0142857142857143,66.7285714285714,87.2328571428571,51.9957142857143,401,171,142,0,0,337,230,195
2019,47,24,"Karacayir",40.735,31.606,5.18571428571429,7.37142857142857,0.0428571428571429,66.3142857142857,104.957142857143,47.8957142857143,391,381,334,0,0,339,10,5
2019,48,24,"Karacayir",40.735,31.606,6.02857142857143,9.67142857142857,3.97257142857143,84.2142857142857,44.2742857142857,39.3428571428571,320,1,0,1,1,251,319,251
2019,49,24,"Karacayir",40.735,31.606,4.42857142857143,3.38571428571429,1.14271428571429,83.0142857142857,59.9585714285714,35.3514285714286,393,91,60,1,1,274,302,214
2019,50,24,"Karacayir",40.735,31.606,7.97142857142857,5.71428571428571,0.685714285714286,81.7,79.87,41.3857142857143,218,109,70,0,0,119,109,49
2019,51,24,"Karacayir",40.735,31.606,7.67142857142857,5.9,0,71.0428571428571,107.47,43.7214285714286,361,248,281,0,0,488,113,207
2019,52,24,"Karacayir",40.735,31.606,10.0428571428571,6.24285714285714,3.14414285714286,84.4428571428571,15.4128571428571,24.6171428571429,279,56,69,33,15,281,223,212
2020,1,24,"Karacayir",40.735,31.606,5.92,1.92,2.1002,84.08,39.528,31.342,160,0,0,6,2,126,160,126
2020,2,24,"Karacayir",40.735,31.606,5.1,2,3.28557142857143,89.9571428571429,84.01,38.8985714285714,240,103,70,43,6,173,137,103
2020,3,24,"Karacayir",40.735,31.606,4.68571428571429,2.77142857142857,0.114285714285714,78.9428571428571,82.7542857142857,38.465,270,148,195,27,15,382,122,187
2020,4,24,"Karacayir",40.735,31.606,7.31428571428571,-0.385714285714286,2.47128571428571,82.1428571428571,88.3542857142857,44.29,358,1,0,90,65,295,357,295
2020,5,24,"Karacayir",40.735,31.606,7.77142857142857,3.75714285714286,2.72857142857143,84.6285714285714,92.0285714285714,43.4385714285714,331,121,91,0,0,272,210,181
2020,6,24,"Karacayir",40.735,31.606,13.7285714285714,2.8,12.1277142857143,81.8142857142857,39.1442857142857,22.0842857142857,343,64,75,52,32,267,279,192
2020,7,24,"Karacayir",40.735,31.606,3.91428571428571,3.1,2.5,79.7714285714286,75.0885714285714,43.1175,341,37,25,11,10,338,304,313
2020,8,24,"Karacayir",40.735,31.606,7.2,3.1,0.271857142857143,78.5142857142857,54.67,41.238,283,126,112,34,18,187,157,75
2020,9,24,"Karacayir",40.735,31.606,9.14285714285714,6.78571428571429,2.72842857142857,65.7714285714286,27.6114285714286,24.7657142857143,393,116,155,0,0,528,277,373
2020,10,24,"Karacayir",40.735,31.606,3.91428571428571,11.8,0,56.1142857142857,47.2228571428571,34.6057142857143,205,76,70,5,1,210,129,140
2020,11,24,"Karacayir",40.735,31.606,6.8,10.9571428571429,0.0857142857142857,68.0857142857143,39.9671428571429,24.8125,115,33,15,34,34,94,82,79
2020,12,24,"Karacayir",40.735,31.606,6.28571428571429,4.04285714285714,2.22885714285714,75.3142857142857,22.1114285714286,30.085,117,0,0,37,46,118,117,118
2020,13,24,"Karacayir",40.735,31.606,7.82857142857143,7.4,6.78542857142857,86.3428571428571,29.8557142857143,31.55,136,8,6,56,39,92,128,86
2020,14,24,"Karacayir",40.735,31.606,10.0714285714286,7.2,3.19985714285714,85.5285714285714,27.9214285714286,25.6914285714286,155,59,46,22,19,121,96,75
2020,15,24,"Karacayir",40.735,31.606,11.5142857142857,7.61428571428571,2.31414285714286,69.5571428571429,26.1257142857143,18.46,133,0,0,6,2,118,133,118
2020,16,24,"Karacayir",40.735,31.606,8.94285714285714,10.3857142857143,1.41428571428571,66.0142857142857,32.9457142857143,28.4466666666667,141,6,4,35,53,106,135,102
2020,17,24,"Karacayir",40.735,31.606,11.0142857142857,8.44285714285714,1.09985714285714,73.7142857142857,20.945,22.1157142857143,137,0,0,71,74,123,137,123
2020,18,24,"Karacayir",40.735,31.606,7.87142857142857,12,0.914285714285714,70.5714285714286,25.9183333333333,24.49,146,56,49,47,81,164,90,115
2020,19,24,"Karacayir",40.735,31.606,8.68571428571429,10.4285714285714,6.24242857142857,79.5857142857143,20.0528571428571,18.18,137,0,0,42,38,157,137,157
2020,20,24,"Karacayir",40.735,31.606,8.72857142857143,19.1571428571429,0.0714285714285714,62.9285714285714,25.0814285714286,28.04,164,42,45,42,54,164,122,119
2020,21,24,"Karacayir",40.735,31.606,10.3857142857143,15.5428571428571,1.343,73.3142857142857,22.97,21.7528571428571,146,5,0,35,42,96,141,96
2020,22,24,"Karacayir",40.735,31.606,7.87142857142857,11.6142857142857,4.29985714285714,81.4857142857143,16.2314285714286,20.2385714285714,118,5,10,50,50,100,113,90
2020,23,24,"Karacayir",40.735,31.606,7.31428571428571,16.4285714285714,5.329,72.3571428571429,21.0571428571429,28.0885714285714,112,17,14,34,5,70,95,56
2020,24,24,"Karacayir",40.735,31.606,3.91428571428571,19.7428571428571,6.38471428571429,73.7285714285714,23.17,31.0266666666667,140,29,10,33,18,150,111,140
2020,25,24,"Karacayir",40.735,31.606,4.17142857142857,19.7571428571429,17.199,81.2857142857143,18.8957142857143,23.31,137,0,0,26,7,108,137,108
2020,26,24,"Karacayir",40.735,31.606,6.34285714285714,20.7714285714286,4.84242857142857,76.4142857142857,13.8557142857143,20.4933333333333,173,4,10,58,34,133,169,123
2020,27,24,"Karacayir",40.735,31.606,8.31428571428571,23.9428571428571,0,69.0714285714286,24.8357142857143,20.2242857142857,113,0,0,36,32,113,113,113
2020,28,24,"Karacayir",40.735,31.606,10.1714285714286,22.5,0.0574285714285714,73.4571428571429,19.1283333333333,20.806,164,0,0,29,9,122,164,122
2020,29,24,"Karacayir",40.735,31.606,8,19.5571428571429,1.27157142857143,79.7142857142857,15.6357142857143,17.762,186,28,10,80,27,111,158,101
2020,30,24,"Karacayir",40.735,31.606,10.4285714285714,21.1,0.0285714285714286,71.8142857142857,33.114,23.6885714285714,190,61,16,19,10,142,129,126
2020,31,24,"Karacayir",40.735,31.606,10.4714285714286,21.7428571428571,0.0857142857142857,66.8571428571429,27.7842857142857,18.6971428571429,150,39,19,20,12,127,111,108
2020,32,24,"Karacayir",40.735,31.606,10.4285714285714,22.3571428571429,0.0571428571428571,62.9714285714286,34.7857142857143,23.805,146,53,68,10,6,107,93,39
2020,33,24,"Karacayir",40.735,31.606,7.31428571428571,20.0571428571429,0,64.7,23.0814285714286,23.5057142857143,183,28,13,29,7,83,155,70
2020,34,24,"Karacayir",40.735,31.606,5.45714285714286,20.2428571428571,0.0142857142857143,67.3285714285714,24.49,26.5542857142857,197,125,46,44,22,97,72,51
2020,35,24,"Karacayir",40.735,31.606,9.28571428571429,21.9,0.0428571428571429,60.8,26.6985714285714,27.3514285714286,164,65,82,30,28,157,99,75
2020,36,24,"Karacayir",40.735,31.606,10.4714285714286,21.0714285714286,0.457142857142857,64.7857142857143,30.8114285714286,17.22,179,80,36,0,0,112,99,76
2020,37,24,"Karacayir",40.735,31.606,10.1714285714286,19.3142857142857,0.571571428571429,75.5285714285714,28.9628571428571,24.9042857142857,193,100,47,0,0,91,93,44
2020,38,24,"Karacayir",40.735,31.606,11.2,19.5285714285714,0.1,72.8428571428571,27.824,25.2828571428571,235,22,14,46,51,157,213,143
2020,39,24,"Karacayir",40.735,31.606,9.48571428571429,18.7714285714286,0.142857142857143,65.8571428571429,32.7028571428571,25.8,220,54,16,2,0,129,166,113
2020,40,24,"Karacayir",40.735,31.606,9.64285714285714,16.2714285714286,3.38542857142857,67.5,26.6828571428571,28.1275,187,48,71,0,0,154,139,83
2020,41,24,"Karacayir",40.735,31.606,7.57142857142857,17.7428571428571,5.77085714285714,65.6714285714286,37.1971428571429,31.0842857142857,182,150,99,0,0,127,32,28
2020,42,24,"Karacayir",40.735,31.606,6.28571428571429,16.7857142857143,0.628571428571429,71.0857142857143,38.4885714285714,36.78,177,5,0,0,0,111,172,111
2020,43,24,"Karacayir",40.735,31.606,6.62857142857143,13.3,1.29985714285714,80.1714285714286,34.0685714285714,25.7442857142857,194,140,120,20,16,161,54,41
2020,44,24,"Karacayir",40.735,31.606,8.12857142857143,12.1142857142857,1.97171428571429,78.9571428571429,41.1914285714286,29.9585714285714,255,117,147,0,0,233,138,86
2020,45,24,"Karacayir",40.735,31.606,6.32857142857143,7.61428571428571,0.271571428571429,84.3285714285714,41.1633333333333,29.8385714285714,156,73,50,10,7,103,83,53
2020,46,24,"Karacayir",40.735,31.606,4.84285714285714,7.58571428571429,0.543,83.9,55.8514285714286,28.38,208,135,90,0,0,109,73,19
2020,47,24,"Karacayir",40.735,31.606,5.61428571428571,4.61428571428571,0.128571428571429,81.4285714285714,43.31,28.47,173,121,65,0,0,83,52,18
2020,48,24,"Karacayir",40.735,31.606,7.4,2.37142857142857,0,70.2285714285714,92.3166666666667,35.3666666666667,199,167,252,0,0,262,32,10
2020,49,24,"Karacayir",40.735,31.606,6.17142857142857,3.97142857142857,0.0857142857142857,75.3285714285714,88.4471428571429,35.7971428571429,207,192,107,0,0,116,15,9
2020,50,24,"Karacayir",40.735,31.606,10.1857142857143,6.94285714285714,0.2,74.2428571428571,70.8,32.1457142857143,181,177,95,0,0,98,4,3
2020,51,24,"Karacayir",40.735,31.606,6.24285714285714,6.31428571428571,1.143,86.8714285714286,10.3671428571429,30.9333333333333,171,83,53,69,22,90,88,37
2020,52,24,"Karacayir",40.735,31.606,8.4,3.45714285714286,0.485714285714286,80.4428571428572,31.9242857142857,34.535,203,140,83,37,13,113,63,30
2020,53,24,"Karacayir",40.735,31.606,10.1,6.575,0.05,69.35,50.9125,34.9375,122,119,106,0,0,111,3,5
2017,1,25,"Burdur",37.7203,30.29,20.3571428571429,0.0571428571428574,2.81642857142857,76.0571428571429,100.67,NA,563,206,301,150,238,847,357,546
2017,2,25,"Burdur",37.7203,30.29,14.6571428571429,-0.514285714285714,4.00971428571429,74.3571428571429,96.3728571428571,NA,757,137,191,158,223,1214,620,1023
2017,3,25,"Burdur",37.7203,30.29,14.7142857142857,3.45714285714286,0.253285714285714,73.2142857142857,84.035,NA,762,118,135,532,1163,1449,644,1314
2017,4,25,"Burdur",37.7203,30.29,21.1714285714286,-1.44285714285714,1.17457142857143,66.0142857142857,144.874285714286,NA,639,0,0,452,621,889,639,889
2017,5,25,"Burdur",37.7203,30.29,12.7428571428571,-0.357142857142857,0.254714285714286,62.5428571428571,209.297142857143,NA,588,0,0,252,587,1163,588,1163
2017,6,25,"Burdur",37.7203,30.29,16.8714285714286,6.4,0.00414285714285714,67.0142857142857,109.837142857143,NA,736,245,370,251,659,1519,491,1149
2017,7,25,"Burdur",37.7203,30.29,19.8571428571429,0.471428571428571,0,51.6285714285714,80.07,NA,492,44,38,223,330,717,448,679
2017,8,25,"Burdur",37.7203,30.29,13.9428571428571,6.84285714285714,0.0952857142857143,62.7428571428571,89.9,NA,739,257,606,276,708,1747,482,1141
2017,9,25,"Burdur",37.7203,30.29,13.3857142857143,7.31428571428571,2.48185714285714,61.6,106.795714285714,NA,574,121,168,235,341,866,453,698
2017,10,25,"Burdur",37.7203,30.29,19.1714285714286,7.95714285714286,2.59357142857143,60.3714285714286,56.7457142857143,NA,712,457,577,0,0,1043,255,466
2017,11,25,"Burdur",37.7203,30.29,18.2285714285714,4.64285714285714,0.182,62.0571428571429,59.9442857142857,NA,525,0,0,487,700,725,525,725
2017,12,25,"Burdur",37.7203,30.29,15.5142857142857,11.0428571428571,0,44.7428571428571,91.7471428571429,NA,589,83,78,361,770,1077,506,999
2017,13,25,"Burdur",37.7203,30.29,20.2428571428571,11.3571428571429,0.601714285714286,55.7285714285714,65.5342857142857,NA,574,45,116,291,444,887,529,771
2017,14,25,"Burdur",37.7203,30.29,16.1428571428571,10.2714285714286,1.31128571428571,53.2285714285714,51.9971428571429,NA,639,25,79,380,700,1336,614,1257
2017,15,25,"Burdur",37.7203,30.29,18.3142857142857,11.5285714285714,0.272428571428571,50.1285714285714,62.0942857142857,NA,587,99,259,480,924,1187,488,928
2017,16,25,"Burdur",37.7203,30.29,23.6571428571429,10.6714285714286,1.42485714285714,63.8571428571429,45.2828571428571,NA,717,364,401,198,229,920,353,519
2017,17,25,"Burdur",37.7203,30.29,13.9142857142857,14,0,44.4714285714286,81.56,NA,731,51,180,662,1232,1478,680,1298
2017,18,25,"Burdur",37.7203,30.29,15.9714285714286,16.0714285714286,2.07657142857143,57.2714285714286,69.0757142857143,NA,506,0,0,348,627,923,506,923
2017,19,25,"Burdur",37.7203,30.29,20.2285714285714,18.7857142857143,0.115857142857143,46.2285714285714,87.0485714285714,NA,471,123,198,337,739,966,348,768
2017,20,25,"Burdur",37.7203,30.29,21.8285714285714,15.0428571428571,2.65942857142857,57.2571428571429,44.4728571428571,NA,472,57,214,279,689,1205,415,991
2017,21,25,"Burdur",37.7203,30.29,17.7428571428571,14.7285714285714,3.393,59.5,43.1571428571429,NA,448,0,0,266,482,849,448,849
2017,22,25,"Burdur",37.7203,30.29,17.1,17.2285714285714,1.433,62.5857142857143,43.28,NA,522,86,221,264,485,1015,436,794
2017,23,25,"Burdur",37.7203,30.29,17.4285714285714,20.1,1.18885714285714,56.8285714285714,44.7142857142857,NA,578,0,0,560,1370,1388,578,1388
2017,24,25,"Burdur",37.7203,30.29,18.7142857142857,21.1142857142857,0.121714285714286,50.9714285714286,40.746,NA,552,63,159,393,838,1139,489,980
2017,25,25,"Burdur",37.7203,30.29,17.5857142857143,20.9857142857143,1.03328571428571,45.5714285714286,34.36,NA,584,0,0,511,955,1041,584,1041
2017,26,25,"Burdur",37.7203,30.29,16.5,27.6142857142857,0.309,35.3,56.0628571428571,NA,564,0,0,445,822,971,564,971
2017,27,25,"Burdur",37.7203,30.29,26.3714285714286,26.3142857142857,0.0482857142857143,35.2857142857143,52.5742857142857,NA,511,90,165,421,477,642,421,477
2017,28,25,"Burdur",37.7203,30.29,20.8,27.6142857142857,0.0427142857142857,31.0428571428571,49.0914285714286,NA,481,0,0,407,738,864,481,864
2017,29,25,"Burdur",37.7203,30.29,24.8,25.9571428571429,1.58257142857143,43.4,47.8785714285714,NA,532,70,214,462,1058,1272,462,1058
2017,30,25,"Burdur",37.7203,30.29,20.2,25.6428571428571,0,35.6714285714286,55.6066666666667,NA,531,87,139,367,628,928,444,789
2017,31,25,"Burdur",37.7203,30.29,18.3571428571429,24.4,1.54,49,41.9657142857143,NA,559,0,0,544,1030,1047,559,1047
2017,32,25,"Burdur",37.7203,30.29,20.1142857142857,27.7714285714286,0.788428571428571,41.5571428571429,54.9066666666667,NA,567,26,111,464,911,1092,541,981
2017,33,25,"Burdur",37.7203,30.29,24.8142857142857,25.8285714285714,0.150142857142857,45.0285714285714,48.1971428571429,NA,596,0,0,593,1198,1199,596,1199
2017,34,25,"Burdur",37.7203,30.29,20.8428571428571,23.4,0.434,44.5285714285714,38.46,NA,601,0,0,514,939,1280,601,1280
2017,35,25,"Burdur",37.7203,30.29,15.6857142857143,23.4285714285714,0.615142857142857,39.4714285714286,39.5428571428571,NA,493,0,0,493,1014,1014,493,1014
2017,36,25,"Burdur",37.7203,30.29,15.7428571428571,22.7571428571429,0,32.8142857142857,53.6971428571429,NA,507,0,0,422,1138,1321,507,1321
2017,37,25,"Burdur",37.7203,30.29,13.3,24.6142857142857,0,31.6142857142857,91.11,NA,589,0,0,499,990,1138,589,1138
2017,38,25,"Burdur",37.7203,30.29,16.8571428571429,22.1285714285714,0.0681428571428571,34.2,68.5728571428571,NA,671,0,0,569,1163,1312,671,1312
2017,39,25,"Burdur",37.7203,30.29,16.1714285714286,18.7,1.80471428571429,51.2,47.6571428571429,NA,782,164,395,616,1234,1630,618,1235
2017,40,25,"Burdur",37.7203,30.29,19.2714285714286,15.1714285714286,1.02971428571429,52.1714285714286,36.1428571428571,NA,543,227,493,315,644,1137,316,644
2017,41,25,"Burdur",37.7203,30.29,18.8,13.2285714285714,0.0248571428571429,51.2714285714286,46.7833333333333,NA,487,0,0,485,843,843,487,843
2017,42,25,"Burdur",37.7203,30.29,14.3571428571429,14.9857142857143,0,40.0142857142857,52.3028571428571,NA,530,0,0,388,602,815,530,815
2017,43,25,"Burdur",37.7203,30.29,18.2857142857143,12.3714285714286,1.70371428571429,66.5142857142857,39.4785714285714,NA,506,272,519,121,198,919,234,400
2017,44,25,"Burdur",37.7203,30.29,15.5142857142857,7.91428571428571,1.25714285714286,60.0142857142857,48.9242857142857,NA,561,0,0,381,684,1102,561,1102
2017,45,25,"Burdur",37.7203,30.29,10.3428571428571,8.42857142857143,0,63.8142857142857,76.6314285714286,NA,577,0,0,477,659,829,577,829
2017,46,25,"Burdur",37.7203,30.29,14.1,8.77142857142857,2.03,78.2857142857143,85.5571428571428,NA,587,121,243,228,483,1085,466,842
2017,47,25,"Burdur",37.7203,30.29,16.2571428571429,4.62857142857143,1.37828571428571,71.8142857142857,73.7185714285714,NA,418,3,3,299,526,804,415,801
2017,48,25,"Burdur",37.7203,30.29,14.7571428571429,7.14285714285714,0.508571428571429,71.8,63.7142857142857,NA,386,151,241,117,202,619,235,378
2017,49,25,"Burdur",37.7203,30.29,19.0714285714286,3.85714285714286,0.288285714285714,66.2142857142857,88.0757142857143,NA,407,42,82,302,511,645,365,563
2017,50,25,"Burdur",37.7203,30.29,13.8285714285714,5.38571428571429,0.172714285714286,81.5,90.388,NA,346,143,197,165,218,442,203,245
2017,51,25,"Burdur",37.7203,30.29,22.0571428571429,6.87142857142857,1.35885714285714,71.4285714285714,72.8914285714286,NA,386,44,23,93,114,349,342,326
2017,52,25,"Burdur",37.7203,30.29,15.1875,2.075,0.85775,77.8125,100.864285714286,NA,528,128,190,254,227,507,400,317
2018,1,25,"Burdur",37.7203,30.29,15.75,3.875,0.531,74.125,76.12375,NA,618,95,166,358,489,914,523,748
2018,2,25,"Burdur",37.7203,30.29,13.9714285714286,4.37142857142857,1.08971428571429,77.1571428571429,105.58,NA,624,35,47,350,839,1309,589,1262
2018,3,25,"Burdur",37.7203,30.29,19.5857142857143,2.87142857142857,1.55,72.3,51.7985714285714,NA,639,84,126,362,232,655,555,529
2018,4,25,"Burdur",37.7203,30.29,23.3857142857143,1.92857142857143,4.44271428571429,65.6857142857143,40.9285714285714,NA,604,16,34,437,531,764,588,730
2018,5,25,"Burdur",37.7203,30.29,14.3142857142857,5.01428571428571,0.114428571428571,69.4,83.3257142857143,NA,670,273,431,319,227,819,397,388
2018,6,25,"Burdur",37.7203,30.29,20.6428571428571,8.74285714285714,0.804714285714286,66.9142857142857,121.398571428571,NA,704,235,329,203,305,1022,469,693
2018,7,25,"Burdur",37.7203,30.29,20.8285714285714,5.71428571428571,0.425714285714286,65.2714285714286,74.506,NA,478,17,35,285,347,557,461,522
2018,8,25,"Burdur",37.7203,30.29,15.1285714285714,6.4,1.41828571428571,73.4285714285714,47.0828571428571,NA,711,227,521,0,0,1321,484,800
2018,9,25,"Burdur",37.7203,30.29,22.0428571428571,6.81428571428571,2.39271428571429,69.6857142857143,54.46,NA,621,475,679,93,162,956,146,277
2018,10,25,"Burdur",37.7203,30.29,17.8857142857143,10.0428571428571,3.46871428571429,67.1857142857143,107.014285714286,NA,556,229,716,207,295,1330,327,614
2018,11,25,"Burdur",37.7203,30.29,18.4571428571429,9.5,1.64628571428571,67.6,49.81,NA,551,147,244,164,640,1426,404,1182
2018,12,25,"Burdur",37.7203,30.29,23.4142857142857,11.1428571428571,0.125,51.7285714285714,74.7514285714286,NA,425,153,418,1,0,1187,272,769
2018,13,25,"Burdur",37.7203,30.29,23.4,9.97142857142857,6.57285714285714,57.6571428571429,80.0514285714286,NA,356,217,241,75,112,428,139,187
2018,14,25,"Burdur",37.7203,30.29,17.9285714285714,11.5571428571429,0.229285714285714,47.5,54.7857142857143,NA,407,180,316,210,154,486,227,170
2018,15,25,"Burdur",37.7203,30.29,12.9285714285714,14.9,0.543428571428571,57.0571428571429,72.6857142857143,NA,374,0,0,334,394,450,374,450
2018,16,25,"Burdur",37.7203,30.29,20.6571428571429,14.7428571428571,0.0714285714285714,42.9857142857143,72.0085714285714,NA,411,64,100,224,338,648,347,548
2018,17,25,"Burdur",37.7203,30.29,15.3285714285714,16.9857142857143,0.134142857142857,42.2571428571429,48.0985714285714,NA,419,0,0,179,204,652,419,652
2018,18,25,"Burdur",37.7203,30.29,17.6,17.6428571428571,1.66771428571429,49.5142857142857,80.77,NA,303,115,199,81,101,474,188,275
2018,19,25,"Burdur",37.7203,30.29,16.1142857142857,13.9714285714286,1.52814285714286,65.1571428571429,46.4028571428571,NA,275,0,0,249,419,467,275,467
2018,20,25,"Burdur",37.7203,30.29,13.8142857142857,19.6571428571429,0.0605714285714286,44.6571428571429,56.6442857142857,NA,204,0,0,204,306,306,204,306
2018,21,25,"Burdur",37.7203,30.29,16.5571428571429,19.2428571428571,3.58614285714286,55.1142857142857,82.5628571428571,NA,252,16,38,149,148,281,236,243
2018,22,25,"Burdur",37.7203,30.29,17.2714285714286,17.6714285714286,6.315,64.3714285714286,42.5971428571429,NA,249,0,0,151,319,427,249,427
2018,23,25,"Burdur",37.7203,30.29,14.6285714285714,22.1714285714286,1.72785714285714,46.9142857142857,65.72,NA,267,70,248,179,550,812,197,564
2018,24,25,"Burdur",37.7203,30.29,16.2428571428571,20.2857142857143,3.39385714285714,56.9857142857143,40.2328571428571,NA,267,41,25,111,311,448,226,423
2018,25,25,"Burdur",37.7203,30.29,14.1714285714286,19.6,4.70085714285714,63.5,31.1171428571429,NA,358,0,0,325,504,518,358,518
2018,26,25,"Burdur",37.7203,30.29,16.1285714285714,21.7,3.00285714285714,51.9428571428571,40.2385714285714,NA,355,170,280,134,184,587,185,307
2018,27,25,"Burdur",37.7203,30.29,23.6,25.6714285714286,0,35.0857142857143,56.5557142857143,NA,342,46,80,296,338,418,296,338
2018,28,25,"Burdur",37.7203,30.29,23.3571428571429,25.8571428571429,0,41.2,71.72,NA,286,40,73,237,454,585,246,512
2018,29,25,"Burdur",37.7203,30.29,24.1714285714286,25.1714285714286,0,37.0857142857143,75.7285714285714,NA,260,29,17,231,739,756,231,739
2018,30,25,"Burdur",37.7203,30.29,15.0428571428571,23.5285714285714,0.767571428571429,50.4857142857143,62.2542857142857,NA,265,116,495,105,260,822,149,327
2018,31,25,"Burdur",37.7203,30.29,20.4142857142857,25.1571428571429,1.90928571428571,49.8428571428571,50.3042857142857,NA,267,0,0,199,463,499,267,499
2018,32,25,"Burdur",37.7203,30.29,17.2571428571429,23.9142857142857,3.34314285714286,43.5714285714286,45.49,NA,297,0,0,221,272,403,297,403
2018,33,25,"Burdur",37.7203,30.29,13.9,25.3,0.000428571428571429,32.8571428571429,47.94,NA,216,13,24,136,213,332,203,308
2018,34,25,"Burdur",37.7203,30.29,14.8,25.8857142857143,0.00485714285714286,39.3571428571429,39.8314285714286,NA,144,19,47,86,122,227,125,180
2018,35,25,"Burdur",37.7203,30.29,17.3285714285714,25.2714285714286,0.0834285714285714,43.5428571428571,57.0057142857143,NA,201,22,21,147,283,314,179,293
2018,36,25,"Burdur",37.7203,30.29,15.9,23.3857142857143,0.0108571428571429,40.7142857142857,53.2271428571429,NA,341,0,0,289,334,370,341,370
2018,37,25,"Burdur",37.7203,30.29,19.6714285714286,19.6857142857143,0.00985714285714286,45.9857142857143,41.4957142857143,NA,241,22,45,217,368,419,219,374
2018,38,25,"Burdur",37.7203,30.29,17.3714285714286,21.4142857142857,0,35.2,48.9042857142857,NA,189,0,0,157,266,344,189,344
2018,39,25,"Burdur",37.7203,30.29,22.9428571428571,18.7285714285714,0.0235714285714286,47.8142857142857,56.7271428571429,NA,180,42,78,90,173,353,138,275
2018,40,25,"Burdur",37.7203,30.29,15.9,17.2,0.211714285714286,48.3714285714286,43.7971428571429,NA,191,17,26,130,235,341,174,315
2018,41,25,"Burdur",37.7203,30.29,14.2714285714286,15.1428571428571,1.56557142857143,58.8285714285714,49.0871428571429,NA,187,0,0,101,167,422,187,422
2018,42,25,"Burdur",37.7203,30.29,11.8428571428571,16.2571428571429,0.805428571428572,59.9285714285714,169.638571428571,NA,168,0,0,87,207,381,168,381
2018,43,25,"Burdur",37.7203,30.29,19.4285714285714,10.8285714285714,1.91514285714286,61.7714285714286,54.2314285714286,NA,187,33,67,93,233,402,154,335
2018,44,25,"Burdur",37.7203,30.29,12.1428571428571,11.6714285714286,0,45.9142857142857,99.2085714285714,NA,196,0,0,174,243,264,196,264
2018,45,25,"Burdur",37.7203,30.29,11.2571428571429,10.8142857142857,0.000428571428571429,51.6857142857143,83.03,NA,231,0,0,179,381,473,231,473
2018,46,25,"Burdur",37.7203,30.29,19.4857142857143,6.85714285714286,1.13671428571429,62.0571428571429,71.46,NA,230,0,0,192,364,465,230,465
2018,47,25,"Burdur",37.7203,30.29,12.8285714285714,8.2,1.48285714285714,78.4857142857143,93.53,NA,270,45,21,177,436,499,225,478
2018,48,25,"Burdur",37.7203,30.29,17.5142857142857,7.97142857142857,1.17242857142857,80.2285714285714,69.5957142857143,NA,245,81,65,107,94,201,164,136
2018,49,25,"Burdur",37.7203,30.29,16.3,5.75714285714286,1.51914285714286,77.5714285714286,67.5914285714286,NA,257,39,35,185,331,420,218,385
2018,50,25,"Burdur",37.7203,30.29,16.2571428571429,4.88571428571429,5.78414285714286,79,63.49,NA,256,60,32,102,139,305,196,273
2018,51,25,"Burdur",37.7203,30.29,17.7857142857143,3.81428571428571,2.36842857142857,87.2428571428571,84.12,NA,250,18,12,180,199,248,232,236
2018,52,25,"Burdur",37.7203,30.29,19.2571428571429,0.785714285714286,2.64542857142857,73.8285714285714,69.8166666666667,NA,244,40,47,182,210,273,204,226
2019,1,25,"Burdur",37.7203,30.29,22.025,3.4625,4.5465,77.4125,40.3775,NA,343,53,294,39,84,784,290,490
2019,2,25,"Burdur",37.7203,30.29,18.1857142857143,0.785714285714286,0.158428571428571,73.9714285714286,48.0828571428571,NA,255,70,48,94,118,208,185,160
2019,3,25,"Burdur",37.7203,30.29,17.9285714285714,2.61428571428571,0.524428571428571,70.4285714285714,68.6071428571429,NA,192,53,32,74,99,198,139,166
2019,4,25,"Burdur",37.7203,30.29,19.2857142857143,5.48571428571429,5.25114285714286,77.3285714285714,62.5014285714286,NA,308,169,194,2,2,314,139,120
2019,5,25,"Burdur",37.7203,30.29,15.2,4.57142857142857,1.19885714285714,73.3142857142857,65.67,NA,253,104,59,93,60,143,149,84
2019,6,25,"Burdur",37.7203,30.29,14.4142857142857,5.67142857142857,1.70257142857143,69.0714285714286,75.5971428571429,NA,276,31,12,107,73,127,245,115
2019,7,25,"Burdur",37.7203,30.29,19.3714285714286,5.07142857142857,0.158,65.6428571428571,56.2828571428571,NA,325,96,129,117,39,234,229,105
2019,8,25,"Burdur",37.7203,30.29,12.8,5.3,0.0115714285714286,62.9714285714286,78.3271428571429,NA,305,1,1,193,140,219,304,218
2019,9,25,"Burdur",37.7203,30.29,19.1857142857143,5.14285714285714,1.17485714285714,60.5571428571429,57.4457142857143,NA,331,0,0,266,289,310,331,310
2019,10,25,"Burdur",37.7203,30.29,13.5714285714286,7.94285714285714,0.261285714285714,57.1285714285714,53.3571428571429,NA,359,24,1,208,176,252,335,251
2019,11,25,"Burdur",37.7203,30.29,20.8,8.12857142857143,1.42142857142857,64.9285714285714,43.45,NA,373,160,105,73,97,400,213,295
2019,12,25,"Burdur",37.7203,30.29,20.2714285714286,10.2,0.0731428571428571,49.6,54.3857142857143,NA,343,0,0,309,406,416,343,416
2019,13,25,"Burdur",37.7203,30.29,23.7571428571429,7.15714285714286,0.877714285714286,51,40.5757142857143,NA,256,49,31,110,113,194,207,163
2019,14,25,"Burdur",37.7203,30.29,18.2571428571429,9.41428571428571,0.373428571428571,59.3857142857143,38.8514285714286,NA,365,60,47,149,74,208,305,161
2019,15,25,"Burdur",37.7203,30.29,18.2428571428571,11.1285714285714,3.52114285714286,62.7,37.8514285714286,NA,359,144,89,54,27,183,215,94
2019,16,25,"Burdur",37.7203,30.29,22.6857142857143,7.44285714285714,1.75614285714286,59.2142857142857,30.6271428571429,NA,318,0,0,317,207,208,318,208
2019,17,25,"Burdur",37.7203,30.29,13.3,13.0571428571429,0.429285714285714,53.6142857142857,53.8071428571429,NA,412,0,0,360,295,313,412,313
2019,18,25,"Burdur",37.7203,30.29,17.7285714285714,14.4571428571429,1.548,51.7,32.3542857142857,NA,523,322,242,72,44,353,201,111
2019,19,25,"Burdur",37.7203,30.29,18.3,12.4571428571429,1.40771428571429,59.3142857142857,25.1114285714286,NA,452,148,128,157,133,386,304,258
2019,20,25,"Burdur",37.7203,30.29,16,18.6714285714286,0.0351428571428571,44.3857142857143,30.5757142857143,NA,454,214,203,240,186,389,240,186
2019,21,25,"Burdur",37.7203,30.29,15.5714285714286,19.3571428571429,0.414,49.4571428571429,36.0442857142857,NA,457,4,1,211,220,413,453,412
2019,22,25,"Burdur",37.7203,30.29,15.8,23.4285714285714,0.0857142857142857,37.2571428571429,39.4985714285714,NA,453,0,0,253,189,323,453,323
2019,23,25,"Burdur",37.7203,30.29,18.6857142857143,20.9714285714286,0.388714285714286,44.2428571428571,36.1,NA,378,112,66,166,330,532,266,466
2019,24,25,"Burdur",37.7203,30.29,19.3857142857143,19.2142857142857,4.32914285714286,63.6142857142857,27.5366666666667,31.07,378,0,0,376,244,244,378,244
2019,25,25,"Burdur",37.7203,30.29,15,20.5857142857143,5.69085714285714,65.0285714285714,27.0042857142857,32.14,306,0,0,306,325,325,306,325
2019,26,25,"Burdur",37.7203,30.29,22.5571428571429,24.6142857142857,0.222857142857143,44.7285714285714,29.86,25.034,377,0,0,365,326,342,377,342
2019,27,25,"Burdur",37.7203,30.29,19.7857142857143,24.3428571428571,0,33.3142857142857,31.22,42.335,456,0,0,327,165,222,456,222
2019,28,25,"Burdur",37.7203,30.29,22.8857142857143,24.2857142857143,0.0138571428571429,37.4285714285714,36.8842857142857,21.206,398,0,0,306,296,421,398,421
2019,29,25,"Burdur",37.7203,30.29,15.9571428571429,21.8285714285714,1.48314285714286,52.2285714285714,24.3857142857143,24.4357142857143,453,3,16,296,120,203,450,187
2019,30,25,"Burdur",37.7203,30.29,20.9714285714286,25.2285714285714,0,36.7285714285714,33.22,26.3171428571429,456,0,0,332,214,335,456,335
2019,31,25,"Burdur",37.7203,30.29,18.1428571428571,27,0.00157142857142857,39,39.3057142857143,25.2071428571429,334,54,55,219,219,375,280,320
2019,32,25,"Burdur",37.7203,30.29,21.5285714285714,25.2714285714286,0,30.1142857142857,29.8985714285714,17.67,346,0,0,217,196,395,346,395
2019,33,25,"Burdur",37.7203,30.29,23.2142857142857,25.1857142857143,1.10728571428571,41.6571428571429,29.3342857142857,22.16,337,5,2,199,319,531,332,529
2019,34,25,"Burdur",37.7203,30.29,21.2,23.9857142857143,0,43.4142857142857,28.6971428571429,21.4,299,0,0,222,227,345,299,345
2019,35,25,"Burdur",37.7203,30.29,17.9285714285714,25.2428571428571,0,35.0142857142857,34.7457142857143,30.37,307,0,0,302,414,415,307,415
2019,36,25,"Burdur",37.7203,30.29,18.0714285714286,22.7142857142857,2.129,50.7857142857143,32.0328571428571,32.1233333333333,171,30,7,113,51,67,141,60
2019,37,25,"Burdur",37.7203,30.29,18.6142857142857,21.8142857142857,0.0107142857142857,42.5571428571429,31.1585714285714,26.6071428571429,218,0,0,215,55,55,218,55
2019,38,25,"Burdur",37.7203,30.29,18.6714285714286,19.1285714285714,0,39.9571428571429,32.0185714285714,21.2233333333333,266,0,0,263,90,91,266,91
2019,39,25,"Burdur",37.7203,30.29,14.3571428571429,18.8,0.264,49.4,30.9257142857143,34.23,237,53,24,177,52,79,184,55
2019,40,25,"Burdur",37.7203,30.29,16.1285714285714,17.9285714285714,1.055,52.6142857142857,31.2371428571429,29.2957142857143,241,39,7,170,76,111,202,104
2019,41,25,"Burdur",37.7203,30.29,13.4,17.6,0,52.9142857142857,23.505,31.704,416,33,3,343,426,448,383,445
2019,42,25,"Burdur",37.7203,30.29,12.0714285714286,16.7857142857143,1.45471428571429,53.0571428571429,31.23,42.74,356,0,0,317,375,408,356,408
2019,43,25,"Burdur",37.7203,30.29,17.3571428571429,14.8857142857143,0,47.8571428571429,35.5914285714286,35.0325,306,0,0,177,238,300,306,300
2019,44,25,"Burdur",37.7203,30.29,12.8285714285714,11.6142857142857,0.316571428571429,57.7428571428571,45.6557142857143,41.4628571428571,350,0,0,339,239,250,350,250
2019,45,25,"Burdur",37.7203,30.29,11.9714285714286,12.2285714285714,0.00128571428571429,59.1714285714286,53.0871428571429,32.84,417,50,20,293,268,328,367,308
2019,46,25,"Burdur",37.7203,30.29,12.9285714285714,11.4285714285714,0.382571428571429,59.2,62.4728571428571,NA,401,18,16,269,217,337,383,321
2019,47,25,"Burdur",37.7203,30.29,9.75714285714286,7.7,0.237428571428571,59.3285714285714,75.54,NA,391,0,0,292,239,339,391,339
2019,48,25,"Burdur",37.7203,30.29,13.4857142857143,9.32857142857143,0.653571428571429,74.0857142857143,43.7085714285714,NA,320,23,18,123,106,251,297,233
2019,49,25,"Burdur",37.7203,30.29,16.4,3.28571428571429,0.629142857142857,67.3571428571429,57.1157142857143,NA,393,0,0,381,270,274,393,274
2019,50,25,"Burdur",37.7203,30.29,16.0714285714286,6.57142857142857,1.04642857142857,75.7571428571429,43.8228571428571,NA,218,47,11,41,7,119,171,108
2019,51,25,"Burdur",37.7203,30.29,10.4857142857143,4.7,0.000428571428571429,72.7142857142857,98.5785714285714,NA,361,57,112,299,373,488,304,376
2019,52,25,"Burdur",37.7203,30.29,21.5142857142857,4.74285714285714,2.40085714285714,71.6571428571429,33.6328571428571,NA,279,49,66,228,214,281,230,215
2020,1,25,"Burdur",37.7203,30.29,17.02,2.14,0.032,67.22,40.436,NA,160,0,0,108,80,126,160,126
2020,2,25,"Burdur",37.7203,30.29,22.9571428571429,2.1,3.45028571428571,69.3142857142857,49.07,NA,240,0,0,211,140,173,240,173
2020,3,25,"Burdur",37.7203,30.29,15.9285714285714,1.48571428571429,0,67.1714285714286,65.7514285714286,NA,270,0,0,219,338,382,270,382
2020,4,25,"Burdur",37.7203,30.29,21.3285714285714,-0.185714285714286,0.000428571428571429,53.1571428571429,59.0814285714286,NA,358,0,0,350,292,295,358,295
2020,5,25,"Burdur",37.7203,30.29,13.1285714285714,3.91428571428571,1.69957142857143,73.0714285714286,47.7928571428571,NA,331,9,18,82,45,272,322,254
2020,6,25,"Burdur",37.7203,30.29,25.9,3.21428571428571,3.503,69.8714285714286,29.5166666666667,NA,343,200,156,87,65,267,143,111
2020,7,25,"Burdur",37.7203,30.29,14.3142857142857,3.11428571428571,1.57728571428571,74.3714285714286,47.932,NA,341,36,25,152,182,338,305,313
2020,8,25,"Burdur",37.7203,30.29,18.2142857142857,4.6,4.88142857142857,67.5285714285714,43.7285714285714,NA,283,31,59,218,114,187,252,128
2020,9,25,"Burdur",37.7203,30.29,25.1428571428571,6.2,0.880142857142857,65.0714285714286,41.19,NA,393,122,202,214,289,528,271,326
2020,10,25,"Burdur",37.7203,30.29,17.3428571428571,8.47142857142857,1.50457142857143,60.3285714285714,43.9171428571429,NA,205,83,54,42,61,210,122,156
2020,11,25,"Burdur",37.7203,30.29,18.1857142857143,11.0428571428571,1.31885714285714,56.7,42.8714285714286,NA,115,46,15,51,59,94,69,79
2020,12,25,"Burdur",37.7203,30.29,24.3,3.94285714285714,0.302428571428571,53.9714285714286,24.9414285714286,NA,117,0,0,95,80,118,117,118
2020,13,25,"Burdur",37.7203,30.29,14.7428571428571,9.64285714285714,1.13614285714286,64.4857142857143,35.8271428571429,NA,136,11,6,50,25,92,125,86
2020,14,25,"Burdur",37.7203,30.29,20.4285714285714,10.2285714285714,1.24457142857143,61.4,30.92,NA,155,47,35,77,63,121,108,86
2020,15,25,"Burdur",37.7203,30.29,22.4571428571429,11.0142857142857,1.38985714285714,58.1428571428571,40.7642857142857,NA,133,1,0,85,91,118,132,118
2020,16,25,"Burdur",37.7203,30.29,19.5142857142857,13.2142857142857,0.005,51.1,32.8514285714286,NA,141,22,15,70,58,106,119,91
2020,17,25,"Burdur",37.7203,30.29,21.7714285714286,12.9571428571429,0.315285714285714,55.6571428571429,28.0714285714286,NA,137,0,0,109,82,123,137,123
2020,18,25,"Burdur",37.7203,30.29,19.6714285714286,13.2428571428571,4.92814285714286,62.8571428571429,23.6742857142857,NA,146,36,30,64,96,164,110,134
2020,19,25,"Burdur",37.7203,30.29,23.3857142857143,12.8857142857143,4.00557142857143,66.4285714285714,22.5471428571429,NA,137,0,0,129,151,157,137,157
2020,20,25,"Burdur",37.7203,30.29,16.8142857142857,21.2285714285714,0,45.9,43.89,NA,164,0,0,137,130,164,164,164
2020,21,25,"Burdur",37.7203,30.29,34.0142857142857,19.0285714285714,0.478857142857143,42.6142857142857,51.7257142857143,NA,146,46,15,98,79,96,100,81
2020,22,25,"Burdur",37.7203,30.29,20.0571428571429,14.5,4.886,57.1,15.9771428571429,NA,118,12,4,24,10,100,106,96
2020,23,25,"Burdur",37.7203,30.29,22.1142857142857,16.3571428571429,2.73571428571429,54.5428571428571,20.6157142857143,NA,112,38,28,29,17,70,74,42
2020,24,25,"Burdur",37.7203,30.29,16.5857142857143,19.8,0.0384285714285714,50.3428571428571,33.1828571428571,NA,140,34,49,65,39,150,106,101
2020,25,25,"Burdur",37.7203,30.29,17.5857142857143,20.5285714285714,0.522714285714286,52.4142857142857,30.7557142857143,NA,137,37,35,100,73,108,100,73
2020,26,25,"Burdur",37.7203,30.29,16.4571428571429,22.5428571428571,1.45171428571429,48.5428571428571,26.9342857142857,NA,173,54,43,117,90,133,119,90
2020,27,25,"Burdur",37.7203,30.29,20.4571428571429,26.6,0.00185714285714286,33.9,32.33,NA,113,0,0,101,108,113,113,113
2020,28,25,"Burdur",37.7203,30.29,21.4428571428571,26.3142857142857,0.368857142857143,37.6428571428571,29.11,NA,164,23,36,120,81,122,141,86
2020,29,25,"Burdur",37.7203,30.29,22.0571428571429,26.0857142857143,0.213857142857143,42.6857142857143,32.0728571428571,NA,186,17,15,140,74,111,169,96
2020,30,25,"Burdur",37.7203,30.29,21.0285714285714,27,0,32.1285714285714,34.0885714285714,NA,190,0,0,165,135,142,190,142
2020,31,25,"Burdur",37.7203,30.29,23.3428571428571,28.4428571428571,0.264142857142857,30.9714285714286,33.5414285714286,NA,150,0,0,150,127,127,150,127
2020,32,25,"Burdur",37.7203,30.29,18.1571428571429,26.7571428571429,1.06057142857143,37.6142857142857,38.8385714285714,NA,146,0,0,126,65,107,146,107
2020,33,25,"Burdur",37.7203,30.29,17.7857142857143,24.3142857142857,0.622,43.6428571428571,26.6214285714286,NA,183,0,0,177,81,83,183,83
2020,34,25,"Burdur",37.7203,30.29,21.0714285714286,24.9142857142857,0.0224285714285714,35.6142857142857,31.65,23.75,197,0,0,189,94,97,197,97
2020,35,25,"Burdur",37.7203,30.29,13.7714285714286,25.0142857142857,1.48228571428571,34.8857142857143,34.44,40.2485714285714,164,0,0,161,156,157,164,157
2020,36,25,"Burdur",37.7203,30.29,21.0857142857143,25.4857142857143,0,32.8571428571429,37.7528571428571,30.1114285714286,179,19,5,160,107,112,160,107
2020,37,25,"Burdur",37.7203,30.29,19.3571428571429,24.6142857142857,0.00457142857142857,36.1142857142857,35.8614285714286,32.55,193,23,9,156,69,91,170,82
2020,38,25,"Burdur",37.7203,30.29,16.4714285714286,23.7428571428571,0.254428571428571,42.3285714285714,41.5257142857143,37.025,235,0,0,231,155,157,235,157
2020,39,25,"Burdur",37.7203,30.29,14.8428571428571,21.4142857142857,0.424428571428571,51.2428571428571,34.96,26.9533333333333,220,63,33,157,96,129,157,96
2020,40,25,"Burdur",37.7203,30.29,14.9714285714286,18.8142857142857,0,41.8,40.9257142857143,30.3985714285714,187,0,0,153,112,154,187,154
2020,41,25,"Burdur",37.7203,30.29,14.4714285714286,19.6571428571429,1.16171428571429,47.6428571428571,57.0028571428571,28.22,182,17,7,109,84,127,165,120
2020,42,25,"Burdur",37.7203,30.29,12.5,17,0.0397142857142857,49.9428571428571,35.7783333333333,29.0614285714286,177,34,7,75,46,111,143,104
2020,43,25,"Burdur",37.7203,30.29,11.5285714285714,14.7285714285714,2.81228571428571,65.8857142857143,37.8814285714286,32.86,194,0,0,108,72,161,194,161
2020,44,25,"Burdur",37.7203,30.29,16.4857142857143,14.2428571428571,1.155,61.1142857142857,53.1485714285714,29.8557142857143,255,93,94,60,57,233,162,139
2020,45,25,"Burdur",37.7203,30.29,23.6428571428571,11.0285714285714,0.000857142857142857,53.8857142857143,41.3371428571429,26.0828571428571,156,0,0,82,57,103,156,103
2020,46,25,"Burdur",37.7203,30.29,14.2571428571429,10.2,1.43685714285714,59.0571428571429,63.67,39.9071428571429,208,0,0,202,104,109,208,109
2020,47,25,"Burdur",37.7203,30.29,13.7,7,0.777142857142857,69.8714285714286,59.1642857142857,37.1157142857143,173,0,0,168,81,83,173,83
2020,48,25,"Burdur",37.7203,30.29,12.9714285714286,4.91428571428571,0,56.5714285714286,68.5228571428571,36.6528571428571,199,0,0,153,184,262,199,262
2020,49,25,"Burdur",37.7203,30.29,10.5,6.84285714285714,0.005,71.6285714285714,69.0271428571429,39.0728571428571,207,18,17,128,56,116,189,99
2020,50,25,"Burdur",37.7203,30.29,16.7428571428571,7.71428571428571,1.08514285714286,72.5714285714286,43.8842857142857,24.9414285714286,181,82,66,27,11,98,99,32
2020,51,25,"Burdur",37.7203,30.29,15.4857142857143,5.58571428571429,2.66928571428571,80.1428571428571,52.6828571428571,27.1571428571429,171,1,2,139,75,90,170,88
2020,52,25,"Burdur",37.7203,30.29,11.5428571428571,3.8,0,80.9571428571429,78.7314285714286,30.2957142857143,203,0,0,99,60,113,203,113
2020,53,25,"Burdur",37.7203,30.29,10.5,4.875,3.18275,91.575,53.41,31.395,122,19,10,62,66,111,103,101
2017,1,26,"Beyazit",40.1828,29.0665,24.4285714285714,2.47142857142857,4.37142857142857,74.9571428571429,77.13,64.93,563,173,151,37,88,847,390,696
2017,2,26,"Beyazit",40.1828,29.0665,28.8571428571429,4.08571428571429,4.77142857142857,72.4285714285714,76.3485714285714,72.0814285714286,757,317,411,0,0,1214,440,803
2017,3,26,"Beyazit",40.1828,29.0665,15.4428571428571,5.45714285714286,2.45714285714286,84.9714285714286,85.1171428571429,71.4842857142857,762,0,0,116,193,1449,762,1449
2017,4,26,"Beyazit",40.1828,29.0665,18.8428571428571,1.8,0.114285714285714,76.1857142857143,77.9871428571429,74.3542857142857,639,97,52,139,138,889,542,837
2017,5,26,"Beyazit",40.1828,29.0665,19.0857142857143,4.22857142857143,0.0285714285714286,64.7,105.291428571429,78.5757142857143,588,116,155,0,0,1163,472,1008
2017,6,26,"Beyazit",40.1828,29.0665,22.0428571428571,7.85714285714286,0.0571428571428571,73.0571428571429,66.4757142857143,61.9985714285714,736,0,0,32,117,1519,736,1519
2017,7,26,"Beyazit",40.1828,29.0665,16.3571428571429,2.85714285714286,0.0172857142857143,68.9142857142857,91.0928571428571,88.6928571428571,492,61,47,147,233,717,431,670
2017,8,26,"Beyazit",40.1828,29.0665,21.5,9.8,2.17142857142857,75.2714285714286,84.7714285714286,68.0014285714286,739,0,0,191,443,1747,739,1747
2017,9,26,"Beyazit",40.1828,29.0665,14.7,10.6,0.142857142857143,77.6,120.335714285714,75.1928571428572,574,41,59,171,316,866,533,807
2017,10,26,"Beyazit",40.1828,29.0665,18.2714285714286,11.5,0.171428571428571,75.0857142857143,96.1742857142857,75.5457142857143,712,105,131,143,334,1043,607,912
2017,11,26,"Beyazit",40.1828,29.0665,15.5,5.87142857142857,2.74285714285714,87.4142857142857,82.312,72.484,525,0,0,248,334,725,525,725
2017,12,26,"Beyazit",40.1828,29.0665,15.2142857142857,10.8571428571429,0,71.7428571428571,117.032857142857,89.52,589,0,0,428,819,1077,589,1077
2017,13,26,"Beyazit",40.1828,29.0665,21.7142857142857,9.61428571428571,0.00414285714285714,69.1,85.3171428571429,79.0685714285714,574,0,0,176,296,887,574,887
2017,14,26,"Beyazit",40.1828,29.0665,14.5428571428571,11.6714285714286,1.88571428571429,73.4,96.2971428571429,84.8214285714286,639,0,0,573,1229,1336,639,1336
2017,15,26,"Beyazit",40.1828,29.0665,15.1,13.1,0.0285714285714286,65.2,94.96,88.6671428571428,587,23,37,157,402,1187,564,1150
2017,16,26,"Beyazit",40.1828,29.0665,19.8571428571429,11.1571428571429,4.54285714285714,77.3571428571429,54.6285714285714,68.0866666666667,717,132,190,214,330,920,585,730
2017,17,26,"Beyazit",40.1828,29.0665,14.3571428571429,15.1,0.142857142857143,60.8142857142857,93.34,95.7816666666667,731,0,0,579,1246,1478,731,1478
2017,18,26,"Beyazit",40.1828,29.0665,15.4,17.1285714285714,2.14285714285714,76.9142857142857,95.8785714285714,71.2428571428571,506,0,0,139,276,923,506,923
2017,19,26,"Beyazit",40.1828,29.0665,17.8142857142857,20,1.11428571428571,67.6285714285714,72.5783333333333,64.18,471,0,0,246,443,966,471,966
2017,20,26,"Beyazit",40.1828,29.0665,21.1857142857143,16.7,1.62857142857143,70.1857142857143,51.0757142857143,58.0885714285714,472,0,0,95,498,1205,472,1205
2017,21,26,"Beyazit",40.1828,29.0665,15.8714285714286,17.5571428571429,5.42857142857143,74.7714285714286,68.8471428571429,66.6457142857143,448,0,0,245,407,849,448,849
2017,22,26,"Beyazit",40.1828,29.0665,14.2857142857143,21.2,4.14285714285714,73.7142857142857,64.8357142857143,66.9833333333333,522,0,0,156,218,1015,522,1015
2017,23,26,"Beyazit",40.1828,29.0665,14.5428571428571,20.9714285714286,3.51428571428571,80.3428571428571,67.6,64.81,578,0,0,360,843,1388,578,1388
2017,24,26,"Beyazit",40.1828,29.0665,17.2,22.0285714285714,1.85714285714286,67.8857142857143,55.68,65.94,552,0,0,339,699,1139,552,1139
2017,25,26,"Beyazit",40.1828,29.0665,14.5857142857143,23.0428571428571,2.02857142857143,70.2285714285714,57.6285714285714,73.81,584,0,0,79,183,1041,584,1041
2017,26,26,"Beyazit",40.1828,29.0665,13.2571428571429,28.1571428571429,0,59.5285714285714,55.022,68.95,564,0,0,297,598,971,564,971
2017,27,26,"Beyazit",40.1828,29.0665,22.2857142857143,23.7285714285714,0.0571428571428571,66.6857142857143,49.735,57.7242857142857,511,0,0,229,227,642,511,642
2017,28,26,"Beyazit",40.1828,29.0665,22.4285714285714,24.9571428571429,0,64.4571428571429,50.94,63.3885714285714,481,0,0,50,105,864,481,864
2017,29,26,"Beyazit",40.1828,29.0665,23.2857142857143,24.0571428571429,0.425714285714286,70.8428571428571,45.71,58.1733333333333,532,0,0,140,338,1272,532,1272
2017,30,26,"Beyazit",40.1828,29.0665,18.5428571428571,25.5714285714286,2.05714285714286,62.1,67.7385714285714,83.6833333333333,531,0,0,267,425,928,531,928
2017,31,26,"Beyazit",40.1828,29.0665,30.4571428571429,26.4142857142857,0,65.1428571428571,52.7828571428571,65.208,559,0,0,207,421,1047,559,1047
2017,32,26,"Beyazit",40.1828,29.0665,22.2,27.2571428571429,0,68.1,60.9228571428571,55.8214285714286,567,0,0,293,503,1092,567,1092
2017,33,26,"Beyazit",40.1828,29.0665,20.3285714285714,25.1,0,70.1714285714286,57.5571428571429,60.5271428571429,596,0,0,358,813,1199,596,1199
2017,34,26,"Beyazit",40.1828,29.0665,24.0142857142857,22.5285714285714,0.731285714285714,69.3142857142857,45.5385714285714,55.6214285714286,601,0,0,69,363,1280,601,1280
2017,35,26,"Beyazit",40.1828,29.0665,19.3428571428571,22.8857142857143,0,59.3428571428571,39.7142857142857,58.9771428571429,493,0,0,27,39,1014,493,1014
2017,36,26,"Beyazit",40.1828,29.0665,13.7714285714286,22.3714285714286,0,61.1571428571429,68.4633333333333,85.7071428571429,507,0,0,269,720,1321,507,1321
2017,37,26,"Beyazit",40.1828,29.0665,17.4571428571429,23.9142857142857,0,65.8857142857143,96.65,86.8357142857143,589,0,0,412,763,1138,589,1138
2017,38,26,"Beyazit",40.1828,29.0665,16.9428571428571,21.6,1.04457142857143,61.6714285714286,76.6928571428571,82.1614285714286,671,0,0,414,791,1312,671,1312
2017,39,26,"Beyazit",40.1828,29.0665,18.2857142857143,18.8714285714286,1.8,75.6428571428571,55.5042857142857,60.4642857142857,782,0,0,172,280,1630,782,1630
2017,40,26,"Beyazit",40.1828,29.0665,13.0857142857143,15.7857142857143,1.37142857142857,72.9857142857143,64.6057142857143,69.5085714285714,543,0,0,81,161,1137,543,1137
2017,41,26,"Beyazit",40.1828,29.0665,14.0714285714286,13.5714285714286,0.571428571428572,71.1571428571429,69.7071428571429,76.1214285714286,487,0,0,192,231,843,487,843
2017,42,26,"Beyazit",40.1828,29.0665,10.6285714285714,15.5571428571429,0,67.8142857142857,88.6771428571429,89.7585714285714,530,0,0,420,652,815,530,815
2017,43,26,"Beyazit",40.1828,29.0665,11.9428571428571,14.0857142857143,3.71428571428571,83.6285714285714,92.79,68.8171428571429,506,0,0,0,0,919,506,919
2017,44,26,"Beyazit",40.1828,29.0665,13.7571428571429,9.12857142857143,1.4,74.2857142857143,109.675,76.97,561,67,129,109,137,1102,494,973
2017,45,26,"Beyazit",40.1828,29.0665,9.48571428571429,11.4714285714286,0,79.8285714285714,147.594285714286,88.4057142857143,577,26,8,177,203,829,551,821
2017,46,26,"Beyazit",40.1828,29.0665,9.78571428571429,13.1,0.114285714285714,78.5428571428571,161.537142857143,84.1685714285714,587,27,12,9,9,1085,560,1073
2017,47,26,"Beyazit",40.1828,29.0665,13.2714285714286,8.11428571428571,5.71671428571429,80.9,129.194285714286,79.6257142857143,418,17,36,168,238,804,401,768
2017,48,26,"Beyazit",40.1828,29.0665,18.9857142857143,12.5571428571429,0.285714285714286,69.3714285714286,83.6885714285714,66.8142857142857,386,100,113,0,0,619,286,506
2017,49,26,"Beyazit",40.1828,29.0665,18.7,7.48571428571429,8.65714285714286,79.2428571428571,117.462857142857,72.26,407,2,0,83,127,645,405,645
2017,50,26,"Beyazit",40.1828,29.0665,16.1571428571429,10.5571428571429,0.103142857142857,74.4,150.202857142857,87.0714285714286,346,102,180,47,89,442,244,262
2017,51,26,"Beyazit",40.1828,29.0665,17.3857142857143,5.84285714285714,7.31714285714286,86.6285714285714,52.23,55.5014285714286,386,0,0,90,77,349,386,349
2017,52,26,"Beyazit",40.1828,29.0665,17.1125,6.9375,1.211125,77.275,118.5525,80.475,528,191,166,0,0,507,337,341
2018,1,26,"Beyazit",40.1828,29.0665,11.95,6.1625,1.025,85.375,140.208571428571,81.2857142857143,618,34,74,0,0,914,584,840
2018,2,26,"Beyazit",40.1828,29.0665,17.6428571428571,7.15714285714286,1.43842857142857,82.8714285714286,134.78,70.4028571428571,624,73,73,23,45,1309,551,1236
2018,3,26,"Beyazit",40.1828,29.0665,19.6428571428571,6.61428571428571,5.82557142857143,74.8142857142857,93.0342857142857,66.31,639,173,350,0,0,655,466,305
2018,4,26,"Beyazit",40.1828,29.0665,20.3571428571429,3.34285714285714,1.42314285714286,76.2571428571429,69.1171428571429,67.2071428571429,604,86,169,60,65,764,518,595
2018,5,26,"Beyazit",40.1828,29.0665,15.5285714285714,8.71428571428571,0,70.7142857142857,182.102857142857,94.7657142857143,670,2,0,206,169,819,668,819
2018,6,26,"Beyazit",40.1828,29.0665,18.4857142857143,9.44285714285714,4.02857142857143,83.2714285714286,123.682857142857,80.4528571428571,704,2,0,210,292,1022,702,1022
2018,7,26,"Beyazit",40.1828,29.0665,16.7857142857143,7.98571428571429,0.314285714285714,80.6142857142857,71.4485714285714,66.2714285714286,478,71,104,107,88,557,407,453
2018,8,26,"Beyazit",40.1828,29.0665,14.9142857142857,7.85714285714286,4.93357142857143,84.8,102.971428571429,73.1628571428571,711,0,0,147,259,1321,711,1321
2018,9,26,"Beyazit",40.1828,29.0665,25.3571428571429,8.12857142857143,7.82471428571429,79.6571428571429,59.8385714285714,58.45,621,95,155,134,181,956,526,801
2018,10,26,"Beyazit",40.1828,29.0665,18.9857142857143,12.1428571428571,4.65442857142857,81.1857142857143,103.598571428571,69.8757142857143,556,0,0,69,177,1330,556,1330
2018,11,26,"Beyazit",40.1828,29.0665,21.7285714285714,14.0857142857143,2.71428571428571,69,95.2457142857143,66.4,551,7,9,115,275,1426,544,1417
2018,12,26,"Beyazit",40.1828,29.0665,20.9571428571429,11.9857142857143,2.68571428571429,77.3571428571429,77.6871428571429,63.9857142857143,425,0,0,201,461,1187,425,1187
2018,13,26,"Beyazit",40.1828,29.0665,18.8285714285714,13.4857142857143,0.828571428571429,69.3714285714286,109.11,67.9385714285714,356,60,54,94,124,428,296,374
2018,14,26,"Beyazit",40.1828,29.0665,14.8428571428571,13.0714285714286,1.37142857142857,70.2428571428571,98.6614285714286,84.4114285714286,407,0,0,207,192,486,407,486
2018,15,26,"Beyazit",40.1828,29.0665,12.7428571428571,15.6857142857143,0.0571428571428571,80.0142857142857,137.62,92.4185714285714,374,0,0,278,219,450,374,450
2018,16,26,"Beyazit",40.1828,29.0665,17.6428571428571,13.2571428571429,0.714285714285714,73.5428571428571,84.6457142857143,75.4885714285714,411,0,0,203,228,648,411,648
2018,17,26,"Beyazit",40.1828,29.0665,18.0142857142857,18.5142857142857,0.0571428571428571,61.7857142857143,90.0828571428571,91.1242857142857,419,0,0,222,302,652,419,652
2018,18,26,"Beyazit",40.1828,29.0665,13,17.4571428571429,1.34285714285714,81.1571428571429,111.657142857143,74.9985714285714,303,0,0,148,226,474,303,474
2018,19,26,"Beyazit",40.1828,29.0665,14.0714285714286,16.7428571428571,5.2,82.8714285714286,60.44,62.9114285714286,275,0,0,110,243,467,275,467
2018,20,26,"Beyazit",40.1828,29.0665,15.1,22.6571428571429,0,62.6,79.6614285714286,77.6557142857143,204,0,0,54,94,306,204,306
2018,21,26,"Beyazit",40.1828,29.0665,16.9857142857143,20.3142857142857,6.28571428571429,82.0571428571429,65.9228571428571,56.5885714285714,252,0,0,120,163,281,252,281
2018,22,26,"Beyazit",40.1828,29.0665,20.1142857142857,20.7571428571429,0.0571428571428571,71.0857142857143,59.1014285714286,56.6514285714286,249,0,0,100,152,427,249,427
2018,23,26,"Beyazit",40.1828,29.0665,14.5428571428571,24.6714285714286,0.142857142857143,65.1714285714286,73.6457142857143,73.4214285714286,267,0,0,142,487,812,267,812
2018,24,26,"Beyazit",40.1828,29.0665,18.7857142857143,23.6,2,63.9428571428571,51.6885714285714,67.5542857142857,267,0,0,107,282,448,267,448
2018,25,26,"Beyazit",40.1828,29.0665,18.8285714285714,22.5857142857143,3.11428571428571,78.8714285714286,55.1457142857143,53.0628571428571,358,0,0,95,120,518,358,518
2018,26,26,"Beyazit",40.1828,29.0665,16.6857142857143,23.0142857142857,2.8,76.9142857142857,50.0928571428571,54.1842857142857,355,0,0,128,229,587,355,587
2018,27,26,"Beyazit",40.1828,29.0665,19.3,25.1714285714286,0,60.5142857142857,52.8128571428571,61.8085714285714,342,0,0,114,168,418,342,418
2018,28,26,"Beyazit",40.1828,29.0665,19.6,26.0428571428571,0,67.8714285714286,54.3885714285714,56.6571428571429,286,0,0,146,234,585,286,585
2018,29,26,"Beyazit",40.1828,29.0665,15.3142857142857,26.1428571428571,1.2,61.3,66.9757142857143,72.0057142857143,260,0,0,206,606,756,260,756
2018,30,26,"Beyazit",40.1828,29.0665,19.7714285714286,24.9714285714286,1.08571428571429,66.4285714285714,73.0157142857143,65.6828571428571,265,0,0,221,746,822,265,822
2018,31,26,"Beyazit",40.1828,29.0665,34.6571428571429,26.3571428571429,0.0285714285714286,66.7285714285714,54.8714285714286,50.1428571428571,267,0,0,29,22,499,267,499
2018,32,26,"Beyazit",40.1828,29.0665,26.1571428571429,26.1714285714286,0,56.5857142857143,44.8971428571429,34.8742857142857,297,0,0,18,49,403,297,403
2018,33,26,"Beyazit",40.1828,29.0665,21.1,26.0142857142857,0.171428571428571,59.6857142857143,62.1057142857143,36.3971428571429,216,0,0,77,155,332,216,332
2018,34,26,"Beyazit",40.1828,29.0665,20.8857142857143,26.1571428571429,0,58.6142857142857,47.7042857142857,29.3971428571429,144,0,0,55,112,227,144,227
2018,35,26,"Beyazit",40.1828,29.0665,21.1857142857143,26.5714285714286,0.228571428571429,62.4,59.0628571428571,35.0414285714286,201,0,0,42,78,314,201,314
2018,36,26,"Beyazit",40.1828,29.0665,15.6142857142857,23.8428571428571,2.42857142857143,66.6857142857143,64.642,44.122,341,0,0,167,195,370,341,370
2018,37,26,"Beyazit",40.1828,29.0665,17.3285714285714,20,3.82857142857143,73.6857142857143,55.62,49.57,241,0,0,142,255,419,241,419
2018,38,26,"Beyazit",40.1828,29.0665,19.0142857142857,20.4428571428571,0,71.6857142857143,49.8114285714286,50.5785714285714,189,0,0,99,143,344,189,344
2018,39,26,"Beyazit",40.1828,29.0665,19.3285714285714,18.7571428571429,0.714285714285714,68.7142857142857,46.9757142857143,46.3228571428571,180,0,0,13,19,353,180,353
2018,40,26,"Beyazit",40.1828,29.0665,17.4571428571429,18.5428571428571,1.02857142857143,71.6571428571429,53.1271428571429,47.0414285714286,191,4,4,79,124,341,187,337
2018,41,26,"Beyazit",40.1828,29.0665,20.4142857142857,17.7,0.224571428571429,76.7571428571429,54.8357142857143,41.2571428571429,187,0,0,38,101,422,187,422
2018,42,26,"Beyazit",40.1828,29.0665,14.1,18.2714285714286,1.85714285714286,83.3714285714286,85.6557142857143,36.9214285714286,168,0,0,62,180,381,168,381
2018,43,26,"Beyazit",40.1828,29.0665,13.2571428571429,12.9285714285714,4.85714285714286,79.2285714285714,75.4757142857143,37.8128571428571,187,0,0,0,0,402,187,402
2018,44,26,"Beyazit",40.1828,29.0665,10.4285714285714,14.3714285714286,0,76.8142857142857,119.954,61.218,196,1,1,27,31,264,195,263
2018,45,26,"Beyazit",40.1828,29.0665,11.9142857142857,12.4142857142857,0,81.6142857142857,100.42,75.752,231,0,0,51,114,473,231,473
2018,46,26,"Beyazit",40.1828,29.0665,18.1428571428571,9.78571428571428,2.1,78.7714285714286,57.81,58.1271428571429,230,0,0,0,0,465,230,465
2018,47,26,"Beyazit",40.1828,29.0665,14.7285714285714,12.3428571428571,1.85714285714286,82.3714285714286,89.4857142857143,60.0042857142857,270,45,21,38,55,499,225,478
2018,48,26,"Beyazit",40.1828,29.0665,19.3,10.3285714285714,4.08571428571429,77.2714285714286,50.5,50.1428571428571,245,18,3,0,0,201,227,198
2018,49,26,"Beyazit",40.1828,29.0665,14.9428571428571,6.6,1.77142857142857,83.1142857142857,108.321428571429,77.2171428571429,257,0,0,70,110,420,257,420
2018,50,26,"Beyazit",40.1828,29.0665,18.0571428571429,6.78571428571429,6.4,85.1571428571429,91.8985714285714,79.7685714285714,256,4,3,0,0,305,252,302
2018,51,26,"Beyazit",40.1828,29.0665,13.6571428571429,6.1,3.85714285714286,89.5,119.694285714286,68.9,250,27,35,79,90,248,223,213
2018,52,26,"Beyazit",40.1828,29.0665,13.1857142857143,3.22857142857143,3,85.2,132.577142857143,81.8214285714286,244,0,0,38,47,273,244,273
2019,1,26,"Beyazit",40.1828,29.0665,19.9375,3.9125,4.98125,85.9875,63.11625,65.415,343,1,1,47,48,784,342,783
2019,2,26,"Beyazit",40.1828,29.0665,18.6,4.87142857142857,4.25714285714286,79.1,61.6971428571429,67.1657142857143,255,77,64,28,33,208,178,144
2019,3,26,"Beyazit",40.1828,29.0665,15.1571428571429,4.41428571428571,2.02857142857143,79,92.7842857142857,95.4128571428571,192,5,5,31,21,198,187,193
2019,4,26,"Beyazit",40.1828,29.0665,20.3857142857143,9.07142857142857,0.371428571428571,74.6571428571429,83.7785714285714,81.6528571428571,308,50,23,48,43,314,258,291
2019,5,26,"Beyazit",40.1828,29.0665,18.4142857142857,9.91428571428571,0.685714285714286,66.5428571428571,73.7933333333333,92.49,253,69,50,0,0,143,184,93
2019,6,26,"Beyazit",40.1828,29.0665,18.0142857142857,7.55714285714286,1.48571428571429,81.7285714285714,52.082,66.072,276,2,0,58,48,127,274,127
2019,7,26,"Beyazit",40.1828,29.0665,21.9857142857143,6.42857142857143,2.17142857142857,76.3571428571429,47.8514285714286,65.9014285714286,325,3,3,60,10,234,322,231
2019,8,26,"Beyazit",40.1828,29.0665,15.6571428571429,5.25714285714286,0.571428571428572,80.7428571428571,120.538571428571,70.3871428571429,305,36,15,104,72,219,269,204
2019,9,26,"Beyazit",40.1828,29.0665,16.9142857142857,5.88571428571429,1.11428571428571,78.2428571428571,59.2214285714286,70.1971428571429,331,0,0,95,65,310,331,310
2019,10,26,"Beyazit",40.1828,29.0665,14.8428571428571,9.9,0,63.7571428571429,86.9214285714286,106.944285714286,359,0,0,47,7,252,359,252
2019,11,26,"Beyazit",40.1828,29.0665,17.3571428571429,9.94285714285714,1.94914285714286,75.0714285714286,50.7757142857143,72.6114285714286,373,0,0,73,58,400,373,400
2019,12,26,"Beyazit",40.1828,29.0665,23.5,9.52857142857143,0,66.8571428571429,58.3828571428571,83.0642857142857,343,0,0,45,267,416,343,416
2019,13,26,"Beyazit",40.1828,29.0665,29.3857142857143,7.37142857142857,0,61,48.2185714285714,73.2914285714286,256,0,0,124,95,194,256,194
2019,14,26,"Beyazit",40.1828,29.0665,18.3285714285714,10.0857142857143,0,72.6,73.0885714285714,90.6657142857143,365,0,0,123,107,208,365,208
2019,15,26,"Beyazit",40.1828,29.0665,18.1142857142857,13.8142857142857,5.77142857142857,80.2714285714286,48.66,70.608,359,0,0,144,69,183,359,183
2019,16,26,"Beyazit",40.1828,29.0665,16.4857142857143,8.84285714285714,0.183714285714286,73.2142857142857,45.1571428571429,72.6142857142857,318,0,0,187,160,208,318,208
2019,17,26,"Beyazit",40.1828,29.0665,13,14.1285714285714,0.285714285714286,63.9142857142857,78.3985714285714,98.46,412,0,0,257,195,313,412,313
2019,18,26,"Beyazit",40.1828,29.0665,19.0857142857143,17.4285714285714,0.457142857142857,63.2714285714286,67.286,76.168,523,0,0,123,77,353,523,353
2019,19,26,"Beyazit",40.1828,29.0665,15.1,14.9714285714286,5.41985714285714,73.0285714285714,50.57,69.5157142857143,452,64,73,236,156,386,388,313
2019,20,26,"Beyazit",40.1828,29.0665,14.2142857142857,19.1571428571429,0.885714285714286,75.7714285714286,59.9771428571429,77.7142857142857,454,0,0,187,194,389,454,389
2019,21,26,"Beyazit",40.1828,29.0665,19.3571428571429,20.6142857142857,0.336428571428571,70.5714285714286,57.5971428571429,69.6985714285714,457,0,0,71,125,413,457,413
2019,22,26,"Beyazit",40.1828,29.0665,15.0571428571429,23.1142857142857,0.231714285714286,66.3428571428571,56.7671428571429,80.3842857142857,453,0,0,258,154,323,453,323
2019,23,26,"Beyazit",40.1828,29.0665,19,22.2285714285714,1.61185714285714,66.0714285714286,39.3142857142857,57.2342857142857,378,0,0,222,220,532,378,532
2019,24,26,"Beyazit",40.1828,29.0665,20.9714285714286,23.3571428571429,0.967571428571429,73.8142857142857,45.4328571428571,57.9757142857143,378,0,0,279,142,244,378,244
2019,25,26,"Beyazit",40.1828,29.0665,16.1714285714286,23.2571428571429,4.02542857142857,78.0285714285714,49.9457142857143,66.9314285714286,306,0,0,52,44,325,306,325
2019,26,26,"Beyazit",40.1828,29.0665,25.6428571428571,24.4,0.00314285714285714,63.3857142857143,36.0114285714286,50.4385714285714,377,0,0,18,9,342,377,342
2019,27,26,"Beyazit",40.1828,29.0665,22.8142857142857,24.3285714285714,0,61.6857142857143,41.8828571428571,61.4214285714286,456,0,0,216,119,222,456,222
2019,28,26,"Beyazit",40.1828,29.0665,14.8142857142857,22.4714285714286,2.74757142857143,68.1428571428571,40.0057142857143,71.7314285714286,398,0,0,292,285,421,398,421
2019,29,26,"Beyazit",40.1828,29.0665,20.7142857142857,22.0571428571429,0.899857142857143,72.2,31.8585714285714,56.34,453,0,0,0,0,203,453,203
2019,30,26,"Beyazit",40.1828,29.0665,20.8857142857143,23.4714285714286,0.285714285714286,66.0428571428571,36.3371428571429,57.68,456,0,0,134,144,335,456,335
2019,31,26,"Beyazit",40.1828,29.0665,16.9428571428571,25.7,0,63.7142857142857,42.2914285714286,63.6457142857143,334,0,0,287,299,375,334,375
2019,32,26,"Beyazit",40.1828,29.0665,24.0571428571429,23.3571428571429,0,61.5,32.66,58.4828571428571,346,0,0,104,102,395,346,395
2019,33,26,"Beyazit",40.1828,29.0665,19.9714285714286,23.3714285714286,4.45942857142857,72.9571428571429,32.8328571428571,48.91,337,0,0,240,388,531,337,531
2019,34,26,"Beyazit",40.1828,29.0665,21.4428571428571,23.2714285714286,0.857142857142857,76.0857142857143,42.5385714285714,57.4685714285714,299,41,60,89,60,345,258,285
2019,35,26,"Beyazit",40.1828,29.0665,26.9285714285714,23.6428571428571,0,69.0285714285714,37.6057142857143,49.6528571428571,307,0,0,4,2,415,307,415
2019,36,26,"Beyazit",40.1828,29.0665,27.1857142857143,22.4714285714286,0.257142857142857,66.7571428571429,36.6914285714286,55.77,171,0,0,0,0,67,171,67
2019,37,26,"Beyazit",40.1828,29.0665,26.9857142857143,21.1142857142857,0,68.6285714285714,34.9257142857143,54.3014285714286,218,0,0,0,0,55,218,55
2019,38,26,"Beyazit",40.1828,29.0665,16.2142857142857,18.2571428571429,1.83657142857143,67.8142857142857,55.7542857142857,70.2642857142857,266,0,0,130,46,91,266,91
2019,39,26,"Beyazit",40.1828,29.0665,12.4857142857143,18.5,0.106428571428571,70.9714285714286,60.7014285714286,78.1142857142857,237,0,0,170,51,79,237,79
2019,40,26,"Beyazit",40.1828,29.0665,17.2428571428571,19.6857142857143,3.03014285714286,64.4142857142857,66.3557142857143,82.8985714285714,241,0,0,88,47,111,241,111
2019,41,26,"Beyazit",40.1828,29.0665,14.1714285714286,16.5285714285714,2.33914285714286,78.3285714285714,50.5916666666667,62.9433333333333,416,0,0,94,180,448,416,448
2019,42,26,"Beyazit",40.1828,29.0665,9.38571428571429,16.9142857142857,0,81.6857142857143,109.485,83,356,0,0,295,365,408,356,408
2019,43,26,"Beyazit",40.1828,29.0665,17.2428571428571,15.6285714285714,0,76.0285714285714,66.7057142857143,68.7757142857143,306,0,0,15,25,300,306,300
2019,44,26,"Beyazit",40.1828,29.0665,11.2,12.3857142857143,3.12185714285714,79.6857142857143,73.3871428571429,70.9557142857143,350,69,35,45,64,250,281,215
2019,45,26,"Beyazit",40.1828,29.0665,14.5714285714286,16.3857142857143,0.0285714285714286,64.0857142857143,62.2614285714286,74.4,417,125,80,0,0,328,292,248
2019,46,26,"Beyazit",40.1828,29.0665,10.4571428571429,14.2571428571429,0.0707142857142857,71.2285714285714,84.9942857142857,88.21,401,94,129,80,34,337,307,208
2019,47,26,"Beyazit",40.1828,29.0665,10.2571428571429,11.5142857142857,0.0457142857142857,67.3714285714286,90.6657142857143,92.4414285714286,391,16,3,0,0,339,375,336
2019,48,26,"Beyazit",40.1828,29.0665,18.0142857142857,12.5,6.70457142857143,80.1428571428571,49.6842857142857,57.8857142857143,320,4,3,61,80,251,316,248
2019,49,26,"Beyazit",40.1828,29.0665,13.8142857142857,5.54285714285714,2.28871428571429,76.4142857142857,58.0185714285714,72.4042857142857,393,125,73,71,66,274,268,201
2019,50,26,"Beyazit",40.1828,29.0665,15.4714285714286,8.18571428571429,0.278285714285714,78.3714285714286,90.4071428571429,82.2042857142857,218,85,60,27,26,119,133,59
2019,51,26,"Beyazit",40.1828,29.0665,18.3857142857143,8.81428571428571,0.0142857142857143,68.7714285714286,107.045714285714,90.3742857142857,361,40,92,0,0,488,321,396
2019,52,26,"Beyazit",40.1828,29.0665,15.8857142857143,8.2,5.91457142857143,81.2571428571429,41.7814285714286,54.5342857142857,279,47,64,173,171,281,232,217
2020,1,26,"Beyazit",40.1828,29.0665,14.2,4.28,0.3474,77.08,84.104,74.406,160,0,0,44,21,126,160,126
2020,2,26,"Beyazit",40.1828,29.0665,16.8142857142857,4.48571428571429,5.18371428571429,77.9428571428572,56.0528571428571,72.16,240,13,8,0,0,173,227,165
2020,3,26,"Beyazit",40.1828,29.0665,15.6571428571429,4.71428571428571,0.0262857142857143,76.9428571428571,93.7257142857143,80.3242857142857,270,16,15,41,35,382,254,367
2020,4,26,"Beyazit",40.1828,29.0665,13.3571428571429,3.44285714285714,0.973285714285714,72.4714285714286,74.5866666666667,77.6933333333333,358,58,85,188,94,295,300,210
2020,5,26,"Beyazit",40.1828,29.0665,16.7,8.15714285714286,2.03928571428571,75.0142857142857,78.4985714285714,76.3957142857143,331,1,1,9,1,272,330,271
2020,6,26,"Beyazit",40.1828,29.0665,21.8142857142857,7.41428571428571,5.87757142857143,70.3714285714286,28.0242857142857,47.7842857142857,343,11,12,108,78,267,332,255
2020,7,26,"Beyazit",40.1828,29.0665,17.6285714285714,6.4,4.52985714285714,73.3857142857143,63.3871428571429,73.42,341,96,109,38,22,338,245,229
2020,8,26,"Beyazit",40.1828,29.0665,13.3,6.42857142857143,0.969142857142857,75.9,82.2071428571429,78.95,283,42,20,82,82,187,241,167
2020,9,26,"Beyazit",40.1828,29.0665,21.3571428571429,9.8,5.42328571428571,64.2142857142857,56.1585714285714,69.2542857142857,393,0,0,189,266,528,393,528
2020,10,26,"Beyazit",40.1828,29.0665,13.3,12.6,3.48857142857143,68.5285714285714,68.1642857142857,81.9971428571429,205,0,0,138,122,210,205,210
2020,11,26,"Beyazit",40.1828,29.0665,15.9142857142857,11.0571428571429,1.24242857142857,77.6714285714286,67.08,73.2557142857143,115,0,0,22,8,94,115,94
2020,12,26,"Beyazit",40.1828,29.0665,20.9285714285714,6.2,1.74557142857143,67.6,46.6814285714286,65.8571428571429,117,0,0,11,10,118,117,118
2020,13,26,"Beyazit",40.1828,29.0665,16.1714285714286,8.88571428571429,4.90585714285714,84.1714285714286,41.58,48.84,136,0,0,3,8,92,136,92
2020,14,26,"Beyazit",40.1828,29.0665,19.1857142857143,10,4.40171428571429,79.1285714285714,44.3685714285714,54.9357142857143,155,4,2,27,31,121,151,119
2020,15,26,"Beyazit",40.1828,29.0665,20.9857142857143,9.48571428571429,2.93142857142857,66.6142857142857,41.3142857142857,49.1057142857143,133,0,0,47,32,118,133,118
2020,16,26,"Beyazit",40.1828,29.0665,18.0142857142857,12.6857142857143,1.33342857142857,59.5428571428571,45.5757142857143,56.1585714285714,141,0,0,70,42,106,141,106
2020,17,26,"Beyazit",40.1828,29.0665,19.8714285714286,10.9285714285714,0.0607142857142857,65.9714285714286,34.0785714285714,42.2614285714286,137,0,0,65,57,123,137,123
2020,18,26,"Beyazit",40.1828,29.0665,15.3571428571429,15.7285714285714,6.085,66.3571428571429,38.3457142857143,52.7842857142857,146,0,0,83,67,164,146,164
2020,19,26,"Beyazit",40.1828,29.0665,15.3285714285714,13.6,4.73271428571429,74.3571428571429,32.3414285714286,45.4885714285714,137,0,0,63,68,157,137,157
2020,20,26,"Beyazit",40.1828,29.0665,14.5857142857143,21.5857142857143,0,58.9714285714286,58.688,68.352,164,0,0,70,92,164,164,164
2020,21,26,"Beyazit",40.1828,29.0665,19.2285714285714,18.0714285714286,3.50542857142857,70.0714285714286,41.72,41.3116666666667,146,0,0,105,78,96,146,96
2020,22,26,"Beyazit",40.1828,29.0665,17.6,14.9142857142857,3.16085714285714,76.9,24.974,39.404,118,0,0,54,52,100,118,100
2020,23,26,"Beyazit",40.1828,29.0665,14.0285714285714,18.5428571428571,4.82457142857143,70.6428571428571,38.6966666666667,57.35,112,2,1,85,63,70,110,69
2020,24,26,"Beyazit",40.1828,29.0665,15.8714285714286,21.6714285714286,1.404,67.5142857142857,44.5771428571429,53.3857142857143,140,0,0,98,124,150,140,150
2020,25,26,"Beyazit",40.1828,29.0665,15.6428571428571,22.3285714285714,4.38742857142857,71.5714285714286,44.2471428571429,48.6328571428571,137,0,0,64,44,108,137,108
2020,26,26,"Beyazit",40.1828,29.0665,21.1857142857143,22.5142857142857,0.170285714285714,70.3714285714286,34.6914285714286,39.6571428571429,173,0,0,72,81,133,173,133
2020,27,26,"Beyazit",40.1828,29.0665,18.5285714285714,25.0285714285714,0,65.2571428571429,61.8157142857143,48.3228571428571,113,0,0,21,18,113,113,113
2020,28,26,"Beyazit",40.1828,29.0665,21.3857142857143,24.6142857142857,0.242857142857143,66.4,51.0028571428571,37.0185714285714,164,0,0,25,36,122,164,122
2020,29,26,"Beyazit",40.1828,29.0665,20.8857142857143,22.6,0,67.0857142857143,33.3857142857143,33.1371428571429,186,0,0,19,16,111,186,111
2020,30,26,"Beyazit",40.1828,29.0665,21.1428571428571,24.4571428571429,0,63,43.3128571428571,40.56,190,0,0,61,35,142,190,142
2020,31,26,"Beyazit",40.1828,29.0665,23.0285714285714,25.2285714285714,0,59.3,35.17,41.2385714285714,150,0,0,16,21,127,150,127
2020,32,26,"Beyazit",40.1828,29.0665,16.9142857142857,24.9857142857143,0.114285714285714,66.3857142857143,38.8516666666667,38.575,146,0,0,60,27,107,146,107
2020,33,26,"Beyazit",40.1828,29.0665,22.7714285714286,24.2714285714286,0,57.5,32.24,40.0614285714286,183,0,0,0,0,83,183,83
2020,34,26,"Beyazit",40.1828,29.0665,19.5571428571429,22.9142857142857,0.3,65.3428571428571,38.6857142857143,45.6671428571429,197,0,0,96,64,97,197,97
2020,35,26,"Beyazit",40.1828,29.0665,16.6857142857143,24.3714285714286,0,60.2428571428571,41.4771428571429,52.7771428571429,164,0,0,84,75,157,164,157
2020,36,26,"Beyazit",40.1828,29.0665,16.9428571428571,23.7142857142857,0.183428571428571,69.7714285714286,53.4116666666667,53.3583333333333,179,0,0,146,87,112,179,112
2020,37,26,"Beyazit",40.1828,29.0665,22.3142857142857,23.1857142857143,2.34285714285714,71.1285714285714,43.4628571428571,42.3014285714286,193,0,0,28,13,91,193,91
2020,38,26,"Beyazit",40.1828,29.0665,21.7,22.6714285714286,0.045,69.6142857142857,41.8085714285714,51.21,235,0,0,35,19,157,235,157
2020,39,26,"Beyazit",40.1828,29.0665,13.5,22.2,0.277,66.1571428571429,45.5714285714286,68.5357142857143,220,24,8,122,46,129,196,121
2020,40,26,"Beyazit",40.1828,29.0665,10.4285714285714,19.4428571428571,1.16414285714286,63.9714285714286,48.3671428571429,81.2271428571429,187,30,3,22,8,154,157,151
2020,41,26,"Beyazit",40.1828,29.0665,10.4142857142857,20.0857142857143,6.64514285714286,70.0428571428571,64.7633333333333,84.14,182,0,0,54,37,127,182,127
2020,42,26,"Beyazit",40.1828,29.0665,13.3714285714286,18.0571428571429,3.17871428571429,75.0857142857143,50.59,77.6985714285714,177,0,0,42,32,111,177,111
2020,43,26,"Beyazit",40.1828,29.0665,12.5285714285714,16.5571428571429,0.848142857142857,81.2857142857143,48.5571428571429,67.2971428571429,194,0,0,49,77,161,194,161
2020,44,26,"Beyazit",40.1828,29.0665,15.5857142857143,14.6428571428571,3.21614285714286,84.6,54.38,68.8142857142857,255,0,0,158,181,233,255,233
2020,45,26,"Beyazit",40.1828,29.0665,13.3142857142857,11.1571428571429,0.947285714285714,83,61.3733333333333,74.1633333333333,156,6,8,28,22,103,150,95
2020,46,26,"Beyazit",40.1828,29.0665,14.4714285714286,11.0857142857143,0.592428571428571,82.5571428571429,59.3814285714286,71.3885714285714,208,1,0,45,22,109,207,109
2020,47,26,"Beyazit",40.1828,29.0665,16.3714285714286,8.21428571428571,0.173714285714286,78.8,66.3771428571429,73.7928571428571,173,0,0,24,4,83,173,83
2020,48,26,"Beyazit",40.1828,29.0665,17.2,6.37142857142857,0.0964285714285714,70.3857142857143,62.4271428571429,90.57,199,27,11,0,0,262,172,251
2020,49,26,"Beyazit",40.1828,29.0665,11.6571428571429,7.77142857142857,0.0142857142857143,80.1857142857143,80.0628571428571,77.0442857142857,207,4,1,49,12,116,203,115
2020,50,26,"Beyazit",40.1828,29.0665,17.4285714285714,11.0857142857143,0.370571428571429,67.4714285714286,58.0957142857143,78.2671428571429,181,33,26,0,0,98,148,72
2020,51,26,"Beyazit",40.1828,29.0665,12.5428571428571,9.57142857142857,2.05471428571429,84.2857142857143,29.11,50.2666666666667,171,0,0,90,58,90,171,90
2020,52,26,"Beyazit",40.1828,29.0665,14.8285714285714,8.42857142857143,0,72.9571428571429,68.5566666666667,67.23,203,46,44,0,0,113,157,69
2020,53,26,"Beyazit",40.1828,29.0665,21.95,11.275,0,63.075,49.0475,83.8,122,77,70,0,0,111,45,41
2017,1,27,"Biga",40.228,27.2428,26.7571428571429,3.32857142857143,11.8648571428571,81.0714285714286,15.1928571428571,8.02,563,228,345,0,0,847,335,502
2017,2,27,"Biga",40.228,27.2428,26.3571428571429,3.17142857142857,8.897,82.6714285714286,21.38,9.34857142857143,757,275,399,0,0,1214,482,815
2017,3,27,"Biga",40.228,27.2428,32.5571428571429,5.27142857142857,5.41442857142857,85.1714285714286,23.8,12.6357142857143,762,0,0,0,0,1449,762,1449
2017,4,27,"Biga",40.228,27.2428,30.8857142857143,2.4,0.628571428571429,73.0428571428571,30.2542857142857,12.2171428571429,639,0,0,0,0,889,639,889
2017,5,27,"Biga",40.228,27.2428,25.7142857142857,6.42857142857143,0.123142857142857,71.3428571428571,26.6742857142857,10.2542857142857,588,1,1,61,88,1163,587,1162
2017,6,27,"Biga",40.228,27.2428,35.1142857142857,8.18571428571429,1.79128571428571,73.6142857142857,27.1357142857143,8.93428571428571,736,219,345,0,0,1519,517,1174
2017,7,27,"Biga",40.228,27.2428,26.6142857142857,4.24285714285714,0.470571428571429,70.0142857142857,29.9642857142857,10.3285714285714,492,61,47,0,0,717,431,670
2017,8,27,"Biga",40.228,27.2428,26,10.7714285714286,2.83214285714286,77.9428571428572,22.0242857142857,8.89142857142857,739,0,0,0,0,1747,739,1747
2017,9,27,"Biga",40.228,27.2428,17.2571428571429,9.9,0.341142857142857,82.6428571428571,34.01,15.7371428571429,574,20,6,120,186,866,554,860
2017,10,27,"Biga",40.228,27.2428,27.5714285714286,10.8142857142857,2.485,81.0285714285714,34.6616666666667,11.1614285714286,712,120,134,0,0,1043,592,909
2017,11,27,"Biga",40.228,27.2428,18.7571428571429,7.6,1.07228571428571,78.7142857142857,19.898,9.09857142857143,525,0,0,32,23,725,525,725
2017,12,27,"Biga",40.228,27.2428,22.3428571428571,12.0428571428571,0.0115714285714286,70.6571428571429,32.0316666666667,11.88,589,0,0,176,364,1077,589,1077
2017,13,27,"Biga",40.228,27.2428,35.1714285714286,10.5714285714286,0.153142857142857,65.4428571428572,27.0085714285714,11.75,574,0,0,0,0,887,574,887
2017,14,27,"Biga",40.228,27.2428,18.4571428571429,11.7,0.730857142857143,75.7857142857143,18.8328571428571,13.2371428571429,639,0,0,139,236,1336,639,1336
2017,15,27,"Biga",40.228,27.2428,22.4,12.9428571428571,0.0187142857142857,62.5571428571429,19.2228571428571,13.4214285714286,587,0,0,151,395,1187,587,1187
2017,16,27,"Biga",40.228,27.2428,26.4142857142857,12.2714285714286,2.00442857142857,70.1285714285714,12.46,7.80142857142857,717,34,20,102,273,920,683,900
2017,17,27,"Biga",40.228,27.2428,17.7428571428571,14.2,0.154571428571429,60.1857142857143,30.6757142857143,13.6828571428571,731,0,0,492,1066,1478,731,1478
2017,18,27,"Biga",40.228,27.2428,25.9428571428571,17.4571428571429,0.215142857142857,66.3,28.19,9.53142857142857,506,0,0,192,334,923,506,923
2017,19,27,"Biga",40.228,27.2428,22.1142857142857,18.7857142857143,0.288142857142857,67.5142857142857,19.74,9.68428571428571,471,0,0,114,223,966,471,966
2017,20,27,"Biga",40.228,27.2428,31.6714285714286,17.0714285714286,1.14828571428571,67.5714285714286,17.9457142857143,8.53142857142857,472,0,0,0,0,1205,472,1205
2017,21,27,"Biga",40.228,27.2428,21.9571428571429,17.8142857142857,1.15114285714286,69.4,17.2685714285714,9.36714285714286,448,0,0,55,92,849,448,849
2017,22,27,"Biga",40.228,27.2428,19.6571428571429,21.1857142857143,1.75542857142857,69.4,20.6,15.4366666666667,522,0,0,188,330,1015,522,1015
2017,23,27,"Biga",40.228,27.2428,20.2857142857143,21.5571428571429,0.941285714285714,71.0714285714286,19.888,14.17,578,0,0,179,441,1388,578,1388
2017,24,27,"Biga",40.228,27.2428,25.1571428571429,22.5857142857143,0.331857142857143,61.2428571428571,16.12,15.4366666666667,552,0,0,101,217,1139,552,1139
2017,25,27,"Biga",40.228,27.2428,23.0714285714286,23.5857142857143,0.834857142857143,61.8857142857143,18.3114285714286,14.5828571428571,584,0,0,186,368,1041,584,1041
2017,26,27,"Biga",40.228,27.2428,21.7714285714286,27.7285714285714,0,53.8857142857143,28.2585714285714,19.3985714285714,564,0,0,177,265,971,564,971
2017,27,27,"Biga",40.228,27.2428,31.9285714285714,24.9428571428571,0,55.0571428571429,24.62,12.62,511,0,0,90,165,642,511,642
2017,28,27,"Biga",40.228,27.2428,32.3571428571429,26.4285714285714,0.0421428571428571,55.7142857142857,24.9642857142857,14.0642857142857,481,0,0,0,0,864,481,864
2017,29,27,"Biga",40.228,27.2428,35.8428571428571,24.4857142857143,1.832,61.6428571428571,24.6657142857143,12.7942857142857,532,0,0,0,0,1272,532,1272
2017,30,27,"Biga",40.228,27.2428,24.5142857142857,25.1571428571429,1.30028571428571,58.7714285714286,23.5457142857143,19.07,531,0,0,217,314,928,531,928
2017,31,27,"Biga",40.228,27.2428,35.7142857142857,27.4142857142857,0,56.1142857142857,29.0157142857143,15.0257142857143,559,0,0,0,0,1047,559,1047
2017,32,27,"Biga",40.228,27.2428,34.5,27.8,0,60.6857142857143,32.3942857142857,12.8642857142857,567,0,0,67,136,1092,567,1092
2017,33,27,"Biga",40.228,27.2428,30.9428571428571,26.4285714285714,0.403428571428571,59.7714285714286,23.9466666666667,12.0785714285714,596,0,0,0,0,1199,596,1199
2017,34,27,"Biga",40.228,27.2428,32.6142857142857,23.6428571428571,2.22085714285714,60.7571428571429,20.17,13.4616666666667,601,0,0,0,0,1280,601,1280
2017,35,27,"Biga",40.228,27.2428,29.1857142857143,22.8285714285714,0,57.5571428571429,21.3642857142857,12.9442857142857,493,0,0,0,0,1014,493,1014
2017,36,27,"Biga",40.228,27.2428,19.0857142857143,21.8714285714286,0,55.0857142857143,22.7142857142857,17.4414285714286,507,0,0,341,898,1321,507,1321
2017,37,27,"Biga",40.228,27.2428,24.1285714285714,23.9571428571429,0,64.4428571428572,19.6285714285714,14.8585714285714,589,0,0,35,16,1138,589,1138
2017,38,27,"Biga",40.228,27.2428,21.7142857142857,21.3,0.346571428571429,57.1428571428571,18.0471428571429,13.86,671,0,0,333,615,1312,671,1312
2017,39,27,"Biga",40.228,27.2428,33.5714285714286,19.0285714285714,6.67685714285714,71.8285714285714,23.968,16.686,782,0,0,70,108,1630,782,1630
2017,40,27,"Biga",40.228,27.2428,24.6142857142857,16.5714285714286,2.54557142857143,67.8,15.6416666666667,16.6383333333333,543,77,181,72,128,1137,466,956
2017,41,27,"Biga",40.228,27.2428,21.6142857142857,14.7428571428571,0.0575714285714286,65.7857142857143,13.726,26.554,487,0,0,0,0,843,487,843
2017,42,27,"Biga",40.228,27.2428,18.9142857142857,15.7714285714286,0,69.5428571428571,47.18,26.92,530,0,0,296,447,815,530,815
2017,43,27,"Biga",40.228,27.2428,23.3142857142857,14.0714285714286,4.70714285714286,78.8714285714286,11.5433333333333,16.1566666666667,506,83,54,0,0,919,423,865
2017,44,27,"Biga",40.228,27.2428,22.5714285714286,10.5428571428571,0.495714285714286,65.9714285714286,15.39,20.9528571428571,561,69,129,38,51,1102,492,973
2017,45,27,"Biga",40.228,27.2428,15.0285714285714,12.0428571428571,0.130571428571429,78.8142857142857,28.802,28.326,577,130,332,53,58,829,447,497
2017,46,27,"Biga",40.228,27.2428,18.9571428571429,14.6142857142857,4.24385714285714,78.9714285714286,26.5666666666667,22.1733333333333,587,76,167,0,0,1085,511,918
2017,47,27,"Biga",40.228,27.2428,13.9714285714286,8.72857142857143,4.49357142857143,80.7,13.5416666666667,17.2616666666667,418,179,431,0,0,804,239,373
2017,48,27,"Biga",40.228,27.2428,25.0428571428571,14.0714285714286,2.59942857142857,72.4714285714286,14.6333333333333,18.7966666666667,386,164,249,0,0,619,222,370
2017,49,27,"Biga",40.228,27.2428,25.0714285714286,9.55714285714286,2.14757142857143,69.5571428571429,18.55,17.7216666666667,407,48,37,52,37,645,359,608
2017,50,27,"Biga",40.228,27.2428,25.2571428571429,13.3857142857143,1.22271428571429,75.0857142857143,22.21,19.2942857142857,346,79,126,0,0,442,267,316
2017,51,27,"Biga",40.228,27.2428,34.1,5.8,10.402,79.6428571428571,22.5371428571429,20.6214285714286,386,0,0,0,0,349,386,349
2017,52,27,"Biga",40.228,27.2428,18.7375,8.175,4.264125,81.225,19.6116666666667,20.3166666666667,528,266,236,0,0,507,262,271
2018,1,27,"Biga",40.228,27.2428,16.7875,6.775,1.5625,82.3,26.07,31.9728571428571,618,180,333,0,0,914,438,581
2018,2,27,"Biga",40.228,27.2428,27.1142857142857,8.8,1.29142857142857,86,29.35,35.2742857142857,624,0,0,0,0,1309,624,1309
2018,3,27,"Biga",40.228,27.2428,25.2857142857143,8.18571428571429,2.01171428571429,75.4285714285714,9.52,20.8371428571429,639,349,426,1,0,655,290,229
2018,4,27,"Biga",40.228,27.2428,33.6142857142857,4.71428571428571,3.54514285714286,68.1714285714286,10.265,24.68,604,0,0,0,0,764,604,764
2018,5,27,"Biga",40.228,27.2428,22.9142857142857,9.58571428571429,0.684285714285714,76.2428571428571,17.9914285714286,25.2014285714286,670,0,0,117,58,819,670,819
2018,6,27,"Biga",40.228,27.2428,25.1857142857143,9.12857142857143,8.14471428571429,82.2428571428571,19.8914285714286,42.0385714285714,704,0,0,177,226,1022,704,1022
2018,7,27,"Biga",40.228,27.2428,27.6571428571429,8.2,1.09928571428571,80.1,14.2328571428571,30.5828571428571,478,47,79,0,0,557,431,478
2018,8,27,"Biga",40.228,27.2428,31.3142857142857,8.51428571428571,4.11642857142857,82.4428571428572,13.8814285714286,30.2442857142857,711,0,0,0,0,1321,711,1321
2018,9,27,"Biga",40.228,27.2428,29.2,8.74285714285714,4.18771428571429,78.0142857142857,16.91,25.17,621,64,92,92,137,956,557,864
2018,10,27,"Biga",40.228,27.2428,22.6285714285714,12.0285714285714,2.76214285714286,79.8142857142857,24.7685714285714,29.1828571428571,556,0,0,57,22,1330,556,1330
2018,11,27,"Biga",40.228,27.2428,22.4857142857143,13.5714285714286,2.10742857142857,72.9,19.8971428571429,27.9971428571429,551,17,124,0,0,1426,534,1302
2018,12,27,"Biga",40.228,27.2428,31.0428571428571,11.7285714285714,3.54071428571429,80.0571428571429,14.7257142857143,26.2014285714286,425,0,0,37,47,1187,425,1187
2018,13,27,"Biga",40.228,27.2428,25.8285714285714,12.2428571428571,1.574,73.6142857142857,22.6,27.9866666666667,356,74,73,0,0,428,282,355
2018,14,27,"Biga",40.228,27.2428,20.8142857142857,12.7428571428571,2.53914285714286,69.4857142857143,21.8616666666667,1.845,407,0,0,146,88,486,407,486
2018,15,27,"Biga",40.228,27.2428,19.4,15.1857142857143,0,76.4857142857143,31.76,3.12142857142857,374,0,0,188,157,450,374,450
2018,16,27,"Biga",40.228,27.2428,27.3285714285714,15.0714285714286,0.126714285714286,65.0857142857143,20.4671428571429,3.14571428571429,411,0,0,134,183,648,411,648
2018,17,27,"Biga",40.228,27.2428,22.3285714285714,18.2714285714286,0,63.1714285714286,27.4557142857143,5.38142857142857,419,0,0,260,436,652,419,652
2018,18,27,"Biga",40.228,27.2428,22.3428571428571,18.8142857142857,1.30657142857143,71,24.4242857142857,6.97714285714286,303,0,0,26,63,474,303,474
2018,19,27,"Biga",40.228,27.2428,19.4,18.2428571428571,2.48485714285714,72.1,19.775,7.09333333333333,275,0,0,56,81,467,275,467
2018,20,27,"Biga",40.228,27.2428,19.6857142857143,21.1857142857143,0.0115714285714286,61.7571428571429,23.6871428571429,7.08,204,0,0,30,58,306,204,306
2018,21,27,"Biga",40.228,27.2428,30,20.9857142857143,3.70014285714286,72.6571428571429,20.7257142857143,7.11142857142857,252,0,0,1,1,281,252,281
2018,22,27,"Biga",40.228,27.2428,30.5142857142857,21.3571428571429,0.0572857142857143,60.0285714285714,23.4428571428571,7.08285714285714,249,0,0,0,0,427,249,427
2018,23,27,"Biga",40.228,27.2428,21.1857142857143,23.7857142857143,0.182285714285714,62.8857142857143,25.7685714285714,7.09,267,0,0,120,302,812,267,812
2018,24,27,"Biga",40.228,27.2428,24.6,23.7857142857143,0.156857142857143,58.5714285714286,23.8742857142857,7.05285714285714,267,0,0,75,56,448,267,448
2018,25,27,"Biga",40.228,27.2428,26.9428571428571,23.1571428571429,0.770714285714286,70.7142857142857,18.4357142857143,7.09857142857143,358,0,0,13,9,518,358,518
2018,26,27,"Biga",40.228,27.2428,24.1142857142857,22.9428571428571,2.09928571428571,70.2428571428571,15.9128571428571,7.09142857142857,355,0,0,43,81,587,355,587
2018,27,27,"Biga",40.228,27.2428,23.6714285714286,26.8714285714286,0,54.8857142857143,23.275,7.02333333333333,342,0,0,0,0,418,342,418
2018,28,27,"Biga",40.228,27.2428,23.9,26.6142857142857,0,61.7142857142857,19.4783333333333,6.99,286,0,0,56,114,585,286,585
2018,29,27,"Biga",40.228,27.2428,18.9714285714286,26.5714285714286,0,56.7285714285714,16.7614285714286,6.95857142857143,260,0,0,74,113,756,260,756
2018,30,27,"Biga",40.228,27.2428,18.1714285714286,25.5285714285714,4.51028571428571,68.4571428571429,19.1942857142857,6.92428571428571,265,0,0,175,614,822,265,822
2018,31,27,"Biga",40.228,27.2428,35.5571428571429,27.9714285714286,0,62.9142857142857,26.6471428571429,6.89857142857143,267,0,0,0,0,499,267,499
2018,32,27,"Biga",40.228,27.2428,37.9714285714286,27.1857142857143,0,56.6428571428571,32.9114285714286,6.90857142857143,297,0,0,0,0,403,297,403
2018,33,27,"Biga",40.228,27.2428,32.7714285714286,26.7571428571429,0.00785714285714286,58.9142857142857,27.8242857142857,6.94571428571429,216,0,0,0,0,332,216,332
2018,34,27,"Biga",40.228,27.2428,31.7571428571429,26.3571428571429,0,62.4,26.35,6.92857142857143,144,0,0,32,40,227,144,227
2018,35,27,"Biga",40.228,27.2428,31.6142857142857,26.8857142857143,0,61.8285714285714,27.0416666666667,6.95142857142857,201,0,0,0,0,314,201,314
2018,36,27,"Biga",40.228,27.2428,21.2857142857143,24.5142857142857,2.85814285714286,68.0714285714286,22.76,6.92,341,0,0,40,57,370,341,370
2018,37,27,"Biga",40.228,27.2428,21.4428571428571,21.6571428571429,9.40185714285714,68.0428571428571,18.8657142857143,6.93,241,0,0,56,93,419,241,419
2018,38,27,"Biga",40.228,27.2428,32.1428571428571,22.6285714285714,0.1,64.5,27.4966666666667,6.93142857142857,189,0,0,0,0,344,189,344
2018,39,27,"Biga",40.228,27.2428,36.0428571428571,18.3714285714286,2.83785714285714,68.4571428571429,27.18,6.91142857142857,180,19,46,0,0,353,161,307
2018,40,27,"Biga",40.228,27.2428,26.8571428571429,18.5142857142857,2.169,74.1428571428571,17.1342857142857,6.90428571428571,191,0,0,0,0,341,191,341
2018,41,27,"Biga",40.228,27.2428,32.1,18.2428571428571,0.0998571428571429,73.9714285714286,23.4685714285714,6.93142857142857,187,0,0,0,0,422,187,422
2018,42,27,"Biga",40.228,27.2428,24.4714285714286,18.3571428571429,0.956714285714286,78.2285714285714,26.0514285714286,6.95,168,0,0,0,0,381,168,381
2018,43,27,"Biga",40.228,27.2428,24.1714285714286,14.5714285714286,0.581285714285714,68.7857142857143,25.0471428571429,6.92428571428571,187,71,201,3,3,402,116,201
2018,44,27,"Biga",40.228,27.2428,23.2142857142857,16.1,0.00385714285714286,72.3857142857143,22.214,6.926,196,60,84,0,0,264,136,180
2018,45,27,"Biga",40.228,27.2428,28.7571428571429,15.4285714285714,0,73.4571428571429,16.2666666666667,6.93666666666667,231,0,0,0,0,473,231,473
2018,46,27,"Biga",40.228,27.2428,32.2,11.4285714285714,3.60771428571429,71.6571428571429,13.41,6.93,230,0,0,0,0,465,230,465
2018,47,27,"Biga",40.228,27.2428,22.7,12,5.88528571428571,85.7428571428571,16.7371428571429,6.93142857142857,270,44,21,0,0,499,226,478
2018,48,27,"Biga",40.228,27.2428,38.0428571428571,10,8.406,80.7285714285714,11.8371428571429,6.95285714285714,245,32,7,0,0,201,213,194
2018,49,27,"Biga",40.228,27.2428,25,7.87142857142857,3.611,78.2714285714286,13.3671428571429,6.97142857142857,257,49,42,0,0,420,208,378
2018,50,27,"Biga",40.228,27.2428,17.8571428571429,8.17142857142857,8.15871428571429,83.9714285714286,11.8885714285714,8.78714285714286,256,41,30,0,0,305,215,275
2018,51,27,"Biga",40.228,27.2428,24.1857142857143,6.65714285714286,3.67771428571429,87.5571428571428,12.3285714285714,12.7357142857143,250,92,57,0,0,248,158,191
2018,52,27,"Biga",40.228,27.2428,21.4285714285714,5.14285714285714,5.94542857142857,77.7142857142857,12.3471428571429,12.85,244,4,10,0,0,273,240,263
2019,1,27,"Biga",40.228,27.2428,34.8875,4.675,5.332375,79.35,9.36125,10.84,343,0,0,0,0,784,343,784
2019,2,27,"Biga",40.228,27.2428,32.2571428571429,5.38571428571429,5.94185714285714,77.6428571428572,8.63142857142857,NA,255,121,78,0,0,208,134,130
2019,3,27,"Biga",40.228,27.2428,18.9714285714286,6.45714285714286,0.93,76.6857142857143,13.2714285714286,37.046,192,138,153,0,0,198,54,45
2019,4,27,"Biga",40.228,27.2428,23.2857142857143,9.38571428571429,4.894,83.0857142857143,17.29,29.1271428571429,308,119,119,0,0,314,189,195
2019,5,27,"Biga",40.228,27.2428,22.1428571428571,11.2428571428571,2.65457142857143,75.0857142857143,11.06,23.95,253,187,118,0,0,143,66,25
2019,6,27,"Biga",40.228,27.2428,27.1,7.48571428571429,0.841714285714286,80.9428571428572,17.3028571428571,35.15,276,0,0,0,0,127,276,127
2019,7,27,"Biga",40.228,27.2428,37.4142857142857,7.12857142857143,5.59185714285714,74.3,13.4585714285714,24.3614285714286,325,20,113,0,0,234,305,121
2019,8,27,"Biga",40.228,27.2428,28.0142857142857,5.92857142857143,2.45657142857143,78.5571428571428,24.3471428571429,44.84,305,0,0,0,0,219,305,219
2019,9,27,"Biga",40.228,27.2428,31.2285714285714,6.98571428571429,0.626571428571429,72.7571428571429,14.5028571428571,21.1671428571429,331,2,0,0,0,310,329,310
2019,10,27,"Biga",40.228,27.2428,17.4142857142857,10.5714285714286,0,75.3571428571428,20.1042857142857,26.9,359,0,0,1,0,252,359,252
2019,11,27,"Biga",40.228,27.2428,27.4142857142857,10.0857142857143,6.49371428571428,76.7428571428571,14.7,17.4257142857143,373,71,40,0,0,400,302,360
2019,12,27,"Biga",40.228,27.2428,31,10.9571428571429,0,68.2,17.8557142857143,18.7885714285714,343,0,0,44,267,416,343,416
2019,13,27,"Biga",40.228,27.2428,41.3285714285714,9.25714285714286,0,58.6285714285714,21.9228571428571,14.7028571428571,256,0,0,4,7,194,256,194
2019,14,27,"Biga",40.228,27.2428,27.7857142857143,10.7857142857143,0.600428571428571,71.6142857142857,19.5071428571429,15.7014285714286,365,0,0,0,0,208,365,208
2019,15,27,"Biga",40.228,27.2428,18.9285714285714,13.5,9.15814285714286,84.2142857142857,12.1314285714286,14.27,359,149,112,111,49,183,210,71
2019,16,27,"Biga",40.228,27.2428,25.1285714285714,10.5,0.252714285714286,67.8,13.5416666666667,13.8242857142857,318,0,0,48,19,208,318,208
2019,17,27,"Biga",40.228,27.2428,17.5714285714286,14.7,0.171,68.0428571428571,26.66,24.1585714285714,412,0,0,211,181,313,412,313
2019,18,27,"Biga",40.228,27.2428,22.7142857142857,16.8142857142857,0.698571428571429,68.6857142857143,19.9257142857143,13.5871428571429,523,103,37,0,0,353,420,316
2019,19,27,"Biga",40.228,27.2428,20.0571428571429,15.9428571428571,1.78414285714286,70.8571428571429,15.5,12.9514285714286,452,0,0,7,4,386,452,386
2019,20,27,"Biga",40.228,27.2428,20.8,19.0571428571429,0.0218571428571429,73.0857142857143,22.3833333333333,18.2733333333333,454,0,0,246,198,389,454,389
2019,21,27,"Biga",40.228,27.2428,20.9714285714286,20.2571428571429,0.737,69.0285714285714,21.05,12.4,457,0,0,181,174,413,457,413
2019,22,27,"Biga",40.228,27.2428,22.3428571428571,22.1714285714286,0.314857142857143,67.0142857142857,19.8628571428571,13.48,453,0,0,137,135,323,453,323
2019,23,27,"Biga",40.228,27.2428,22.4428571428571,22.3,1.26314285714286,67.0571428571429,14.6057142857143,8.27,378,0,0,76,79,532,378,532
2019,24,27,"Biga",40.228,27.2428,26.0285714285714,24.8571428571429,1.498,68.4,17.77,8.38571428571429,378,0,0,102,20,244,378,244
2019,25,27,"Biga",40.228,27.2428,24,25.7285714285714,0,63.1714285714286,21.2514285714286,9.93857142857143,306,0,0,51,21,325,306,325
2019,26,27,"Biga",40.228,27.2428,38.1285714285714,26.6857142857143,0,57.1857142857143,24.48,9.23,377,0,0,0,0,342,377,342
2019,27,27,"Biga",40.228,27.2428,29.5857142857143,26.3857142857143,0,56.1714285714286,17.2514285714286,8.86857142857143,456,0,0,0,0,222,456,222
2019,28,27,"Biga",40.228,27.2428,19.3,23.7714285714286,3.12942857142857,64.5428571428571,16.2028571428571,11.4285714285714,398,0,0,172,204,421,398,421
2019,29,27,"Biga",40.228,27.2428,29.3857142857143,24.2428571428571,0,58.3428571428571,15.9342857142857,9.49285714285714,453,0,0,57,5,203,453,203
2019,30,27,"Biga",40.228,27.2428,30.6428571428571,25.8571428571429,0,56.5,15.73,7.91285714285714,456,0,0,0,0,335,456,335
2019,31,27,"Biga",40.228,27.2428,23.6,27.0285714285714,0.181571428571429,60.1,18.7242857142857,8.83,334,0,0,122,186,375,334,375
2019,32,27,"Biga",40.228,27.2428,32.4714285714286,25.9571428571429,0,55.5571428571429,13.8485714285714,7.19,346,0,0,0,0,395,346,395
2019,33,27,"Biga",40.228,27.2428,31.1857142857143,25.6571428571429,1.35928571428571,65.1571428571429,16.9342857142857,5.28857142857143,337,0,0,0,0,531,337,531
2019,34,27,"Biga",40.228,27.2428,32.9428571428571,26.1857142857143,0,62.4571428571429,20.5914285714286,7.26285714285714,299,0,0,0,0,345,299,345
2019,35,27,"Biga",40.228,27.2428,38.1714285714286,26.1285714285714,0,60.2285714285714,20.8257142857143,5.51714285714286,307,0,0,0,0,415,307,415
2019,36,27,"Biga",40.228,27.2428,36.0142857142857,24.9142857142857,0,61.2857142857143,17.8357142857143,6.01142857142857,171,0,0,0,0,67,171,67
2019,37,27,"Biga",40.228,27.2428,38.1857142857143,23.9428571428571,0.0115714285714286,59.7285714285714,23.0828571428571,7.83428571428571,218,0,0,0,0,55,218,55
2019,38,27,"Biga",40.228,27.2428,27.1714285714286,19.8,0.154285714285714,60.9142857142857,20.0857142857143,11.3514285714286,266,0,0,86,38,91,266,91
2019,39,27,"Biga",40.228,27.2428,18.7571428571429,19.5,0.165142857142857,66.9571428571429,17.7228571428571,12.9628571428571,237,0,0,9,5,79,237,79
2019,40,27,"Biga",40.228,27.2428,21.0857142857143,20.4142857142857,4.16585714285714,67.6857142857143,19.4128571428571,15.5,241,28,25,107,61,111,213,86
2019,41,27,"Biga",40.228,27.2428,24.1285714285714,17.8857142857143,0.996,75.1428571428571,12.9342857142857,13.5885714285714,416,0,0,0,0,448,416,448
2019,42,27,"Biga",40.228,27.2428,17.9857142857143,18.1142857142857,0.0115714285714286,83.2142857142857,25.9014285714286,14.2342857142857,356,0,0,52,63,408,356,408
2019,43,27,"Biga",40.228,27.2428,31.7142857142857,18.1428571428571,0,69.9428571428571,16.848,11.626,306,0,0,0,0,300,306,300
2019,44,27,"Biga",40.228,27.2428,21.9,14.1857142857143,0.731571428571428,77.5285714285714,15.825,12.67,350,68,34,0,0,250,282,216
2019,45,27,"Biga",40.228,27.2428,24,18.9857142857143,0.023,68.3285714285714,21.344,11.342,417,235,150,0,0,328,182,178
2019,46,27,"Biga",40.228,27.2428,14.9285714285714,15.6857142857143,0.228142857142857,78.1571428571429,25.7925,19.895,401,64,62,0,0,337,337,275
2019,47,27,"Biga",40.228,27.2428,14.7571428571429,13.6857142857143,0.551142857142857,77.7285714285714,31.8133333333333,20.945,391,0,0,0,0,339,391,339
2019,48,27,"Biga",40.228,27.2428,22.2857142857143,13.2428571428571,2.25928571428571,78.6714285714286,15.5871428571429,16.1842857142857,320,34,14,0,0,251,286,237
2019,49,27,"Biga",40.228,27.2428,21.9142857142857,7.85714285714286,3.30871428571429,77.1,13.8614285714286,16.5685714285714,393,0,0,0,0,274,393,274
2019,50,27,"Biga",40.228,27.2428,16.7285714285714,9.62857142857143,1.67814285714286,79.5714285714286,19.54,20.4657142857143,218,52,12,0,0,119,166,107
2019,51,27,"Biga",40.228,27.2428,16.7571428571429,11.9285714285714,0.0171428571428571,79.3,19.7014285714286,13.1185714285714,361,164,160,0,0,488,197,328
2019,52,27,"Biga",40.228,27.2428,25.4714285714286,8.44285714285714,3.837,74.3285714285714,8.39,9.46833333333333,279,49,66,0,0,281,230,215
2020,1,27,"Biga",40.228,27.2428,33.5,5.52,0.6454,71.32,12.6,14.696,160,19,0,0,0,126,141,126
2020,2,27,"Biga",40.228,27.2428,31.8,4.78571428571429,7.24985714285714,75.3571428571429,14.4571428571429,14.8757142857143,240,0,0,0,0,173,240,173
2020,3,27,"Biga",40.228,27.2428,31.1,7.11428571428571,0.245285714285714,73.4571428571429,15.9485714285714,17.7971428571429,270,0,0,0,0,382,270,382
2020,4,27,"Biga",40.228,27.2428,23.3714285714286,4.94285714285714,0.280285714285714,68.8285714285714,16.5085714285714,17.1314285714286,358,119,159,0,0,295,239,136
2020,5,27,"Biga",40.228,27.2428,20.5857142857143,10.1,5.32057142857143,77.3142857142857,12.0557142857143,13.8142857142857,331,149,117,24,20,272,182,155
2020,6,27,"Biga",40.228,27.2428,29.0285714285714,7.32857142857143,2.82614285714286,71.7142857142857,14.8171428571429,8.64,343,0,0,0,0,267,343,267
2020,7,27,"Biga",40.228,27.2428,24.1714285714286,8.31428571428571,2.32557142857143,73.9714285714286,27.1185714285714,17.1114285714286,341,85,138,0,0,338,256,200
2020,8,27,"Biga",40.228,27.2428,28.4285714285714,7.57142857142857,0.635571428571429,73.7,36.7157142857143,17.2785714285714,283,0,0,2,0,187,283,187
2020,9,27,"Biga",40.228,27.2428,25.0571428571429,9.64285714285714,3.30328571428571,69.7285714285714,23.1485714285714,12.6914285714286,393,57,60,48,67,528,336,468
2020,10,27,"Biga",40.228,27.2428,22.3,13.3,2.51385714285714,72.5571428571429,29.1342857142857,15.0114285714286,205,102,91,0,0,210,103,119
2020,11,27,"Biga",40.228,27.2428,24.9285714285714,12.0142857142857,0.357142857142857,72.5714285714286,37.7257142857143,18.6485714285714,115,0,0,32,39,94,115,94
2020,12,27,"Biga",40.228,27.2428,30.7285714285714,7.95714285714286,0.0342857142857143,60.3285714285714,34.8857142857143,16.0442857142857,117,0,0,13,13,118,117,118
2020,13,27,"Biga",40.228,27.2428,30.4857142857143,9.71428571428571,1.99557142857143,82.1,27.346,9.69714285714286,136,2,2,0,0,92,134,90
2020,14,27,"Biga",40.228,27.2428,31.3857142857143,9.85714285714286,3.39071428571429,80.5142857142857,33.8433333333333,13.0942857142857,155,15,17,0,0,121,140,104
2020,15,27,"Biga",40.228,27.2428,40.4571428571429,11.0714285714286,1.66314285714286,63.5428571428571,NA,14.2428571428571,133,0,0,3,2,118,133,118
2020,16,27,"Biga",40.228,27.2428,23.8,12.1142857142857,1.16571428571429,68.0571428571429,NA,16.4985714285714,141,0,0,46,33,106,141,106
2020,17,27,"Biga",40.228,27.2428,35.2714285714286,12.1571428571429,0.035,66.1571428571429,30.888,10.1885714285714,137,0,0,48,57,123,137,123
2020,18,27,"Biga",40.228,27.2428,18.7857142857143,15.4428571428571,3.04557142857143,73.8571428571429,29.1614285714286,17.9928571428571,146,0,0,44,81,164,146,164
2020,19,27,"Biga",40.228,27.2428,24.9,14.4857142857143,4.21771428571429,73.3142857142857,22.2642857142857,11.4285714285714,137,0,0,102,110,157,137,157
2020,20,27,"Biga",40.228,27.2428,21.3142857142857,20.9428571428571,0,66.7,49.8842857142857,15.8542857142857,164,0,0,100,96,164,164,164
2020,21,27,"Biga",40.228,27.2428,29.7571428571429,18.4,1.49657142857143,71.7,36.0057142857143,11.8928571428571,146,0,0,88,40,96,146,96
2020,22,27,"Biga",40.228,27.2428,24.0428571428571,15.7857142857143,0.955714285714286,73.5571428571428,19.3428571428571,8.71428571428571,118,0,0,12,29,100,118,100
2020,23,27,"Biga",40.228,27.2428,20.6857142857143,18.4571428571429,1.48342857142857,71.3142857142857,25.8333333333333,12.5585714285714,112,0,0,38,18,70,112,70
2020,24,27,"Biga",40.228,27.2428,20.7857142857143,21.6428571428571,0.277428571428571,68.7428571428571,NA,13.5742857142857,140,0,0,22,11,150,140,150
2020,25,27,"Biga",40.228,27.2428,22.5714285714286,23.4571428571429,0.414428571428571,65.8714285714286,NA,12.1742857142857,137,0,0,14,24,108,137,108
2020,26,27,"Biga",40.228,27.2428,28.7285714285714,23.8285714285714,1.42928571428571,67.1714285714286,35.99,9.07714285714286,173,29,37,41,43,133,144,96
2020,27,27,"Biga",40.228,27.2428,29.7,27.3,0,57.9142857142857,42.97,9.85571428571428,113,0,0,0,0,113,113,113
2020,28,27,"Biga",40.228,27.2428,36.6857142857143,26.0714285714286,0.00471428571428572,61.0428571428571,41.1514285714286,6.98714285714286,164,0,0,8,11,122,164,122
2020,29,27,"Biga",40.228,27.2428,31.8,24.1857142857143,0,57.5857142857143,34.2757142857143,7.15428571428571,186,0,0,0,0,111,186,111
2020,30,27,"Biga",40.228,27.2428,33.1571428571429,26.3428571428571,0,58.4571428571429,38.962,7.646,190,0,0,0,0,142,190,142
2020,31,27,"Biga",40.228,27.2428,31.0571428571429,27.9,0,53.3714285714286,38.97,7.71714285714286,150,0,0,0,0,127,150,127
2020,32,27,"Biga",40.228,27.2428,30.8428571428571,26.5428571428571,0.0287142857142857,62.1142857142857,36.2771428571429,6.6,146,0,0,37,15,107,146,107
2020,33,27,"Biga",40.228,27.2428,33.6142857142857,26.8,0,51.9142857142857,36.4314285714286,7.23428571428571,183,0,0,0,0,83,183,83
2020,34,27,"Biga",40.228,27.2428,27.4142857142857,25.3857142857143,0.189142857142857,57.2571428571429,38.605,10.18,197,0,0,0,0,97,197,97
2020,35,27,"Biga",40.228,27.2428,26.7285714285714,26.3285714285714,0,58.2857142857143,29.5933333333333,8.44,164,0,0,17,25,157,164,157
2020,36,27,"Biga",40.228,27.2428,27.6,24.9714285714286,0,61.8,30.9371428571429,7.40285714285714,179,0,0,47,20,112,179,112
2020,37,27,"Biga",40.228,27.2428,37.1142857142857,25.5428571428571,0.115285714285714,62.5714285714286,41.7728571428571,7.20285714285714,193,0,0,0,0,91,193,91
2020,38,27,"Biga",40.228,27.2428,36.9714285714286,24.1428571428571,0.00471428571428572,62.7571428571429,47.1166666666667,8.02666666666667,235,0,0,0,0,157,235,157
2020,39,27,"Biga",40.228,27.2428,25.3857142857143,22.3571428571429,0.388428571428571,65.3285714285714,34.2371428571429,9.87714285714286,220,9,6,1,1,129,211,123
2020,40,27,"Biga",40.228,27.2428,19.1285714285714,19.6714285714286,0.669,67.0714285714286,30.9557142857143,12.6414285714286,187,0,0,81,31,154,187,154
2020,41,27,"Biga",40.228,27.2428,15.6857142857143,19.8428571428571,4.015,72.7571428571429,38.4942857142857,12.72,182,14,7,14,6,127,168,120
2020,42,27,"Biga",40.228,27.2428,20.6,18.9142857142857,3.17185714285714,75.5142857142857,30.1942857142857,12.31,177,91,39,0,0,111,86,72
2020,43,27,"Biga",40.228,27.2428,23.4714285714286,17.7285714285714,0.126,75.1428571428571,40.135,13.25,194,0,0,0,0,161,194,161
2020,44,27,"Biga",40.228,27.2428,15.8857142857143,15.2,1.77957142857143,77.6857142857143,35.5828571428571,13.3857142857143,255,0,0,6,3,233,255,233
2020,45,27,"Biga",40.228,27.2428,28.9285714285714,13.8142857142857,0.155285714285714,69.8571428571429,31.4528571428571,12.9057142857143,156,0,0,0,0,103,156,103
2020,46,27,"Biga",40.228,27.2428,28.6,13.9142857142857,0.770142857142857,75.2571428571429,28.9528571428571,11.6542857142857,208,0,0,0,0,109,208,109
2020,47,27,"Biga",40.228,27.2428,32,11.5285714285714,0.569571428571429,72.0428571428571,34.4071428571429,14.3171428571429,173,0,0,0,0,83,173,83
2020,48,27,"Biga",40.228,27.2428,25.4142857142857,9.68571428571429,0.0575714285714286,70.9571428571429,34.8057142857143,19.3471428571429,199,3,3,0,0,262,196,259
2020,49,27,"Biga",40.228,27.2428,24.1,8.67142857142857,0.126142857142857,78.5571428571428,39.0814285714286,19.6857142857143,207,0,0,0,0,116,207,116
2020,50,27,"Biga",40.228,27.2428,21.2,12.4857142857143,6.76671428571429,81.3285714285714,21.4914285714286,14.6142857142857,181,100,76,0,0,98,81,22
2020,51,27,"Biga",40.228,27.2428,27.3714285714286,9.98571428571429,2.52814285714286,81.4714285714286,22.0928571428571,14.7542857142857,171,0,0,0,0,90,171,90
2020,52,27,"Biga",40.228,27.2428,23.3714285714286,11.4857142857143,0.248428571428571,74.6285714285714,21.385,13.68,203,81,50,0,0,113,122,63
2020,53,27,"Biga",40.228,27.2428,28.075,14.225,1.53675,71.225,18.8725,9.7075,122,113,104,0,0,111,9,7
2017,1,28,"Cankiri",40.5983,33.6142,12.5285714285714,-2.95714285714286,2.08571428571429,88.8714285714286,62.3057142857143,NA,563,98,152,167,267,847,465,695
2017,2,28,"Cankiri",40.5983,33.6142,10.8857142857143,-5.05714285714286,0.242857142857143,88.2142857142857,72.7471428571429,NA,757,31,15,357,514,1214,726,1199
2017,3,28,"Cankiri",40.5983,33.6142,10.6285714285714,-0.228571428571429,0.585714285714286,91.6857142857143,91.2428571428571,NA,762,133,493,365,501,1449,629,956
2017,4,28,"Cankiri",40.5983,33.6142,14.8428571428571,-3.02857142857143,0.0857142857142857,75.2714285714286,52.0514285714286,NA,639,0,0,474,638,889,639,889
2017,5,28,"Cankiri",40.5983,33.6142,10.6142857142857,-5.18571428571429,0.0857142857142857,72.9571428571429,87.3542857142857,NA,588,77,144,422,825,1163,511,1019
2017,6,28,"Cankiri",40.5983,33.6142,12.2142857142857,2.22857142857143,0.114285714285714,86.8857142857143,79.1414285714286,NA,736,114,345,298,622,1519,622,1174
2017,7,28,"Cankiri",40.5983,33.6142,14.5714285714286,-2.27142857142857,0,64.0857142857143,55.5842857142857,NA,492,0,0,353,481,717,492,717
2017,8,28,"Cankiri",40.5983,33.6142,11.9714285714286,5.25714285714286,0.0285714285714286,71.2428571428571,75.3414285714286,NA,739,1,0,190,352,1747,738,1747
2017,9,28,"Cankiri",40.5983,33.6142,13.7571428571429,7.57142857142857,0.114285714285714,67.4428571428572,76.2514285714286,NA,574,0,0,165,222,866,574,866
2017,10,28,"Cankiri",40.5983,33.6142,11.7142857142857,7.77142857142857,0.457142857142857,67.7285714285714,82.7057142857143,NA,712,494,688,0,0,1043,218,355
2017,11,28,"Cankiri",40.5983,33.6142,16.1714285714286,4.22857142857143,0.828571428571429,75.7428571428571,53.6571428571429,NA,525,0,0,281,408,725,525,725
2017,12,28,"Cankiri",40.5983,33.6142,16.4285714285714,8.35714285714286,0.142857142857143,51.9142857142857,64.8457142857143,NA,589,101,162,332,639,1077,488,915
2017,13,28,"Cankiri",40.5983,33.6142,16.7714285714286,8.94285714285714,0.385714285714286,50.0142857142857,54.5114285714286,NA,574,188,294,127,222,887,386,593
2017,14,28,"Cankiri",40.5983,33.6142,14.3714285714286,9.85714285714286,1.64285714285714,52.7571428571429,55.9557142857143,NA,639,205,493,234,419,1336,434,843
2017,15,28,"Cankiri",40.5983,33.6142,12.6857142857143,8.82857142857143,0.857142857142857,63.4142857142857,51.53,NA,587,122,217,232,657,1187,465,970
2017,16,28,"Cankiri",40.5983,33.6142,22.8428571428571,9.64285714285714,0.742857142857143,62.6857142857143,44.3614285714286,NA,717,1,0,142,173,920,716,920
2017,17,28,"Cankiri",40.5983,33.6142,12.0142857142857,11.6,0,45.2428571428571,57.9057142857143,NA,731,145,371,142,138,1478,586,1107
2017,18,28,"Cankiri",40.5983,33.6142,15.0571428571429,15.4714285714286,0.885714285714286,59.1285714285714,49.4871428571429,NA,506,113,244,248,435,923,393,679
2017,19,28,"Cankiri",40.5983,33.6142,22.5428571428571,17.4,0.342857142857143,51.4142857142857,50.8942857142857,NA,471,61,139,157,288,966,410,827
2017,20,28,"Cankiri",40.5983,33.6142,20.3857142857143,13.4428571428571,0.757142857142857,63.5,23.7142857142857,NA,472,13,4,200,744,1205,459,1201
2017,21,28,"Cankiri",40.5983,33.6142,14.0714285714286,13.4714285714286,2.64285714285714,65.9285714285714,29.82,NA,448,78,194,256,527,849,370,655
2017,22,28,"Cankiri",40.5983,33.6142,15.1,16.2428571428571,6.48571428571429,74.2714285714286,37.5642857142857,NA,522,0,0,215,462,1015,522,1015
2017,23,28,"Cankiri",40.5983,33.6142,19.1,18.8142857142857,2.82857142857143,68.7428571428571,30.5757142857143,NA,578,0,0,275,657,1388,578,1388
2017,24,28,"Cankiri",40.5983,33.6142,16.3857142857143,19.0428571428571,0.714285714285714,58.8285714285714,27.59,NA,552,72,113,300,608,1139,480,1026
2017,25,28,"Cankiri",40.5983,33.6142,13.7714285714286,18.2428571428571,2.11428571428571,68.6142857142857,27.9828571428571,NA,584,61,118,427,816,1041,523,923
2017,26,28,"Cankiri",40.5983,33.6142,15.0571428571429,25.2571428571429,0,45.7571428571429,36.9428571428571,NA,564,0,0,329,508,971,564,971
2017,27,28,"Cankiri",40.5983,33.6142,20.0857142857143,22.8,0,47.3,34.9157142857143,NA,511,0,0,283,316,642,511,642
2017,28,28,"Cankiri",40.5983,33.6142,20.6285714285714,24.8857142857143,0.0571428571428571,40.8571428571429,38.5585714285714,NA,481,29,40,93,210,864,452,824
2017,29,28,"Cankiri",40.5983,33.6142,21.1428571428571,24.7714285714286,0.442857142857143,49.0428571428571,32.9671428571429,NA,532,0,0,149,280,1272,532,1272
2017,30,28,"Cankiri",40.5983,33.6142,18.2285714285714,24.8857142857143,0,37.7285714285714,54.9785714285714,NA,531,79,128,103,107,928,452,800
2017,31,28,"Cankiri",40.5983,33.6142,20.4142857142857,24.7428571428571,3.42857142857143,51.7,38.2285714285714,NA,559,75,124,91,306,1047,484,923
2017,32,28,"Cankiri",40.5983,33.6142,19.5571428571429,27,0.0285714285714286,44.1285714285714,49.78,NA,567,80,158,63,162,1092,487,934
2017,33,28,"Cankiri",40.5983,33.6142,19.5571428571429,24.1714285714286,0.714285714285714,55,42.1557142857143,NA,596,0,0,259,606,1199,596,1199
2017,34,28,"Cankiri",40.5983,33.6142,23.2857142857143,21.8428571428571,0.114285714285714,49.7285714285714,28.04,NA,601,0,0,193,594,1280,601,1280
2017,35,28,"Cankiri",40.5983,33.6142,17.4571428571429,20.2142857142857,0.571428571428572,49.2714285714286,38.3428571428571,NA,493,18,123,38,59,1014,475,891
2017,36,28,"Cankiri",40.5983,33.6142,11.7571428571429,19.7857142857143,0.428571428571429,44.1857142857143,41.3657142857143,NA,507,105,288,151,418,1321,402,1033
2017,37,28,"Cankiri",40.5983,33.6142,17.5428571428571,24.7428571428571,0,31.1857142857143,79.6671428571428,NA,589,69,153,74,87,1138,520,985
2017,38,28,"Cankiri",40.5983,33.6142,16.3857142857143,22.3285714285714,0.0857142857142857,35.5571428571429,63.43,NA,671,0,0,379,854,1312,671,1312
2017,39,28,"Cankiri",40.5983,33.6142,20.1571428571429,16.4285714285714,3.17142857142857,63.9857142857143,39.8314285714286,NA,782,141,161,43,156,1630,641,1469
2017,40,28,"Cankiri",40.5983,33.6142,12.7857142857143,12.1,1.04285714285714,58.8285714285714,42.6157142857143,NA,543,47,187,197,448,1137,496,950
2017,41,28,"Cankiri",40.5983,33.6142,13.8142857142857,10.9857142857143,0.571428571428572,63.0857142857143,36.2414285714286,NA,487,0,0,300,383,843,487,843
2017,42,28,"Cankiri",40.5983,33.6142,9.58571428571429,11.0285714285714,0,57.7571428571429,60.9028571428571,NA,530,78,127,221,360,815,452,688
2017,43,28,"Cankiri",40.5983,33.6142,12.2714285714286,10.9571428571429,1.88571428571429,75.8857142857143,63.2685714285714,NA,506,71,71,134,352,919,435,848
2017,44,28,"Cankiri",40.5983,33.6142,13.7571428571429,4.34285714285714,0.914285714285714,67.7714285714286,63.9157142857143,NA,561,0,0,240,466,1102,561,1102
2017,45,28,"Cankiri",40.5983,33.6142,8.11428571428571,6,1.07142857142857,88.4,81.8957142857143,NA,577,42,77,75,141,829,535,752
2017,46,28,"Cankiri",40.5983,33.6142,7.74285714285714,6.84285714285714,0,80.4,102.461428571429,NA,587,0,0,94,159,1085,587,1085
2017,47,28,"Cankiri",40.5983,33.6142,15.3428571428571,4,2.51428571428571,79.7714285714286,44.9857142857143,NA,418,10,8,164,248,804,408,796
2017,48,28,"Cankiri",40.5983,33.6142,9.28571428571429,4.32857142857143,0.457142857142857,90.0571428571428,75.7942857142857,NA,386,68,118,146,232,619,318,501
2017,49,28,"Cankiri",40.5983,33.6142,13.8,2.4,0.228571428571429,82.1428571428571,57.5914285714286,NA,407,60,160,224,296,645,347,485
2017,50,28,"Cankiri",40.5983,33.6142,10.3571428571429,3.01428571428571,0.457142857142857,96.0142857142857,60.4783333333333,NA,346,0,0,139,208,442,346,442
2017,51,28,"Cankiri",40.5983,33.6142,16.6428571428571,4.41428571428571,4.45714285714286,83.5857142857143,44.3371428571429,NA,386,0,0,166,202,349,386,349
2017,52,28,"Cankiri",40.5983,33.6142,9.35,-0.0874999999999999,0.9875,88.8375,60.18375,NA,528,216,244,115,134,507,312,263
2018,1,28,"Cankiri",40.5983,33.6142,8.95,3.35,1.100125,83.2,45.07,NA,618,180,325,211,286,914,438,589
2018,2,28,"Cankiri",40.5983,33.6142,13.6,3.98571428571429,0.5,86.3285714285714,44.2171428571429,NA,624,80,521,10,8,1309,544,788
2018,3,28,"Cankiri",40.5983,33.6142,16.4857142857143,2,2.54285714285714,75.6285714285714,41.6985714285714,NA,639,135,117,359,376,655,504,538
2018,4,28,"Cankiri",40.5983,33.6142,23.0428571428571,1.01428571428571,1.68571428571429,69,32.3571428571429,NA,604,81,166,161,161,764,523,598
2018,5,28,"Cankiri",40.5983,33.6142,8.57142857142857,2.81428571428571,0,76.9142857142857,73.9014285714286,NA,670,112,58,312,372,819,558,761
2018,6,28,"Cankiri",40.5983,33.6142,12.4714285714286,6,2.34285714285714,82.0142857142857,65.5957142857143,NA,704,86,74,302,523,1022,618,948
2018,7,28,"Cankiri",40.5983,33.6142,15.4,4.55714285714286,1.34285714285714,77.5714285714286,40.8742857142857,NA,478,0,0,212,268,557,478,557
2018,8,28,"Cankiri",40.5983,33.6142,13.5571428571429,5.77142857142857,2.62857142857143,79,44.7857142857143,NA,711,103,219,167,315,1321,608,1102
2018,9,28,"Cankiri",40.5983,33.6142,19.1285714285714,4.92857142857143,0.628571428571429,74.5428571428571,35.6014285714286,NA,621,65,67,267,429,956,556,889
2018,10,28,"Cankiri",40.5983,33.6142,12,9.01428571428571,0.9,72.7571428571429,53.3371428571429,NA,556,84,214,217,458,1330,472,1116
2018,11,28,"Cankiri",40.5983,33.6142,10.1142857142857,9.65714285714286,0.885714285714286,70.5285714285714,46.6828571428571,NA,551,48,380,214,343,1426,503,1046
2018,12,28,"Cankiri",40.5983,33.6142,12.9857142857143,11.0428571428571,1.14285714285714,64.8428571428571,69.8471428571429,NA,425,58,177,141,291,1187,367,1010
2018,13,28,"Cankiri",40.5983,33.6142,12.5285714285714,10.2857142857143,1,68.9857142857143,65.5685714285714,NA,356,87,105,128,192,428,269,323
2018,14,28,"Cankiri",40.5983,33.6142,15.4,11.4142857142857,0.228571428571429,59.7142857142857,49.4042857142857,NA,407,6,8,112,88,486,401,478
2018,15,28,"Cankiri",40.5983,33.6142,10.6857142857143,15.2714285714286,1,61.4571428571429,43.888,NA,374,24,70,89,98,450,350,380
2018,16,28,"Cankiri",40.5983,33.6142,12.5714285714286,12.1142857142857,0.0285714285714286,51.8571428571429,40.6257142857143,NA,411,1,1,119,229,648,410,647
2018,17,28,"Cankiri",40.5983,33.6142,10.9428571428571,17.5,0,43.4285714285714,48.6685714285714,NA,419,49,50,68,102,652,370,602
2018,18,28,"Cankiri",40.5983,33.6142,12.7857142857143,17.9,2.71428571428571,56.7285714285714,48.1914285714286,NA,303,1,1,128,286,474,302,473
2018,19,28,"Cankiri",40.5983,33.6142,9.65714285714286,14.5428571428571,4.47142857142857,77.7428571428571,30.35,NA,275,104,159,60,105,467,171,308
2018,20,28,"Cankiri",40.5983,33.6142,11.5,18.2285714285714,2.41428571428571,67.2142857142857,40.2942857142857,NA,204,3,0,74,129,306,201,306
2018,21,28,"Cankiri",40.5983,33.6142,12.4857142857143,18.5285714285714,5.22857142857143,70.9142857142857,37.4014285714286,NA,252,0,0,182,216,281,252,281
2018,22,28,"Cankiri",40.5983,33.6142,12.2285714285714,19.2,2.85714285714286,64.0142857142857,38.4571428571429,NA,249,63,101,139,268,427,186,326
2018,23,28,"Cankiri",40.5983,33.6142,12.2714285714286,20.3142857142857,1,59.6142857142857,37.7414285714286,NA,267,0,0,244,711,812,267,812
2018,24,28,"Cankiri",40.5983,33.6142,12.0142857142857,21.8571428571429,2.42857142857143,53.7142857142857,26.9828571428571,NA,267,39,162,137,140,448,228,286
2018,25,28,"Cankiri",40.5983,33.6142,14.0714285714286,20.7571428571429,1.44285714285714,66.2285714285714,21.9071428571429,NA,358,0,0,235,283,518,358,518
2018,26,28,"Cankiri",40.5983,33.6142,17.4571428571429,23.4428571428571,6.71414285714286,54.5571428571429,30.9557142857143,NA,355,0,0,137,305,587,355,587
2018,27,28,"Cankiri",40.5983,33.6142,18.7857142857143,23.6428571428571,0,44.1,35.6314285714286,NA,342,0,0,132,139,418,342,418
2018,28,28,"Cankiri",40.5983,33.6142,22.4714285714286,25.3,1.02857142857143,48.3428571428571,32.435,NA,286,0,0,146,373,585,286,585
2018,29,28,"Cankiri",40.5983,33.6142,16.9428571428571,22,3.91428571428571,54.1714285714286,17.3366666666667,14.04,260,0,0,186,469,756,260,756
2018,30,28,"Cankiri",40.5983,33.6142,19,23.5142857142857,0.757142857142857,57.4285714285714,19.9442857142857,18.1214285714286,265,0,0,146,552,822,265,822
2018,31,28,"Cankiri",40.5983,33.6142,18.7857142857143,24.2428571428571,2.28571428571429,55.7285714285714,20.9871428571429,15.9657142857143,267,0,0,48,136,499,267,499
2018,32,28,"Cankiri",40.5983,33.6142,20.1142857142857,22.9142857142857,0,46.4285714285714,19.34,16.1471428571429,297,0,0,52,68,403,297,403
2018,33,28,"Cankiri",40.5983,33.6142,19.3428571428571,24.0285714285714,0,37.5285714285714,25.0714285714286,18.51,216,0,0,48,105,332,216,332
2018,34,28,"Cankiri",40.5983,33.6142,16.9857142857143,24.8285714285714,0,35.6142857142857,25.4628571428571,NA,144,0,0,19,12,227,144,227
2018,35,28,"Cankiri",40.5983,33.6142,21.1428571428571,26.2714285714286,0,38.9571428571429,25.56,NA,201,0,0,32,60,314,201,314
2018,36,28,"Cankiri",40.5983,33.6142,16.8571428571429,21.4571428571429,2.57142857142857,52.7285714285714,27.9,NA,341,0,0,204,232,370,341,370
2018,37,28,"Cankiri",40.5983,33.6142,21.3571428571429,18.7857142857143,0.0857142857142857,54.0142857142857,19.085,NA,241,1,0,50,125,419,240,419
2018,38,28,"Cankiri",40.5983,33.6142,19.0428571428571,17.7857142857143,0,47.2571428571429,19.8014285714286,36.9,189,50,60,59,101,344,139,284
2018,39,28,"Cankiri",40.5983,33.6142,21.1571428571429,16.1428571428571,0.0428571428571429,53,24.4228571428571,41.375,180,0,0,34,59,353,180,353
2018,40,28,"Cankiri",40.5983,33.6142,16.7285714285714,15,0.457142857142857,59.8142857142857,20.1457142857143,43.9333333333333,191,26,36,84,158,341,165,305
2018,41,28,"Cankiri",40.5983,33.6142,13.7714285714286,15.4285714285714,0.485714285714286,59.1857142857143,30.7085714285714,46.43,187,54,112,40,55,422,133,310
2018,42,28,"Cankiri",40.5983,33.6142,12.9857142857143,16.0142857142857,1.65714285714286,68.9571428571429,88.9657142857143,50.672,168,0,0,84,259,381,168,381
2018,43,28,"Cankiri",40.5983,33.6142,14.6285714285714,9.41428571428571,2.81428571428571,74.5857142857143,25.1057142857143,36.3625,187,21,28,69,169,402,166,374
2018,44,28,"Cankiri",40.5983,33.6142,10.9142857142857,9.95714285714286,0,61.7714285714286,49.7342857142857,53.2342857142857,196,51,77,0,0,264,145,187
2018,45,28,"Cankiri",40.5983,33.6142,12.7428571428571,8.3,0,66.2857142857143,39.24,43.6414285714286,231,12,77,36,70,473,219,396
2018,46,28,"Cankiri",40.5983,33.6142,12.5285714285714,4.9,0,66.6,26.1257142857143,36.3433333333333,230,60,68,101,231,465,170,397
2018,47,28,"Cankiri",40.5983,33.6142,12.2,7,0.4,79.2428571428571,31.4785714285714,NA,270,4,3,159,258,499,266,496
2018,48,28,"Cankiri",40.5983,33.6142,15.4571428571429,6.68571428571429,3.04285714285714,84.7285714285714,34.01,41.0575,245,26,5,58,40,201,219,196
2018,49,28,"Cankiri",40.5983,33.6142,13.3428571428571,3.31428571428571,1.65714285714286,82.1571428571429,25.09,34.9157142857143,257,97,186,100,196,420,160,234
2018,50,28,"Cankiri",40.5983,33.6142,14.6428571428571,2.6,1.32857142857143,84.4,28.4571428571429,41.9971428571429,256,45,63,121,110,305,211,242
2018,51,28,"Cankiri",40.5983,33.6142,12.4714285714286,4.98571428571429,1.84285714285714,85.1,22.9242857142857,35.6071428571429,250,45,60,124,117,248,205,188
2018,52,28,"Cankiri",40.5983,33.6142,10.8857142857143,-2.02857142857143,2.57157142857143,82.3,26.9671428571429,34.2833333333333,244,27,78,115,144,273,217,195
2019,1,28,"Cankiri",40.5983,33.6142,20.575,1.025,4.675,82.9875,28.265,46.7733333333333,343,49,284,34,98,784,294,500
2019,2,28,"Cankiri",40.5983,33.6142,12.4857142857143,-3.34285714285714,0.457142857142857,81.0142857142857,41.1971428571429,55.8433333333333,255,121,78,127,117,208,134,130
2019,3,28,"Cankiri",40.5983,33.6142,18.1714285714286,-0.342857142857143,4.25714285714286,81.3571428571429,30.3714285714286,48.46,192,59,50,78,106,198,133,148
2019,4,28,"Cankiri",40.5983,33.6142,14.3,2.8,3.04285714285714,84.7571428571429,38.1471428571429,58.0925,308,4,42,115,145,314,304,272
2019,5,28,"Cankiri",40.5983,33.6142,12.9,4.34285714285714,0.314285714285714,77.0142857142857,36.1571428571429,50.7542857142857,253,55,33,109,52,143,198,110
2019,6,28,"Cankiri",40.5983,33.6142,12.5571428571429,4.55714285714286,4.45714285714286,79.9142857142857,34.8128571428571,50.9614285714286,276,33,13,48,30,127,243,114
2019,7,28,"Cankiri",40.5983,33.6142,16.9571428571429,4.24285714285714,0.185714285714286,74.0714285714286,31.95,43.6857142857143,325,94,126,0,0,234,231,108
2019,8,28,"Cankiri",40.5983,33.6142,13.3857142857143,4.14285714285714,0.428571428571429,68.5857142857143,40.2585714285714,NA,305,11,5,119,107,219,294,214
2019,9,28,"Cankiri",40.5983,33.6142,16.2142857142857,2.88571428571429,0,66.2428571428571,24.4314285714286,33.855,331,0,0,206,259,310,331,310
2019,10,28,"Cankiri",40.5983,33.6142,12.8857142857143,5.61428571428571,0.285714285714286,60.7857142857143,37.96,43.98,359,108,79,160,146,252,251,173
2019,11,28,"Cankiri",40.5983,33.6142,17.8142857142857,7.1,4.28571428571429,70.3428571428571,25.4942857142857,40.204,373,0,0,131,203,400,373,400
2019,12,28,"Cankiri",40.5983,33.6142,15.6571428571429,7.18571428571429,0,56.1571428571429,42.4385714285714,40.09,343,43,34,156,79,416,300,382
2019,13,28,"Cankiri",40.5983,33.6142,22.2571428571429,5.11428571428571,0,50.7142857142857,23.7785714285714,25.875,256,33,37,65,108,194,223,157
2019,14,28,"Cankiri",40.5983,33.6142,14.3,9.62857142857143,0,53.5714285714286,29.115,37.2325,365,68,65,34,15,208,297,143
2019,15,28,"Cankiri",40.5983,33.6142,18.8142857142857,10.2428571428571,3.68571428571429,74.4857142857143,18.3733333333333,33.2228571428571,359,52,24,6,1,183,307,159
2019,16,28,"Cankiri",40.5983,33.6142,18.3142857142857,6.51428571428571,2,66.2714285714286,10.4457142857143,17.75,318,0,0,193,120,208,318,208
2019,17,28,"Cankiri",40.5983,33.6142,16.1857142857143,11.0571428571429,0.142857142857143,59.4857142857143,28.4385714285714,28.5385714285714,412,186,167,89,29,313,226,146
2019,18,28,"Cankiri",40.5983,33.6142,15.6428571428571,14.7142857142857,0.628571428571429,56.2142857142857,28.0985714285714,28.26,523,130,54,138,66,353,393,299
2019,19,28,"Cankiri",40.5983,33.6142,13.8428571428571,12.3285714285714,5.1,71.0285714285714,29.7042857142857,26.7314285714286,452,144,127,79,81,386,308,259
2019,20,28,"Cankiri",40.5983,33.6142,15.4857142857143,17.6285714285714,1.5,59.8285714285714,24.3671428571429,31.3014285714286,454,140,119,189,185,389,314,270
2019,21,28,"Cankiri",40.5983,33.6142,16.5285714285714,17.9857142857143,3.95714285714286,64.9714285714286,24.7457142857143,25.49,457,0,0,124,100,413,457,413
2019,22,28,"Cankiri",40.5983,33.6142,12.6285714285714,21.8428571428571,0.142857142857143,57.4857142857143,29.4214285714286,27.3771428571429,453,92,43,232,193,323,361,280
2019,23,28,"Cankiri",40.5983,33.6142,17.0857142857143,22.2285714285714,0.428571428571429,54.2142857142857,19.18,21.0157142857143,378,113,65,62,58,532,265,467
2019,24,28,"Cankiri",40.5983,33.6142,14.8,20.0571428571429,7.6,69.5714285714286,14.6685714285714,21.7857142857143,378,0,0,178,112,244,378,244
2019,25,28,"Cankiri",40.5983,33.6142,13.5571428571429,20.4142857142857,4.22857142857143,70.0857142857143,18.855,22.6375,306,25,62,149,81,325,281,263
2019,26,28,"Cankiri",40.5983,33.6142,17.5285714285714,22.5285714285714,0,55.7142857142857,14.5542857142857,15.6614285714286,377,0,0,173,203,342,377,342
2019,27,28,"Cankiri",40.5983,33.6142,18.5,21.7285714285714,1,49.5714285714286,16.1085714285714,23.2971428571429,456,0,0,13,6,222,456,222
2019,28,28,"Cankiri",40.5983,33.6142,15.9142857142857,20.7,0.571428571428572,53.2142857142857,11.2271428571429,18.6228571428571,398,0,0,259,269,421,398,421
2019,29,28,"Cankiri",40.5983,33.6142,15.6285714285714,19.9571428571429,1.68571428571429,59.8714285714286,15.6642857142857,22.8442857142857,453,0,0,7,18,203,453,203
2019,30,28,"Cankiri",40.5983,33.6142,18.8285714285714,22.5285714285714,0.428571428571429,45.4,23.1585714285714,22.6657142857143,456,0,0,65,31,335,456,335
2019,31,28,"Cankiri",40.5983,33.6142,18.4142857142857,24.7857142857143,0.0142857142857143,47.3142857142857,35.9385714285714,24.3971428571429,334,0,0,169,190,375,334,375
2019,32,28,"Cankiri",40.5983,33.6142,21,22.4857142857143,0,41.6857142857143,23.6528571428571,26.3614285714286,346,2,0,7,27,395,344,395
2019,33,28,"Cankiri",40.5983,33.6142,22.1857142857143,24.5,2.08571428571429,41.6285714285714,28.9542857142857,31.1585714285714,337,49,68,108,218,531,288,463
2019,34,28,"Cankiri",40.5983,33.6142,19.5571428571429,21.6285714285714,0.685714285714286,58.6285714285714,25.2883333333333,22.5471428571429,299,0,0,70,48,345,299,345
2019,35,28,"Cankiri",40.5983,33.6142,18.8857142857143,23.2285714285714,0,44.8714285714286,33.1966666666667,28.5657142857143,307,0,0,8,15,415,307,415
2019,36,28,"Cankiri",40.5983,33.6142,19.1857142857143,21.6571428571429,0.428571428571429,44.9571428571429,32.8414285714286,30.5371428571429,171,18,5,0,0,67,153,62
2019,37,28,"Cankiri",40.5983,33.6142,19.2571428571429,20.1714285714286,0,47.0571428571429,34.6842857142857,31.9814285714286,218,0,0,1,0,55,218,55
2019,38,28,"Cankiri",40.5983,33.6142,13.0571428571429,16.7571428571429,0,45.1,39.5114285714286,33.44,266,76,24,50,8,91,190,67
2019,39,28,"Cankiri",40.5983,33.6142,10.5285714285714,15.7571428571429,0.428571428571429,54.7,36.25,44.3057142857143,237,63,32,112,38,79,174,47
2019,40,28,"Cankiri",40.5983,33.6142,13.8285714285714,17.0714285714286,1.08571428571429,45.2428571428571,45.4966666666667,49.0814285714286,241,38,49,109,24,111,203,62
2019,41,28,"Cankiri",40.5983,33.6142,11.5428571428571,14.4428571428571,0,60.6142857142857,31.3428571428571,45.1485714285714,416,83,126,181,166,448,333,322
2019,42,28,"Cankiri",40.5983,33.6142,9.44285714285714,15.3142857142857,0.714285714285714,53.9857142857143,53.1328571428571,61.3014285714286,356,141,172,13,10,408,215,236
2019,43,28,"Cankiri",40.5983,33.6142,14.3285714285714,13.3285714285714,0,61.7142857142857,39.6857142857143,55.3728571428571,306,25,22,13,18,300,281,278
2019,44,28,"Cankiri",40.5983,33.6142,9.75714285714286,8.65714285714286,0.942857142857143,68.3571428571429,41.7885714285714,57.1342857142857,350,33,49,50,36,250,317,201
2019,45,28,"Cankiri",40.5983,33.6142,7.22857142857143,9.18571428571429,0,67.9857142857143,70.5671428571429,62.4671428571429,417,153,177,50,20,328,264,151
2019,46,28,"Cankiri",40.5983,33.6142,6.51428571428571,9.31428571428571,0,60.1571428571429,86.2971428571429,60.3428571428571,401,38,48,65,63,337,363,289
2019,47,28,"Cankiri",40.5983,33.6142,6.97142857142857,3.98571428571429,0,66.0428571428571,80.0285714285714,53.4657142857143,391,0,0,129,134,339,391,339
2019,48,28,"Cankiri",40.5983,33.6142,10.1857142857143,6.58571428571429,1.74285714285714,80.8571428571429,64.76,48.9585714285714,320,18,11,62,76,251,302,240
2019,49,28,"Cankiri",40.5983,33.6142,11.1857142857143,0.157142857142857,0.2,80.0714285714286,58.6957142857143,41.8842857142857,393,0,0,110,54,274,393,274
2019,50,28,"Cankiri",40.5983,33.6142,5.61428571428571,3.97142857142857,0.242857142857143,85.5571428571428,56.5642857142857,49.6057142857143,218,28,3,53,30,119,190,116
2019,51,28,"Cankiri",40.5983,33.6142,5.78571428571429,0.528571428571428,0,88.6571428571429,59.7142857142857,37.4871428571429,361,0,0,211,274,488,361,488
2019,52,28,"Cankiri",40.5983,33.6142,15.3857142857143,4.02857142857143,8.17142857142857,83.0428571428571,38.5542857142857,36.4971428571429,279,84,142,132,86,281,195,139
2020,1,28,"Cankiri",40.5983,33.6142,14.32,1.68,0.04,74.92,60.354,40.518,160,32,24,61,22,126,128,102
2020,2,28,"Cankiri",40.5983,33.6142,15.3571428571429,0.514285714285714,3.71428571428571,78.5428571428571,56.7957142857143,43.4428571428571,240,0,0,114,89,173,240,173
2020,3,28,"Cankiri",40.5983,33.6142,12.5142857142857,0.114285714285714,1.42857142857143,73.1,63.8742857142857,44.2671428571429,270,21,15,8,28,382,249,367
2020,4,28,"Cankiri",40.5983,33.6142,14.1,-1.84285714285714,0.0285714285714286,69.7285714285714,39.6428571428571,30.7157142857143,358,119,91,239,204,295,239,204
2020,5,28,"Cankiri",40.5983,33.6142,12.9,2.17142857142857,1.05714285714286,77.2,61.085,45.5416666666667,331,0,0,105,59,272,331,272
2020,6,28,"Cankiri",40.5983,33.6142,31.0714285714286,2.95714285714286,1.85714285714286,71.6,28.2333333333333,31.4566666666667,343,24,14,101,70,267,319,253
2020,7,28,"Cankiri",40.5983,33.6142,15.1428571428571,0.7,0.528571428571429,70.2714285714286,45.7171428571429,41.6471428571429,341,86,86,38,27,338,255,252
2020,8,28,"Cankiri",40.5983,33.6142,13.0142857142857,3.05714285714286,1.08571428571429,69.8571428571429,51.2557142857143,44.6957142857143,283,54,74,18,14,187,229,113
2020,9,28,"Cankiri",40.5983,33.6142,19.8857142857143,5.65714285714286,1.14285714285714,64.2571428571429,36.2642857142857,40.8171428571429,393,49,19,95,119,528,344,509
2020,10,28,"Cankiri",40.5983,33.6142,12.5142857142857,8.02857142857143,0.0571428571428571,64.1285714285714,73.6214285714286,49.8414285714286,205,104,132,0,0,210,101,78
2020,11,28,"Cankiri",40.5983,33.6142,17.1285714285714,11.6142857142857,0.0857142857142857,58.1,64.5085714285714,41.4328571428571,115,27,46,34,14,94,88,48
2020,12,28,"Cankiri",40.5983,33.6142,16.8142857142857,3.01428571428571,0.885714285714286,64.9714285714286,23.0528571428571,24.0357142857143,117,18,11,56,58,118,99,107
2020,13,28,"Cankiri",40.5983,33.6142,17.6142857142857,9.7,2.14285714285714,67.1714285714286,35.0557142857143,36.1642857142857,136,15,15,0,0,92,121,77
2020,14,28,"Cankiri",40.5983,33.6142,21.2142857142857,7.91428571428571,4.04285714285714,72.2142857142857,40.0942857142857,43.1271428571429,155,0,0,26,20,121,155,121
2020,15,28,"Cankiri",40.5983,33.6142,30.3285714285714,8.71428571428571,0,48.6428571428571,44.82,35.4914285714286,133,0,0,8,3,118,133,118
2020,16,28,"Cankiri",40.5983,33.6142,20.3428571428571,10.7142857142857,2.68571428571429,56.4142857142857,43.01,33.8371428571429,141,9,5,13,12,106,132,101
2020,17,28,"Cankiri",40.5983,33.6142,20.0285714285714,9.67142857142857,0.342857142857143,56.1714285714286,34.3214285714286,28.6214285714286,137,0,0,67,70,123,137,123
2020,18,28,"Cankiri",40.5983,33.6142,24.0714285714286,11.7571428571429,3.54285714285714,61.9714285714286,38.25,34.6385714285714,146,26,27,20,17,164,120,137
2020,19,28,"Cankiri",40.5983,33.6142,22.0714285714286,11.4285714285714,0.828571428571429,63.4857142857143,20.3316666666667,27.3585714285714,137,25,58,22,14,157,112,99
2020,20,28,"Cankiri",40.5983,33.6142,20.6857142857143,19.9571428571429,0,46.5142857142857,51.5085714285714,29.5342857142857,164,0,0,73,70,164,164,164
2020,21,28,"Cankiri",40.5983,33.6142,27.3714285714286,17.4142857142857,0.571428571428571,49.7857142857143,44.6457142857143,16.33,146,0,0,49,29,96,146,96
2020,22,28,"Cankiri",40.5983,33.6142,24.6571428571429,13.5714285714286,0.785714285714286,61.2714285714286,17.9542857142857,15.9842857142857,118,0,0,48,61,100,118,100
2020,23,28,"Cankiri",40.5983,33.6142,17.5428571428571,17.6,1.45714285714286,55.6,26.96,26.8428571428571,112,12,8,23,20,70,100,62
2020,24,28,"Cankiri",40.5983,33.6142,19.4,19.7714285714286,5.25714285714286,60.8285714285714,47.6666666666667,26.5466666666667,140,34,54,84,85,150,106,96
2020,25,28,"Cankiri",40.5983,33.6142,15.2857142857143,18.8428571428571,2.72857142857143,69.8428571428571,NA,23.994,137,26,16,70,79,108,111,92
2020,26,28,"Cankiri",40.5983,33.6142,17.3,21.8714285714286,1.42857142857143,59.4857142857143,30.028,20.2785714285714,173,0,0,48,49,133,173,133
2020,27,28,"Cankiri",40.5983,33.6142,17.0142857142857,24.7857142857143,0,47.6714285714286,37.3442857142857,20.8471428571429,113,0,0,35,63,113,113,113
2020,28,28,"Cankiri",40.5983,33.6142,19.5714285714286,24.1142857142857,1.02857142857143,50.8,36.1728571428571,21.52,164,16,12,32,10,122,148,110
2020,29,28,"Cankiri",40.5983,33.6142,21.9285714285714,24.4857142857143,0.0285714285714286,52.4285714285714,32.2075,21.1771428571429,186,0,0,33,19,111,186,111
2020,30,28,"Cankiri",40.5983,33.6142,23.1142857142857,24.4142857142857,0,43.8714285714286,48.375,21.9042857142857,190,0,0,51,51,142,190,142
2020,31,28,"Cankiri",40.5983,33.6142,20.0571428571429,25.4857142857143,0.228571428571429,44.9428571428571,40.9214285714286,17.4328571428571,150,0,0,95,98,127,150,127
2020,32,28,"Cankiri",40.5983,33.6142,20.0285714285714,24.9142857142857,0,37.9571428571429,45.28,27.1114285714286,146,34,20,4,4,107,112,87
2020,33,28,"Cankiri",40.5983,33.6142,21.3,23,0,44.6857142857143,42.0485714285714,20.69,183,0,0,31,16,83,183,83
2020,34,28,"Cankiri",40.5983,33.6142,20.6,22.1285714285714,0,44.0285714285714,58.3471428571429,23.9414285714286,197,29,7,68,33,97,168,90
2020,35,28,"Cankiri",40.5983,33.6142,15.9857142857143,24.3285714285714,0,36.0857142857143,52.2828571428571,29.6828571428571,164,44,50,42,36,157,120,107
2020,36,28,"Cankiri",40.5983,33.6142,15.1714285714286,24.9142857142857,0,33.6857142857143,65.4957142857143,30.1471428571429,179,70,28,77,64,112,109,84
2020,37,28,"Cankiri",40.5983,33.6142,18.6,23.1571428571429,0.114285714285714,48.9,53.0071428571429,25.8714285714286,193,13,3,30,25,91,180,88
2020,38,28,"Cankiri",40.5983,33.6142,22.4,22.0142857142857,0,45.6,44.3942857142857,24.4628571428571,235,0,0,29,23,157,235,157
2020,39,28,"Cankiri",40.5983,33.6142,14.6428571428571,19.1428571428571,0.228571428571429,56.1857142857143,41.6742857142857,34.6,220,91,27,17,6,129,129,102
2020,40,28,"Cankiri",40.5983,33.6142,10.9142857142857,17.6428571428571,0.285714285714286,49.6571428571429,45.6114285714286,31.7757142857143,187,23,12,19,7,154,164,142
2020,41,28,"Cankiri",40.5983,33.6142,14.3142857142857,19.1285714285714,0.314285714285714,45.8142857142857,59.86,39.6871428571429,182,60,33,53,54,127,122,94
2020,42,28,"Cankiri",40.5983,33.6142,10.9428571428571,16.5,1.42857142857143,50.1714285714286,56.15,40.4171428571429,177,69,30,24,31,111,108,81
2020,43,28,"Cankiri",40.5983,33.6142,12.2285714285714,14,2.25714285714286,63.8714285714286,32.0114285714286,38.1971428571429,194,59,72,20,16,161,135,89
2020,44,28,"Cankiri",40.5983,33.6142,10.7,12.3142857142857,2.24285714285714,62.9285714285714,42.2142857142857,41.4657142857143,255,40,15,51,57,233,215,218
2020,45,28,"Cankiri",40.5983,33.6142,18,8.6,0.428571428571429,69.5571428571428,24.9942857142857,30.0014285714286,156,39,38,27,11,103,117,65
2020,46,28,"Cankiri",40.5983,33.6142,12,5.62857142857143,0,73.9428571428571,40.45,38.215,208,71,31,20,8,109,137,78
2020,47,28,"Cankiri",40.5983,33.6142,15.3,3.62857142857143,0,69.2,34.5742857142857,39.3985714285714,173,59,35,31,13,83,114,48
2020,48,28,"Cankiri",40.5983,33.6142,9.51428571428571,0.5,0,68.8857142857143,35.4914285714286,42.8914285714286,199,74,93,2,0,262,125,169
2020,49,28,"Cankiri",40.5983,33.6142,6.64285714285714,2.91428571428571,0.457142857142857,73.3428571428571,50.9757142857143,48.3285714285714,207,82,46,19,8,116,125,70
2020,50,28,"Cankiri",40.5983,33.6142,8.27142857142857,3.9,0.571428571428571,84.2428571428571,48.7785714285714,43.8742857142857,181,0,0,80,28,98,181,98
2020,51,28,"Cankiri",40.5983,33.6142,10.6714285714286,5.74285714285714,1.02857142857143,80.7,34.3128571428571,39.2914285714286,171,15,10,25,24,90,156,80
2020,52,28,"Cankiri",40.5983,33.6142,7.75714285714286,1.01428571428571,0,78.2857142857143,37.5942857142857,33.6485714285714,203,37,13,87,49,113,166,100
2020,53,28,"Cankiri",40.5983,33.6142,5.8,3.875,0.2,81.875,49.1075,41.915,122,22,37,40,22,111,100,74
2017,1,29,"Corum",40.5489,34.9533,18.0285714285714,-0.471428571428572,1.11428571428571,81.1,59.2671428571429,NA,563,13,12,205,285,847,550,835
2017,2,29,"Corum",40.5489,34.9533,13.6,-2.47142857142857,0.185714285714286,79.9142857142857,73.3971428571429,NA,757,0,0,364,597,1214,757,1214
2017,3,29,"Corum",40.5489,34.9533,12.4571428571429,0.742857142857143,0.857142857142857,88.4142857142857,72.2771428571429,NA,762,0,0,304,453,1449,762,1449
2017,4,29,"Corum",40.5489,34.9533,11.3428571428571,-2.02857142857143,1.64285714285714,80.2428571428571,53.9585714285714,NA,639,0,0,337,427,889,639,889
2017,5,29,"Corum",40.5489,34.9533,12.1714285714286,-3.35714285714286,0.171428571428571,69.5142857142857,38.0033333333333,NA,588,0,0,332,539,1163,588,1163
2017,6,29,"Corum",40.5489,34.9533,14.8285714285714,2.98571428571429,0.0714285714285714,76.8,65.6083333333333,NA,736,0,0,231,431,1519,736,1519
2017,7,29,"Corum",40.5489,34.9533,13.5571428571429,-1.74285714285714,0.1,64.7428571428571,45.9614285714286,NA,492,0,0,154,217,717,492,717
2017,8,29,"Corum",40.5489,34.9533,20.9,5.88571428571429,0.142857142857143,63.5142857142857,64.0657142857143,NA,739,0,0,229,701,1747,739,1747
2017,9,29,"Corum",40.5489,34.9533,16.1714285714286,7.38571428571429,1.97142857142857,68.5142857142857,81.5228571428571,NA,574,0,0,163,301,866,574,866
2017,10,29,"Corum",40.5489,34.9533,11.7142857142857,8.77142857142857,1.51428571428571,65.7857142857143,81.6642857142857,NA,712,48,73,606,862,1043,664,970
2017,11,29,"Corum",40.5489,34.9533,11.9714285714286,4.81428571428571,4.25714285714286,85.3,34.0685714285714,NA,525,43,59,283,347,725,482,666
2017,12,29,"Corum",40.5489,34.9533,16.6428571428571,7.18571428571429,0.285714285714286,60.1857142857143,45.94,NA,589,0,0,219,431,1077,589,1077
2017,13,29,"Corum",40.5489,34.9533,20.1714285714286,8,1.58571428571429,63.9714285714286,40.7442857142857,NA,574,0,0,133,239,887,574,887
2017,14,29,"Corum",40.5489,34.9533,13.3428571428571,9.52857142857143,3.32857142857143,61.0428571428571,49.0771428571429,NA,639,121,305,166,277,1336,518,1031
2017,15,29,"Corum",40.5489,34.9533,12.6285714285714,9.28571428571429,2.17142857142857,72.3571428571429,40.1985714285714,NA,587,110,155,199,255,1187,477,1032
2017,16,29,"Corum",40.5489,34.9533,24.2142857142857,10.8714285714286,1.46742857142857,62.9142857142857,32.2157142857143,NA,717,14,14,118,77,920,703,906
2017,17,29,"Corum",40.5489,34.9533,13.5142857142857,11.7571428571429,0,49.6714285714286,43.9771428571429,NA,731,229,446,130,254,1478,502,1032
2017,18,29,"Corum",40.5489,34.9533,14.5428571428571,15.1142857142857,1.37142857142857,61.1428571428571,52.8542857142857,NA,506,152,278,26,43,923,354,645
2017,19,29,"Corum",40.5489,34.9533,20.4142857142857,17.3285714285714,0.385714285714286,56.8142857142857,50.91,NA,471,53,131,158,302,966,418,835
2017,20,29,"Corum",40.5489,34.9533,20.3857142857143,12.6428571428571,0.5,69.0571428571428,25.88,NA,472,30,33,23,40,1205,442,1172
2017,21,29,"Corum",40.5489,34.9533,17.9285714285714,13.8142857142857,5.95285714285714,68.6428571428571,33.6928571428571,NA,448,100,106,0,0,849,348,743
2017,22,29,"Corum",40.5489,34.9533,18.2285714285714,17.6571428571429,0.605142857142857,66.9285714285714,37.04,NA,522,67,129,169,233,1015,455,886
2017,23,29,"Corum",40.5489,34.9533,16.9428571428571,19.7142857142857,4.74285714285714,70.8857142857143,39.66,NA,578,0,0,254,724,1388,578,1388
2017,24,29,"Corum",40.5489,34.9533,19.6857142857143,18.2285714285714,0.406428571428571,62.0571428571429,33.2571428571429,NA,552,34,39,38,82,1139,518,1100
2017,25,29,"Corum",40.5489,34.9533,15.1428571428571,18.1714285714286,7.10942857142857,73.6428571428571,38.6157142857143,NA,584,88,57,31,62,1041,496,984
2017,26,29,"Corum",40.5489,34.9533,18.2714285714286,23.6857142857143,0,55.9,47.6442857142857,NA,564,0,0,189,410,971,564,971
2017,27,29,"Corum",40.5489,34.9533,20.4142857142857,21.8,0,55.5285714285714,45.3085714285714,NA,511,0,0,113,237,642,511,642
2017,28,29,"Corum",40.5489,34.9533,23.5571428571429,22.2857142857143,0,51.0285714285714,38.7071428571429,NA,481,28,54,0,0,864,453,810
2017,29,29,"Corum",40.5489,34.9533,24.1142857142857,23.3285714285714,0.571428571428572,59.6571428571429,34.71,NA,532,2,1,0,0,1272,530,1271
2017,30,29,"Corum",40.5489,34.9533,21.4,24.6428571428571,0.0857142857142857,44.4428571428571,59.1971428571429,NA,531,0,0,13,1,928,531,928
2017,31,29,"Corum",40.5489,34.9533,29.1714285714286,23.7285714285714,0.142857142857143,58.9142857142857,46.2114285714286,NA,559,6,3,0,0,1047,553,1044
2017,32,29,"Corum",40.5489,34.9533,23.8,26.0571428571429,0,53.1714285714286,61.6428571428571,NA,567,34,32,0,0,1092,533,1060
2017,33,29,"Corum",40.5489,34.9533,26.7285714285714,24.2,0.428571428571429,60.3,48.2071428571429,NA,596,0,0,0,0,1199,596,1199
2017,34,29,"Corum",40.5489,34.9533,19.8571428571429,20.9142857142857,0.0571428571428571,59.3857142857143,32.7628571428571,NA,601,164,215,0,0,1280,437,1065
2017,35,29,"Corum",40.5489,34.9533,17.7142857142857,19.5,0.428571428571429,55.8428571428571,34.3071428571429,NA,493,78,91,0,0,1014,415,923
2017,36,29,"Corum",40.5489,34.9533,18.3285714285714,20.3142857142857,0.857142857142857,51.1857142857143,54.2742857142857,NA,507,3,0,2,1,1321,504,1321
2017,37,29,"Corum",40.5489,34.9533,19.6,23.9142857142857,0,37.4857142857143,96.7242857142857,NA,589,6,0,39,126,1138,583,1138
2017,38,29,"Corum",40.5489,34.9533,18.2714285714286,22.8,0,41.0428571428571,92.3457142857143,NA,671,106,214,105,150,1312,565,1098
2017,39,29,"Corum",40.5489,34.9533,17.4142857142857,16.1571428571429,0.1,65.2142857142857,45.7442857142857,NA,782,221,371,0,0,1630,561,1259
2017,40,29,"Corum",40.5489,34.9533,17.5142857142857,12.2142857142857,2.14285714285714,59.4571428571429,67.8857142857143,NA,543,0,0,105,288,1137,543,1137
2017,41,29,"Corum",40.5489,34.9533,14.5857142857143,10.9571428571429,0.479714285714286,70.0714285714286,42.6885714285714,NA,487,53,96,0,0,843,434,747
2017,42,29,"Corum",40.5489,34.9533,8.97142857142857,10.9857142857143,0,57.9428571428571,96.0714285714286,NA,530,0,0,105,175,815,530,815
2017,43,29,"Corum",40.5489,34.9533,11.1857142857143,12.1857142857143,0.0714285714285714,59.5142857142857,102.838571428571,NA,506,0,0,205,336,919,506,919
2017,44,29,"Corum",40.5489,34.9533,12.9714285714286,4.97142857142857,0.928571428571428,62.1142857142857,68.9957142857143,NA,561,0,0,229,391,1102,561,1102
2017,45,29,"Corum",40.5489,34.9533,8.2,7.14285714285714,0.2,80.0142857142857,105.934285714286,NA,577,0,0,341,438,829,577,829
2017,46,29,"Corum",40.5489,34.9533,8.82857142857143,7.21428571428571,0,80.3285714285714,152.012857142857,NA,587,30,90,451,758,1085,557,995
2017,47,29,"Corum",40.5489,34.9533,13.6857142857143,3.84285714285714,2.88571428571429,87.8428571428571,59.8271428571429,NA,418,1,0,96,259,804,417,804
2017,48,29,"Corum",40.5489,34.9533,5,4.92857142857143,1.14285714285714,89.1857142857143,102.498571428571,NA,386,132,211,105,178,619,254,408
2017,49,29,"Corum",40.5489,34.9533,10.3142857142857,3.08571428571429,1.57142857142857,84.6,65.2742857142857,NA,407,8,13,51,106,645,399,632
2017,50,29,"Corum",40.5489,34.9533,10.8857142857143,4.3,0.185714285714286,87.3428571428571,109.767142857143,NA,346,0,0,285,294,442,346,442
2017,51,29,"Corum",40.5489,34.9533,12.1714285714286,4.67142857142857,6.28571428571429,93.6571428571429,43.3071428571429,NA,386,19,22,24,23,349,367,327
2017,52,29,"Corum",40.5489,34.9533,7.45,0.5,0.55,89.1625,136.735,NA,528,0,0,141,212,507,528,507
2018,1,29,"Corum",40.5489,34.9533,9.025,3.4,1.5125,94.275,66.9214285714286,NA,618,23,4,261,351,914,595,910
2018,2,29,"Corum",40.5489,34.9533,10.0571428571429,3.58571428571429,0.771428571428571,95.1714285714286,53.65,NA,624,91,145,130,270,1309,533,1164
2018,3,29,"Corum",40.5489,34.9533,11.9714285714286,2.84285714285714,1.74285714285714,86.3142857142857,41.14,NA,639,26,20,72,22,655,613,635
2018,4,29,"Corum",40.5489,34.9533,16.1714285714286,1.44285714285714,2.51428571428571,78.8285714285714,27.9142857142857,NA,604,2,0,15,20,764,602,764
2018,5,29,"Corum",40.5489,34.9533,10.8857142857143,3.44285714285714,0,80.4714285714286,71.1357142857143,NA,670,0,0,81,45,819,670,819
2018,6,29,"Corum",40.5489,34.9533,10.0571428571429,6.24285714285714,0.228571428571429,84.2857142857143,79.89,NA,704,33,116,177,267,1022,671,906
2018,7,29,"Corum",40.5489,34.9533,13.5,4.9,0.542857142857143,81.5714285714286,52.7071428571429,NA,478,79,96,59,47,557,399,461
2018,8,29,"Corum",40.5489,34.9533,20.6714285714286,6.1,0.885714285714286,81.3,48.8485714285714,NA,711,0,0,137,164,1321,711,1321
2018,9,29,"Corum",40.5489,34.9533,18.7714285714286,5.4,2.25714285714286,77.4857142857143,48.57,NA,621,0,0,102,160,956,621,956
2018,10,29,"Corum",40.5489,34.9533,12.7285714285714,8.68571428571429,1.71428571428571,79.4571428571429,63.2928571428571,NA,556,8,7,238,455,1330,548,1323
2018,11,29,"Corum",40.5489,34.9533,12.7857142857143,9.7,2.14285714285714,74.5428571428571,54.99,NA,551,6,13,333,766,1426,545,1413
2018,12,29,"Corum",40.5489,34.9533,18.4857142857143,11.4857142857143,1.22857142857143,64.6142857142857,93.455,NA,425,59,105,143,282,1187,366,1082
2018,13,29,"Corum",40.5489,34.9533,17.7571428571429,10.5857142857143,3.08571428571429,72.4,90.1285714285714,NA,356,0,0,109,98,428,356,428
2018,14,29,"Corum",40.5489,34.9533,15.3428571428571,11.1142857142857,0.0285714285714286,59.1571428571429,54.4314285714286,NA,407,0,0,188,137,486,407,486
2018,15,29,"Corum",40.5489,34.9533,16.9857142857143,14.2714285714286,0.0714285714285714,57.4714285714286,59.31,NA,374,104,208,49,50,450,270,242
2018,16,29,"Corum",40.5489,34.9533,16.6857142857143,11.1285714285714,0.285714285714286,52.5,48.0542857142857,NA,411,7,23,125,100,648,404,625
2018,17,29,"Corum",40.5489,34.9533,18.4857142857143,15.9714285714286,0,47.0142857142857,53.7428571428571,NA,419,5,1,61,96,652,414,651
2018,18,29,"Corum",40.5489,34.9533,15.1,17.5285714285714,5.37114285714286,59.2,56.2671428571429,NA,303,63,102,58,69,474,240,372
2018,19,29,"Corum",40.5489,34.9533,15.6571428571429,13.9428571428571,2.62871428571429,76.7714285714286,35.6985714285714,NA,275,0,0,125,206,467,275,467
2018,20,29,"Corum",40.5489,34.9533,16.3857142857143,18.1142857142857,1.82342857142857,62.3428571428571,46.94,NA,204,35,40,69,158,306,169,266
2018,21,29,"Corum",40.5489,34.9533,20.5857142857143,19.4,2.48271428571429,68.7142857142857,46.0271428571429,NA,252,0,0,9,32,281,252,281
2018,22,29,"Corum",40.5489,34.9533,19.2571428571429,17.7285714285714,1.88571428571429,68.5571428571429,37.9866666666667,NA,249,63,83,0,0,427,186,344
2018,23,29,"Corum",40.5489,34.9533,16.9428571428571,20.0142857142857,0.857142857142857,59.1714285714286,42.0357142857143,NA,267,0,0,111,322,812,267,812
2018,24,29,"Corum",40.5489,34.9533,20.8857142857143,20.8857142857143,1.77142857142857,58.0428571428571,33.7985714285714,NA,267,4,11,81,136,448,263,437
2018,25,29,"Corum",40.5489,34.9533,18.0142857142857,20.4142857142857,1.42857142857143,67.4857142857143,36.5885714285714,NA,358,0,0,65,75,518,358,518
2018,26,29,"Corum",40.5489,34.9533,25.6714285714286,23.8571428571429,0,57.9428571428571,40.2271428571429,NA,355,90,101,59,59,587,265,486
2018,27,29,"Corum",40.5489,34.9533,23.5571428571429,21.9285714285714,0,56.0714285714286,36.3442857142857,NA,342,0,0,6,16,418,342,418
2018,28,29,"Corum",40.5489,34.9533,26.6857142857143,24.4285714285714,2.42842857142857,53.3571428571429,40.4028571428571,NA,286,0,0,2,1,585,286,585
2018,29,29,"Corum",40.5489,34.9533,21.7571428571429,22.2714285714286,2.18814285714286,57.9428571428571,33.6085714285714,NA,260,0,0,13,43,756,260,756
2018,30,29,"Corum",40.5489,34.9533,23.3428571428571,24.0857142857143,1.74285714285714,59.3285714285714,41.9214285714286,NA,265,52,307,17,96,822,213,515
2018,31,29,"Corum",40.5489,34.9533,19,23.7571428571429,1.857,58.3142857142857,40.36,NA,267,21,17,38,85,499,246,482
2018,32,29,"Corum",40.5489,34.9533,18.5428571428571,20.9428571428571,0.828571428571429,56.4714285714286,36.7885714285714,NA,297,5,2,11,28,403,292,401
2018,33,29,"Corum",40.5489,34.9533,20.4142857142857,22.4,0,49.1857142857143,36.0442857142857,NA,216,0,0,7,14,332,216,332
2018,34,29,"Corum",40.5489,34.9533,21.7,23.5,0,43.9285714285714,36.6685714285714,NA,144,12,22,1,0,227,132,205
2018,35,29,"Corum",40.5489,34.9533,25.2428571428571,24.1285714285714,0,50.6,41.5442857142857,NA,201,0,0,2,12,314,201,314
2018,36,29,"Corum",40.5489,34.9533,22.2285714285714,21.7142857142857,0.0142857142857143,54.5857142857143,46.2771428571429,NA,341,0,0,88,91,370,341,370
2018,37,29,"Corum",40.5489,34.9533,22.2285714285714,19.2857142857143,1.82857142857143,64.6285714285714,34.9628571428571,NA,241,0,0,84,176,419,241,419
2018,38,29,"Corum",40.5489,34.9533,26.2857142857143,17.5,0.0142857142857143,61.1285714285714,37.8671428571429,NA,189,0,0,0,0,344,189,344
2018,39,29,"Corum",40.5489,34.9533,24.4857142857143,16.2428571428571,0.0285714285714286,56.5,50.3014285714286,NA,180,0,0,43,78,353,180,353
2018,40,29,"Corum",40.5489,34.9533,13.6714285714286,14.9571428571429,0.4,60.2571428571429,42.8225,NA,191,14,37,13,28,341,177,304
2018,41,29,"Corum",40.5489,34.9533,13.2571428571429,15.2571428571429,0.142857142857143,70.9714285714286,42.02,NA,187,38,19,15,30,422,149,403
2018,42,29,"Corum",40.5489,34.9533,16.5142857142857,16.7857142857143,3.75985714285714,69.2428571428571,144.338571428571,NA,168,13,16,88,188,381,155,365
2018,43,29,"Corum",40.5489,34.9533,11.3285714285714,10.2142857142857,3.306,79.1857142857143,57.1128571428571,NA,187,21,28,48,38,402,166,374
2018,44,29,"Corum",40.5489,34.9533,7.88571428571429,10.3,0,68.5428571428571,76.0742857142857,NA,196,58,47,18,28,264,138,217
2018,45,29,"Corum",40.5489,34.9533,7.74285714285714,8.42857142857143,0,72.6285714285714,69.0828571428571,NA,231,34,36,84,156,473,197,437
2018,46,29,"Corum",40.5489,34.9533,11.3857142857143,4.84285714285714,0,73.9142857142857,57.5742857142857,NA,230,0,0,117,208,465,230,465
2018,47,29,"Corum",40.5489,34.9533,11.1428571428571,6.67142857142857,0.457142857142857,82.6,70.1342857142857,NA,270,60,74,58,15,499,210,425
2018,48,29,"Corum",40.5489,34.9533,13.3,7.08571428571429,3.91428571428571,92.2714285714286,48.1742857142857,NA,245,47,60,27,5,201,198,141
2018,49,29,"Corum",40.5489,34.9533,9.01428571428571,3.55714285714286,2.74285714285714,94.2285714285714,57.2757142857143,NA,257,0,0,124,97,420,257,420
2018,50,29,"Corum",40.5489,34.9533,12.5857142857143,2.6,3.77142857142857,92.9,66.4228571428571,NA,256,53,71,107,103,305,203,234
2018,51,29,"Corum",40.5489,34.9533,10.3714285714286,5.87142857142857,0.857142857142857,92.9,56.8366666666667,NA,250,40,59,83,35,248,210,189
2018,52,29,"Corum",40.5489,34.9533,8.14285714285714,-1.8,4.27142857142857,91.8142857142857,42.995,NA,244,0,0,85,51,273,244,273
2019,1,29,"Corum",40.5489,34.9533,15.325,1.675,3.45,90.425,24.92,NA,343,0,0,164,312,784,343,784
2019,2,29,"Corum",40.5489,34.9533,11.1857142857143,-2.92857142857143,0.885714285714286,88.1142857142857,NA,NA,255,7,16,55,9,208,248,192
2019,3,29,"Corum",40.5489,34.9533,15.7285714285714,0.442857142857143,3.08771428571429,85.8142857142857,74.5766666666667,NA,192,19,29,84,101,198,173,169
2019,4,29,"Corum",40.5489,34.9533,11.4714285714286,3.34285714285714,0.585714285714286,87.6857142857143,87.382,NA,308,0,0,128,127,314,308,314
2019,5,29,"Corum",40.5489,34.9533,12.6,4.85714285714286,0.185714285714286,78.1714285714286,75.0085714285714,NA,253,0,0,135,68,143,253,143
2019,6,29,"Corum",40.5489,34.9533,12.4285714285714,4.72857142857143,3.21428571428571,84.7857142857143,74.5385714285714,NA,276,1,0,85,30,127,275,127
2019,7,29,"Corum",40.5489,34.9533,16.4285714285714,3.84285714285714,0.2,78.5,47.2614285714286,NA,325,0,0,53,11,234,325,234
2019,8,29,"Corum",40.5489,34.9533,20.8285714285714,4.6,0.857142857142857,72.6142857142857,63.69,NA,305,0,0,140,65,219,305,219
2019,9,29,"Corum",40.5489,34.9533,22.3142857142857,3.02857142857143,0.142857142857143,74.8,35.82,NA,331,0,0,106,54,310,331,310
2019,10,29,"Corum",40.5489,34.9533,15.1,5.22857142857143,0.171428571428571,66.4714285714286,56.66,NA,359,0,0,139,63,252,359,252
2019,11,29,"Corum",40.5489,34.9533,24.4571428571429,7.15714285714286,1.51428571428571,72.5571428571428,37.8828571428571,NA,373,0,0,77,75,400,373,400
2019,12,29,"Corum",40.5489,34.9533,17.4142857142857,6.01428571428571,0,63.1571428571429,39.69,NA,343,0,0,83,290,416,343,416
2019,13,29,"Corum",40.5489,34.9533,28.9,4,0,60.9857142857143,27.7771428571429,NA,256,0,0,54,38,194,256,194
2019,14,29,"Corum",40.5489,34.9533,17.2285714285714,9,0,55.1857142857143,40.7757142857143,NA,365,63,12,29,13,208,302,196
2019,15,29,"Corum",40.5489,34.9533,21.4285714285714,11.8,1.48571428571429,69.9142857142857,26.2342857142857,NA,359,56,22,63,32,183,303,161
2019,16,29,"Corum",40.5489,34.9533,18.4285714285714,6.14285714285714,4.536,83.6714285714286,15.22,NA,318,0,0,35,36,208,318,208
2019,17,29,"Corum",40.5489,34.9533,14.4285714285714,11.1714285714286,0.285714285714286,64.2285714285714,33.9328571428571,NA,412,0,0,158,119,313,412,313
2019,18,29,"Corum",40.5489,34.9533,17.2428571428571,14.7285714285714,0.996142857142857,60.0428571428571,41.28,NA,523,0,0,145,45,353,523,353
2019,19,29,"Corum",40.5489,34.9533,17.2285714285714,13.7,5.91414285714286,73.0428571428571,28.9833333333333,NA,452,0,0,236,165,386,452,386
2019,20,29,"Corum",40.5489,34.9533,15.7857142857143,17.7857142857143,0.371428571428571,63.0857142857143,34.3257142857143,NA,454,122,102,305,236,389,332,287
2019,21,29,"Corum",40.5489,34.9533,12.9857142857143,18.0714285714286,2.79357142857143,70.3285714285714,38.3,NA,457,3,2,246,135,413,454,411
2019,22,29,"Corum",40.5489,34.9533,14.0571428571429,21.4571428571429,0.285714285714286,55.1857142857143,48.1285714285714,NA,453,0,0,153,87,323,453,323
2019,23,29,"Corum",40.5489,34.9533,23.6428571428571,22,2.90442857142857,63.6285714285714,35.6728571428571,NA,378,0,0,42,85,532,378,532
2019,24,29,"Corum",40.5489,34.9533,15.7714285714286,20.3142857142857,7.37142857142857,75.9714285714286,37.2728571428571,NA,378,4,4,67,40,244,374,240
2019,25,29,"Corum",40.5489,34.9533,14.6,20.8285714285714,7.14271428571429,74.6714285714286,34.886,NA,306,0,0,83,186,325,306,325
2019,26,29,"Corum",40.5489,34.9533,21.0142857142857,21.6571428571429,0.114285714285714,60.9,32.95,NA,377,0,0,3,1,342,377,342
2019,27,29,"Corum",40.5489,34.9533,21.6714285714286,20.6571428571429,0,55.7285714285714,33.6914285714286,NA,456,0,0,0,0,222,456,222
2019,28,29,"Corum",40.5489,34.9533,21.4285714285714,20.3571428571429,3.83142857142857,60.4142857142857,27.1885714285714,NA,398,0,0,42,101,421,398,421
2019,29,29,"Corum",40.5489,34.9533,22.8428571428571,19.5714285714286,3.69285714285714,65.0714285714286,27.198,NA,453,0,0,55,5,203,453,203
2019,30,29,"Corum",40.5489,34.9533,19.4857142857143,20.7428571428571,0,58.6714285714286,30.5916666666667,NA,456,0,0,1,0,335,456,335
2019,31,29,"Corum",40.5489,34.9533,24.4142857142857,23.6142857142857,0.0285714285714286,54.1857142857143,38.35,NA,334,0,0,101,105,375,334,375
2019,32,29,"Corum",40.5489,34.9533,21.6714285714286,20.1285714285714,0,56.5857142857143,27.4128571428571,NA,346,0,0,0,0,395,346,395
2019,33,29,"Corum",40.5489,34.9533,22.1285714285714,22.5571428571429,0.000142857142857143,55.4285714285714,28.6357142857143,NA,337,0,0,2,2,531,337,531
2019,34,29,"Corum",40.5489,34.9533,16.6285714285714,20.5142857142857,1.52857142857143,73.6,39.39,NA,299,0,0,46,41,345,299,345
2019,35,29,"Corum",40.5489,34.9533,21.9142857142857,21.3142857142857,0,59.8142857142857,33.6685714285714,NA,307,0,0,0,0,415,307,415
2019,36,29,"Corum",40.5489,34.9533,19.9428571428571,19.7285714285714,0,53.8571428571429,32.7985714285714,NA,171,0,0,0,0,67,171,67
2019,37,29,"Corum",40.5489,34.9533,18.2857142857143,18.5285714285714,0,58.5428571428571,30.55,NA,218,0,0,0,0,55,218,55
2019,38,29,"Corum",40.5489,34.9533,20.5285714285714,16.7571428571429,0.428571428571429,57.1285714285714,38.5333333333333,NA,266,0,0,89,40,91,266,91
2019,39,29,"Corum",40.5489,34.9533,11.5714285714286,15.9142857142857,0.0857142857142857,63.7714285714286,43.5771428571429,NA,237,0,0,165,65,79,237,79
2019,40,29,"Corum",40.5489,34.9533,14.8857142857143,18.0285714285714,0.157142857142857,48.5571428571429,56.1514285714286,NA,241,0,0,166,90,111,241,111
2019,41,29,"Corum",40.5489,34.9533,18.1857142857143,15.1428571428571,0,60.9285714285714,38.8171428571429,NA,416,0,0,165,221,448,416,448
2019,42,29,"Corum",40.5489,34.9533,10.0714285714286,15.8,0.514285714285714,57.6428571428571,62.2142857142857,NA,356,0,0,253,238,408,356,408
2019,43,29,"Corum",40.5489,34.9533,15.8571428571429,13.7428571428571,0.0857142857142857,73.6285714285714,35.73,NA,306,0,0,32,49,300,306,300
2019,44,29,"Corum",40.5489,34.9533,17.7285714285714,9.05714285714286,1.71428571428571,77.2,43.0285714285714,NA,350,0,0,153,116,250,350,250
2019,45,29,"Corum",40.5489,34.9533,6.72857142857143,10.1142857142857,0,67.8142857142857,60.8042857142857,NA,417,0,0,385,321,328,417,328
2019,46,29,"Corum",40.5489,34.9533,5.18571428571429,9.1,0,62.4571428571429,86.2514285714286,NA,401,45,32,220,196,337,356,305
2019,47,29,"Corum",40.5489,34.9533,6.27142857142857,4.57142857142857,0,63.7428571428571,71.4666666666667,NA,391,0,0,341,286,339,391,339
2019,48,29,"Corum",40.5489,34.9533,10.2142857142857,7.05714285714286,3.15714285714286,84.3142857142857,39.4,NA,320,68,51,115,91,251,252,200
2019,49,29,"Corum",40.5489,34.9533,16.2714285714286,1.62857142857143,0.0285714285714286,79.3428571428571,30.7828571428571,NA,393,0,0,133,63,274,393,274
2019,50,29,"Corum",40.5489,34.9533,8.67142857142857,4.25714285714286,0.128571428571429,85.5571428571428,67.8428571428571,NA,218,0,0,164,108,119,218,119
2019,51,29,"Corum",40.5489,34.9533,7.45714285714286,3.5,0,79.8285714285714,75.0228571428571,NA,361,0,0,296,371,488,361,488
2019,52,29,"Corum",40.5489,34.9533,14.5714285714286,5.18571428571429,5.08571428571429,86.7,32.0066666666667,NA,279,19,25,98,54,281,260,256
2020,1,29,"Corum",40.5489,34.9533,14.06,2.38,0.12,84.86,27.206,NA,160,0,0,39,21,126,160,126
2020,2,29,"Corum",40.5489,34.9533,10.3142857142857,1.48571428571429,0.542857142857143,84.9285714285714,41.49,NA,240,27,3,151,87,173,213,170
2020,3,29,"Corum",40.5489,34.9533,12.1142857142857,1.15714285714286,0,78.4714285714286,39.426,NA,270,0,0,62,51,382,270,382
2020,4,29,"Corum",40.5489,34.9533,11.0714285714286,-1.11428571428571,0.714285714285714,79.3857142857143,41.2,NA,358,0,0,195,177,295,358,295
2020,5,29,"Corum",40.5489,34.9533,11.6,2.81428571428571,1.97142857142857,85.0285714285714,54.1757142857143,NA,331,51,22,68,59,272,280,250
2020,6,29,"Corum",40.5489,34.9533,21.1857142857143,3.61428571428571,3.62857142857143,75.0428571428571,29.83,NA,343,13,12,55,41,267,330,255
2020,7,29,"Corum",40.5489,34.9533,14.2857142857143,-0.271428571428572,0.0571428571428571,75.7,43.3628571428571,NA,341,7,0,43,24,338,334,338
2020,8,29,"Corum",40.5489,34.9533,16.7285714285714,3,1.82857142857143,77,49.3114285714286,NA,283,0,0,96,100,187,283,187
2020,9,29,"Corum",40.5489,34.9533,24.0857142857143,6.15714285714286,0.728571428571429,65.1,36.2585714285714,NA,393,0,0,99,56,528,393,528
2020,10,29,"Corum",40.5489,34.9533,15.6571428571429,9.15714285714286,0.1,59.1571428571429,50.9516666666667,NA,205,3,2,108,108,210,202,208
2020,11,29,"Corum",40.5489,34.9533,21.8571428571429,11.1285714285714,0.428571428571429,61.0428571428571,45.77,NA,115,12,7,20,24,94,103,87
2020,12,29,"Corum",40.5489,34.9533,17.2,2.42857142857143,0.426571428571429,73.6571428571429,20.1528571428571,NA,117,10,5,32,23,118,107,113
2020,13,29,"Corum",40.5489,34.9533,20.4285714285714,8.57142857142857,0.142857142857143,70.7571428571429,38.7866666666667,NA,136,1,1,0,0,92,135,91
2020,14,29,"Corum",40.5489,34.9533,22.8142857142857,8.85714285714286,0.828571428571429,73.6285714285714,27.665,NA,155,0,0,63,51,121,155,121
2020,15,29,"Corum",40.5489,34.9533,38.9428571428571,7.4,0,55.7428571428571,21.645,NA,133,0,0,0,0,118,133,118
2020,16,29,"Corum",40.5489,34.9533,23.8714285714286,10.2857142857143,0.428571428571429,55.7285714285714,NA,NA,141,22,15,11,2,106,119,91
2020,17,29,"Corum",40.5489,34.9533,30.4857142857143,8.82857142857143,0.328571428571429,59.4571428571429,19.35,NA,137,0,0,5,1,123,137,123
2020,18,29,"Corum",40.5489,34.9533,26.0285714285714,12.6142857142857,2.02857142857143,64.0142857142857,30.296,NA,146,17,5,60,52,164,129,159
2020,19,29,"Corum",40.5489,34.9533,24.2857142857143,12.3857142857143,1.6,68.0714285714286,19.718,NA,137,0,0,2,0,157,137,157
2020,20,29,"Corum",40.5489,34.9533,21.7285714285714,20.1714285714286,0,47.2285714285714,40.345,NA,164,28,19,6,17,164,136,145
2020,21,29,"Corum",40.5489,34.9533,34.1857142857143,17.8857142857143,2.85714285714286,52.7428571428571,35.4975,NA,146,0,0,39,11,96,146,96
2020,22,29,"Corum",40.5489,34.9533,32.8571428571429,14.5428571428571,0.285714285714286,60.3,21.562,NA,118,22,11,0,0,100,96,89
2020,23,29,"Corum",40.5489,34.9533,19.0428571428571,17.9,3.54285714285714,60.6571428571429,30.5385714285714,NA,112,0,0,33,30,70,112,70
2020,24,29,"Corum",40.5489,34.9533,15.6142857142857,20.2428571428571,9.97114285714286,64.6,44.318,NA,140,24,48,62,62,150,116,102
2020,25,29,"Corum",40.5489,34.9533,12.7428571428571,19.0428571428571,3.34285714285714,73.7285714285714,38.8057142857143,NA,137,0,0,77,55,108,137,108
2020,26,29,"Corum",40.5489,34.9533,20.1142857142857,21.4857142857143,0.342857142857143,62.7428571428571,32.1385714285714,NA,173,6,2,31,37,133,167,131
2020,27,29,"Corum",40.5489,34.9533,21.7571428571429,22.7,0,53.2,37.39,NA,113,0,0,0,0,113,113,113
2020,28,29,"Corum",40.5489,34.9533,23.8142857142857,23.0285714285714,0.000142857142857143,57.7142857142857,35.8916666666667,NA,164,0,0,23,36,122,164,122
2020,29,29,"Corum",40.5489,34.9533,27.0428571428571,22.6571428571429,0.142857142857143,58.8,33.62,NA,186,0,0,0,0,111,186,111
2020,30,29,"Corum",40.5489,34.9533,21.4142857142857,23.9142857142857,0,48.4571428571429,35.6016666666667,NA,190,27,6,0,0,142,163,136
2020,31,29,"Corum",40.5489,34.9533,26.7428571428571,24.2428571428571,0.0285714285714286,52.6714285714286,68.53,NA,150,0,0,0,0,127,150,127
2020,32,29,"Corum",40.5489,34.9533,24.3714285714286,23.2857142857143,0,49.2142857142857,32.87,NA,146,4,5,0,0,107,142,102
2020,33,29,"Corum",40.5489,34.9533,22.5142857142857,22.3,0,48.5,31.45,NA,183,21,3,0,0,83,162,80
2020,34,29,"Corum",40.5489,34.9533,20.1142857142857,22.2,0,46.4857142857143,32.0571428571429,NA,197,26,3,0,0,97,171,94
2020,35,29,"Corum",40.5489,34.9533,19.8142857142857,22.9714285714286,0,41.7857142857143,35.6942857142857,NA,164,51,35,3,1,157,113,122
2020,36,29,"Corum",40.5489,34.9533,22.2571428571429,25.3857142857143,0,37.6714285714286,46.3033333333333,NA,179,0,0,49,36,112,179,112
2020,37,29,"Corum",40.5489,34.9533,23.6,22.8142857142857,0,57.4714285714286,42.7116666666667,NA,193,0,0,0,0,91,193,91
2020,38,29,"Corum",40.5489,34.9533,22.1857142857143,21.4714285714286,0,52.3571428571429,35.6914285714286,NA,235,15,7,35,19,157,220,150
2020,39,29,"Corum",40.5489,34.9533,21.1714285714286,20.7571428571429,0.0428571428571429,54.5,37.4914285714286,NA,220,0,0,49,17,129,220,129
2020,40,29,"Corum",40.5489,34.9533,22.6,20.7142857142857,0.0571428571428571,50.8142857142857,44.8357142857143,NA,187,0,0,79,68,154,187,154
2020,41,29,"Corum",40.5489,34.9533,16.1142857142857,20.3571428571429,0,42.2571428571429,51.0425,NA,182,15,15,27,16,127,167,112
2020,42,29,"Corum",40.5489,34.9533,16.2285714285714,19.1857142857143,0,46.3857142857143,63.4914285714286,NA,177,0,0,94,45,111,177,111
2020,43,29,"Corum",40.5489,34.9533,16.1571428571429,16.1571428571429,0.142857142857143,54.2714285714286,41.78,NA,194,8,2,60,85,161,186,159
2020,44,29,"Corum",40.5489,34.9533,10.3714285714286,15.4428571428571,0.171428571428571,47.5285714285714,65.39,NA,255,31,59,208,153,233,224,174
2020,45,29,"Corum",40.5489,34.9533,14.8857142857143,11.1428571428571,0.4,60.8714285714286,38.454,NA,156,24,16,54,36,103,132,87
2020,46,29,"Corum",40.5489,34.9533,11.9714285714286,8.7,0,63.8428571428571,57.9516666666667,NA,208,0,0,98,55,109,208,109
2020,47,29,"Corum",40.5489,34.9533,14.3714285714286,7.21428571428571,0,63.8285714285714,58.6133333333333,NA,173,0,0,50,32,83,173,83
2020,48,29,"Corum",40.5489,34.9533,10.0142857142857,3.34285714285714,0,61.7142857142857,68.4942857142857,NA,199,2,2,134,203,262,197,260
2020,49,29,"Corum",40.5489,34.9533,6.71428571428571,4.25714285714286,0,62,129.27,NA,207,0,0,109,54,116,207,116
2020,50,29,"Corum",40.5489,34.9533,8.71428571428571,6.04285714285714,0.657142857142857,76.5857142857143,85.7233333333333,NA,181,0,0,131,82,98,181,98
2020,51,29,"Corum",40.5489,34.9533,11.4571428571429,6.68571428571429,2.09042857142857,76.9571428571429,54.6742857142857,NA,171,0,0,117,64,90,171,90
2020,52,29,"Corum",40.5489,34.9533,9.42857142857143,2.74285714285714,0,70.7571428571429,55.4,NA,203,0,0,155,100,113,203,113
2020,53,29,"Corum",40.5489,34.9533,7.85,4.425,0,69.65,85.7166666666667,NA,122,0,0,78,80,111,122,111
2017,1,30,"Merkezefendi",37.7765,29.0864,25.3714285714286,2.87142857142857,6.499,75.3571428571429,68.2428571428571,NA,563,434,640,0,0,847,129,207
2017,2,30,"Merkezefendi",37.7765,29.0864,18.0571428571429,4.24285714285714,3.64371428571429,71.8285714285714,55.7357142857143,NA,757,644,1098,0,0,1214,113,116
2017,3,30,"Merkezefendi",37.7765,29.0864,15.9285714285714,6.31428571428571,10.9121428571429,78.2428571428571,51.7757142857143,NA,762,725,1411,0,0,1449,37,38
2017,4,30,"Merkezefendi",37.7765,29.0864,25.2428571428571,1.12857142857143,2.114,70.8142857142857,56.0928571428571,NA,639,309,419,0,0,889,330,470
2017,5,30,"Merkezefendi",37.7765,29.0864,12.5142857142857,3.81428571428571,0.0571428571428571,61.3285714285714,86.1728571428571,NA,588,570,1142,0,0,1163,18,21
2017,6,30,"Merkezefendi",37.7765,29.0864,10.1142857142857,9.87142857142857,0,64.5,63.4514285714286,NA,736,623,1364,0,0,1519,113,155
2017,7,30,"Merkezefendi",37.7765,29.0864,8.82857142857143,4.6,0,47.1857142857143,50.855,NA,492,400,536,0,0,717,92,181
2017,8,30,"Merkezefendi",37.7765,29.0864,7.17142857142857,11.1714285714286,0,61.8714285714286,NA,NA,739,672,1505,0,0,1747,67,242
2017,9,30,"Merkezefendi",37.7765,29.0864,11.1714285714286,11.1428571428571,2.42828571428571,65.8571428571429,66.852,NA,574,571,865,0,0,866,3,1
2017,10,30,"Merkezefendi",37.7765,29.0864,23.0285714285714,10.7571428571429,1.61485714285714,63.1,48.7742857142857,NA,712,686,1004,0,0,1043,26,39
2017,11,30,"Merkezefendi",37.7765,29.0864,15.4,5.97142857142857,0.414285714285714,71.6571428571429,47.37,NA,525,162,281,0,0,725,363,444
2017,12,30,"Merkezefendi",37.7765,29.0864,7.42857142857143,15.2571428571429,0,47.0857142857143,85.9885714285714,NA,589,562,974,0,0,1077,27,103
2017,13,30,"Merkezefendi",37.7765,29.0864,10.1142857142857,14.2428571428571,0.542857142857143,58.6142857142857,75.4457142857143,NA,574,514,825,0,0,887,60,62
2017,14,30,"Merkezefendi",37.7765,29.0864,9.4,13.9285714285714,2.42842857142857,56.5714285714286,77.8414285714286,NA,639,581,1231,0,0,1336,58,105
2017,15,30,"Merkezefendi",37.7765,29.0864,9.12857142857143,15.0428571428571,0.285714285714286,50.6,59.918,NA,587,559,1125,0,0,1187,28,62
2017,16,30,"Merkezefendi",37.7765,29.0864,13.5571428571429,13.5571428571429,4.67057142857143,63.0714285714286,55.52,NA,717,650,872,0,0,920,67,48
2017,17,30,"Merkezefendi",37.7765,29.0864,6.85714285714286,17.7857142857143,0,44.4428571428571,72.31,NA,731,708,1472,0,0,1478,23,6
2017,18,30,"Merkezefendi",37.7765,29.0864,12.4857142857143,19.6142857142857,4.29985714285714,56.6714285714286,73.1814285714286,NA,506,506,923,0,0,923,0,0
2017,19,30,"Merkezefendi",37.7765,29.0864,15.9714285714286,22.5714285714286,0.0428571428571429,43.3,93.6342857142857,NA,471,427,928,0,0,966,44,38
2017,20,30,"Merkezefendi",37.7765,29.0864,10.9428571428571,18.7428571428571,0.971857142857143,54.8857142857143,51.2314285714286,NA,472,441,1185,0,0,1205,31,20
2017,21,30,"Merkezefendi",37.7765,29.0864,12.2285714285714,18.5285714285714,0.600142857142857,53.7714285714286,51.8214285714286,NA,448,408,831,0,0,849,40,18
2017,22,30,"Merkezefendi",37.7765,29.0864,9.85714285714286,20.6428571428571,2.61442857142857,63.8857142857143,27.8933333333333,NA,522,464,883,0,0,1015,58,132
2017,23,30,"Merkezefendi",37.7765,29.0864,11.2,23.4142857142857,0.428571428571429,56.5428571428571,68.8483333333333,NA,578,525,1303,0,0,1388,53,85
2017,24,30,"Merkezefendi",37.7765,29.0864,11.4571428571429,23.7428571428571,1.02857142857143,52.4714285714286,51.958,NA,552,292,733,166,267,1139,260,406
2017,25,30,"Merkezefendi",37.7765,29.0864,9.91428571428571,24.5571428571429,0.0571428571428571,44.1714285714286,47.9071428571429,NA,584,0,0,506,859,1041,584,1041
2017,26,30,"Merkezefendi",37.7765,29.0864,16.6428571428571,30.5428571428571,0,33.8857142857143,NA,NA,564,0,0,316,563,971,564,971
2017,27,30,"Merkezefendi",37.7765,29.0864,22.9857142857143,27.4142857142857,0,39.4571428571429,50.6825,NA,511,0,0,464,470,642,511,642
2017,28,30,"Merkezefendi",37.7765,29.0864,16.9428571428571,29.3571428571429,0,33.3,62.1757142857143,NA,481,0,0,363,516,864,481,864
2017,29,30,"Merkezefendi",37.7765,29.0864,18.4857142857143,26.8857142857143,0.0715714285714286,47.7857142857143,60.3842857142857,NA,532,0,0,456,1057,1272,532,1272
2017,30,30,"Merkezefendi",37.7765,29.0864,17.7142857142857,27.4142857142857,0,36.7428571428571,58.4428571428571,NA,531,0,0,250,382,928,531,928
2017,31,30,"Merkezefendi",37.7765,29.0864,17.1571428571429,27.1571428571429,0.529285714285714,48.5714285714286,58.9285714285714,NA,559,74,105,485,942,1047,485,942
2017,32,30,"Merkezefendi",37.7765,29.0864,11.4571428571429,30.2,0.428571428571429,46.2,70.5685714285714,NA,567,0,0,487,934,1092,567,1092
2017,33,30,"Merkezefendi",37.7765,29.0864,13.5571428571429,27.8857142857143,2.70014285714286,47.7428571428571,63.2414285714286,NA,596,85,166,372,733,1199,511,1033
2017,34,30,"Merkezefendi",37.7765,29.0864,12.0142857142857,25.8,0.0142857142857143,47.0428571428571,55.2985714285714,NA,601,0,0,601,1280,1280,601,1280
2017,35,30,"Merkezefendi",37.7765,29.0864,10.1142857142857,26.5714285714286,0,39.2428571428571,57.9771428571429,NA,493,0,0,437,896,1014,493,1014
2017,36,30,"Merkezefendi",37.7765,29.0864,19.1,24.3428571428571,0,35.5142857142857,65.245,NA,507,0,0,307,855,1321,507,1321
2017,37,30,"Merkezefendi",37.7765,29.0864,14.5857142857143,25.8714285714286,0,40.5571428571429,101.243333333333,NA,589,0,0,193,444,1138,589,1138
2017,38,30,"Merkezefendi",37.7765,29.0864,15.3571428571429,22.9142857142857,0,38.3571428571429,104.4,NA,671,0,0,179,272,1312,671,1312
2017,39,30,"Merkezefendi",37.7765,29.0864,15.6142857142857,19.2428571428571,0.157285714285714,58.8857142857143,91.9828571428571,NA,782,0,0,354,709,1630,782,1630
2017,40,30,"Merkezefendi",37.7765,29.0864,20.8857142857143,17.2285714285714,0.6,55.2571428571429,71.4342857142857,NA,543,147,269,261,536,1137,396,868
2017,41,30,"Merkezefendi",37.7765,29.0864,14.3857142857143,15,0,50.9428571428571,42.66,NA,487,0,0,102,72,843,487,843
2017,42,30,"Merkezefendi",37.7765,29.0864,14.4428571428571,17.9428571428571,0,43.3,56.7714285714286,NA,530,77,168,0,0,815,453,647
2017,43,30,"Merkezefendi",37.7765,29.0864,9.74285714285714,14.1714285714286,8.28428571428571,73.5,55.3685714285714,NA,506,88,56,85,181,919,418,863
2017,44,30,"Merkezefendi",37.7765,29.0864,12.7428571428571,8.82857142857143,0.0714285714285714,67.0714285714286,59.4814285714286,NA,561,25,28,259,584,1102,536,1074
2017,45,30,"Merkezefendi",37.7765,29.0864,9.54285714285714,10.4428571428571,0,67.4714285714286,70.3842857142857,NA,577,1,6,13,13,829,576,823
2017,46,30,"Merkezefendi",37.7765,29.0864,15.8142857142857,12.2285714285714,1.88571428571429,69.8,70.9928571428571,NA,587,174,257,0,0,1085,413,828
2017,47,30,"Merkezefendi",37.7765,29.0864,12.7714285714286,6.28571428571429,2.42842857142857,74.4571428571429,62.1128571428571,NA,418,75,139,59,59,804,343,665
2017,48,30,"Merkezefendi",37.7765,29.0864,18.2714285714286,10.3142857142857,1.71414285714286,71.1571428571429,57.6685714285714,NA,386,243,432,0,0,619,143,187
2017,49,30,"Merkezefendi",37.7765,29.0864,18.8285714285714,6.67142857142857,1.41414285714286,71.7857142857143,53.4328571428571,NA,407,118,126,124,209,645,289,519
2017,50,30,"Merkezefendi",37.7765,29.0864,14.5857142857143,9.85714285714286,0.428571428571429,72.3,57.6957142857143,NA,346,136,197,47,29,442,210,245
2017,51,30,"Merkezefendi",37.7765,29.0864,15.1,6.88571428571429,1.94271428571429,80.6571428571429,58.3314285714286,NA,386,49,18,174,156,349,337,331
2017,52,30,"Merkezefendi",37.7765,29.0864,17.875,5.2625,1.53725,74.7375,63.145,NA,528,276,296,39,39,507,252,211
2018,1,30,"Merkezefendi",37.7765,29.0864,9.925,7.25,0.9625,73.475,64.12875,NA,618,159,281,101,132,914,459,633
2018,2,30,"Merkezefendi",37.7765,29.0864,7.68571428571429,8.88571428571429,1.39985714285714,73.9285714285714,69.7614285714286,NA,624,64,174,179,158,1309,560,1135
2018,3,30,"Merkezefendi",37.7765,29.0864,12.2142857142857,7,3.01442857142857,69.4571428571429,58.6714285714286,NA,639,81,126,402,253,655,558,529
2018,4,30,"Merkezefendi",37.7765,29.0864,21.7142857142857,3.85714285714286,2.57114285714286,64.9428571428572,34.4157142857143,NA,604,182,274,219,276,764,422,490
2018,5,30,"Merkezefendi",37.7765,29.0864,13.1857142857143,7.7,0.0428571428571429,67.2714285714286,61.0585714285714,NA,670,173,263,0,0,819,497,556
2018,6,30,"Merkezefendi",37.7765,29.0864,21.7714285714286,11.0714285714286,0.414285714285714,69.5571428571428,102.732857142857,NA,704,419,572,30,45,1022,285,450
2018,7,30,"Merkezefendi",37.7765,29.0864,14.3142857142857,8.04285714285714,1.71414285714286,69.6,50.2242857142857,NA,478,194,248,28,39,557,284,309
2018,8,30,"Merkezefendi",37.7765,29.0864,6.54285714285714,10.0285714285714,2.04242857142857,73.8428571428571,64.3385714285714,NA,711,31,65,104,300,1321,680,1256
2018,9,30,"Merkezefendi",37.7765,29.0864,14.8428571428571,11.1857142857143,2.914,64.7142857142857,74.6914285714286,NA,621,324,458,179,305,956,297,498
2018,10,30,"Merkezefendi",37.7765,29.0864,18.2285714285714,13.5857142857143,0.728571428571429,64.2857142857143,104.218571428571,NA,556,127,366,89,171,1330,429,964
2018,11,30,"Merkezefendi",37.7765,29.0864,15.1571428571429,12.3142857142857,1.41414285714286,67.7857142857143,61.86,NA,551,66,124,263,593,1426,485,1302
2018,12,30,"Merkezefendi",37.7765,29.0864,23.7857142857143,14.0571428571429,1.014,53.8285714285714,76.33,NA,425,250,554,74,228,1187,175,633
2018,13,30,"Merkezefendi",37.7765,29.0864,11.4428571428571,13.8285714285714,5.314,57.4,NA,NA,356,105,124,93,107,428,251,304
2018,14,30,"Merkezefendi",37.7765,29.0864,13.9571428571429,15.0714285714286,0.0428571428571429,49.3142857142857,57.6183333333333,NA,407,140,214,56,39,486,267,272
2018,15,30,"Merkezefendi",37.7765,29.0864,9.02857142857143,18.9,0.285714285714286,53.9714285714286,76.2528571428571,NA,374,50,34,72,172,450,324,416
2018,16,30,"Merkezefendi",37.7765,29.0864,10.9285714285714,19.0285714285714,0,42.3285714285714,72.6771428571429,NA,411,56,42,92,172,648,355,606
2018,17,30,"Merkezefendi",37.7765,29.0864,10.1142857142857,22.2428571428571,0,32.7857142857143,66.1557142857143,NA,419,156,164,42,30,652,263,488
2018,18,30,"Merkezefendi",37.7765,29.0864,12.5285714285714,21.9857142857143,0.372142857142857,43.1714285714286,75.9885714285714,NA,303,143,144,10,54,474,160,330
2018,19,30,"Merkezefendi",37.7765,29.0864,15.3142857142857,17.3428571428571,0.115285714285714,61.4571428571429,52.6428571428571,NA,275,94,168,85,91,467,181,299
2018,20,30,"Merkezefendi",37.7765,29.0864,13.7714285714286,22.9285714285714,0.0142857142857143,40.9,63.0157142857143,NA,204,31,36,16,5,306,173,270
2018,21,30,"Merkezefendi",37.7765,29.0864,13.2571428571429,23.7142857142857,2.18542857142857,49.7142857142857,88.5,NA,252,63,64,132,151,281,189,217
2018,22,30,"Merkezefendi",37.7765,29.0864,13.0428571428571,20.8142857142857,11.9135714285714,66.2,44.0316666666667,NA,249,0,0,93,149,427,249,427
2018,23,30,"Merkezefendi",37.7765,29.0864,11.2,26.2428571428571,0.000142857142857143,37.4857142857143,72.37,NA,267,0,0,79,214,812,267,812
2018,24,30,"Merkezefendi",37.7765,29.0864,10.3714285714286,23.8142857142857,14.3124285714286,57.6,53.7585714285714,NA,267,60,51,0,0,448,207,397
2018,25,30,"Merkezefendi",37.7765,29.0864,12.2285714285714,22.4,2.10057142857143,66.8428571428571,45.5525,NA,358,57,109,204,324,518,301,409
2018,26,30,"Merkezefendi",37.7765,29.0864,14.3285714285714,24.0857142857143,0.0291428571428571,53.2,48.9742857142857,NA,355,14,36,121,236,587,341,551
2018,27,30,"Merkezefendi",37.7765,29.0864,18.7428571428571,27.2857142857143,0,38.3,49.7414285714286,NA,342,0,0,219,272,418,342,418
2018,28,30,"Merkezefendi",37.7765,29.0864,18.2285714285714,27.5857142857143,0,46.5857142857143,57.0942857142857,NA,286,0,0,72,242,585,286,585
2018,29,30,"Merkezefendi",37.7765,29.0864,12.4857142857143,28.9428571428571,0,34.6714285714286,50.2385714285714,NA,260,0,0,214,633,756,260,756
2018,30,30,"Merkezefendi",37.7765,29.0864,10.6857142857143,26.7714285714286,0.172285714285714,47.8285714285714,54.6428571428571,NA,265,62,79,59,191,822,203,743
2018,31,30,"Merkezefendi",37.7765,29.0864,17.7571428571429,26.5571428571429,2.75742857142857,57.1571428571429,46.36,NA,267,38,15,88,122,499,229,484
2018,32,30,"Merkezefendi",37.7765,29.0864,23.2571428571429,27.0428571428571,0,44.3142857142857,44.1,NA,297,0,0,107,165,403,297,403
2018,33,30,"Merkezefendi",37.7765,29.0864,15.6142857142857,27.2714285714286,0.428428571428571,42.3285714285714,59.3814285714286,NA,216,0,0,98,161,332,216,332
2018,34,30,"Merkezefendi",37.7765,29.0864,9.08571428571429,27.9571428571429,0.385714285714286,46.9285714285714,49.4171428571429,NA,144,29,27,71,134,227,115,200
2018,35,30,"Merkezefendi",37.7765,29.0864,11.4571428571429,27.9142857142857,0.00128571428571429,46.3,58.2557142857143,NA,201,0,0,116,135,314,201,314
2018,36,30,"Merkezefendi",37.7765,29.0864,12.4857142857143,25.3714285714286,0,45.7428571428571,56.3014285714286,NA,341,0,0,76,123,370,341,370
2018,37,30,"Merkezefendi",37.7765,29.0864,13.3,22.4428571428571,0.0714285714285714,43.2857142857143,40.1414285714286,NA,241,0,0,108,202,419,241,419
2018,38,30,"Merkezefendi",37.7765,29.0864,19.8714285714286,22.8285714285714,0,41.8571428571429,53.8071428571429,NA,189,0,0,46,102,344,189,344
2018,39,30,"Merkezefendi",37.7765,29.0864,14.5142857142857,21.7428571428571,0,44.7857142857143,64.1914285714286,NA,180,40,65,18,56,353,140,288
2018,40,30,"Merkezefendi",37.7765,29.0864,13.0428571428571,19.0428571428571,0.371428571428571,50.5571428571429,47.4385714285714,NA,191,57,99,31,70,341,134,242
2018,41,30,"Merkezefendi",37.7765,29.0864,16.3857142857143,17.0571428571429,4.599,64.2857142857143,60.164,NA,187,79,173,0,0,422,108,249
2018,42,30,"Merkezefendi",37.7765,29.0864,10.2571428571429,18.4857142857143,0,63.4,107.204285714286,NA,168,4,2,0,0,381,164,379
2018,43,30,"Merkezefendi",37.7765,29.0864,15.3,12.7285714285714,1.39985714285714,63.1142857142857,57.7442857142857,NA,187,0,0,5,4,402,187,402
2018,44,30,"Merkezefendi",37.7765,29.0864,8,16.1857142857143,0,41.0714285714286,58.7514285714286,NA,196,27,32,0,0,264,169,232
2018,45,30,"Merkezefendi",37.7765,29.0864,15.4142857142857,12.7428571428571,0,56.6428571428571,80.71,NA,231,94,172,3,2,473,137,301
2018,46,30,"Merkezefendi",37.7765,29.0864,13.0285714285714,8.91428571428571,2.39942857142857,67.3571428571429,65.5485714285714,NA,230,78,131,36,89,465,152,334
2018,47,30,"Merkezefendi",37.7765,29.0864,8.97142857142857,11.3428571428571,2.91385714285714,77.3428571428571,61.1866666666667,NA,270,121,123,56,124,499,149,376
2018,48,30,"Merkezefendi",37.7765,29.0864,17.2,9.91428571428571,4.62785714285714,81,48.1257142857143,NA,245,108,70,1,0,201,137,131
2018,49,30,"Merkezefendi",37.7765,29.0864,17.9714285714286,7.28571428571429,5.48557142857143,82.5571428571429,67.0185714285714,NA,257,113,123,25,105,420,144,297
2018,50,30,"Merkezefendi",37.7765,29.0864,17.5,7.45714285714286,4.28557142857143,81.7857142857143,59.5457142857143,NA,256,125,122,2,2,305,131,183
2018,51,30,"Merkezefendi",37.7765,29.0864,16.9,5.58571428571429,1.15714285714286,85.6714285714286,69.6471428571429,NA,250,118,131,3,0,248,132,117
2018,52,30,"Merkezefendi",37.7765,29.0864,8.55714285714286,4.28571428571429,3.75671428571429,69.5428571428571,49.3885714285714,NA,244,75,98,32,55,273,169,175
2019,1,30,"Merkezefendi",37.7765,29.0864,9.2375,6.025,6.236875,82.6,42.08375,NA,343,76,359,117,127,784,267,425
2019,2,30,"Merkezefendi",37.7765,29.0864,12.7857142857143,5.41428571428571,0.686,68.4142857142857,38.7828571428571,NA,255,96,55,3,1,208,159,153
2019,3,30,"Merkezefendi",37.7765,29.0864,15.8714285714286,4.27142857142857,5.68457142857143,79.4714285714286,53.7357142857143,NA,192,36,39,4,10,198,156,159
2019,4,30,"Merkezefendi",37.7765,29.0864,16.6714285714286,8.32857142857143,3.17114285714286,76.6857142857143,64.2742857142857,NA,308,179,206,0,0,314,129,108
2019,5,30,"Merkezefendi",37.7765,29.0864,9.42857142857143,9.28571428571429,2.571,65.7571428571429,40.3171428571429,NA,253,84,57,0,0,143,169,86
2019,6,30,"Merkezefendi",37.7765,29.0864,8.88571428571429,9.35714285714286,1.01442857142857,68.7285714285714,49.9957142857143,NA,276,98,24,0,0,127,178,103
2019,7,30,"Merkezefendi",37.7765,29.0864,10.3571428571429,8.65714285714286,0,61.8285714285714,42.55,NA,325,67,26,186,81,234,258,208
2019,8,30,"Merkezefendi",37.7765,29.0864,6.91428571428571,9.3,0.0714285714285714,58.7428571428571,59.165,NA,305,0,0,280,206,219,305,219
2019,9,30,"Merkezefendi",37.7765,29.0864,15.1428571428571,6.07142857142857,0.328571428571429,71.1285714285714,53.7457142857143,NA,331,0,0,233,229,310,331,310
2019,10,30,"Merkezefendi",37.7765,29.0864,12.6857142857143,10.5,0.0285714285714286,62.4,54.7716666666667,NA,359,121,124,54,44,252,238,128
2019,11,30,"Merkezefendi",37.7765,29.0864,16.9857142857143,11.5142857142857,0.8,59.1714285714286,44.4771428571429,NA,373,71,40,148,141,400,302,360
2019,12,30,"Merkezefendi",37.7765,29.0864,14.8285714285714,13.3142857142857,0.0142857142857143,50.6,49.9485714285714,NA,343,0,0,199,87,416,343,416
2019,13,30,"Merkezefendi",37.7765,29.0864,22.8,9.64285714285714,1.22842857142857,50.9285714285714,44.2857142857143,NA,256,50,70,28,8,194,206,124
2019,14,30,"Merkezefendi",37.7765,29.0864,9.08571428571429,13.4285714285714,0.742714285714286,54.8428571428571,46.0814285714286,NA,365,121,70,199,101,208,244,138
2019,15,30,"Merkezefendi",37.7765,29.0864,13.2571428571429,14.4857142857143,1.35771428571429,61.9857142857143,40.2342857142857,NA,359,139,84,54,27,183,220,99
2019,16,30,"Merkezefendi",37.7765,29.0864,13.5142857142857,11.4142857142857,0.300571428571429,52.5142857142857,34.5228571428571,NA,318,0,0,317,207,208,318,208
2019,17,30,"Merkezefendi",37.7765,29.0864,7.42857142857143,17.6142857142857,0.0285714285714286,42.8,57.11,NA,412,0,0,154,69,313,412,313
2019,18,30,"Merkezefendi",37.7765,29.0864,16.4285714285714,17.9142857142857,1,47.5714285714286,45.78,NA,523,203,82,71,34,353,320,271
2019,19,30,"Merkezefendi",37.7765,29.0864,13.2857142857143,16.3571428571429,0.243,55.6714285714286,44.6428571428571,NA,452,75,54,213,155,386,377,332
2019,20,30,"Merkezefendi",37.7765,29.0864,9.65714285714286,22.6571428571429,0.186,41.2,42.22,NA,454,0,0,405,340,389,454,389
2019,21,30,"Merkezefendi",37.7765,29.0864,9.08571428571429,22.8714285714286,0.0571428571428571,42.9,NA,NA,457,0,0,271,245,413,457,413
2019,22,30,"Merkezefendi",37.7765,29.0864,10.6857142857143,26.3,0,32.6857142857143,61.9266666666667,NA,453,88,54,249,188,323,365,269
2019,23,30,"Merkezefendi",37.7765,29.0864,14.5857142857143,24.4714285714286,0.100285714285714,41.8714285714286,50.1714285714286,NA,378,59,121,313,404,532,319,411
2019,24,30,"Merkezefendi",37.7765,29.0864,14.5857142857143,23.0714285714286,3.14328571428571,57.5428571428571,48.76,NA,378,0,0,230,105,244,378,244
2019,25,30,"Merkezefendi",37.7765,29.0864,10.6857142857143,23.9,0.929,60.2285714285714,48.4483333333333,NA,306,0,0,209,232,325,306,325
2019,26,30,"Merkezefendi",37.7765,29.0864,22.8,26.6857142857143,0.886,46.7714285714286,52.5157142857143,NA,377,0,0,121,70,342,377,342
2019,27,30,"Merkezefendi",37.7765,29.0864,19.0571428571429,26.5714285714286,0,35.5571428571429,53.3142857142857,NA,456,1,1,278,94,222,455,221
2019,28,30,"Merkezefendi",37.7765,29.0864,15.6142857142857,26.7714285714286,0.571428571428572,35.6285714285714,52.2614285714286,NA,398,0,0,305,296,421,398,421
2019,29,30,"Merkezefendi",37.7765,29.0864,11.7,24.7,0.571428571428572,50.5,47.0533333333333,NA,453,0,0,320,161,203,453,203
2019,30,30,"Merkezefendi",37.7765,29.0864,11.2,28.6285714285714,0,33.1142857142857,53.7471428571429,NA,456,0,0,402,251,335,456,335
2019,31,30,"Merkezefendi",37.7765,29.0864,12.2285714285714,30.2,0,35.2571428571429,58.6814285714286,NA,334,0,0,331,373,375,334,375
2019,32,30,"Merkezefendi",37.7765,29.0864,9.8,29.2428571428571,0,26.1,47.7542857142857,NA,346,0,0,346,395,395,346,395
2019,33,30,"Merkezefendi",37.7765,29.0864,11.0857142857143,28.4285714285714,0.1,37.7,51.4071428571429,NA,337,53,86,192,357,531,284,445
2019,34,30,"Merkezefendi",37.7765,29.0864,19.8714285714286,27.6571428571429,0,36.6142857142857,45.7328571428571,NA,299,0,0,173,204,345,299,345
2019,35,30,"Merkezefendi",37.7765,29.0864,18.5714285714286,27.5,0,36.3714285714286,60.1485714285714,NA,307,0,0,165,229,415,307,415
2019,36,30,"Merkezefendi",37.7765,29.0864,11.9714285714286,25.7857142857143,0.428714285714286,49.1285714285714,61.084,NA,171,0,0,116,45,67,171,67
2019,37,30,"Merkezefendi",37.7765,29.0864,17.4571428571429,22.4714285714286,2.07114285714286,54.9,48.3942857142857,NA,218,0,0,162,48,55,218,55
2019,38,30,"Merkezefendi",37.7765,29.0864,20.4428571428571,20.9142857142857,0,44.6571428571429,46.5314285714286,NA,266,2,0,91,24,91,264,91
2019,39,30,"Merkezefendi",37.7765,29.0864,14.2857142857143,20.6714285714286,0.0574285714285714,52.0285714285714,45.7885714285714,NA,237,0,0,85,43,79,237,79
2019,40,30,"Merkezefendi",37.7765,29.0864,17.2571428571429,21.0571428571429,0.000142857142857143,46.1,48.6628571428571,NA,241,62,53,38,9,111,179,58
2019,41,30,"Merkezefendi",37.7765,29.0864,13.5571428571429,18.8142857142857,0.485571428571429,61.0428571428571,49.1114285714286,NA,416,47,15,71,81,448,369,433
2019,42,30,"Merkezefendi",37.7765,29.0864,5.2,20.9571428571429,0.914142857142857,52.9142857142857,52.6685714285714,NA,356,0,0,3,3,408,356,408
2019,43,30,"Merkezefendi",37.7765,29.0864,5.4,18.6857142857143,0,47.0714285714286,57.3685714285714,NA,306,0,0,11,15,300,306,300
2019,44,30,"Merkezefendi",37.7765,29.0864,6.6,15.5,0.142857142857143,56.0428571428571,58.8914285714286,NA,350,0,0,40,28,250,350,250
2019,45,30,"Merkezefendi",37.7765,29.0864,11.9142857142857,16.6571428571429,0,53,63.1328571428571,NA,417,61,36,57,53,328,356,292
2019,46,30,"Merkezefendi",37.7765,29.0864,11.1428571428571,13.7571428571429,0.599857142857143,61.1857142857143,76.9514285714286,NA,401,130,66,0,0,337,271,271
2019,47,30,"Merkezefendi",37.7765,29.0864,14.3285714285714,10.8285714285714,0,54.7428571428571,60.8114285714286,NA,391,32,30,74,81,339,359,309
2019,48,30,"Merkezefendi",37.7765,29.0864,15.1857142857143,11.6428571428571,2.89971428571429,78.2142857142857,48.0442857142857,NA,320,49,16,91,93,251,271,235
2019,49,30,"Merkezefendi",37.7765,29.0864,7.37142857142857,6.94285714285714,1.29985714285714,66.4142857142857,43.9371428571429,NA,393,54,39,223,145,274,339,235
2019,50,30,"Merkezefendi",37.7765,29.0864,15.3428571428571,9.51428571428571,1.28571428571429,72.1,48.5057142857143,NA,218,113,79,28,3,119,105,40
2019,51,30,"Merkezefendi",37.7765,29.0864,8.45714285714286,9.47142857142857,0,63.1428571428571,66.3042857142857,NA,361,154,196,0,0,488,207,292
2019,52,30,"Merkezefendi",37.7765,29.0864,11.1285714285714,7.72857142857143,9.02742857142857,78.1,38.8385714285714,NA,279,71,94,118,56,281,208,187
2020,1,30,"Merkezefendi",37.7765,29.0864,5.48,5.08,0.16,70.42,42.874,NA,160,0,0,45,25,126,160,126
2020,2,30,"Merkezefendi",37.7765,29.0864,6.02857142857143,5.51428571428571,2.88542857142857,71.9714285714286,38.6928571428571,NA,240,0,0,98,105,173,240,173
2020,3,30,"Merkezefendi",37.7765,29.0864,5.2,5.74285714285714,0,64.0857142857143,61.15,NA,270,24,21,2,4,382,246,361
2020,4,30,"Merkezefendi",37.7765,29.0864,7.48571428571429,4.38571428571429,0,50.5285714285714,44.1528571428571,NA,358,0,0,183,121,295,358,295
2020,5,30,"Merkezefendi",37.7765,29.0864,8.45714285714286,8.44285714285714,1.38571428571429,68.6285714285714,55.9428571428571,NA,331,37,65,40,26,272,294,207
2020,6,30,"Merkezefendi",37.7765,29.0864,12.9857142857143,7.11428571428571,3.77185714285714,67.5857142857143,36.39,NA,343,62,75,155,99,267,281,192
2020,7,30,"Merkezefendi",37.7765,29.0864,4.8,7.85714285714286,1.68585714285714,73.0285714285714,55.48,NA,341,3,1,204,165,338,338,337
2020,8,30,"Merkezefendi",37.7765,29.0864,6.08571428571429,8.31428571428571,1.52871428571429,70.4857142857143,44.5957142857143,NA,283,31,59,120,71,187,252,128
2020,9,30,"Merkezefendi",37.7765,29.0864,10.1,10.5142857142857,0.428571428571429,60.1857142857143,48.1542857142857,NA,393,67,138,79,147,528,326,390
2020,10,30,"Merkezefendi",37.7765,29.0864,19.3,11.6714285714286,1.28585714285714,58.9571428571429,58.28,NA,205,161,140,6,12,210,44,70
2020,11,30,"Merkezefendi",37.7765,29.0864,7.37142857142857,14.8142857142857,0.143,56.0857142857143,54.53,NA,115,17,9,28,20,94,98,85
2020,12,30,"Merkezefendi",37.7765,29.0864,25.1571428571429,6.38571428571429,1.64285714285714,56.8285714285714,29.41,NA,117,0,0,85,80,118,117,118
2020,13,30,"Merkezefendi",37.7765,29.0864,14.5428571428571,11.4142857142857,3.05671428571429,76.1142857142857,61.9385714285714,NA,136,27,20,5,9,92,109,72
2020,14,30,"Merkezefendi",37.7765,29.0864,23.3,12.2285714285714,0.986285714285714,65.4571428571429,48.66,NA,155,66,45,18,8,121,89,76
2020,15,30,"Merkezefendi",37.7765,29.0864,18.2714285714286,12.2857142857143,3.79971428571429,66.7428571428571,38.6614285714286,NA,133,14,6,56,79,118,119,112
2020,16,30,"Merkezefendi",37.7765,29.0864,9.48571428571429,16.8571428571429,0.0571428571428571,45.8857142857143,44.5985714285714,NA,141,7,4,51,46,106,134,102
2020,17,30,"Merkezefendi",37.7765,29.0864,10.1,17,0.1,47.7142857142857,44.4842857142857,NA,137,0,0,105,83,123,137,123
2020,18,30,"Merkezefendi",37.7765,29.0864,9.84285714285714,17.3857142857143,1.85714285714286,50.2857142857143,40.6157142857143,NA,146,21,15,3,4,164,125,149
2020,19,30,"Merkezefendi",37.7765,29.0864,10.4142857142857,16.2571428571429,6.34442857142857,59.5571428571429,29.52,NA,137,24,5,81,100,157,113,152
2020,20,30,"Merkezefendi",37.7765,29.0864,8.67142857142857,25.4285714285714,0,33.9285714285714,68.2942857142857,NA,164,58,65,44,51,164,106,99
2020,21,30,"Merkezefendi",37.7765,29.0864,16.3857142857143,21.8142857142857,0.728428571428571,40.9142857142857,78.9471428571429,NA,146,17,7,40,43,96,129,89
2020,22,30,"Merkezefendi",37.7765,29.0864,13.3,16.2571428571429,1.00028571428571,58.8857142857143,31.3742857142857,NA,118,0,0,34,27,100,118,100
2020,23,30,"Merkezefendi",37.7765,29.0864,20.9142857142857,18.9571428571429,1.59957142857143,50.2285714285714,28.3714285714286,NA,112,25,17,22,21,70,87,53
2020,24,30,"Merkezefendi",37.7765,29.0864,22,21.0857142857143,0.114285714285714,53.5714285714286,29.89,NA,140,0,0,17,15,150,140,150
2020,25,30,"Merkezefendi",37.7765,29.0864,18.0142857142857,23.2142857142857,0.714142857142857,48.9857142857143,31.4114285714286,NA,137,0,0,35,57,108,137,108
2020,26,30,"Merkezefendi",37.7765,29.0864,12.7428571428571,24.6,0.0142857142857143,50.2,35.4657142857143,NA,173,0,0,46,25,133,173,133
2020,27,30,"Merkezefendi",37.7765,29.0864,20.1142857142857,28.6285714285714,0.0428571428571429,34.7571428571429,43.5414285714286,NA,113,0,0,9,10,113,113,113
2020,28,30,"Merkezefendi",37.7765,29.0864,21.4,27.0571428571429,0.443285714285714,48.6,45.7614285714286,NA,164,34,7,56,31,122,130,115
2020,29,30,"Merkezefendi",37.7765,29.0864,18.0142857142857,25.9142857142857,0,46.2714285714286,44.8414285714286,NA,186,0,0,6,3,111,186,111
2020,30,30,"Merkezefendi",37.7765,29.0864,19.8142857142857,28.2142857142857,0,35.2142857142857,47.4242857142857,NA,190,58,39,0,0,142,132,103
2020,31,30,"Merkezefendi",37.7765,29.0864,20.3714285714286,29.7142857142857,0,32.2428571428571,43.1171428571429,NA,150,0,0,42,39,127,150,127
2020,32,30,"Merkezefendi",37.7765,29.0864,19.0571428571429,27.4,1.00014285714286,42.9285714285714,52.9471428571429,NA,146,0,0,1,1,107,146,107
2020,33,30,"Merkezefendi",37.7765,29.0864,15.8714285714286,25.8428571428571,0.0151428571428571,45.2142857142857,38.4371428571429,NA,183,0,0,51,18,83,183,83
2020,34,30,"Merkezefendi",37.7765,29.0864,21.6571428571429,26.0714285714286,0,39.4571428571429,39.07,NA,197,0,0,33,18,97,197,97
2020,35,30,"Merkezefendi",37.7765,29.0864,18.0142857142857,27.2857142857143,0.0142857142857143,36.9142857142857,47.3328571428571,NA,164,0,0,21,10,157,164,157
2020,36,30,"Merkezefendi",37.7765,29.0864,18.2285714285714,27.4714285714286,0,33.4714285714286,57.16,NA,179,0,0,91,70,112,179,112
2020,37,30,"Merkezefendi",37.7765,29.0864,23.6142857142857,26.2285714285714,5.02742857142857,40.5571428571429,47.24,NA,193,0,0,16,10,91,193,91
2020,38,30,"Merkezefendi",37.7765,29.0864,16.0857142857143,24.1285714285714,0.0428571428571429,52.7857142857143,48.68,NA,235,0,0,40,19,157,235,157
2020,39,30,"Merkezefendi",37.7765,29.0864,22.7571428571429,22.6571428571429,0,51.3714285714286,45.0042857142857,NA,220,0,0,1,1,129,220,129
2020,40,30,"Merkezefendi",37.7765,29.0864,15.1,19.8571428571429,0,45.3,43.1285714285714,NA,187,29,1,8,5,154,158,153
2020,41,30,"Merkezefendi",37.7765,29.0864,16.8857142857143,21.1142857142857,1.28542857142857,46.1857142857143,58.22,NA,182,36,18,3,2,127,146,109
2020,42,30,"Merkezefendi",37.7765,29.0864,17.2,18.6285714285714,0.0571428571428571,51.4428571428571,53.9385714285714,NA,177,38,13,15,17,111,139,98
2020,43,30,"Merkezefendi",37.7765,29.0864,11.7,15.7142857142857,4.42814285714286,73.6714285714286,50.6614285714286,NA,194,38,21,4,4,161,156,140
2020,44,30,"Merkezefendi",37.7765,29.0864,13.2571428571429,14.6571428571429,0.699857142857143,71.1571428571429,57.3314285714286,NA,255,53,16,2,2,233,202,217
2020,45,30,"Merkezefendi",37.7765,29.0864,22.8,12.5571428571429,0,56.6857142857143,40.6271428571429,NA,156,20,12,31,23,103,136,91
2020,46,30,"Merkezefendi",37.7765,29.0864,13.0428571428571,11.0285714285714,0.857142857142857,62.3428571428571,61.9385714285714,NA,208,68,23,1,2,109,140,86
2020,47,30,"Merkezefendi",37.7765,29.0864,13.5428571428571,8.55714285714286,0.857428571428571,76.0428571428571,53.12,NA,173,2,2,6,13,83,171,81
2020,48,30,"Merkezefendi",37.7765,29.0864,19.9285714285714,7.02857142857143,0,58.1714285714286,53.634,NA,199,143,183,0,0,262,56,79
2020,49,30,"Merkezefendi",37.7765,29.0864,12.9857142857143,9.07142857142857,0,70.9857142857143,50.695,NA,207,69,12,27,8,116,138,104
2020,50,30,"Merkezefendi",37.7765,29.0864,20.8857142857143,10.5571428571429,2.14242857142857,69.6285714285714,51.62,NA,181,109,74,0,0,98,72,24
2020,51,30,"Merkezefendi",37.7765,29.0864,14.5571428571429,7.34285714285714,0.343,78.6428571428571,51.8314285714286,NA,171,65,30,24,23,90,106,60
2020,52,30,"Merkezefendi",37.7765,29.0864,13.2428571428571,6.51428571428571,0,73.2428571428571,65.8814285714286,NA,203,72,14,15,6,113,131,99
2020,53,30,"Merkezefendi",37.7765,29.0864,20.35,8.85,2.7495,77.625,64.0725,NA,122,70,85,0,0,111,52,26
2017,1,31,"Diyarbakir",37.9206,40.229,14.5,2.04285714285714,0.00157142857142857,79.8714285714286,48.0642857142857,NA,563,87,110,105,192,847,476,737
2017,2,31,"Diyarbakir",37.9206,40.229,16.6714285714286,2.04285714285714,0.114142857142857,70.8428571428571,58.5057142857143,NA,757,1,1,140,422,1214,756,1213
2017,3,31,"Diyarbakir",37.9206,40.229,15.6,2.88571428571429,0.826571428571429,62.7571428571429,57.0257142857143,NA,762,21,35,178,358,1449,741,1414
2017,4,31,"Diyarbakir",37.9206,40.229,18.7857142857143,0.957142857142857,2.12357142857143,70.3714285714286,33.0557142857143,NA,639,4,2,51,163,889,635,887
2017,5,31,"Diyarbakir",37.9206,40.229,20.3714285714286,-4.8,0.374,79.4142857142857,67.9842857142857,NA,588,29,51,19,4,1163,559,1112
2017,6,31,"Diyarbakir",37.9206,40.229,10.8714285714286,-0.785714285714286,0.0862857142857143,90.4285714285714,89.1128571428571,NA,736,120,378,0,0,1519,616,1141
2017,7,31,"Diyarbakir",37.9206,40.229,23.8428571428571,1.41428571428571,0.0572857142857143,44.8285714285714,31.0214285714286,NA,492,51,54,13,13,717,441,663
2017,8,31,"Diyarbakir",37.9206,40.229,12.9857142857143,6.01428571428571,0,49.7714285714286,59.22,NA,739,75,227,265,655,1747,664,1520
2017,9,31,"Diyarbakir",37.9206,40.229,15.0714285714286,9.22857142857143,4.17128571428571,68.2,46.2128571428571,NA,574,91,131,2,0,866,483,735
2017,10,31,"Diyarbakir",37.9206,40.229,17.9571428571429,10.6428571428571,0.0292857142857143,59.7142857142857,33.3966666666667,NA,712,243,361,43,79,1043,469,682
2017,11,31,"Diyarbakir",37.9206,40.229,26.1142857142857,7.97142857142857,3.705,80.1857142857143,21.1614285714286,NA,525,95,176,55,27,725,430,549
2017,12,31,"Diyarbakir",37.9206,40.229,20.0857142857143,8.28571428571429,2.48385714285714,65.0428571428571,25.9971428571429,NA,589,197,471,102,128,1077,392,606
2017,13,31,"Diyarbakir",37.9206,40.229,22.2285714285714,11.4285714285714,4.90942857142857,74.1714285714286,23.8871428571429,NA,574,0,0,249,374,887,574,887
2017,14,31,"Diyarbakir",37.9206,40.229,19.8714285714286,10.7428571428571,2.057,71,22.5071428571429,NA,639,274,556,160,246,1336,365,780
2017,15,31,"Diyarbakir",37.9206,40.229,17.7571428571429,12,4.05814285714286,70.8,25.8071428571429,NA,587,62,358,267,359,1187,525,829
2017,16,31,"Diyarbakir",37.9206,40.229,23.3285714285714,14.0428571428571,2.858,76.8428571428571,33.5471428571429,NA,717,202,243,115,121,920,515,677
2017,17,31,"Diyarbakir",37.9206,40.229,21.1428571428571,15.0857142857143,0.142714285714286,51.9571428571429,32.06,NA,731,0,0,146,331,1478,731,1478
2017,18,31,"Diyarbakir",37.9206,40.229,17.6428571428571,15.5714285714286,1.94642857142857,78.1285714285714,26.0133333333333,NA,506,225,395,19,49,923,281,528
2017,19,31,"Diyarbakir",37.9206,40.229,19.2571428571429,19.8142857142857,0,56.0285714285714,47.6114285714286,NA,471,80,160,156,306,966,391,806
2017,20,31,"Diyarbakir",37.9206,40.229,26.9428571428571,20.2142857142857,0.344,50.0857142857143,45.5485714285714,NA,472,162,469,80,255,1205,310,736
2017,21,31,"Diyarbakir",37.9206,40.229,22.9571428571429,18.3,1.28671428571429,56.9428571428571,24.9057142857143,NA,448,107,193,118,250,849,341,656
2017,22,31,"Diyarbakir",37.9206,40.229,23.2857142857143,22.2857142857143,0,39.6142857142857,30.2771428571429,NA,522,94,238,202,248,1015,428,777
2017,23,31,"Diyarbakir",37.9206,40.229,23.0428571428571,27.2714285714286,0,30.6857142857143,44.0685714285714,NA,578,88,185,260,582,1388,490,1203
2017,24,31,"Diyarbakir",37.9206,40.229,27.2142857142857,25.6714285714286,0,31.3428571428571,35.4757142857143,NA,552,0,0,230,559,1139,552,1139
2017,25,31,"Diyarbakir",37.9206,40.229,23.7714285714286,26.5714285714286,0.427571428571429,31.8285714285714,27.5257142857143,NA,584,0,0,176,315,1041,584,1041
2017,26,31,"Diyarbakir",37.9206,40.229,21.1142857142857,32,0,20.7142857142857,40.8671428571429,NA,564,34,32,137,270,971,530,939
2017,27,31,"Diyarbakir",37.9206,40.229,23.8142857142857,32.1428571428571,0,21.6,54.9957142857143,NA,511,14,18,178,262,642,497,624
2017,28,31,"Diyarbakir",37.9206,40.229,18.7428571428571,32.5285714285714,0,17.9857142857143,37.3442857142857,NA,481,0,0,76,148,864,481,864
2017,29,31,"Diyarbakir",37.9206,40.229,25.1,32.5,0,19.6714285714286,55.9728571428571,NA,532,26,56,223,497,1272,506,1216
2017,30,31,"Diyarbakir",37.9206,40.229,23.4571428571429,32.0142857142857,0,20.2142857142857,45.4928571428571,NA,531,0,0,128,299,928,531,928
2017,31,31,"Diyarbakir",37.9206,40.229,18.7428571428571,32.0285714285714,0,19.2571428571429,58.3414285714286,NA,559,143,203,79,87,1047,416,844
2017,32,31,"Diyarbakir",37.9206,40.229,24.6142857142857,32.9285714285714,0,19.1428571428571,54.2742857142857,NA,567,59,105,173,336,1092,508,987
2017,33,31,"Diyarbakir",37.9206,40.229,23.2285714285714,31.1285714285714,0,26.6857142857143,53.8642857142857,NA,596,21,33,155,231,1199,575,1166
2017,34,31,"Diyarbakir",37.9206,40.229,18.4857142857143,30.5714285714286,0,25.3428571428571,52.3342857142857,NA,601,98,250,8,19,1280,503,1030
2017,35,31,"Diyarbakir",37.9206,40.229,21.1142857142857,28.6714285714286,0,23.6428571428571,45.71,NA,493,79,72,127,232,1014,414,942
2017,36,31,"Diyarbakir",37.9206,40.229,20.8428571428571,27.4285714285714,0,20.3428571428571,50.1228571428571,NA,507,87,173,86,248,1321,420,1148
2017,37,31,"Diyarbakir",37.9206,40.229,12.9142857142857,28.1571428571429,0,17.1,66.7642857142857,NA,589,117,377,70,80,1138,472,761
2017,38,31,"Diyarbakir",37.9206,40.229,19,26.5,0,26,84.1257142857143,NA,671,111,237,267,486,1312,560,1075
2017,39,31,"Diyarbakir",37.9206,40.229,19.8714285714286,23.8428571428571,0,30.9285714285714,65.3657142857143,NA,782,158,402,97,319,1630,624,1228
2017,40,31,"Diyarbakir",37.9206,40.229,20.0714285714286,18.7428571428571,0.000285714285714286,30.8285714285714,50.5928571428571,NA,543,147,371,45,106,1137,396,766
2017,41,31,"Diyarbakir",37.9206,40.229,18.9714285714286,18.2571428571429,0.0285714285714286,37.6857142857143,43.3157142857143,NA,487,57,41,128,252,843,430,802
2017,42,31,"Diyarbakir",37.9206,40.229,19.3142857142857,16.5,0,29.8857142857143,57.57,NA,530,148,213,59,120,815,382,602
2017,43,31,"Diyarbakir",37.9206,40.229,16.4,15.9285714285714,2.99528571428571,46.2,79.0214285714286,NA,506,257,564,76,107,919,249,355
2017,44,31,"Diyarbakir",37.9206,40.229,15.2714285714286,12.3571428571429,1.28842857142857,67.4857142857143,45.148,NA,561,83,199,130,347,1102,478,903
2017,45,31,"Diyarbakir",37.9206,40.229,12.2285714285714,12.4142857142857,0.314,73.7,109.422857142857,NA,577,6,3,185,429,829,571,826
2017,46,31,"Diyarbakir",37.9206,40.229,9.85714285714286,10.6571428571429,0.715285714285714,63.2142857142857,79.0542857142857,NA,587,77,169,187,356,1085,510,916
2017,47,31,"Diyarbakir",37.9206,40.229,18.7428571428571,7.34285714285714,0.087,64.3857142857143,33.5914285714286,NA,418,112,307,113,183,804,306,497
2017,48,31,"Diyarbakir",37.9206,40.229,10.4285714285714,5.95714285714286,0.428857142857143,79.8857142857143,55.5357142857143,NA,386,132,219,131,155,619,254,400
2017,49,31,"Diyarbakir",37.9206,40.229,18.7714285714286,4.38571428571429,0.407,69.9714285714286,46.4642857142857,NA,407,57,109,168,204,645,350,536
2017,50,31,"Diyarbakir",37.9206,40.229,9.35714285714286,4.47142857142857,0,67.5142857142857,74.0128571428571,NA,346,65,138,96,131,442,281,304
2017,51,31,"Diyarbakir",37.9206,40.229,13.5142857142857,8.34285714285714,0.631714285714286,83.0285714285714,68.2628571428571,NA,386,97,86,121,78,349,289,263
2017,52,31,"Diyarbakir",37.9206,40.229,16.2125,6.5375,0.4,73.8375,57.40875,NA,528,82,75,211,147,507,446,432
2018,1,31,"Diyarbakir",37.9206,40.229,14.05,5.65,3.24775,80.9125,24.45,NA,618,197,308,37,156,914,421,606
2018,2,31,"Diyarbakir",37.9206,40.229,13.2,4.68571428571429,0.0292857142857143,66.8428571428571,49.5442857142857,NA,624,153,739,59,66,1309,471,570
2018,3,31,"Diyarbakir",37.9206,40.229,22.5,5.17142857142857,3.99585714285714,84.4428571428572,74.1457142857143,NA,639,126,366,55,67,655,513,289
2018,4,31,"Diyarbakir",37.9206,40.229,15.4,5.84285714285714,5.512,85.9857142857143,90.115,NA,604,181,211,46,47,764,423,553
2018,5,31,"Diyarbakir",37.9206,40.229,13.7428571428571,4.25714285714286,0,66.1714285714286,47.96,NA,670,118,102,55,164,819,552,717
2018,6,31,"Diyarbakir",37.9206,40.229,10.9,7.55714285714286,0.057,63.1571428571429,NA,NA,704,113,181,170,366,1022,591,841
2018,7,31,"Diyarbakir",37.9206,40.229,19.8285714285714,8.45714285714286,9.32914285714286,78.6714285714286,NA,NA,478,85,86,133,171,557,393,471
2018,8,31,"Diyarbakir",37.9206,40.229,16.9142857142857,8.21428571428571,2.28428571428571,80.2285714285714,NA,NA,711,53,118,111,223,1321,658,1203
2018,9,31,"Diyarbakir",37.9206,40.229,19.3142857142857,9.12857142857143,0.86,79.8714285714286,NA,NA,621,159,239,185,253,956,462,717
2018,10,31,"Diyarbakir",37.9206,40.229,17.9857142857143,11.6857142857143,0.000142857142857143,65.6857142857143,NA,NA,556,54,169,22,53,1330,502,1161
2018,11,31,"Diyarbakir",37.9206,40.229,22.9714285714286,11.8428571428571,0.125857142857143,61.2285714285714,31.5233333333333,NA,551,4,3,125,175,1426,547,1423
2018,12,31,"Diyarbakir",37.9206,40.229,26.6285714285714,14.7428571428571,0,52.4857142857143,88.1571428571429,NA,425,58,305,51,54,1187,367,882
2018,13,31,"Diyarbakir",37.9206,40.229,17.9714285714286,13.1142857142857,0.912571428571429,65.7,51.1042857142857,NA,356,37,56,34,80,428,319,372
2018,14,31,"Diyarbakir",37.9206,40.229,23.1857142857143,14.8142857142857,0,40.1714285714286,29.978,NA,407,116,260,4,16,486,291,226
2018,15,31,"Diyarbakir",37.9206,40.229,21.8857142857143,16.1,3.66357142857143,61.9142857142857,28.6628571428571,NA,374,149,240,8,36,450,225,210
2018,16,31,"Diyarbakir",37.9206,40.229,20.1571428571429,15.6285714285714,1.51085714285714,50.2285714285714,26.7671428571429,NA,411,109,234,56,106,648,302,414
2018,17,31,"Diyarbakir",37.9206,40.229,22.7,17.1571428571429,1.65414285714286,58.1428571428571,37.3442857142857,NA,419,55,81,38,17,652,364,571
2018,18,31,"Diyarbakir",37.9206,40.229,18.9428571428571,18.6142857142857,0.549,69,24.9157142857143,NA,303,87,108,65,154,474,216,366
2018,19,31,"Diyarbakir",37.9206,40.229,18.5,14.5571428571429,19.2502857142857,89.9714285714286,17.1285714285714,NA,275,150,327,44,39,467,125,140
2018,20,31,"Diyarbakir",37.9206,40.229,15.6285714285714,20.5,0.146857142857143,60.7428571428571,23.4514285714286,NA,204,49,66,26,41,306,155,240
2018,21,31,"Diyarbakir",37.9206,40.229,24.5285714285714,22.7571428571429,1.43657142857143,54.8571428571429,34.7516666666667,NA,252,31,14,86,128,281,221,267
2018,22,31,"Diyarbakir",37.9206,40.229,23.7857142857143,21.7,1.05828571428571,57.8714285714286,28.9785714285714,NA,249,0,0,107,272,427,249,427
2018,23,31,"Diyarbakir",37.9206,40.229,24.3142857142857,24.7142857142857,1.58185714285714,42.9714285714286,23.58,NA,267,0,0,104,458,812,267,812
2018,24,31,"Diyarbakir",37.9206,40.229,25.8857142857143,25.9285714285714,0.429857142857143,40.3285714285714,36.1528571428571,NA,267,9,11,85,94,448,258,437
2018,25,31,"Diyarbakir",37.9206,40.229,18.9285714285714,27.6285714285714,0.0285714285714286,34.1,30.1442857142857,NA,358,0,0,226,374,518,358,518
2018,26,31,"Diyarbakir",37.9206,40.229,22.4142857142857,30.6,0,26.2,46.81,NA,355,0,0,89,104,587,355,587
2018,27,31,"Diyarbakir",37.9206,40.229,23.5285714285714,31.8857142857143,0,22.1571428571429,49.1828571428571,NA,342,0,0,159,163,418,342,418
2018,28,31,"Diyarbakir",37.9206,40.229,21.4285714285714,31.4857142857143,0,24.8714285714286,51.8271428571429,NA,286,10,38,27,75,585,276,547
2018,29,31,"Diyarbakir",37.9206,40.229,25.1428571428571,30.8285714285714,0,24.7571428571429,29.2528571428571,NA,260,8,4,44,97,756,252,752
2018,30,31,"Diyarbakir",37.9206,40.229,25.6714285714286,31.1,0,24.5714285714286,46.0942857142857,NA,265,26,23,79,420,822,239,799
2018,31,31,"Diyarbakir",37.9206,40.229,19.4571428571429,31.8142857142857,0.114,28.8142857142857,40.2471428571429,NA,267,14,24,37,64,499,253,475
2018,32,31,"Diyarbakir",37.9206,40.229,25.5714285714286,31.6,0,24.8285714285714,34.76,NA,297,7,16,26,55,403,290,387
2018,33,31,"Diyarbakir",37.9206,40.229,22.9571428571429,31.9142857142857,0,20.8857142857143,35.2328571428571,NA,216,6,33,25,60,332,210,299
2018,34,31,"Diyarbakir",37.9206,40.229,20.5428571428571,31.4571428571429,0,23.9571428571429,33.3457142857143,NA,144,35,28,30,38,227,109,199
2018,35,31,"Diyarbakir",37.9206,40.229,19.5285714285714,30.4,0,25.5142857142857,46.7442857142857,NA,201,8,41,28,71,314,193,273
2018,36,31,"Diyarbakir",37.9206,40.229,19.8428571428571,27.2428571428571,0.0572857142857143,32.0428571428571,50.3842857142857,NA,341,59,42,121,166,370,282,328
2018,37,31,"Diyarbakir",37.9206,40.229,19.5285714285714,24.6571428571429,0.712714285714286,40.9857142857143,42.6457142857143,NA,241,9,44,52,167,419,232,375
2018,38,31,"Diyarbakir",37.9206,40.229,18.4571428571429,26.3857142857143,0,23.9285714285714,32.2714285714286,NA,189,4,10,32,92,344,185,334
2018,39,31,"Diyarbakir",37.9206,40.229,17.9571428571429,25.0428571428571,0,25.0857142857143,39.8585714285714,NA,180,42,145,39,104,353,138,208
2018,40,31,"Diyarbakir",37.9206,40.229,18.4285714285714,22.9857142857143,0,29.1285714285714,35.0071428571429,NA,191,25,34,61,112,341,166,307
2018,41,31,"Diyarbakir",37.9206,40.229,17.1571428571429,20.4857142857143,0.717142857142857,51.8857142857143,78.3585714285714,NA,187,22,101,54,180,422,165,321
2018,42,31,"Diyarbakir",37.9206,40.229,15.5714285714286,19.8714285714286,2.31,51.7571428571429,65.1271428571429,NA,168,57,71,49,63,381,111,310
2018,43,31,"Diyarbakir",37.9206,40.229,21.4571428571429,14.3714285714286,7.72428571428571,76.4285714285714,33.252,NA,187,23,77,41,188,402,164,325
2018,44,31,"Diyarbakir",37.9206,40.229,11.1142857142857,13.8428571428571,0,55.9142857142857,42.7314285714286,NA,196,50,35,79,97,264,146,229
2018,45,31,"Diyarbakir",37.9206,40.229,11.6142857142857,11.8428571428571,2.08685714285714,80.2571428571429,33.3485714285714,NA,231,25,38,121,313,473,206,435
2018,46,31,"Diyarbakir",37.9206,40.229,15.8285714285714,9.42857142857143,4.65471428571429,73.4285714285714,33.1314285714286,NA,230,0,0,84,333,465,230,465
2018,47,31,"Diyarbakir",37.9206,40.229,9.6,8.45714285714286,1.402,86.4,42.9485714285714,NA,270,90,256,15,6,499,180,243
2018,48,31,"Diyarbakir",37.9206,40.229,11.6714285714286,8.8,13.5237142857143,96.8857142857143,30.2028571428571,NA,245,139,142,27,16,201,106,59
2018,49,31,"Diyarbakir",37.9206,40.229,14.5142857142857,8.32857142857143,2.59642857142857,91.9428571428571,29.0071428571429,NA,257,72,79,61,95,420,185,341
2018,50,31,"Diyarbakir",37.9206,40.229,22.8142857142857,6.97142857142857,1.94857142857143,85.0428571428571,32.9771428571429,NA,256,9,16,69,140,305,247,289
2018,51,31,"Diyarbakir",37.9206,40.229,13.7,5.64285714285714,4.07728571428571,93.4428571428571,37.5457142857143,NA,250,92,32,60,84,248,158,216
2018,52,31,"Diyarbakir",37.9206,40.229,19.8,4,5.36214285714286,87.5571428571429,27.8725,NA,244,50,89,17,44,273,194,184
2019,1,31,"Diyarbakir",37.9206,40.229,16.1125,5.325,3.6445,91.25,26.19,NA,343,93,345,17,98,784,250,439
2019,2,31,"Diyarbakir",37.9206,40.229,21.5571428571429,1.68571428571429,3.99785714285714,80.2142857142857,29.3133333333333,NA,255,3,1,81,61,208,252,207
2019,3,31,"Diyarbakir",37.9206,40.229,22.9428571428571,2.87142857142857,2.02885714285714,77,43.3342857142857,NA,192,14,17,29,80,198,178,181
2019,4,31,"Diyarbakir",37.9206,40.229,11.4142857142857,4.88571428571429,0.142571428571429,80.4571428571429,34.105,NA,308,10,107,45,6,314,298,207
2019,5,31,"Diyarbakir",37.9206,40.229,22.2428571428571,6.35714285714286,2.26071428571429,78.0571428571428,NA,NA,253,37,21,53,63,143,216,122
2019,6,31,"Diyarbakir",37.9206,40.229,12.9571428571429,4.75714285714286,1.57728571428571,80.3714285714286,27.16,NA,276,61,25,106,49,127,215,102
2019,7,31,"Diyarbakir",37.9206,40.229,14.2857142857143,4.81428571428571,4.13771428571429,79.2428571428571,24.8942857142857,NA,325,29,8,15,120,234,296,226
2019,8,31,"Diyarbakir",37.9206,40.229,14.1285714285714,5.97142857142857,0.998142857142857,72.1285714285714,27.95,NA,305,42,32,42,35,219,263,187
2019,9,31,"Diyarbakir",37.9206,40.229,20.4428571428571,5.94285714285714,3.406,76.1142857142857,22.5928571428571,NA,331,50,92,15,23,310,281,218
2019,10,31,"Diyarbakir",37.9206,40.229,15.5857142857143,7.47142857142857,2.31285714285714,71.5714285714286,21.7814285714286,NA,359,42,15,126,139,252,317,237
2019,11,31,"Diyarbakir",37.9206,40.229,23.7,9.5,4.39271428571429,77.6571428571429,17.01,NA,373,115,148,70,52,400,258,252
2019,12,31,"Diyarbakir",37.9206,40.229,21.0857142857143,8.1,5.70914285714286,64.4714285714286,18.048,NA,343,83,34,114,60,416,260,382
2019,13,31,"Diyarbakir",37.9206,40.229,21.4,9.07142857142857,3.72185714285714,88.6142857142857,14.3957142857143,NA,256,99,70,12,24,194,157,124
2019,14,31,"Diyarbakir",37.9206,40.229,17.5,10.7714285714286,5.94714285714286,87.6571428571429,9.675,NA,365,200,112,0,0,208,165,96
2019,15,31,"Diyarbakir",37.9206,40.229,17.7,13.2428571428571,6.76257142857143,75.8857142857143,NA,NA,359,44,37,113,68,183,315,146
2019,16,31,"Diyarbakir",37.9206,40.229,23.3285714285714,10.5,7.45957142857143,85.3571428571429,NA,NA,318,88,68,89,38,208,230,140
2019,17,31,"Diyarbakir",37.9206,40.229,14.2571428571429,12.2285714285714,0.314142857142857,64.1285714285714,NA,NA,412,63,18,142,141,313,349,295
2019,18,31,"Diyarbakir",37.9206,40.229,17.3571428571429,15.1857142857143,6.13842857142857,80.2142857142857,NA,NA,523,48,22,144,74,353,475,331
2019,19,31,"Diyarbakir",37.9206,40.229,18.3714285714286,16.7428571428571,0.542428571428571,70.4428571428572,31.42,NA,452,200,166,171,142,386,252,220
2019,20,31,"Diyarbakir",37.9206,40.229,16.5,21.3142857142857,0,57.5,34.7542857142857,NA,454,54,61,112,100,389,400,328
2019,21,31,"Diyarbakir",37.9206,40.229,20.2,22.4714285714286,0,49.6142857142857,38.98,NA,457,69,30,84,41,413,388,383
2019,22,31,"Diyarbakir",37.9206,40.229,19.5,25.8714285714286,0,34.6428571428571,30.1614285714286,NA,453,7,54,16,18,323,446,269
2019,23,31,"Diyarbakir",37.9206,40.229,21.7428571428571,27.3857142857143,0,33.0857142857143,51.24,NA,378,50,97,164,163,532,328,435
2019,24,31,"Diyarbakir",37.9206,40.229,26.2285714285714,26.8714285714286,0.0285714285714286,34.6285714285714,38.9514285714286,NA,378,102,65,201,145,244,276,179
2019,25,31,"Diyarbakir",37.9206,40.229,22.1285714285714,27.7142857142857,0.000285714285714286,36.0714285714286,38.9842857142857,NA,306,48,10,144,220,325,258,315
2019,26,31,"Diyarbakir",37.9206,40.229,24.7571428571429,31.6285714285714,0,25.3714285714286,38.0357142857143,NA,377,100,60,10,18,342,277,282
2019,27,31,"Diyarbakir",37.9206,40.229,22.6857142857143,29.5285714285714,0,22.9285714285714,34.9114285714286,NA,456,132,102,7,6,222,324,120
2019,28,31,"Diyarbakir",37.9206,40.229,26.6285714285714,30.4142857142857,0,25.1571428571429,27.7042857142857,NA,398,0,0,82,54,421,398,421
2019,29,31,"Diyarbakir",37.9206,40.229,22.8714285714286,29.8428571428571,0,28.6428571428571,33.2042857142857,NA,453,0,0,242,107,203,453,203
2019,30,31,"Diyarbakir",37.9206,40.229,23.5285714285714,31.3714285714286,0,25.1142857142857,34.9157142857143,NA,456,13,12,126,96,335,443,323
2019,31,31,"Diyarbakir",37.9206,40.229,23.3428571428571,32.1714285714286,0,23.6428571428571,38.3442857142857,NA,334,60,76,20,22,375,274,299
2019,32,31,"Diyarbakir",37.9206,40.229,25.7714285714286,31.8428571428571,0,21.5142857142857,33.9071428571429,NA,346,0,0,31,54,395,346,395
2019,33,31,"Diyarbakir",37.9206,40.229,18.2142857142857,31.6714285714286,0,25.1428571428571,44.9228571428571,NA,337,50,92,50,83,531,287,439
2019,34,31,"Diyarbakir",37.9206,40.229,18.6142857142857,29.7571428571429,0,30.3857142857143,40.5385714285714,NA,299,40,44,137,131,345,259,301
2019,35,31,"Diyarbakir",37.9206,40.229,24.4714285714286,29.5571428571429,0.000142857142857143,28.1,40.7,NA,307,120,149,80,61,415,187,266
2019,36,31,"Diyarbakir",37.9206,40.229,20.1,28.0428571428571,0,24.2714285714286,29.8928571428571,NA,171,40,9,8,26,67,131,58
2019,37,31,"Diyarbakir",37.9206,40.229,15.8,25.7142857142857,0.0571428571428571,28,41.3614285714286,NA,218,60,8,3,1,55,158,47
2019,38,31,"Diyarbakir",37.9206,40.229,26.7571428571429,24.3285714285714,0,31.2571428571429,43.2028571428571,NA,266,35,15,107,44,91,231,76
2019,39,31,"Diyarbakir",37.9206,40.229,18.8142857142857,22.7142857142857,0,30.1,41.99,NA,237,38,13,62,28,79,199,66
2019,40,31,"Diyarbakir",37.9206,40.229,19.2714285714286,22.7714285714286,0.855,32.1857142857143,51.3642857142857,NA,241,123,43,97,40,111,118,68
2019,41,31,"Diyarbakir",37.9206,40.229,17.0142857142857,22.1285714285714,0,38.2285714285714,51.2757142857143,NA,416,6,1,108,107,448,410,447
2019,42,31,"Diyarbakir",37.9206,40.229,14.6,19.4,0.997714285714286,46.5142857142857,51.3857142857143,NA,356,145,179,56,102,408,211,229
2019,43,31,"Diyarbakir",37.9206,40.229,13.5428571428571,16.4285714285714,2.43014285714286,66.0285714285714,35.8428571428571,NA,306,68,33,82,111,300,238,267
2019,44,31,"Diyarbakir",37.9206,40.229,15.2428571428571,12.7,3.541,76.2571428571429,33.9257142857143,NA,350,120,75,47,41,250,230,175
2019,45,31,"Diyarbakir",37.9206,40.229,8.3,11.3,0,59.6,61.1,NA,417,5,18,163,122,328,412,310
2019,46,31,"Diyarbakir",37.9206,40.229,9.15714285714286,10.4428571428571,0,51.2571428571429,76.1028571428571,NA,401,14,40,116,153,337,387,297
2019,47,31,"Diyarbakir",37.9206,40.229,8.27142857142857,7.27142857142857,0,43.4571428571429,72.9485714285714,NA,391,115,57,69,69,339,276,282
2019,48,31,"Diyarbakir",37.9206,40.229,13.6571428571429,9.15714285714286,2.567,76.8571428571429,67.1171428571429,NA,320,66,76,87,45,251,254,175
2019,49,31,"Diyarbakir",37.9206,40.229,15.0428571428571,6.65714285714286,12.9798571428571,85.0142857142857,35.25,NA,393,102,63,10,14,274,291,211
2019,50,31,"Diyarbakir",37.9206,40.229,11.6,6.58571428571429,6.53457142857143,97.9571428571429,43.4214285714286,NA,218,159,104,0,0,119,59,15
2019,51,31,"Diyarbakir",37.9206,40.229,11.7857142857143,6.74285714285714,0,74.9714285714286,58.8457142857143,NA,361,2,3,152,253,488,359,485
2019,52,31,"Diyarbakir",37.9206,40.229,21.4857142857143,6.44285714285714,3.88642857142857,86.4428571428572,49.4285714285714,NA,279,124,146,0,0,281,155,135
2020,1,31,"Diyarbakir",37.9206,40.229,11.86,4.44,8.5472,96.68,22.158,NA,160,51,74,1,0,126,109,52
2020,2,31,"Diyarbakir",37.9206,40.229,16.1142857142857,4.51428571428571,4.07771428571429,82.0571428571429,22.3285714285714,NA,240,30,34,29,27,173,210,139
2020,3,31,"Diyarbakir",37.9206,40.229,14.2714285714286,2.55714285714286,1.06028571428571,73.1285714285714,35.8114285714286,NA,270,11,3,37,82,382,259,379
2020,4,31,"Diyarbakir",37.9206,40.229,18.1142857142857,3.1,0.688571428571429,65.2571428571429,21.1914285714286,NA,358,113,76,9,3,295,245,219
2020,5,31,"Diyarbakir",37.9206,40.229,18.5,3.65714285714286,1.61057142857143,77.9857142857143,41.3457142857143,NA,331,104,132,9,20,272,227,140
2020,6,31,"Diyarbakir",37.9206,40.229,24.3142857142857,3.04285714285714,1.54885714285714,81.2714285714286,31.4657142857143,NA,343,101,68,40,11,267,242,199
2020,7,31,"Diyarbakir",37.9206,40.229,15.2571428571429,-2.88571428571429,4.30528571428571,73.0857142857143,38.0985714285714,NA,341,34,51,128,78,338,307,287
2020,8,31,"Diyarbakir",37.9206,40.229,13.9142857142857,7.15714285714286,5.63957142857143,82.0428571428571,39.5971428571429,NA,283,55,60,31,12,187,228,127
2020,9,31,"Diyarbakir",37.9206,40.229,20.5,8.58571428571429,1.03957142857143,66.8428571428571,33.1328571428571,NA,393,174,158,0,0,528,219,370
2020,10,31,"Diyarbakir",37.9206,40.229,13.5714285714286,10.3571428571429,0.0285714285714286,58.8428571428571,37.9528571428571,NA,205,60,84,37,25,210,145,126
2020,11,31,"Diyarbakir",37.9206,40.229,14.6,12.3142857142857,1.541,68.9285714285714,40.65,NA,115,68,71,26,6,94,47,23
2020,12,31,"Diyarbakir",37.9206,40.229,21.0714285714286,9.5,10.734,78.8428571428571,20.5057142857143,NA,117,10,4,33,13,118,107,114
2020,13,31,"Diyarbakir",37.9206,40.229,18,10.6571428571429,8.31371428571429,79.9,22.41,NA,136,70,51,5,4,92,66,41
2020,14,31,"Diyarbakir",37.9206,40.229,18.2571428571429,10.0714285714286,6.96742857142857,81.5857142857143,16.5714285714286,NA,155,33,15,46,20,121,122,106
2020,15,31,"Diyarbakir",37.9206,40.229,19.3142857142857,13.1857142857143,3.33785714285714,70.2571428571429,18.9742857142857,NA,133,64,33,3,2,118,69,85
2020,16,31,"Diyarbakir",37.9206,40.229,14.9285714285714,14.6857142857143,0.00314285714285714,63.6428571428571,24.1757142857143,NA,141,12,9,60,46,106,129,97
2020,17,31,"Diyarbakir",37.9206,40.229,15.8857142857143,15.0142857142857,3.94685714285714,72.6142857142857,27.25,NA,137,44,52,26,17,123,93,71
2020,18,31,"Diyarbakir",37.9206,40.229,18.4571428571429,14.1428571428571,2.455,73.3857142857143,NA,NA,146,35,65,31,24,164,111,99
2020,19,31,"Diyarbakir",37.9206,40.229,23.9714285714286,15.8857142857143,1.83457142857143,72.0857142857143,14.03,NA,137,16,16,48,36,157,121,141
2020,20,31,"Diyarbakir",37.9206,40.229,15.7571428571429,20.6285714285714,0,54.3857142857143,16.9,NA,164,53,22,2,10,164,111,142
2020,21,31,"Diyarbakir",37.9206,40.229,29.9571428571429,23.4,0.0397142857142857,41.8571428571429,38.1933333333333,NA,146,60,38,16,21,96,86,58
2020,22,31,"Diyarbakir",37.9206,40.229,17.4428571428571,19.6428571428571,5.70157142857143,55,21.0085714285714,NA,118,14,27,27,16,100,104,73
2020,23,31,"Diyarbakir",37.9206,40.229,18.1857142857143,22.8428571428571,0,39.8428571428571,32.2357142857143,NA,112,23,15,41,37,70,89,55
2020,24,31,"Diyarbakir",37.9206,40.229,23.7142857142857,26.0428571428571,0,35.5857142857143,46.2314285714286,NA,140,20,45,49,67,150,120,105
2020,25,31,"Diyarbakir",37.9206,40.229,22.9571428571429,25.9,0.0855714285714286,39.9857142857143,39.8814285714286,NA,137,37,24,36,16,108,100,84
2020,26,31,"Diyarbakir",37.9206,40.229,18.2857142857143,28.8714285714286,0,29.3428571428571,38.0828571428571,NA,173,83,42,35,29,133,90,91
2020,27,31,"Diyarbakir",37.9206,40.229,22.4,29.7,0.000142857142857143,30.3428571428571,40.5514285714286,NA,113,83,93,0,0,113,30,20
2020,28,31,"Diyarbakir",37.9206,40.229,21.6714285714286,30.9428571428571,0.114,29.9285714285714,35.8614285714286,NA,164,68,23,4,0,122,96,99
2020,29,31,"Diyarbakir",37.9206,40.229,19.5142857142857,30.8,0,26.2714285714286,30.626,NA,186,84,32,49,23,111,102,79
2020,30,31,"Diyarbakir",37.9206,40.229,24.9857142857143,32.4142857142857,0,24.3714285714286,44.2716666666667,NA,190,56,32,63,39,142,134,110
2020,31,31,"Diyarbakir",37.9206,40.229,21.6,32.5857142857143,0,25.1285714285714,33.6785714285714,NA,150,76,58,1,0,127,74,69
2020,32,31,"Diyarbakir",37.9206,40.229,17.7857142857143,31.7714285714286,0,22.5857142857143,26.8685714285714,NA,146,66,55,21,4,107,80,52
2020,33,31,"Diyarbakir",37.9206,40.229,22.8857142857143,30.7714285714286,0,27.3428571428571,29.5028571428571,NA,183,90,48,14,2,83,93,35
2020,34,31,"Diyarbakir",37.9206,40.229,24.9428571428571,29.7714285714286,0,25.3571428571429,31.1414285714286,NA,197,88,27,46,26,97,109,70
2020,35,31,"Diyarbakir",37.9206,40.229,16.2142857142857,28.8285714285714,0,21.9,31.15,NA,164,75,66,18,5,157,89,91
2020,36,31,"Diyarbakir",37.9206,40.229,21.6428571428571,29.9285714285714,0.000142857142857143,21.5857142857143,46.9371428571429,NA,179,58,30,64,34,112,121,82
2020,37,31,"Diyarbakir",37.9206,40.229,20.3571428571429,28.8,0,24.1571428571429,43.1885714285714,NA,193,85,36,1,1,91,108,55
2020,38,31,"Diyarbakir",37.9206,40.229,19.1857142857143,27.2714285714286,0,25.9714285714286,50.4485714285714,NA,235,34,16,111,96,157,201,141
2020,39,31,"Diyarbakir",37.9206,40.229,19.2857142857143,25.7,0,34.2857142857143,47.92,NA,220,70,70,80,30,129,150,59
2020,40,31,"Diyarbakir",37.9206,40.229,20.2571428571429,24.6142857142857,0,29.4714285714286,46.3814285714286,NA,187,82,68,53,56,154,105,86
2020,41,31,"Diyarbakir",37.9206,40.229,15.9714285714286,20.4428571428571,0,27.6285714285714,42.8171428571429,NA,182,59,38,32,29,127,123,89
2020,42,31,"Diyarbakir",37.9206,40.229,11.4,20.4571428571429,0,27.3571428571429,85.11,NA,177,20,17,68,59,111,157,94
2020,43,31,"Diyarbakir",37.9206,40.229,11.8,19.2428571428571,0,32.9428571428571,70.7028571428571,NA,194,72,23,12,12,161,122,138
2020,44,31,"Diyarbakir",37.9206,40.229,10.6428571428571,18.3857142857143,0,27.9285714285714,125.382857142857,NA,255,59,79,45,11,233,196,154
2020,45,31,"Diyarbakir",37.9206,40.229,16.1857142857143,14.2857142857143,4.02657142857143,69.9285714285714,49.61,NA,156,68,35,1,0,103,88,68
2020,46,31,"Diyarbakir",37.9206,40.229,10.9,11.6,0,60.9857142857143,40.4285714285714,NA,208,65,15,5,0,109,143,94
2020,47,31,"Diyarbakir",37.9206,40.229,13.5,8.62857142857143,0.0578571428571429,71.0285714285714,43.2142857142857,NA,173,1,0,78,19,83,172,83
2020,48,31,"Diyarbakir",37.9206,40.229,13.3428571428571,7.61428571428571,3.59171428571429,60.5714285714286,34.9371428571429,NA,199,0,0,55,88,262,199,262
2020,49,31,"Diyarbakir",37.9206,40.229,12.0714285714286,7.02857142857143,0.286142857142857,77.1142857142857,41.4457142857143,NA,207,34,23,53,41,116,173,93
2020,50,31,"Diyarbakir",37.9206,40.229,11.0142857142857,5.04285714285714,0.458285714285714,81.6285714285714,39.4828571428571,NA,181,59,23,13,35,98,122,75
2020,51,31,"Diyarbakir",37.9206,40.229,11.1142857142857,5.38571428571429,1.201,93.7285714285714,38.7171428571429,NA,171,61,33,52,35,90,110,57
2020,52,31,"Diyarbakir",37.9206,40.229,16.0571428571429,2.71428571428571,1.03285714285714,73.1428571428571,38.13,NA,203,27,5,57,9,113,176,108
2020,53,31,"Diyarbakir",37.9206,40.229,7.975,3.15,0,72.375,97.185,NA,122,0,0,94,107,111,122,111
2017,1,32,"Duzce",40.8438,31.1565,7.11428571428571,1.87142857142857,2.89771428571429,83.7857142857143,99.28,NA,563,110,175,348,531,847,453,672
2017,2,32,"Duzce",40.8438,31.1565,12.4714285714286,4.71428571428571,0.343428571428571,65.9142857142857,69.5371428571429,NA,757,124,181,82,84,1214,633,1033
2017,3,32,"Duzce",40.8438,31.1565,6.4,4.9,1.34328571428571,90.9714285714286,71.5914285714286,NA,762,0,0,446,710,1449,762,1449
2017,4,32,"Duzce",40.8438,31.1565,5.77142857142857,0.671428571428571,2.56785714285714,91.1428571428571,124.524285714286,NA,639,21,16,235,394,889,618,873
2017,5,32,"Duzce",40.8438,31.1565,9.8,3.21428571428571,0.342428571428571,68,188.378571428571,NA,588,0,0,28,78,1163,588,1163
2017,6,32,"Duzce",40.8438,31.1565,10.1142857142857,7.87142857142857,0.629857142857143,74.1,78.3528571428571,NA,736,261,707,0,0,1519,475,812
2017,7,32,"Duzce",40.8438,31.1565,7.17142857142857,2.81428571428571,1.513,74.1,103.217142857143,NA,492,172,253,0,0,717,320,464
2017,8,32,"Duzce",40.8438,31.1565,11.4,10.4285714285714,1.79814285714286,67.7428571428571,124.102857142857,NA,739,14,24,0,0,1747,725,1723
2017,9,32,"Duzce",40.8438,31.1565,7.17142857142857,9.8,0.428142857142857,75.6428571428571,129.344285714286,NA,574,118,235,0,0,866,456,631
2017,10,32,"Duzce",40.8438,31.1565,7.11428571428571,11.8142857142857,0.0571428571428571,64.0285714285714,137.628571428571,NA,712,228,313,0,0,1043,484,730
2017,11,32,"Duzce",40.8438,31.1565,9.27142857142857,6.58571428571429,4.33885714285714,83.0428571428571,65.0114285714286,NA,525,74,136,41,115,725,451,589
2017,12,32,"Duzce",40.8438,31.1565,8,10.3285714285714,1.08628571428571,70.1571428571429,104.562857142857,NA,589,74,154,0,0,1077,515,923
2017,13,32,"Duzce",40.8438,31.1565,10.1571428571429,8.88571428571429,0.942428571428571,72.2285714285714,81.5171428571429,NA,574,224,390,0,0,887,350,497
2017,14,32,"Duzce",40.8438,31.1565,10.2714285714286,11,2.00114285714286,73.4571428571429,101.751428571429,NA,639,42,133,0,0,1336,597,1203
2017,15,32,"Duzce",40.8438,31.1565,9.08571428571429,11.7142857142857,0.0144285714285714,67.2285714285714,73.8371428571429,NA,587,137,459,0,0,1187,450,728
2017,16,32,"Duzce",40.8438,31.1565,9.14285714285714,10.7142857142857,7.45257142857143,75.4714285714286,30.5185714285714,NA,717,164,199,0,0,920,553,721
2017,17,32,"Duzce",40.8438,31.1565,10.1714285714286,14.4428571428571,1.17,58.6142857142857,46.4514285714286,NA,731,217,477,0,0,1478,514,1001
2017,18,32,"Duzce",40.8438,31.1565,7.48571428571429,16.8428571428571,1.94414285714286,72.4857142857143,27.0871428571429,NA,506,83,289,0,0,923,423,634
2017,19,32,"Duzce",40.8438,31.1565,7.17142857142857,17.9,3.312,74.0857142857143,38.5285714285714,NA,471,178,432,0,0,966,293,534
2017,20,32,"Duzce",40.8438,31.1565,8.2,15.1571428571429,1.77214285714286,77.5142857142857,42.4757142857143,NA,472,160,483,0,0,1205,312,722
2017,21,32,"Duzce",40.8438,31.1565,10.3428571428571,16.4428571428571,0.0598571428571429,73.4571428571429,45.3357142857143,NA,448,184,537,0,0,849,264,312
2017,22,32,"Duzce",40.8438,31.1565,7.74285714285714,20.0571428571429,1.37285714285714,75.5,50.2185714285714,NA,522,207,463,0,0,1015,315,552
2017,23,32,"Duzce",40.8438,31.1565,7.42857142857143,20.4142857142857,5.59814285714286,82.8285714285714,42.1328571428571,NA,578,193,505,0,0,1388,385,883
2017,24,32,"Duzce",40.8438,31.1565,9.34285714285714,20.5285714285714,0.201142857142857,71.1714285714286,43.4971428571429,NA,552,204,592,0,0,1139,348,547
2017,25,32,"Duzce",40.8438,31.1565,7.37142857142857,20.5285714285714,9.27685714285714,77.8714285714286,36.9442857142857,NA,584,198,590,0,0,1041,386,451
2017,26,32,"Duzce",40.8438,31.1565,11.1142857142857,25.3714285714286,0,69.2285714285714,50.8328571428571,NA,564,190,445,0,0,971,374,526
2017,27,32,"Duzce",40.8438,31.1565,9.08571428571429,21.5428571428571,0.899,75.7428571428571,36.6242857142857,NA,511,182,312,0,0,642,329,330
2017,28,32,"Duzce",40.8438,31.1565,8.45714285714286,21.9285714285714,0.000142857142857143,74.6571428571429,48.5528571428571,NA,481,379,673,0,0,864,102,191
2017,29,32,"Duzce",40.8438,31.1565,9.65714285714286,22.2571428571429,2.34157142857143,79.6142857142857,38.2642857142857,NA,532,277,688,0,0,1272,255,584
2017,30,32,"Duzce",40.8438,31.1565,10.4285714285714,25.1142857142857,0.858571428571429,68.2857142857143,49.6914285714286,NA,531,201,488,0,0,928,330,440
2017,31,32,"Duzce",40.8438,31.1565,8.5,25.1285714285714,0.401571428571429,75.1142857142857,33.9657142857143,NA,559,99,251,172,378,1047,460,796
2017,32,32,"Duzce",40.8438,31.1565,12.5285714285714,26.5714285714286,0,76.3857142857143,41.8914285714286,NA,567,0,0,187,514,1092,567,1092
2017,33,32,"Duzce",40.8438,31.1565,9.08571428571429,24.1285714285714,0.101285714285714,76.8142857142857,57.4857142857143,NA,596,0,0,137,342,1199,596,1199
2017,34,32,"Duzce",40.8438,31.1565,11.3857142857143,21.1571428571429,5.85414285714286,77.9142857142857,41.2314285714286,NA,601,0,0,147,371,1280,601,1280
2017,35,32,"Duzce",40.8438,31.1565,10.1142857142857,18.6714285714286,1.61285714285714,74.8,42.2357142857143,NA,493,80,245,47,288,1014,413,769
2017,36,32,"Duzce",40.8438,31.1565,8.3,18.7,1.18485714285714,75.1,41.1957142857143,NA,507,303,829,125,346,1321,204,492
2017,37,32,"Duzce",40.8438,31.1565,8.04285714285714,23.5,0,71.6285714285714,75.3566666666667,NA,589,156,294,237,423,1138,433,844
2017,38,32,"Duzce",40.8438,31.1565,8.77142857142857,21.2428571428571,2.054,73.5142857142857,74.4014285714286,NA,671,2,4,180,572,1312,669,1308
2017,39,32,"Duzce",40.8438,31.1565,7.68571428571429,17.7571428571429,2.40357142857143,83.4571428571429,65.5814285714286,NA,782,131,160,378,938,1630,651,1470
2017,40,32,"Duzce",40.8438,31.1565,6.6,14.9857142857143,3.973,78.1428571428571,52.8028571428571,NA,543,89,307,122,313,1137,454,830
2017,41,32,"Duzce",40.8438,31.1565,6.14285714285714,12.1857142857143,1.05685714285714,81.5714285714286,55.1028571428571,NA,487,1,0,183,241,843,486,843
2017,42,32,"Duzce",40.8438,31.1565,4.62857142857143,14.6571428571429,0.114142857142857,80.7285714285714,89.1442857142857,NA,530,78,127,195,322,815,452,688
2017,43,32,"Duzce",40.8438,31.1565,6.27142857142857,14.1857142857143,6.99585714285714,89.2857142857143,69.5271428571429,NA,506,3,2,97,94,919,503,917
2017,44,32,"Duzce",40.8438,31.1565,6.54285714285714,8.38571428571429,0.856857142857143,79.8,100.272857142857,NA,561,36,72,111,194,1102,525,1030
2017,45,32,"Duzce",40.8438,31.1565,4.68571428571429,10.2857142857143,1.45557142857143,87.1428571428571,148.91,NA,577,0,0,234,320,829,577,829
2017,46,32,"Duzce",40.8438,31.1565,6.01428571428571,12,0.0571428571428571,80.9714285714286,173.618571428571,NA,587,89,172,87,118,1085,498,913
2017,47,32,"Duzce",40.8438,31.1565,7.74285714285714,8.18571428571429,5.31585714285714,88.8428571428571,127.181428571429,NA,418,38,151,107,138,804,380,653
2017,48,32,"Duzce",40.8438,31.1565,11.1428571428571,13.9857142857143,1.71271428571429,63.8428571428571,111.251428571429,NA,386,81,155,0,0,619,305,464
2017,49,32,"Duzce",40.8438,31.1565,6.28571428571429,5.94285714285714,10.6477142857143,87.2714285714286,144.56,NA,407,68,173,168,229,645,339,472
2017,50,32,"Duzce",40.8438,31.1565,9.21428571428571,10.2,0.0285714285714286,76.0428571428571,178.51,NA,346,0,0,0,0,442,346,442
2017,51,32,"Duzce",40.8438,31.1565,6.91428571428571,5.3,8.19728571428571,92.8857142857143,51.2442857142857,NA,386,50,33,275,240,349,336,316
2017,52,32,"Duzce",40.8438,31.1565,5.825,6.85,0.875125,79.5125,150.665,NA,528,77,74,121,151,507,451,433
2018,1,32,"Duzce",40.8438,31.1565,3.825,6.3375,0.325375,86.1,139.48125,25.17,618,170,304,115,124,914,448,610
2018,2,32,"Duzce",40.8438,31.1565,4.72857142857143,7.08571428571429,0.915571428571428,88.2428571428571,178.922857142857,NA,624,1,1,118,51,1309,623,1308
2018,3,32,"Duzce",40.8438,31.1565,7.48571428571429,6.3,4.19828571428572,75.4714285714286,78.8714285714286,NA,639,95,70,205,138,655,544,585
2018,4,32,"Duzce",40.8438,31.1565,7.17142857142857,3.44285714285714,2.59714285714286,79.2285714285714,58.4071428571429,NA,604,79,162,396,404,764,525,602
2018,5,32,"Duzce",40.8438,31.1565,4.42857142857143,8.51428571428571,0.000142857142857143,69.8857142857143,148.397142857143,NA,670,3,1,111,70,819,667,818
2018,6,32,"Duzce",40.8438,31.1565,7.14285714285714,9.42857142857143,2.39742857142857,82.9285714285714,79.2057142857143,NA,704,119,245,328,428,1022,585,777
2018,7,32,"Duzce",40.8438,31.1565,6.02857142857143,7.3,0.428142857142857,83.9571428571429,48.74,NA,478,27,40,174,192,557,451,517
2018,8,32,"Duzce",40.8438,31.1565,6.85714285714286,7.3,3.62842857142857,88.6,56.1157142857143,NA,711,0,0,409,804,1321,711,1321
2018,9,32,"Duzce",40.8438,31.1565,9.34285714285714,7.5,5.85557142857143,81.3571428571429,42.71,NA,621,0,0,366,542,956,621,956
2018,10,32,"Duzce",40.8438,31.1565,7.98571428571429,11.4571428571429,3.28357142857143,80.7714285714286,74.5985714285714,NA,556,177,506,101,295,1330,379,824
2018,11,32,"Duzce",40.8438,31.1565,7.68571428571429,14,3.77157142857143,68.6857142857143,75.4728571428571,NA,551,223,352,44,169,1426,328,1074
2018,12,32,"Duzce",40.8438,31.1565,7.42857142857143,11.2428571428571,1.65514285714286,83.6571428571429,66.0483333333333,NA,425,0,0,358,1072,1187,425,1187
2018,13,32,"Duzce",40.8438,31.1565,9.08571428571429,13.1571428571429,4.39771428571429,71.4,65.7,NA,356,60,53,128,187,428,296,375
2018,14,32,"Duzce",40.8438,31.1565,8.77142857142857,13.1428571428571,0.770714285714286,69.8428571428571,62.5728571428571,NA,407,0,0,298,416,486,407,486
2018,15,32,"Duzce",40.8438,31.1565,8.14285714285714,15.2714285714286,1.884,77.8428571428571,68.0542857142857,NA,374,0,0,321,400,450,374,450
2018,16,32,"Duzce",40.8438,31.1565,8.77142857142857,13.6142857142857,1.31285714285714,73.2142857142857,61.4128571428571,NA,411,0,0,275,382,648,411,648
2018,17,32,"Duzce",40.8438,31.1565,10.1714285714286,18.0714285714286,0,61.1,42.225,43.96,419,0,0,148,186,652,419,652
2018,18,32,"Duzce",40.8438,31.1565,7.22857142857143,17.8571428571429,0.886714285714286,79.2285714285714,NA,32.875,303,0,0,292,412,474,303,474
2018,19,32,"Duzce",40.8438,31.1565,7.42857142857143,15.9,11.7045714285714,88.3,NA,31.6,275,0,0,53,141,467,275,467
2018,20,32,"Duzce",40.8438,31.1565,9.38571428571429,21.0285714285714,0.913285714285714,66.9142857142857,NA,39.87,204,21,27,76,110,306,183,279
2018,21,32,"Duzce",40.8438,31.1565,8.82857142857143,20.5142857142857,1.03442857142857,85.9,NA,22.34,252,0,0,210,261,281,252,281
2018,22,32,"Duzce",40.8438,31.1565,9.51428571428571,19.0857142857143,2.79928571428571,83.3142857142857,NA,25.5833333333333,249,0,0,130,245,427,249,427
2018,23,32,"Duzce",40.8438,31.1565,8.37142857142857,23.0714285714286,0.00271428571428571,67.2,NA,35.8328571428571,267,0,0,97,298,812,267,812
2018,24,32,"Duzce",40.8438,31.1565,10.4285714285714,22.4,4.57028571428571,71.6,NA,29.43,267,0,0,157,232,448,267,448
2018,25,32,"Duzce",40.8438,31.1565,8.05714285714286,22.2285714285714,4.03357142857143,82.9571428571429,NA,26.4,358,0,0,271,361,518,358,518
2018,26,32,"Duzce",40.8438,31.1565,8.25714285714286,23.2571428571429,6.53742857142857,78.2285714285714,NA,22.5733333333333,355,6,11,61,86,587,349,576
2018,27,32,"Duzce",40.8438,31.1565,10.9428571428571,23.4142857142857,0,66.4571428571429,NA,22.7028571428571,342,0,0,211,254,418,342,418
2018,28,32,"Duzce",40.8438,31.1565,10.6571428571429,24.7,1.28657142857143,77.6714285714286,20.17,17.7528571428571,286,0,0,94,245,585,286,585
2018,29,32,"Duzce",40.8438,31.1565,8.31428571428571,23.5142857142857,6.05414285714286,77.7142857142857,26.81,23.2328571428571,260,29,17,104,388,756,231,739
2018,30,32,"Duzce",40.8438,31.1565,8.61428571428571,24.2142857142857,4.13985714285714,79.6714285714286,26.7057142857143,20.8871428571429,265,0,0,196,489,822,265,822
2018,31,32,"Duzce",40.8438,31.1565,10.0571428571429,23.8857142857143,0.130285714285714,81.2285714285714,31.0157142857143,19.8557142857143,267,0,0,82,131,499,267,499
2018,32,32,"Duzce",40.8438,31.1565,11.4428571428571,24.2142857142857,0.285428571428571,73.7428571428571,27.6857142857143,19.4657142857143,297,0,0,145,180,403,297,403
2018,33,32,"Duzce",40.8438,31.1565,9.91428571428571,24.1857142857143,0.286142857142857,73.8571428571429,31.2442857142857,20.7942857142857,216,0,0,121,176,332,216,332
2018,34,32,"Duzce",40.8438,31.1565,10.1714285714286,22.8714285714286,0,74.0714285714286,29.6371428571429,15.8971428571429,144,2,34,63,95,227,142,193
2018,35,32,"Duzce",40.8438,31.1565,10.6714285714286,24.8,1.487,78.4714285714286,29.8285714285714,17.8842857142857,201,0,0,98,136,314,201,314
2018,36,32,"Duzce",40.8438,31.1565,9.85714285714286,22.2428571428571,5.44942857142857,83.0285714285714,30.73,21.0357142857143,341,95,96,142,152,370,246,274
2018,37,32,"Duzce",40.8438,31.1565,7.84285714285714,18.2142857142857,5.62157142857143,85.2428571428571,28.9685714285714,21.7242857142857,241,21,44,113,120,419,220,375
2018,38,32,"Duzce",40.8438,31.1565,10,18.7428571428571,0.228571428571429,77.8142857142857,25.3328571428571,18.5985714285714,189,3,1,86,184,344,186,343
2018,39,32,"Duzce",40.8438,31.1565,9.91428571428571,18.0285714285714,0.316,76.6571428571429,24.5871428571429,19.1285714285714,180,4,5,94,177,353,176,348
2018,40,32,"Duzce",40.8438,31.1565,8.02857142857143,17.3857142857143,2.043,82.6714285714286,27.7928571428571,19.72,191,0,0,123,235,341,191,341
2018,41,32,"Duzce",40.8438,31.1565,6.97142857142857,16.3857142857143,0.357428571428571,86.3142857142857,32.6828571428571,20.0128571428571,187,12,57,53,41,422,175,365
2018,42,32,"Duzce",40.8438,31.1565,5.45714285714286,18.4,2.60114285714286,89.1285714285714,34.0328571428571,19.6,168,0,0,134,342,381,168,381
2018,43,32,"Duzce",40.8438,31.1565,9.38571428571429,13.5571428571429,5.36457142857143,79.1285714285714,39.0385714285714,21.0642857142857,187,30,74,52,72,402,157,328
2018,44,32,"Duzce",40.8438,31.1565,4.11428571428571,14,0,80.3714285714286,76.9057142857143,26.9385714285714,196,83,79,2,5,264,113,185
2018,45,32,"Duzce",40.8438,31.1565,5.77142857142857,13.9285714285714,0,83.9714285714286,49.1357142857143,21.7957142857143,231,77,166,97,204,473,154,307
2018,46,32,"Duzce",40.8438,31.1565,5.57142857142857,9.72857142857143,1.34357142857143,86.2571428571429,36.8514285714286,20.8785714285714,230,6,20,134,271,465,224,445
2018,47,32,"Duzce",40.8438,31.1565,7.48571428571429,11.2285714285714,1.116,87.2857142857143,37.308,19.068,270,68,53,86,224,499,202,446
2018,48,32,"Duzce",40.8438,31.1565,12.3714285714286,10.2857142857143,4.00014285714286,84.0571428571428,24.998,18.7,245,0,0,34,55,201,245,201
2018,49,32,"Duzce",40.8438,31.1565,8,7.15714285714286,4.45285714285714,84.2,66.4414285714286,22.4128571428571,257,1,1,89,235,420,256,419
2018,50,32,"Duzce",40.8438,31.1565,12.2571428571429,8.04285714285714,1.20028571428571,81.9,43.6228571428571,26.5271428571429,256,11,26,3,12,305,245,279
2018,51,32,"Duzce",40.8438,31.1565,5.77142857142857,7.15714285714286,1.03214285714286,92.8428571428571,38.3357142857143,19.7485714285714,250,2,0,56,43,248,248,248
2018,52,32,"Duzce",40.8438,31.1565,3.91428571428571,2.81428571428571,6.85571428571429,95.5285714285714,32.6271428571429,26.7885714285714,244,0,0,116,150,273,244,273
2019,1,32,"Duzce",40.8438,31.1565,4.8125,3.5125,2.652375,93.8625,40.38375,20.80375,343,26,14,109,130,784,317,770
2019,2,32,"Duzce",40.8438,31.1565,6.54285714285714,4.22857142857143,3.54014285714286,83.7714285714286,15.1828571428571,15.9714285714286,255,55,19,31,10,208,200,189
2019,3,32,"Duzce",40.8438,31.1565,7.42857142857143,5,5.99842857142857,82.4285714285714,40.0885714285714,29.69,192,46,43,18,16,198,146,155
2019,4,32,"Duzce",40.8438,31.1565,8.7,10.8142857142857,0.372,67.6,37.9885714285714,14.1914285714286,308,126,95,36,7,314,182,219
2019,5,32,"Duzce",40.8438,31.1565,6.65714285714286,11.9,0.714571428571429,63.4,68.1814285714286,14.2371428571429,253,64,22,88,35,143,189,121
2019,6,32,"Duzce",40.8438,31.1565,5.44285714285714,10.0714285714286,4.48285714285714,74.2857142857143,58.5871428571429,13.39,276,0,0,142,84,127,276,127
2019,7,32,"Duzce",40.8438,31.1565,7.42857142857143,9,1.43071428571429,71.2285714285714,30.6828571428571,8.72,325,0,0,205,82,234,325,234
2019,8,32,"Duzce",40.8438,31.1565,6.02857142857143,8.55714285714286,0.371857142857143,69.1428571428571,69.7528571428571,15.6314285714286,305,0,0,183,132,219,305,219
2019,9,32,"Duzce",40.8438,31.1565,7.68571428571429,5.32857142857143,2.36985714285714,79.6142857142857,36.8414285714286,12.6071428571429,331,0,0,117,129,310,331,310
2019,10,32,"Duzce",40.8438,31.1565,6.02857142857143,9.48571428571429,0.772,66.8857142857143,67.9871428571429,21.94,359,0,0,119,73,252,359,252
2019,11,32,"Duzce",40.8438,31.1565,8.34285714285714,9.2,3.68514285714286,74.3285714285714,36.1171428571429,15.7571428571429,373,0,0,150,194,400,373,400
2019,12,32,"Duzce",40.8438,31.1565,11.1857142857143,9.98571428571429,0,63.5285714285714,48.6085714285714,16.9028571428571,343,43,34,213,363,416,300,382
2019,13,32,"Duzce",40.8438,31.1565,12.9857142857143,6.72857142857143,0,63.6428571428571,43.2114285714286,15.12,256,7,6,164,167,194,249,188
2019,14,32,"Duzce",40.8438,31.1565,7.48571428571429,10.3,0.0285714285714286,71.4714285714286,51.0728571428571,16.3571428571429,365,0,0,189,100,208,365,208
2019,15,32,"Duzce",40.8438,31.1565,6.65714285714286,13.2285714285714,3.17185714285714,79.9428571428572,38.53,19.3728571428571,359,48,51,121,64,183,311,132
2019,16,32,"Duzce",40.8438,31.1565,7.11428571428571,7.8,6.07857142857143,83.1857142857143,20.6242857142857,12.07,318,0,0,91,44,208,318,208
2019,17,32,"Duzce",40.8438,31.1565,8.05714285714286,13.4714285714286,0.029,62.3571428571429,46.8271428571429,19.04,412,33,8,313,276,313,379,305
2019,18,32,"Duzce",40.8438,31.1565,10.4142857142857,17.7,5.109,63.4857142857143,46.9075,16.93,523,148,77,269,234,353,375,276
2019,19,32,"Duzce",40.8438,31.1565,8.88571428571429,15.0142857142857,4.59542857142857,72.7857142857143,NA,10.9914285714286,452,14,17,202,163,386,438,369
2019,20,32,"Duzce",40.8438,31.1565,8.55714285714286,19.3714285714286,2.60928571428571,69.9714285714286,50.864,12.8771428571429,454,0,0,407,343,389,454,389
2019,21,32,"Duzce",40.8438,31.1565,8.57142857142857,20.9857142857143,2.45714285714286,67.1428571428571,44.2957142857143,13.4728571428571,457,2,6,219,197,413,455,407
2019,22,32,"Duzce",40.8438,31.1565,8.77142857142857,22.8714285714286,0.858285714285714,66.3285714285714,56.0257142857143,14.8028571428571,453,0,0,282,231,323,453,323
2019,23,32,"Duzce",40.8438,31.1565,11.7,21.4714285714286,0.000571428571428571,73,42.7285714285714,7.31,378,0,0,116,74,532,378,532
2019,24,32,"Duzce",40.8438,31.1565,9.14285714285714,22.3,5.48914285714286,78.1142857142857,42.68,10.2171428571429,378,24,16,58,21,244,354,228
2019,25,32,"Duzce",40.8438,31.1565,7.74285714285714,22.7,9.19985714285714,79.0571428571428,43.8928571428571,13,306,0,0,30,54,325,306,325
2019,26,32,"Duzce",40.8438,31.1565,10.6714285714286,23.7142857142857,3.57,70.0571428571428,38.8457142857143,7.77714285714286,377,0,0,122,70,342,377,342
2019,27,32,"Duzce",40.8438,31.1565,9.9,23.4428571428571,0,69.4285714285714,41.1157142857143,8.31142857142857,456,0,0,151,105,222,456,222
2019,28,32,"Duzce",40.8438,31.1565,7.8,21.7857142857143,6.59385714285714,70.1571428571429,33.9528571428571,10.1671428571429,398,0,0,235,236,421,398,421
2019,29,32,"Duzce",40.8438,31.1565,9.85714285714286,21.3428571428571,4.51828571428571,76.2714285714286,32.3571428571429,7.985,453,0,0,277,140,203,453,203
2019,30,32,"Duzce",40.8438,31.1565,10.4285714285714,23.2428571428571,0.171428571428571,69.4571428571429,40.7028571428571,NA,456,0,0,295,201,335,456,335
2019,31,32,"Duzce",40.8438,31.1565,7.94285714285714,25.1142857142857,2.597,69.9142857142857,45.8975,16.59,334,0,0,260,305,375,334,375
2019,32,32,"Duzce",40.8438,31.1565,10.5714285714286,22.2142857142857,0.114285714285714,67.4428571428571,38.88,15.9057142857143,346,0,0,181,156,395,346,395
2019,33,32,"Duzce",40.8438,31.1565,8,21.4714285714286,6.08928571428571,82.0571428571429,39.8671428571429,11.0242857142857,337,51,69,155,300,531,286,462
2019,34,32,"Duzce",40.8438,31.1565,8.81428571428571,21.4571428571429,4.05814285714286,79.8142857142857,41.7871428571429,12.9742857142857,299,0,0,73,102,345,299,345
2019,35,32,"Duzce",40.8438,31.1565,10.4285714285714,21.6857142857143,0.0428571428571429,77.2,52.4785714285714,13.1757142857143,307,57,32,17,4,415,250,383
2019,36,32,"Duzce",40.8438,31.1565,10.1142857142857,20.2714285714286,0.0142857142857143,76.6142857142857,48.74,13.7642857142857,171,0,0,76,29,67,171,67
2019,37,32,"Duzce",40.8438,31.1565,11.4571428571429,19.3428571428571,0,77.3,44.56,14.5985714285714,218,0,0,39,19,55,218,55
2019,38,32,"Duzce",40.8438,31.1565,8,16.7857142857143,2.19785714285714,70.9142857142857,45.5085714285714,17.1985714285714,266,115,42,45,10,91,151,49
2019,39,32,"Duzce",40.8438,31.1565,5.77142857142857,16.5571428571429,0.499428571428571,78.5285714285714,50.7242857142857,18.1828571428571,237,126,41,33,9,79,111,38
2019,40,32,"Duzce",40.8438,31.1565,6.28571428571429,19.1285714285714,3.88485714285714,73.9,59.1571428571429,21.7614285714286,241,5,21,0,0,111,236,90
2019,41,32,"Duzce",40.8438,31.1565,5.82857142857143,15.7142857142857,1.88457142857143,84.4428571428572,45.1257142857143,16.8314285714286,416,48,97,214,144,448,368,351
2019,42,32,"Duzce",40.8438,31.1565,4.74285714285714,15.7571428571429,0.2,83.5571428571429,95.9142857142857,21.6014285714286,356,201,212,0,0,408,155,196
2019,43,32,"Duzce",40.8438,31.1565,7.48571428571429,15.2142857142857,0.171428571428571,80.4142857142857,69.7283333333333,18.0185714285714,306,42,22,65,127,300,264,278
2019,44,32,"Duzce",40.8438,31.1565,5.24285714285714,12.8857142857143,0.744285714285714,81.1714285714286,57.78,18.9628571428571,350,50,21,79,90,250,300,229
2019,45,32,"Duzce",40.8438,31.1565,4.82857142857143,15.3857142857143,0,70.3571428571429,144.921428571429,30.1557142857143,417,165,85,0,0,328,252,243
2019,46,32,"Duzce",40.8438,31.1565,3.34285714285714,14.2142857142857,0,74.1571428571429,189.515714285714,36.3333333333333,401,61,73,61,55,337,340,264
2019,47,32,"Duzce",40.8438,31.1565,5,9.18571428571429,0.0287142857142857,75.3428571428571,223.598571428571,35.435,391,334,285,0,0,339,57,54
2019,48,32,"Duzce",40.8438,31.1565,4.72857142857143,11.2857142857143,9.70485714285714,89.4571428571429,111.267142857143,24.3557142857143,320,36,14,0,0,251,284,237
2019,49,32,"Duzce",40.8438,31.1565,3.6,5.55714285714286,0.401571428571429,82.4857142857143,119.107142857143,23.3557142857143,393,8,16,161,91,274,385,258
2019,50,32,"Duzce",40.8438,31.1565,7.95714285714286,7.55714285714286,0.5,83.0428571428571,191.235714285714,29.4971428571429,218,144,86,39,6,119,74,33
2019,51,32,"Duzce",40.8438,31.1565,7.35714285714286,6.65714285714286,0,77.9571428571429,324.711428571429,37.2128571428571,361,266,281,0,0,488,95,207
2019,52,32,"Duzce",40.8438,31.1565,8.64285714285714,8.38571428571429,10.473,84.9,32.9328571428571,19.8042857142857,279,123,118,41,22,281,156,163
2020,1,32,"Duzce",40.8438,31.1565,3.96,3.54,3.4382,88.14,84.536,19.498,160,0,0,88,77,126,160,126
2020,2,32,"Duzce",40.8438,31.1565,4.47142857142857,3.75714285714286,2.71714285714286,89.7142857142857,129.951428571429,21.9114285714286,240,15,4,81,74,173,225,169
2020,3,32,"Duzce",40.8438,31.1565,5.24285714285714,5.18571428571429,0.0578571428571429,78.5857142857143,99.7428571428571,20.3142857142857,270,0,0,148,209,382,270,382
2020,4,32,"Duzce",40.8438,31.1565,7.61428571428571,1.85714285714286,2.656,84.2285714285714,67.162,37.6671428571429,358,62,85,167,163,295,296,210
2020,5,32,"Duzce",40.8438,31.1565,8.02857142857143,6.44285714285714,2.14428571428571,81.4714285714286,81.5216666666667,40.56,331,148,107,0,0,272,183,165
2020,6,32,"Duzce",40.8438,31.1565,12.3714285714286,5.57142857142857,8.45971428571429,80.0285714285714,31.27,25.5514285714286,343,69,77,52,12,267,274,190
2020,7,32,"Duzce",40.8438,31.1565,5.24285714285714,5.52857142857143,2.515,79,88.4057142857143,52.8528571428571,341,63,56,95,43,338,278,282
2020,8,32,"Duzce",40.8438,31.1565,6.81428571428571,5.25714285714286,2.84057142857143,79.1428571428571,63.6871428571429,22.3257142857143,283,107,86,161,85,187,176,101
2020,9,32,"Duzce",40.8438,31.1565,10.3285714285714,9.3,1.72971428571429,66.2428571428571,49.6285714285714,17.0885714285714,393,159,193,138,187,528,234,335
2020,10,32,"Duzce",40.8438,31.1565,5.25714285714286,14.0142857142857,0.171428571428571,58.9857142857143,72.8142857142857,17.9485714285714,205,53,56,25,28,210,152,154
2020,11,32,"Duzce",40.8438,31.1565,10.0857142857143,12.2,0.171571428571429,72.3428571428571,57.5728571428571,14.0642857142857,115,17,6,69,60,94,98,88
2020,12,32,"Duzce",40.8438,31.1565,9.2,5.62857142857143,3.256,76.1428571428571,44.2442857142857,7.91857142857143,117,0,0,57,57,118,117,118
2020,13,32,"Duzce",40.8438,31.1565,7.42857142857143,8.17142857142857,5.31571428571429,87.6,30.3071428571429,5.89142857142857,136,12,7,85,43,92,124,85
2020,14,32,"Duzce",40.8438,31.1565,11.2428571428571,8.65714285714286,1.90171428571429,83.9714285714286,64.69,10.2828571428571,155,22,19,3,4,121,133,102
2020,15,32,"Duzce",40.8438,31.1565,14.3285714285714,8.88571428571429,1.717,70.0571428571428,57.9,7.73142857142857,133,0,0,24,13,118,133,118
2020,16,32,"Duzce",40.8438,31.1565,11.7142857142857,12.3714285714286,1.34271428571429,65.1857142857143,77.1271428571429,12.3042857142857,141,41,30,6,21,106,100,76
2020,17,32,"Duzce",40.8438,31.1565,13.2571428571429,9.22857142857143,0.457857142857143,75.1,55.04,8.60714285714286,137,0,0,42,46,123,137,123
2020,18,32,"Duzce",40.8438,31.1565,8.17142857142857,13.1714285714286,0.600285714285714,71.3142857142857,71.5075,12.1928571428571,146,62,54,43,74,164,84,110
2020,19,32,"Duzce",40.8438,31.1565,8.38571428571429,11.5142857142857,3.64857142857143,79.7714285714286,41,8.05714285714286,137,0,0,47,51,157,137,157
2020,20,32,"Duzce",40.8438,31.1565,8.62857142857143,20.0857142857143,0.0142857142857143,66.0571428571429,78.8557142857143,13.2514285714286,164,73,87,44,55,164,91,77
2020,21,32,"Duzce",40.8438,31.1565,10.1,16.2428571428571,2.69957142857143,77,59.0985714285714,7.51428571428571,146,18,4,68,56,96,128,92
2020,22,32,"Duzce",40.8438,31.1565,7.55714285714286,12.4571428571429,3.50042857142857,84.3857142857143,31.4842857142857,6.32428571428571,118,18,14,53,52,100,100,86
2020,23,32,"Duzce",40.8438,31.1565,8.87142857142857,17.4571428571429,7.85157142857143,75.3285714285714,47.3257142857143,13.0128571428571,112,19,15,56,27,70,93,55
2020,24,32,"Duzce",40.8438,31.1565,8,21.4,1.57828571428571,73.2857142857143,56.66,14.0042857142857,140,39,21,26,14,150,101,129
2020,25,32,"Duzce",40.8438,31.1565,7.62857142857143,21.4285714285714,13.7175714285714,81.7571428571429,40.1285714285714,9.8,137,18,27,44,36,108,119,81
2020,26,32,"Duzce",40.8438,31.1565,8.82857142857143,22.3,2.146,76.1857142857143,35.3357142857143,8.14,173,0,0,104,78,133,173,133
2020,27,32,"Duzce",40.8438,31.1565,9.38571428571429,25.1714285714286,0,71.4714285714286,51,11.1928571428571,113,0,0,91,101,113,113,113
2020,28,32,"Duzce",40.8438,31.1565,8.05714285714286,23.4285714285714,1.68257142857143,76.8714285714286,42.5742857142857,10.5371428571429,164,0,0,135,88,122,164,122
2020,29,32,"Duzce",40.8438,31.1565,7.61428571428571,20.7,1.37042857142857,81.8714285714286,36.2742857142857,9.30571428571429,186,0,0,146,71,111,186,111
2020,30,32,"Duzce",40.8438,31.1565,8.57142857142857,22.6714285714286,0.0285714285714286,74.6,49.6885714285714,10.2242857142857,190,0,0,72,51,142,190,142
2020,31,32,"Duzce",40.8438,31.1565,10.4714285714286,23.0857142857143,0,71.3142857142857,45.9128571428571,10.95,150,0,0,65,72,127,150,127
2020,32,32,"Duzce",40.8438,31.1565,9.12857142857143,23.6714285714286,0,71,51.2285714285714,11.9314285714286,146,59,66,59,22,107,87,41
2020,33,32,"Duzce",40.8438,31.1565,10.6714285714286,24.3,0,66.2,41.1442857142857,11.9971428571429,183,0,0,106,39,83,183,83
2020,34,32,"Duzce",40.8438,31.1565,7.98571428571429,23.9857142857143,0,65.7,42.8971428571429,14.9171428571429,197,0,0,116,68,97,197,97
2020,35,32,"Duzce",40.8438,31.1565,7.52857142857143,22.9428571428571,0.0571428571428571,67.3857142857143,47.2785714285714,18.9428571428571,164,57,55,43,47,157,107,102
2020,36,32,"Duzce",40.8438,31.1565,5.71428571428571,22.4142857142857,0.628,75.1571428571429,46.27,19.3328571428571,179,96,46,39,25,112,83,66
2020,37,32,"Duzce",40.8438,31.1565,7.8,22.1,0.856285714285714,77.1142857142857,45.2885714285714,18.59,193,0,0,3,2,91,193,91
2020,38,32,"Duzce",40.8438,31.1565,7.11428571428571,21.5714285714286,0.142714285714286,75.8714285714286,41.7228571428571,17.6228571428571,235,38,21,100,71,157,197,136
2020,39,32,"Duzce",40.8438,31.1565,6.92857142857143,20.6285714285714,0.2,68.3428571428571,50.31,26.7485714285714,220,146,54,40,23,129,74,75
2020,40,32,"Duzce",40.8438,31.1565,6.34285714285714,17.9142857142857,2.144,72.5428571428571,48.23,35.4514285714286,187,144,134,23,12,154,43,20
2020,41,32,"Duzce",40.8438,31.1565,7.4,19.4714285714286,3.147,71.0142857142857,73.5416666666667,29.6433333333333,182,151,106,0,0,127,31,21
2020,42,32,"Duzce",40.8438,31.1565,4.52857142857143,18.4142857142857,0.800428571428571,76.9714285714286,73.6483333333333,28.0566666666667,177,68,60,18,12,111,109,51
2020,43,32,"Duzce",40.8438,31.1565,5.7,14.5857142857143,1.11528571428571,87.8142857142857,154.372857142857,20.2685714285714,194,140,120,20,16,161,54,41
2020,44,32,"Duzce",40.8438,31.1565,7.51428571428571,13.9285714285714,3.397,86.2428571428571,65.5742857142857,23.9971428571429,255,155,165,0,0,233,100,68
2020,45,32,"Duzce",40.8438,31.1565,5.28571428571429,9.9,0.757857142857143,85.8,79.9485714285714,27.7957142857143,156,73,50,56,34,103,83,53
2020,46,32,"Duzce",40.8438,31.1565,3.91428571428571,9.9,0.942714285714286,85.9428571428571,107.581428571429,23.7628571428571,208,134,90,0,0,109,74,19
2020,47,32,"Duzce",40.8438,31.1565,4.98571428571429,6.45714285714286,0.1,85.5285714285714,123.282857142857,24.9714285714286,173,113,58,0,0,83,60,25
2020,48,32,"Duzce",40.8438,31.1565,7.31428571428571,4.44285714285714,0,78.0142857142857,173.516666666667,32.64,199,180,253,0,0,262,19,9
2020,49,32,"Duzce",40.8438,31.1565,5.32857142857143,5.6,0.044,81.8,183.316666666667,35.33,207,206,116,0,0,116,1,0
2020,50,32,"Duzce",40.8438,31.1565,10.7428571428571,9.58571428571429,0.342428571428571,73.0142857142857,158.174285714286,33.6771428571429,181,181,98,0,0,98,0,0
2020,51,32,"Duzce",40.8438,31.1565,5.97142857142857,8.62857142857143,2.37157142857143,86.7142857142857,52.2614285714286,18.8771428571429,171,67,36,59,28,90,104,54
2020,52,32,"Duzce",40.8438,31.1565,8.28571428571428,6.12857142857143,0.342857142857143,79.9,112.525714285714,21.6342857142857,203,146,85,53,23,113,57,28
2020,53,32,"Duzce",40.8438,31.1565,10.55,9.625,0.15,67.375,150.6925,31.57,122,122,111,0,0,111,0,0
2017,1,33,"Edirne",41.6772,26.5558,11.4285714285714,-3.52857142857143,3.20228571428571,90.5857142857143,64.9428571428571,NA,563,79,72,399,595,847,484,775
2017,2,33,"Edirne",41.6772,26.5558,13.2571428571429,-2.92857142857143,4.91414285714286,88.5,60.9971428571429,NA,757,196,276,538,901,1214,561,938
2017,3,33,"Edirne",41.6772,26.5558,12.7285714285714,-0.357142857142857,3.34228571428571,89.5857142857143,37.7257142857143,NA,762,0,0,726,1403,1449,762,1449
2017,4,33,"Edirne",41.6772,26.5558,12.9285714285714,0.185714285714286,0,75.4714285714286,56.4371428571429,NA,639,0,0,498,668,889,639,889
2017,5,33,"Edirne",41.6772,26.5558,9.94285714285714,3.38571428571429,0.257142857142857,81.1571428571429,81.3942857142857,NA,588,376,593,8,32,1163,212,570
2017,6,33,"Edirne",41.6772,26.5558,17.9428571428571,4.58571428571429,0.543428571428571,81.6,44.18,NA,736,245,370,207,686,1519,491,1149
2017,7,33,"Edirne",41.6772,26.5558,13.8428571428571,3.17142857142857,2.28557142857143,66.1285714285714,49.7728571428571,NA,492,209,226,126,232,717,283,491
2017,8,33,"Edirne",41.6772,26.5558,15.1285714285714,9.84285714285714,1.78742857142857,73.1285714285714,46.2657142857143,NA,739,171,382,118,263,1747,568,1365
2017,9,33,"Edirne",41.6772,26.5558,13.5142857142857,10.1,0.600571428571429,74.3714285714286,62.2142857142857,NA,574,458,741,77,82,866,116,125
2017,10,33,"Edirne",41.6772,26.5558,18.0142857142857,10.8142857142857,2.87,75.5714285714286,40.1271428571429,NA,712,231,267,262,511,1043,481,776
2017,11,33,"Edirne",41.6772,26.5558,14.4142857142857,8.15714285714286,2.25657142857143,74.1285714285714,43.34,NA,525,94,90,363,498,725,431,635
2017,12,33,"Edirne",41.6772,26.5558,12.2714285714286,13.2142857142857,0.856714285714286,58,44.9914285714286,NA,589,0,0,56,84,1077,589,1077
2017,13,33,"Edirne",41.6772,26.5558,13.9571428571429,11.2571428571429,0.428714285714286,53.1714285714286,43.3171428571429,NA,574,99,144,89,150,887,475,743
2017,14,33,"Edirne",41.6772,26.5558,13.1857142857143,11.9428571428571,0.658,62.6857142857143,42.72,NA,639,276,647,182,337,1336,363,689
2017,15,33,"Edirne",41.6772,26.5558,12.4142857142857,15.0714285714286,0.0857142857142857,49.1714285714286,38.7885714285714,NA,587,336,757,85,118,1187,251,430
2017,16,33,"Edirne",41.6772,26.5558,14.6285714285714,9.78571428571429,8.172,71.7857142857143,31.4325,NA,717,99,75,504,655,920,618,845
2017,17,33,"Edirne",41.6772,26.5558,13.1,16.4285714285714,0.485714285714286,48.1142857142857,NA,NA,731,565,1121,97,111,1478,166,357
2017,18,33,"Edirne",41.6772,26.5558,14.7714285714286,19.1285714285714,0.229571428571429,52.8714285714286,44.252,NA,506,100,153,121,245,923,406,770
2017,19,33,"Edirne",41.6772,26.5558,11.9714285714286,18.1714285714286,3.29914285714286,70.9857142857143,34.7485714285714,NA,471,188,462,81,163,966,283,504
2017,20,33,"Edirne",41.6772,26.5558,16.1,18.2142857142857,0.200428571428571,48.9428571428571,24.1814285714286,NA,472,0,0,0,0,1205,472,1205
2017,21,33,"Edirne",41.6772,26.5558,12.6714285714286,18.2,5.42585714285714,63.7714285714286,24.4171428571429,NA,448,118,216,86,111,849,330,633
2017,22,33,"Edirne",41.6772,26.5558,11.6428571428571,22.0714285714286,8.45285714285714,65.6857142857143,41.4714285714286,NA,522,109,132,146,229,1015,413,883
2017,23,33,"Edirne",41.6772,26.5558,12.5142857142857,21.7,1.856,64.7142857142857,31.5566666666667,NA,578,102,299,222,544,1388,476,1089
2017,24,33,"Edirne",41.6772,26.5558,12.5142857142857,22.7714285714286,0.885857142857143,54.1285714285714,33.2728571428571,NA,552,72,119,290,640,1139,480,1020
2017,25,33,"Edirne",41.6772,26.5558,12.7428571428571,24.9571428571429,2.68414285714286,56.9142857142857,37.5671428571429,NA,584,137,289,194,299,1041,447,752
2017,26,33,"Edirne",41.6772,26.5558,11.8,29.4714285714286,0.000142857142857143,45.3714285714286,45.4085714285714,NA,564,462,770,0,0,971,102,201
2017,27,33,"Edirne",41.6772,26.5558,14.9285714285714,24.6714285714286,1.43028571428571,50.1428571428571,32.0885714285714,NA,511,65,50,170,282,642,446,592
2017,28,33,"Edirne",41.6772,26.5558,14.9857142857143,26.7571428571429,3.19785714285714,47.9,30.1928571428571,NA,481,108,197,0,0,864,373,667
2017,29,33,"Edirne",41.6772,26.5558,14.1,24.3857142857143,6.599,49.3714285714286,31.2185714285714,NA,532,65,134,103,296,1272,467,1138
2017,30,33,"Edirne",41.6772,26.5558,15.4571428571429,26.1714285714286,0.0714285714285714,50.1142857142857,42.535,NA,531,206,458,200,246,928,325,470
2017,31,33,"Edirne",41.6772,26.5558,14.4142857142857,29.0142857142857,0,40.1428571428571,38.0385714285714,NA,559,0,0,3,1,1047,559,1047
2017,32,33,"Edirne",41.6772,26.5558,15.8,29.6285714285714,0,42.4571428571429,42.7314285714286,NA,567,1,0,92,228,1092,566,1092
2017,33,33,"Edirne",41.6772,26.5558,16.5142857142857,27.8,0,38.6285714285714,37.7528571428571,NA,596,0,0,268,615,1199,596,1199
2017,34,33,"Edirne",41.6772,26.5558,12.2,22.9142857142857,0.871571428571429,55.0714285714286,29.0128571428571,NA,601,0,0,252,622,1280,601,1280
2017,35,33,"Edirne",41.6772,26.5558,12.8142857142857,22.7142857142857,0.285571428571429,53.7428571428571,26.0257142857143,NA,493,177,390,90,129,1014,316,624
2017,36,33,"Edirne",41.6772,26.5558,14.5714285714286,23.2571428571429,0.3,44.8142857142857,40.8214285714286,NA,507,303,829,204,492,1321,204,492
2017,37,33,"Edirne",41.6772,26.5558,11.9571428571429,25.3,0,50.7857142857143,46.49,NA,589,290,494,0,0,1138,299,644
2017,38,33,"Edirne",41.6772,26.5558,14.6571428571429,21.9142857142857,0.771285714285714,54.0285714285714,43.96,NA,671,282,467,389,845,1312,389,845
2017,39,33,"Edirne",41.6772,26.5558,19.4857142857143,15.8285714285714,7.84028571428571,74.1,25.1228571428571,NA,782,0,0,178,380,1630,782,1630
2017,40,33,"Edirne",41.6772,26.5558,14.3142857142857,14.7714285714286,9.196,72.7714285714286,46.7771428571429,NA,543,239,566,97,180,1137,304,571
2017,41,33,"Edirne",41.6772,26.5558,7.47142857142857,14.7571428571429,0,66.6857142857143,72.1971428571429,NA,487,0,0,399,727,843,487,843
2017,42,33,"Edirne",41.6772,26.5558,7.85714285714286,16.3285714285714,0,63.6571428571429,93.23,NA,530,4,3,280,494,815,526,812
2017,43,33,"Edirne",41.6772,26.5558,16.6857142857143,11.8142857142857,12.8974285714286,81.3142857142857,52.4571428571429,NA,506,212,211,181,473,919,294,708
2017,44,33,"Edirne",41.6772,26.5558,11.6714285714286,8.71428571428572,0.0285714285714286,64.8857142857143,57.5571428571429,NA,561,94,223,395,770,1102,467,879
2017,45,33,"Edirne",41.6772,26.5558,9.31428571428571,11.3571428571429,1.43,82.4,73.52,NA,577,250,455,124,136,829,327,374
2017,46,33,"Edirne",41.6772,26.5558,12.1428571428571,12.9428571428571,3.14357142857143,84.5857142857143,46.8314285714286,NA,587,89,172,155,265,1085,498,913
2017,47,33,"Edirne",41.6772,26.5558,11.2142857142857,7.85714285714286,1.61442857142857,82.1571428571429,62.2214285714286,NA,418,124,323,190,302,804,294,481
2017,48,33,"Edirne",41.6772,26.5558,23.4142857142857,12.1285714285714,5.898,79.9285714285714,42.5742857142857,NA,386,286,463,68,118,619,100,156
2017,49,33,"Edirne",41.6772,26.5558,15.7428571428571,7.58571428571429,1.631,72.7,47.98,NA,407,107,78,251,474,645,300,567
2017,50,33,"Edirne",41.6772,26.5558,15.0142857142857,9.88571428571429,8.12742857142857,82.3857142857143,62.22,NA,346,269,329,0,0,442,77,113
2017,51,33,"Edirne",41.6772,26.5558,15,1.71428571428571,2.31357142857143,80.1857142857143,40.3057142857143,NA,386,0,0,291,299,349,386,349
2017,52,33,"Edirne",41.6772,26.5558,14.2875,6.2125,5.912125,85.9375,52.7485714285714,NA,528,286,264,174,203,507,242,243
2018,1,33,"Edirne",41.6772,26.5558,10.425,5.8,0.050375,84.7375,64.6,12.75,618,286,405,122,170,914,332,509
2018,2,33,"Edirne",41.6772,26.5558,14.7857142857143,6.28571428571429,1.87085714285714,87.6,32.4628571428571,NA,624,89,192,202,743,1309,535,1117
2018,3,33,"Edirne",41.6772,26.5558,17.7428571428571,4.67142857142857,4.059,81.3428571428571,45.9985714285714,NA,639,349,426,238,185,655,290,229
2018,4,33,"Edirne",41.6772,26.5558,14.1857142857143,1.52857142857143,1.14471428571429,70,43.78,NA,604,0,0,542,692,764,604,764
2018,5,33,"Edirne",41.6772,26.5558,17.5428571428571,8.61428571428571,3.51242857142857,78.4428571428571,65.3485714285714,NA,670,207,383,0,0,819,463,436
2018,6,33,"Edirne",41.6772,26.5558,13.4857142857143,6.37142857142857,5.94257142857143,83.3714285714286,61.9628571428571,NA,704,244,395,120,158,1022,460,627
2018,7,33,"Edirne",41.6772,26.5558,13.5857142857143,5.9,3.27028571428571,77.0714285714286,42.37,NA,478,225,272,155,164,557,253,285
2018,8,33,"Edirne",41.6772,26.5558,13.7857142857143,5.51428571428571,2.442,82.6857142857143,33.2366666666667,NA,711,0,0,13,19,1321,711,1321
2018,9,33,"Edirne",41.6772,26.5558,19.0857142857143,1.58571428571429,5.00014285714286,82.9142857142857,63.6,NA,621,97,158,138,159,956,524,798
2018,10,33,"Edirne",41.6772,26.5558,12.7142857142857,10.2714285714286,2.35728571428571,77.0428571428571,50.3671428571429,NA,556,178,338,129,299,1330,378,992
2018,11,33,"Edirne",41.6772,26.5558,17.6714285714286,13.3142857142857,4.299,75.6714285714286,41.2785714285714,NA,551,378,1143,0,0,1426,173,283
2018,12,33,"Edirne",41.6772,26.5558,17.2857142857143,6.44285714285714,5.91828571428571,83.8285714285714,29.8285714285714,NA,425,74,228,158,589,1187,351,959
2018,13,33,"Edirne",41.6772,26.5558,16.2285714285714,10.8428571428571,7.88542857142857,78.3285714285714,45.4914285714286,NA,356,180,201,61,85,428,176,227
2018,14,33,"Edirne",41.6772,26.5558,15.2571428571429,14.6285714285714,0,53.7,41.3114285714286,NA,407,172,131,122,107,486,235,355
2018,15,33,"Edirne",41.6772,26.5558,12.0571428571429,16.6,0,62.8428571428571,49.875,NA,374,198,174,48,159,450,176,276
2018,16,33,"Edirne",41.6772,26.5558,13.6285714285714,16.3,0.0428571428571429,55.6571428571429,38.525,NA,411,71,91,146,239,648,340,557
2018,17,33,"Edirne",41.6772,26.5558,12.2571428571429,20.2714285714286,0.428285714285714,55.8714285714286,47.9828571428571,NA,419,178,394,26,36,652,241,258
2018,18,33,"Edirne",41.6772,26.5558,10.3571428571429,19.2714285714286,0,63.1285714285714,42.7071428571429,NA,303,53,95,61,30,474,250,379
2018,19,33,"Edirne",41.6772,26.5558,12.6714285714286,18.8142857142857,1.57414285714286,66.8,40.8628571428571,NA,275,0,0,198,380,467,275,467
2018,20,33,"Edirne",41.6772,26.5558,13.3,21.6714285714286,1.57142857142857,60.4428571428571,40.9042857142857,NA,204,154,261,43,44,306,50,45
2018,21,33,"Edirne",41.6772,26.5558,14.9714285714286,21.4142857142857,0.199857142857143,64.2428571428571,33.3342857142857,NA,252,0,0,80,99,281,252,281
2018,22,33,"Edirne",41.6772,26.5558,14.9714285714286,22.2285714285714,0.1,49.7857142857143,39.3414285714286,NA,249,0,0,40,96,427,249,427
2018,23,33,"Edirne",41.6772,26.5558,13.0285714285714,23.7285714285714,5.31785714285714,65.4285714285714,44.6985714285714,NA,267,76,217,41,109,812,191,595
2018,24,33,"Edirne",41.6772,26.5558,13.7428571428571,23.9428571428571,1.71685714285714,57.6285714285714,37.62,NA,267,125,178,62,183,448,142,270
2018,25,33,"Edirne",41.6772,26.5558,13.6571428571429,23.4285714285714,0.800428571428572,58.1142857142857,37.7042857142857,NA,358,0,0,100,123,518,358,518
2018,26,33,"Edirne",41.6772,26.5558,11.6857142857143,21.7,6.142,73.7285714285714,32.46,NA,355,60,86,37,65,587,295,501
2018,27,33,"Edirne",41.6772,26.5558,10.0571428571429,25.1428571428571,4.02842857142857,66.1,41.7971428571429,NA,342,172,187,50,103,418,170,231
2018,28,33,"Edirne",41.6772,26.5558,10.4571428571429,25.7428571428571,2.24142857142857,61.9285714285714,37.2628571428571,NA,286,0,0,240,450,585,286,585
2018,29,33,"Edirne",41.6772,26.5558,11.9571428571429,25.9,2.29885714285714,60.0428571428571,45.1542857142857,NA,260,19,7,228,598,756,241,749
2018,30,33,"Edirne",41.6772,26.5558,9.94285714285714,24.2,4.05971428571429,75.6142857142857,44.1566666666667,NA,265,39,59,214,763,822,226,763
2018,31,33,"Edirne",41.6772,26.5558,13.2285714285714,26.5857142857143,0.742714285714286,65.7142857142857,38.7857142857143,NA,267,0,0,121,360,499,267,499
2018,32,33,"Edirne",41.6772,26.5558,13.2571428571429,26.0571428571429,0,54.1428571428571,32.0928571428571,NA,297,0,0,37,77,403,297,403
2018,33,33,"Edirne",41.6772,26.5558,12.6142857142857,26.6285714285714,0,53.5714285714286,36.8257142857143,NA,216,0,0,38,93,332,216,332
2018,34,33,"Edirne",41.6772,26.5558,13.2285714285714,25.8,0,55.1142857142857,36.4928571428571,NA,144,32,40,20,37,227,112,187
2018,35,33,"Edirne",41.6772,26.5558,13.5428571428571,27.2285714285714,0.0287142857142857,48.2,41.81,NA,201,0,0,114,179,314,201,314
2018,36,33,"Edirne",41.6772,26.5558,12.2,24.2714285714286,0.186142857142857,60.8714285714286,48.5628571428571,NA,341,0,0,280,278,370,341,370
2018,37,33,"Edirne",41.6772,26.5558,12.9857142857143,22.2571428571429,1.45642857142857,60.6428571428571,42.1528571428571,NA,241,0,0,203,366,419,241,419
2018,38,33,"Edirne",41.6772,26.5558,13.8285714285714,21.5428571428571,0,60.9857142857143,40.9285714285714,NA,189,7,12,33,61,344,182,332
2018,39,33,"Edirne",41.6772,26.5558,21.3428571428571,15.9857142857143,2.17114285714286,59.0428571428571,41.4942857142857,NA,180,27,53,79,122,353,153,300
2018,40,33,"Edirne",41.6772,26.5558,11.8285714285714,16.9428571428571,4.52785714285714,70.5714285714286,36.7871428571429,NA,191,26,38,68,121,341,165,303
2018,41,33,"Edirne",41.6772,26.5558,15.3857142857143,16.5,0.0857142857142857,67.3,39.69,NA,187,0,0,143,327,422,187,422
2018,42,33,"Edirne",41.6772,26.5558,11.2,15.9857142857143,0.242714285714286,77.9857142857143,56.9357142857143,NA,168,0,0,165,367,381,168,381
2018,43,33,"Edirne",41.6772,26.5558,16.9857142857143,13.7,0,64.1285714285714,54.0314285714286,27.858,187,52,75,68,115,402,135,327
2018,44,33,"Edirne",41.6772,26.5558,10.1571428571429,16.4428571428571,0,73.8428571428571,50.6414285714286,15.0371428571429,196,87,116,76,99,264,109,148
2018,45,33,"Edirne",41.6772,26.5558,10.1428571428571,12.8714285714286,0.142714285714286,73.2,35.515,12.4633333333333,231,0,0,180,363,473,231,473
2018,46,33,"Edirne",41.6772,26.5558,14.7714285714286,8.62857142857143,0.914285714285714,72.3571428571429,28.83,20.135,230,0,0,158,244,465,230,465
2018,47,33,"Edirne",41.6772,26.5558,14.3142857142857,7.42857142857143,4.25685714285714,80.4142857142857,41.6057142857143,25.2285714285714,270,50,195,107,195,499,220,304
2018,48,33,"Edirne",41.6772,26.5558,18.8428571428571,4.47142857142857,18.8178571428571,78.0571428571429,45.64,23.5242857142857,245,70,20,129,128,201,175,181
2018,49,33,"Edirne",41.6772,26.5558,12.6714285714286,3.91428571428571,1.10085714285714,78.4,56.0614285714286,23.1071428571429,257,30,31,203,285,420,227,389
2018,50,33,"Edirne",41.6772,26.5558,12.6571428571429,5.47142857142857,0.300857142857143,79,78.8514285714286,17.35,256,70,39,102,126,305,186,266
2018,51,33,"Edirne",41.6772,26.5558,14.3571428571429,3.2,2.08514285714286,82.4714285714286,38.44,12.1628571428571,250,58,43,96,108,248,192,205
2018,52,33,"Edirne",41.6772,26.5558,11.5,4.25714285714286,0.571714285714286,73.1571428571429,60.65,16.3957142857143,244,45,63,149,176,273,199,210
2019,1,33,"Edirne",41.6772,26.5558,21.5875,1.45,0.400375,74.9625,38.53625,13.07375,343,0,0,278,665,784,343,784
2019,2,33,"Edirne",41.6772,26.5558,17.0571428571429,0.928571428571429,5.40685714285714,77.8142857142857,53.56,16.0942857142857,255,73,61,150,142,208,182,147
2019,3,33,"Edirne",41.6772,26.5558,11.7428571428571,4.4,0.2,76.8,68.4942857142857,15.6185714285714,192,103,123,54,45,198,89,75
2019,4,33,"Edirne",41.6772,26.5558,18.3285714285714,7.7,0.93,81.2571428571429,47.0557142857143,9.24142857142857,308,163,162,100,87,314,145,152
2019,5,33,"Edirne",41.6772,26.5558,16.3142857142857,10.4,2.38542857142857,79.7714285714286,49.5871428571429,8.92714285714286,253,217,127,0,0,143,36,16
2019,6,33,"Edirne",41.6772,26.5558,15.7714285714286,6.34285714285714,1.14257142857143,75.4,46.8271428571429,9.57,276,79,32,91,25,127,197,95
2019,7,33,"Edirne",41.6772,26.5558,18.8714285714286,5.97142857142857,1.08642857142857,70.0285714285714,38.3557142857143,10.3957142857143,325,27,102,194,81,234,298,132
2019,8,33,"Edirne",41.6772,26.5558,15.4857142857143,4.85714285714286,0.571428571428572,68.0857142857143,76.0671428571429,11.8914285714286,305,128,58,76,94,219,177,161
2019,9,33,"Edirne",41.6772,26.5558,13.9571428571429,5.67142857142857,0.0581428571428571,67.0142857142857,48.6828571428571,22.0285714285714,331,10,6,198,165,310,321,304
2019,10,33,"Edirne",41.6772,26.5558,13.7714285714286,11.2714285714286,0.0428571428571429,70.3,54.02,18.4042857142857,359,307,208,52,44,252,52,44
2019,11,33,"Edirne",41.6772,26.5558,14.6857142857143,9.61428571428571,0.343571428571429,68.2571428571429,44.7914285714286,17.0442857142857,373,189,185,27,25,400,184,215
2019,12,33,"Edirne",41.6772,26.5558,14.2857142857143,12.1857142857143,0.0285714285714286,61.4714285714286,45.8542857142857,13.6857142857143,343,88,301,11,8,416,255,115
2019,13,33,"Edirne",41.6772,26.5558,15.7714285714286,9.91428571428571,0,54.0714285714286,44.1642857142857,13.3842857142857,256,46,35,0,0,194,210,159
2019,14,33,"Edirne",41.6772,26.5558,13.7428571428571,10.8,0.0857142857142857,59.0714285714286,45.1428571428571,15.9714285714286,365,102,81,10,8,208,263,127
2019,15,33,"Edirne",41.6772,26.5558,13.3857142857143,13.3142857142857,7.37057142857143,80.2571428571429,34.8128571428571,14.69,359,207,80,49,23,183,152,103
2019,16,33,"Edirne",41.6772,26.5558,12.2571428571429,10.7142857142857,0.742857142857143,65.8285714285714,35.0042857142857,15.9528571428571,318,0,0,186,108,208,318,208
2019,17,33,"Edirne",41.6772,26.5558,11.9428571428571,16.0285714285714,0.114285714285714,58.2714285714286,48.3771428571429,15.84,412,410,313,0,0,313,2,0
2019,18,33,"Edirne",41.6772,26.5558,16.9,17.3428571428571,2.056,66.2142857142857,45.6228571428571,12.4242857142857,523,382,272,0,0,353,141,81
2019,19,33,"Edirne",41.6772,26.5558,13.8,15.7857142857143,3.45871428571429,67.5857142857143,42.14,12.4314285714286,452,226,188,168,171,386,226,198
2019,20,33,"Edirne",41.6772,26.5558,11.9,19.2,0.315571428571429,70.3428571428571,38.6214285714286,11.0985714285714,454,193,133,98,106,389,261,256
2019,21,33,"Edirne",41.6772,26.5558,12.4142857142857,20.5285714285714,1.17157142857143,64.3,42.3242857142857,12.0814285714286,457,176,205,137,61,413,281,208
2019,22,33,"Edirne",41.6772,26.5558,14.1714285714286,22.6857142857143,2.859,65.3142857142857,48.01,12.2525,453,281,147,113,115,323,172,176
2019,23,33,"Edirne",41.6772,26.5558,10.9857142857143,22.6714285714286,0.885285714285714,68.9714285714286,NA,NA,378,197,173,112,206,532,181,359
2019,24,33,"Edirne",41.6772,26.5558,14.8857142857143,25.4857142857143,1.09942857142857,65.2428571428571,35.985,12.33,378,0,0,369,238,244,378,244
2019,25,33,"Edirne",41.6772,26.5558,12.1,26.4285714285714,0.00171428571428571,59.1142857142857,42.1985714285714,15.1928571428571,306,0,0,174,179,325,306,325
2019,26,33,"Edirne",41.6772,26.5558,16.0142857142857,26.4571428571429,0.0285714285714286,58.0428571428571,38.42,12.5,377,40,30,235,146,342,337,312
2019,27,33,"Edirne",41.6772,26.5558,11.5428571428571,27.3,0,52.3571428571429,41.8871428571429,18.61,456,79,25,143,46,222,377,197
2019,28,33,"Edirne",41.6772,26.5558,12.6142857142857,23.3142857142857,3.51371428571429,63.0285714285714,38.415,16.455,398,62,57,161,217,421,336,364
2019,29,33,"Edirne",41.6772,26.5558,11.9571428571429,24.3428571428571,0.0285714285714286,58.5,33.5971428571429,12.5157142857143,453,56,22,123,46,203,397,181
2019,30,33,"Edirne",41.6772,26.5558,13.7,26,1.80242857142857,53.8142857142857,37.8785714285714,16.1642857142857,456,148,139,125,84,335,308,196
2019,31,33,"Edirne",41.6772,26.5558,11.7,27.3285714285714,0.260571428571429,60.0285714285714,37.4185714285714,16.5957142857143,334,84,94,182,206,375,250,281
2019,32,33,"Edirne",41.6772,26.5558,11.8857142857143,26.7,0,50.8714285714286,31.36,16.8685714285714,346,99,85,50,38,395,247,310
2019,33,33,"Edirne",41.6772,26.5558,12.8571428571429,26,6.04042857142857,60.1,32.3014285714286,9.715,337,0,0,204,371,531,337,531
2019,34,33,"Edirne",41.6772,26.5558,13.4857142857143,27.1857142857143,0,51.8857142857143,39.8514285714286,11.9885714285714,299,0,0,54,42,345,299,345
2019,35,33,"Edirne",41.6772,26.5558,13.6285714285714,25.6285714285714,0,54.1571428571429,42.0085714285714,8.82142857142857,307,0,0,16,7,415,307,415
2019,36,33,"Edirne",41.6772,26.5558,12.9714285714286,24.1714285714286,0,57.4714285714286,41.3814285714286,10.0371428571429,171,0,0,0,0,67,171,67
2019,37,33,"Edirne",41.6772,26.5558,14.3857142857143,23.0714285714286,0,55.4857142857143,42.3157142857143,9.10571428571428,218,0,0,6,0,55,218,55
2019,38,33,"Edirne",41.6772,26.5558,14.5142857142857,19.6,1.07185714285714,57.2714285714286,49.4485714285714,15.4542857142857,266,87,41,38,5,91,179,50
2019,39,33,"Edirne",41.6772,26.5558,10.1,19.5571428571429,0.771428571428571,66.9571428571429,47.7466666666667,17.645,237,174,63,50,14,79,63,16
2019,40,33,"Edirne",41.6772,26.5558,14.1714285714286,20.5,2.54857142857143,66.5571428571429,42.7614285714286,14.4157142857143,241,167,73,58,20,111,74,38
2019,41,33,"Edirne",41.6772,26.5558,10.4857142857143,15.9571428571429,0.971428571428571,73.5571428571429,36.8314285714286,15.5914285714286,416,138,129,70,98,448,278,319
2019,42,33,"Edirne",41.6772,26.5558,8.15714285714286,15.9714285714286,0,78.3285714285714,75.0128571428571,25.2128571428571,356,79,78,162,260,408,277,330
2019,43,33,"Edirne",41.6772,26.5558,8.44285714285714,15.5714285714286,0,73.5285714285714,64.5814285714286,22.7357142857143,306,0,0,171,149,300,306,300
2019,44,33,"Edirne",41.6772,26.5558,12.5571428571429,11.7428571428571,0.114285714285714,75.5428571428571,57.1842857142857,16.77,350,90,63,117,94,250,260,187
2019,45,33,"Edirne",41.6772,26.5558,15.2285714285714,18.5571428571429,0.428428571428571,76.1142857142857,50.8885714285714,11.9114285714286,417,364,306,0,0,328,53,22
2019,46,33,"Edirne",41.6772,26.5558,9.47142857142857,14.9,0.715285714285714,82,64.4914285714286,19.1385714285714,401,273,205,45,32,337,128,132
2019,47,33,"Edirne",41.6772,26.5558,11.7285714285714,12.5428571428571,1.25671428571429,83.4857142857143,45.5714285714286,15.3257142857143,391,47,25,70,88,339,344,314
2019,48,33,"Edirne",41.6772,26.5558,15.3285714285714,10.5428571428571,3.79971428571429,81.4857142857143,46.1314285714286,16.9242857142857,320,34,14,95,127,251,286,237
2019,49,33,"Edirne",41.6772,26.5558,10.2142857142857,3.75714285714286,3.39857142857143,81.0285714285714,64.1457142857143,20.9628571428571,393,0,0,160,71,274,393,274
2019,50,33,"Edirne",41.6772,26.5558,9.77142857142857,8.95714285714286,0.257142857142857,81.5428571428571,70.8285714285714,25.1628571428571,218,50,11,20,18,119,168,108
2019,51,33,"Edirne",41.6772,26.5558,15,9.2,0.4,88.1,55.6642857142857,20.7957142857143,361,345,471,0,0,488,16,17
2019,52,33,"Edirne",41.6772,26.5558,16.3,7.4,0.829571428571428,73.5714285714286,45.4871428571429,21.2585714285714,279,47,64,227,213,281,232,217
2020,1,33,"Edirne",41.6772,26.5558,14.18,3.2,2e-04,69.14,60.46,29.952,160,0,0,151,120,126,160,126
2020,2,33,"Edirne",41.6772,26.5558,17.5857142857143,2.65714285714286,0.000285714285714286,67.5142857142857,59.4742857142857,26.5314285714286,240,0,0,98,105,173,240,173
2020,3,33,"Edirne",41.6772,26.5558,11.3714285714286,2.78571428571429,0,82.8857142857143,56.1971428571429,22.5885714285714,270,0,0,242,366,382,270,382
2020,4,33,"Edirne",41.6772,26.5558,9.82857142857143,2.35714285714286,0,74.2,67.0014285714286,28.8228571428571,358,57,84,156,85,295,301,211
2020,5,33,"Edirne",41.6772,26.5558,10.8857142857143,8.77142857142857,1.34528571428571,75.6714285714286,50.3357142857143,24.5828571428571,331,173,136,76,91,272,158,136
2020,6,33,"Edirne",41.6772,26.5558,18.5285714285714,4.98571428571429,3.78514285714286,74.3285714285714,36.3142857142857,20.5871428571429,343,104,64,71,69,267,239,203
2020,7,33,"Edirne",41.6772,26.5558,11.8857142857143,7.22857142857143,0.271714285714286,71.8285714285714,50.2928571428571,27.0314285714286,341,88,138,88,44,338,253,200
2020,8,33,"Edirne",41.6772,26.5558,11.7285714285714,6.51428571428571,0.0572857142857143,73.1714285714286,67.19,29.5542857142857,283,55,40,83,36,187,228,147
2020,9,33,"Edirne",41.6772,26.5558,18.1571428571429,9.24285714285714,1.00242857142857,68.6857142857143,54.1971428571429,20.68,393,163,154,99,150,528,230,374
2020,10,33,"Edirne",41.6772,26.5558,15.0428571428571,13.7142857142857,0.371142857142857,72.9,52.3614285714286,17.9,205,145,164,0,0,210,60,46
2020,11,33,"Edirne",41.6772,26.5558,13.4714285714286,12.2142857142857,2.48571428571429,71.2571428571429,52.6942857142857,22.4585714285714,115,0,0,21,8,94,115,94
2020,12,33,"Edirne",41.6772,26.5558,12.5,8.14285714285714,0.0285714285714286,63.5714285714286,48.1185714285714,22.0714285714286,117,10,5,30,15,118,107,113
2020,13,33,"Edirne",41.6772,26.5558,15.7428571428571,8.65714285714286,2.52728571428571,74.7714285714286,70.8742857142857,11.7542857142857,136,0,0,35,25,92,136,92
2020,14,33,"Edirne",41.6772,26.5558,17.5285714285714,8.38571428571429,8.59728571428571,73.6,35.3457142857143,12.4628571428571,155,24,20,15,17,121,131,101
2020,15,33,"Edirne",41.6772,26.5558,16.9285714285714,12.4571428571429,0.0142857142857143,52.8285714285714,41.3371428571429,10.5271428571429,133,11,4,31,13,118,122,114
2020,16,33,"Edirne",41.6772,26.5558,13.4428571428571,13.2285714285714,2.08614285714286,64.1571428571429,38.7885714285714,10.0642857142857,141,86,52,43,45,106,55,54
2020,17,33,"Edirne",41.6772,26.5558,13.9571428571429,12.5857142857143,3.45542857142857,55.4571428571429,33.84,9.54571428571429,137,12,13,1,1,123,125,110
2020,18,33,"Edirne",41.6772,26.5558,13.9857142857143,17.3142857142857,4.08414285714286,67.6285714285714,40.3728571428571,10.1642857142857,146,38,75,23,18,164,108,89
2020,19,33,"Edirne",41.6772,26.5558,14.5142857142857,15.5857142857143,3.77385714285714,66.6,34.4314285714286,11.1657142857143,137,37,80,84,72,157,100,77
2020,20,33,"Edirne",41.6772,26.5558,13.0571428571429,22.3142857142857,0,60.3,61.1757142857143,11.0828571428571,164,96,70,0,0,164,68,94
2020,21,33,"Edirne",41.6772,26.5558,15.0571428571429,19.8285714285714,0.314285714285714,60.1857142857143,44.7242857142857,10.53,146,9,2,15,9,96,137,94
2020,22,33,"Edirne",41.6772,26.5558,13.9285714285714,16.4142857142857,4.05614285714286,71.5285714285714,28.3957142857143,9.14142857142857,118,0,0,70,61,100,118,100
2020,23,33,"Edirne",41.6772,26.5558,14.0285714285714,19.7285714285714,1.38542857142857,65.7857142857143,40.9342857142857,12.8071428571429,112,43,29,35,15,70,69,41
2020,24,33,"Edirne",41.6772,26.5558,8.5,22.9285714285714,2.12771428571429,67.8714285714286,46.9842857142857,14.0485714285714,140,23,12,72,44,150,117,138
2020,25,33,"Edirne",41.6772,26.5558,9.68571428571429,22.9,2.72071428571429,72.7428571428571,44.2385714285714,14.8428571428571,137,0,0,113,98,108,137,108
2020,26,33,"Edirne",41.6772,26.5558,12.4571428571429,24,0.715142857142857,66.1571428571429,40.3657142857143,11.8757142857143,173,34,40,75,52,133,139,93
2020,27,33,"Edirne",41.6772,26.5558,11.0142857142857,28.5714285714286,0.0142857142857143,55.6,38.2566666666667,9.34666666666667,113,0,0,33,52,113,113,113
2020,28,33,"Edirne",41.6772,26.5558,15,26.1285714285714,0.157142857142857,57.0714285714286,55.4885714285714,6.76714285714286,164,0,0,58,53,122,164,122
2020,29,33,"Edirne",41.6772,26.5558,15.0857142857143,24.6428571428571,0,49.4,66.4957142857143,8.99857142857143,186,53,32,11,12,111,133,79
2020,30,33,"Edirne",41.6772,26.5558,12.2142857142857,27.0857142857143,0,53.9714285714286,66.4,7.37142857142857,190,0,0,21,14,142,190,142
2020,31,33,"Edirne",41.6772,26.5558,11.8142857142857,29.0142857142857,0.0142857142857143,47.7857142857143,78.8214285714286,11.3928571428571,150,23,22,50,63,127,127,105
2020,32,33,"Edirne",41.6772,26.5558,16,27.1857142857143,0,56.2857142857143,80.5257142857143,5.51428571428571,146,0,0,2,3,107,146,107
2020,33,33,"Edirne",41.6772,26.5558,13.6428571428571,26.6714285714286,0.142714285714286,52.6714285714286,83.0414285714286,10.43,183,50,23,4,1,83,133,60
2020,34,33,"Edirne",41.6772,26.5558,11.9428571428571,25.9857142857143,0.0577142857142857,56.6857142857143,80.7142857142857,11.8471428571429,197,25,7,69,34,97,172,90
2020,35,33,"Edirne",41.6772,26.5558,10.9714285714286,27.0428571428571,0,55.1857142857143,76.1985714285714,12.97,164,27,37,26,33,157,137,120
2020,36,33,"Edirne",41.6772,26.5558,12.3,26.0285714285714,0,52.9285714285714,77.5842857142857,11.9042857142857,179,51,17,80,65,112,128,95
2020,37,33,"Edirne",41.6772,26.5558,12.1428571428571,25.4428571428571,0,56.8285714285714,78.1614285714286,8.14428571428572,193,0,0,21,13,91,193,91
2020,38,33,"Edirne",41.6772,26.5558,15.4142857142857,23.2142857142857,0.000142857142857143,56.1571428571429,78.7142857142857,6.70857142857143,235,0,0,21,28,157,235,157
2020,39,33,"Edirne",41.6772,26.5558,12.3571428571429,21.9,0.557142857142857,64.7428571428571,87.0357142857143,9.74857142857143,220,116,37,0,0,129,104,92
2020,40,33,"Edirne",41.6772,26.5558,11.1428571428571,19.9857142857143,0.158285714285714,64,87.4557142857143,13.0428571428571,187,110,92,20,8,154,77,62
2020,41,33,"Edirne",41.6772,26.5558,9.02857142857143,20.7428571428571,7.34214285714286,71.1285714285714,112.504285714286,15.0928571428571,182,137,103,31,17,127,45,24
2020,42,33,"Edirne",41.6772,26.5558,12.3714285714286,18.5428571428571,1.11385714285714,73.4285714285714,111.978571428571,13.48,177,137,62,18,16,111,40,49
2020,43,33,"Edirne",41.6772,26.5558,10.9142857142857,15.3,0.0142857142857143,69.2857142857143,160.092857142857,17.2957142857143,194,4,2,100,109,161,190,159
2020,44,33,"Edirne",41.6772,26.5558,12.9285714285714,14.5,1.05928571428571,75.7285714285714,124.982857142857,16.6242857142857,255,0,0,141,128,233,255,233
2020,45,33,"Edirne",41.6772,26.5558,9.64285714285714,12.1,0,72.1428571428571,87.7685714285714,11.0228571428571,156,17,8,71,48,103,139,95
2020,46,33,"Edirne",41.6772,26.5558,7.92857142857143,11.8857142857143,0.114142857142857,74.9714285714286,79.82,11.1414285714286,208,0,0,156,91,109,208,109
2020,47,33,"Edirne",41.6772,26.5558,13.9857142857143,8.58571428571429,0.143,75.2428571428571,91.1371428571429,11.4471428571429,173,0,0,89,63,83,173,83
2020,48,33,"Edirne",41.6772,26.5558,8.9,5.4,0.142714285714286,70.9571428571429,158.736666666667,15.44,199,0,0,130,163,262,199,262
2020,49,33,"Edirne",41.6772,26.5558,6.28571428571429,5.04285714285714,0.342714285714286,78.9142857142857,129.58,10.33,207,0,0,176,88,116,207,116
2020,50,33,"Edirne",41.6772,26.5558,10.9428571428571,10.6428571428571,4.85614285714286,81.0571428571429,63.6714285714286,9.19714285714286,181,98,76,55,16,98,83,22
2020,51,33,"Edirne",41.6772,26.5558,9.21428571428572,6.48571428571429,4.59728571428571,81.7428571428571,67.2328571428571,8.15142857142857,171,0,0,163,88,90,171,90
2020,52,33,"Edirne",41.6772,26.5558,7.27142857142857,8.62857142857143,0.314714285714286,82.4285714285714,93.32,9.65142857142857,203,112,73,55,24,113,91,40
2020,53,33,"Edirne",41.6772,26.5558,16.15,13.425,5.24975,79.25,79.2375,10.5975,122,122,111,0,0,111,0,0
2017,1,34,"Elazig",38.6753,39.22,18.8714285714286,1.6,0.232714285714286,79.5571428571429,53.9128571428571,NA,563,363,566,81,136,847,200,281
2017,2,34,"Elazig",38.6753,39.22,17.8142857142857,-0.471428571428571,0.256571428571429,74.7428571428571,77.6728571428571,NA,757,180,267,349,468,1214,577,947
2017,3,34,"Elazig",38.6753,39.22,13.2,-0.742857142857143,0,71.8142857142857,67.1571428571429,NA,762,0,0,677,1166,1449,762,1449
2017,4,34,"Elazig",38.6753,39.22,19.4714285714286,-1.58571428571429,1.10457142857143,69.7571428571429,38.0885714285714,NA,639,190,259,417,522,889,449,630
2017,5,34,"Elazig",38.6753,39.22,19.7,-4.01428571428571,0.263714285714286,69.9428571428572,37.47,NA,588,334,716,212,428,1163,254,447
2017,6,34,"Elazig",38.6753,39.22,15.1285714285714,0.657142857142857,0,74.9,59.51,NA,736,549,1193,88,163,1519,187,326
2017,7,34,"Elazig",38.6753,39.22,19.8857142857143,-2.22857142857143,0,48.9285714285714,36.1014285714286,NA,492,127,112,272,479,717,365,605
2017,8,34,"Elazig",38.6753,39.22,15.2,2.45714285714286,0.306857142857143,58.1571428571429,66.6085714285714,NA,739,433,1022,133,315,1747,306,725
2017,9,34,"Elazig",38.6753,39.22,14.1714285714286,6.65714285714286,2.84814285714286,70.1714285714286,65.85,NA,574,418,657,86,154,866,156,209
2017,10,34,"Elazig",38.6753,39.22,18.8857142857143,8.62857142857143,0.156285714285714,63.0571428571429,57.2185714285714,NA,712,543,859,93,113,1043,169,184
2017,11,34,"Elazig",38.6753,39.22,20.9714285714286,5.65714285714286,2.35671428571429,74.4857142857143,27.378,NA,525,105,112,193,403,725,420,613
2017,12,34,"Elazig",38.6753,39.22,24.5857142857143,6.62857142857143,0.0581428571428571,58.7142857142857,34.5516666666667,NA,589,106,121,244,540,1077,483,956
2017,13,34,"Elazig",38.6753,39.22,20.3142857142857,10.4571428571429,1.106,59.1,33.5885714285714,NA,574,122,148,347,604,887,452,739
2017,14,34,"Elazig",38.6753,39.22,22.8,8.98571428571429,1.048,64.3571428571429,38.57,NA,639,223,488,167,387,1336,416,848
2017,15,34,"Elazig",38.6753,39.22,22.6285714285714,9.98571428571429,3.91185714285714,67.3142857142857,39.1466666666667,NA,587,209,377,361,762,1187,378,810
2017,16,34,"Elazig",38.6753,39.22,25.7,14.3857142857143,1.45171428571429,63.0428571428571,61.1285714285714,NA,717,226,467,76,95,920,491,453
2017,17,34,"Elazig",38.6753,39.22,22.8142857142857,13.2428571428571,0,44.2857142857143,44.2885714285714,NA,731,2,1,489,745,1478,729,1477
2017,18,34,"Elazig",38.6753,39.22,17.8857142857143,15.1428571428571,3.03771428571429,70.4428571428571,53.3328571428571,NA,506,98,175,195,336,923,408,748
2017,19,34,"Elazig",38.6753,39.22,23.0285714285714,18.0285714285714,0.0995714285714286,55.5428571428571,75.3157142857143,NA,471,1,0,316,685,966,470,966
2017,20,34,"Elazig",38.6753,39.22,24.5428571428571,17.7,1.01242857142857,53.4714285714286,47.01,NA,472,0,0,341,901,1205,472,1205
2017,21,34,"Elazig",38.6753,39.22,22.5428571428571,15.9428571428571,2.83142857142857,62.6,43.516,NA,448,92,241,233,445,849,356,608
2017,22,34,"Elazig",38.6753,39.22,20.9714285714286,19.1285714285714,0.151142857142857,47.6142857142857,38.8783333333333,NA,522,0,0,362,673,1015,522,1015
2017,23,34,"Elazig",38.6753,39.22,22.9142857142857,24.1571428571429,0.000857142857142857,37.6714285714286,58.3928571428571,NA,578,69,161,286,709,1388,509,1227
2017,24,34,"Elazig",38.6753,39.22,24.6571428571429,22.4428571428571,0.142857142857143,38.2428571428571,37.9128571428571,NA,552,62,111,269,655,1139,490,1028
2017,25,34,"Elazig",38.6753,39.22,20.3857142857143,23.1142857142857,0.0277142857142857,37.7428571428571,30.7942857142857,NA,584,0,0,532,936,1041,584,1041
2017,26,34,"Elazig",38.6753,39.22,20.7142857142857,28.9142857142857,0,26.9,42.0742857142857,NA,564,10,3,305,584,971,554,968
2017,27,34,"Elazig",38.6753,39.22,22.8142857142857,28.3714285714286,0,28.7857142857143,71.78,NA,511,16,76,295,345,642,495,566
2017,28,34,"Elazig",38.6753,39.22,21.8428571428571,28.7142857142857,0,22.1714285714286,47.16,NA,481,0,0,423,724,864,481,864
2017,29,34,"Elazig",38.6753,39.22,21.8142857142857,30.3428571428571,0,22.4285714285714,68.8185714285714,NA,532,0,0,355,786,1272,532,1272
2017,30,34,"Elazig",38.6753,39.22,21.2571428571429,28.8714285714286,0,26.1285714285714,68.2483333333333,NA,531,9,9,411,702,928,522,919
2017,31,34,"Elazig",38.6753,39.22,18.8142857142857,29.2714285714286,0,21.9428571428571,87.2033333333333,NA,559,0,0,211,319,1047,559,1047
2017,32,34,"Elazig",38.6753,39.22,22.7142857142857,29.6,0,21.3428571428571,86.46,NA,567,2,48,302,560,1092,565,1044
2017,33,34,"Elazig",38.6753,39.22,17.4857142857143,28.4857142857143,0.037,27.5857142857143,60.7414285714286,NA,596,79,195,281,564,1199,517,1004
2017,34,34,"Elazig",38.6753,39.22,18.5,27.9714285714286,0,28.0428571428571,54.6628571428571,NA,601,0,0,504,807,1280,601,1280
2017,35,34,"Elazig",38.6753,39.22,20.3857142857143,26.1571428571429,0,28.1285714285714,60.2257142857143,NA,493,0,0,301,470,1014,493,1014
2017,36,34,"Elazig",38.6753,39.22,18.3285714285714,24.1,0,24.7714285714286,71.9542857142857,NA,507,0,0,340,851,1321,507,1321
2017,37,34,"Elazig",38.6753,39.22,14.4142857142857,24.6714285714286,0,21.8142857142857,93.1785714285714,NA,589,0,0,452,732,1138,589,1138
2017,38,34,"Elazig",38.6753,39.22,15.9857142857143,23.7571428571429,0,28.7714285714286,106.46,NA,671,107,258,270,372,1312,564,1054
2017,39,34,"Elazig",38.6753,39.22,18.9571428571429,20.4142857142857,0.152,39.9142857142857,71.1328571428571,NA,782,0,0,693,1442,1630,782,1630
2017,40,34,"Elazig",38.6753,39.22,20.2428571428571,14.9285714285714,0,39.0285714285714,31.47,NA,543,0,0,423,741,1137,543,1137
2017,41,34,"Elazig",38.6753,39.22,19.1428571428571,14.2428571428571,0.299428571428571,51.1571428571429,44.055,NA,487,83,58,303,677,843,404,785
2017,42,34,"Elazig",38.6753,39.22,19.5285714285714,12.9571428571429,0,39.8285714285714,54.0528571428571,NA,530,0,0,504,770,815,530,815
2017,43,34,"Elazig",38.6753,39.22,19.3857142857143,14.4571428571429,0.0628571428571429,45.4142857142857,74.518,NA,506,143,414,124,195,919,363,505
2017,44,34,"Elazig",38.6753,39.22,16.8857142857143,9.77142857142857,0.799142857142857,60.4285714285714,47.2242857142857,NA,561,94,224,399,742,1102,467,878
2017,45,34,"Elazig",38.6753,39.22,13.5428571428571,9.82857142857143,0.132571428571429,69.9714285714286,96.6585714285714,NA,577,88,102,385,402,829,489,727
2017,46,34,"Elazig",38.6753,39.22,13.7,8.64285714285714,0.0207142857142857,59.5857142857143,95.6114285714286,NA,587,80,171,362,655,1085,507,914
2017,47,34,"Elazig",38.6753,39.22,22.2428571428571,4.8,1.25714285714286,71.7,39.166,NA,418,74,108,264,519,804,344,696
2017,48,34,"Elazig",38.6753,39.22,14.8142857142857,4.35714285714286,0.536428571428571,84.8857142857143,54.6242857142857,NA,386,89,166,228,292,619,297,453
2017,49,34,"Elazig",38.6753,39.22,18.6285714285714,2.27142857142857,0.33,77.3285714285714,51.5785714285714,NA,407,0,0,350,477,645,407,645
2017,50,34,"Elazig",38.6753,39.22,11.6714285714286,0.885714285714286,0.00414285714285714,88.3142857142857,83.7742857142857,NA,346,0,0,301,322,442,346,442
2017,51,34,"Elazig",38.6753,39.22,19.2142857142857,6.9,1.35528571428571,84.2285714285714,94.6085714285714,NA,386,154,172,108,57,349,232,177
2017,52,34,"Elazig",38.6753,39.22,16.0875,3.925,0.129125,77.925,98.96875,NA,528,55,137,282,226,507,473,370
2018,1,34,"Elazig",38.6753,39.22,17.55,3.9375,0.289,79.575,36.6133333333333,NA,618,214,287,381,567,914,404,627
2018,2,34,"Elazig",38.6753,39.22,15.0714285714286,2.64285714285714,0.133428571428571,74.9714285714286,71.3571428571429,NA,624,188,230,354,981,1309,436,1079
2018,3,34,"Elazig",38.6753,39.22,21.9142857142857,3.24285714285714,5.18942857142857,79.9714285714286,41.8371428571429,NA,639,235,249,274,194,655,404,406
2018,4,34,"Elazig",38.6753,39.22,20.2857142857143,4.95714285714286,1.69357142857143,81.8571428571429,62.8716666666667,NA,604,282,362,217,222,764,322,402
2018,5,34,"Elazig",38.6753,39.22,15.2142857142857,1.71428571428571,0,72.9142857142857,63.3928571428571,NA,670,5,13,583,633,819,665,806
2018,6,34,"Elazig",38.6753,39.22,14.7571428571429,4.71428571428571,0,68.0571428571428,112.168571428571,NA,704,4,12,611,946,1022,700,1010
2018,7,34,"Elazig",38.6753,39.22,22.7428571428571,7.42857142857143,5.14071428571429,70.6428571428571,61.5571428571429,NA,478,179,243,70,65,557,299,314
2018,8,34,"Elazig",38.6753,39.22,17.2428571428571,6.2,0.365142857142857,79.5285714285714,64.1575,NA,711,89,101,440,704,1321,622,1220
2018,9,34,"Elazig",38.6753,39.22,19.6571428571429,6.8,0.487857142857143,75.5857142857143,48.9714285714286,NA,621,171,241,291,471,956,450,715
2018,10,34,"Elazig",38.6753,39.22,24.1285714285714,8.85714285714286,1.19657142857143,72.5428571428571,71.6914285714286,NA,556,8,10,292,899,1330,548,1320
2018,11,34,"Elazig",38.6753,39.22,22.8142857142857,10.4285714285714,0.698571428571429,60.8285714285714,47.224,NA,551,65,124,337,1006,1426,486,1302
2018,12,34,"Elazig",38.6753,39.22,26.0714285714286,14.2142857142857,0.0151428571428571,49.8857142857143,114.275,NA,425,6,204,86,294,1187,419,983
2018,13,34,"Elazig",38.6753,39.22,23.1,12.3857142857143,1.31842857142857,57.8428571428571,80.04,NA,356,48,119,67,64,428,308,309
2018,14,34,"Elazig",38.6753,39.22,24.1714285714286,11.8428571428571,0,44.4142857142857,40.3125,NA,407,0,0,299,390,486,407,486
2018,15,34,"Elazig",38.6753,39.22,22.3571428571429,15,1.46171428571429,56.2285714285714,38.522,NA,374,44,22,275,333,450,330,428
2018,16,34,"Elazig",38.6753,39.22,22.8571428571429,14.4714285714286,0.042,39.5,52.645,NA,411,0,0,281,434,648,411,648
2018,17,34,"Elazig",38.6753,39.22,22.0714285714286,17.2428571428571,0.557428571428571,46.4285714285714,NA,NA,419,83,88,109,179,652,336,564
2018,18,34,"Elazig",38.6753,39.22,23.1285714285714,16.3,1.84142857142857,73.0857142857143,46.33,NA,303,89,128,57,61,474,214,346
2018,19,34,"Elazig",38.6753,39.22,15.1857142857143,14.2571428571429,6.03357142857143,81.8428571428571,39.2557142857143,NA,275,111,237,57,45,467,164,230
2018,20,34,"Elazig",38.6753,39.22,26.2142857142857,18.5857142857143,1.24471428571429,64.8,38.0557142857143,NA,204,35,54,121,150,306,169,252
2018,21,34,"Elazig",38.6753,39.22,21.8714285714286,20.5857142857143,0.17,60.4142857142857,78.605,NA,252,11,25,104,116,281,241,256
2018,22,34,"Elazig",38.6753,39.22,29.6428571428571,18.2857142857143,1.90242857142857,71.8285714285714,43.2285714285714,NA,249,2,0,120,164,427,247,427
2018,23,34,"Elazig",38.6753,39.22,23.6714285714286,21.9428571428571,0.197571428571429,53.0714285714286,41.6071428571429,NA,267,14,91,169,404,812,253,721
2018,24,34,"Elazig",38.6753,39.22,27.4857142857143,23.1428571428571,0.989714285714286,53.4285714285714,50.06,NA,267,8,18,125,82,448,259,430
2018,25,34,"Elazig",38.6753,39.22,23.0571428571429,24.1,1.54542857142857,47.5714285714286,33.0557142857143,NA,358,0,0,345,478,518,358,518
2018,26,34,"Elazig",38.6753,39.22,17.8,28.3857142857143,0.000857142857142857,32.5142857142857,53.9371428571429,NA,355,5,2,198,293,587,350,585
2018,27,34,"Elazig",38.6753,39.22,23.9142857142857,28.7428571428571,0,31.6142857142857,47.1942857142857,NA,342,0,0,306,405,418,342,418
2018,28,34,"Elazig",38.6753,39.22,22.0857142857143,29.6142857142857,0.046,30.3714285714286,65.9914285714286,NA,286,92,203,108,187,585,194,382
2018,29,34,"Elazig",38.6753,39.22,28.1857142857143,27.7285714285714,0,29.4714285714286,35.3571428571429,NA,260,0,0,195,674,756,260,756
2018,30,34,"Elazig",38.6753,39.22,17.9,28.5857142857143,0,26.7571428571429,69.9033333333333,NA,265,50,90,145,553,822,215,732
2018,31,34,"Elazig",38.6753,39.22,22.6142857142857,29.9857142857143,0,31.8714285714286,NA,NA,267,4,3,114,191,499,263,496
2018,32,34,"Elazig",38.6753,39.22,23.8428571428571,28.2571428571429,0.002,31.2428571428571,39.028,NA,297,0,0,155,227,403,297,403
2018,33,34,"Elazig",38.6753,39.22,22.0857142857143,28.2,0,25,39.0457142857143,NA,216,0,0,184,314,332,216,332
2018,34,34,"Elazig",38.6753,39.22,17.2,28.6714285714286,0,27.7142857142857,45.2857142857143,NA,144,0,0,105,175,227,144,227
2018,35,34,"Elazig",38.6753,39.22,19.1714285714286,27.9142857142857,0,27.4142857142857,66.865,NA,201,2,0,134,250,314,199,314
2018,36,34,"Elazig",38.6753,39.22,21.8,25.3857142857143,0.0314285714285714,35.0714285714286,62.514,NA,341,0,0,286,274,370,341,370
2018,37,34,"Elazig",38.6753,39.22,24.9571428571429,22.1857142857143,0.0884285714285714,44.8142857142857,60.89,NA,241,55,150,135,192,419,186,269
2018,38,34,"Elazig",38.6753,39.22,17.3571428571429,22.8571428571429,0.0277142857142857,30.5714285714286,53.7428571428571,NA,189,0,0,149,284,344,189,344
2018,39,34,"Elazig",38.6753,39.22,15.3,21.8714285714286,0,31.2142857142857,60.924,NA,180,0,0,126,131,353,180,353
2018,40,34,"Elazig",38.6753,39.22,19.4285714285714,20.0285714285714,0,36,53.2175,NA,191,1,0,112,207,341,190,341
2018,41,34,"Elazig",38.6753,39.22,19.9285714285714,17.7142857142857,0.117285714285714,58.6285714285714,89.1414285714286,NA,187,15,82,70,73,422,172,340
2018,42,34,"Elazig",38.6753,39.22,17.2857142857143,17.7714285714286,0.519571428571429,57.7428571428571,158.355714285714,NA,168,44,60,68,62,381,124,321
2018,43,34,"Elazig",38.6753,39.22,23.5571428571429,13.2,3.81414285714286,72.6142857142857,56.818,NA,187,10,66,66,147,402,177,336
2018,44,34,"Elazig",38.6753,39.22,13.9714285714286,11.7857142857143,0.0694285714285714,66.4285714285714,64.975,NA,196,28,51,106,103,264,168,213
2018,45,34,"Elazig",38.6753,39.22,12.1285714285714,10.0142857142857,0.723,77.8857142857143,61.4766666666667,NA,231,8,22,160,234,473,223,451
2018,46,34,"Elazig",38.6753,39.22,15.8,5.64285714285714,3.07757142857143,76.9857142857143,50.7933333333333,NA,230,0,0,180,326,465,230,465
2018,47,34,"Elazig",38.6753,39.22,11.8857142857143,7,0.224571428571429,88.0714285714286,82.96,NA,270,24,13,198,296,499,246,486
2018,48,34,"Elazig",38.6753,39.22,18.7142857142857,8.38571428571429,4.46257142857143,86.0142857142857,49.7433333333333,NA,245,170,165,29,5,201,75,36
2018,49,34,"Elazig",38.6753,39.22,15.7285714285714,6.91428571428571,1.64157142857143,87.5142857142857,50.1825,NA,257,107,203,52,34,420,150,217
2018,50,34,"Elazig",38.6753,39.22,18.4714285714286,5.78571428571429,0.838428571428571,81.1857142857143,44.5314285714286,NA,256,64,99,127,134,305,192,206
2018,51,34,"Elazig",38.6753,39.22,14.5,5.2,4.88114285714286,90.2428571428571,51.2557142857143,NA,250,95,117,116,84,248,155,131
2018,52,34,"Elazig",38.6753,39.22,22.0571428571429,1.55714285714286,12.1871428571429,83.4428571428571,40.3375,NA,244,97,127,80,63,273,147,146
2019,1,34,"Elazig",38.6753,39.22,21.9,4.025,0.770375,83.2,51.05,NA,343,122,426,114,112,784,221,358
2019,2,34,"Elazig",38.6753,39.22,18.3714285714286,-0.557142857142857,2.11142857142857,79.7285714285714,39.14,NA,255,107,52,119,75,208,148,156
2019,3,34,"Elazig",38.6753,39.22,22.9142857142857,0.428571428571428,1.77042857142857,78.8714285714286,60.3257142857143,NA,192,18,23,64,67,198,174,175
2019,4,34,"Elazig",38.6753,39.22,17.0714285714286,3.28571428571429,0.0467142857142857,75.9,138.616,NA,308,153,243,46,21,314,155,71
2019,5,34,"Elazig",38.6753,39.22,19.9571428571429,4.1,0.352714285714286,74.5428571428571,72.9642857142857,NA,253,98,36,141,85,143,155,107
2019,6,34,"Elazig",38.6753,39.22,16.5571428571429,2.38571428571429,1.99785714285714,82.7142857142857,73.59,NA,276,94,43,119,28,127,182,84
2019,7,34,"Elazig",38.6753,39.22,15.0142857142857,3.4,0.755714285714286,81.1,NA,NA,325,170,95,150,123,234,155,139
2019,8,34,"Elazig",38.6753,39.22,17.3857142857143,4.18571428571429,0.0927142857142857,68.4285714285714,73.62,NA,305,156,105,86,88,219,149,114
2019,9,34,"Elazig",38.6753,39.22,17.3285714285714,3.25714285714286,2.224,77.7857142857143,37.345,NA,331,119,127,153,69,310,212,183
2019,10,34,"Elazig",38.6753,39.22,15.5857142857143,5.82857142857143,0.0615714285714286,67.0142857142857,49.3514285714286,NA,359,100,33,206,134,252,259,219
2019,11,34,"Elazig",38.6753,39.22,25.6857142857143,7.81428571428571,5.90171428571429,74.4857142857143,52.44,NA,373,268,321,16,28,400,105,79
2019,12,34,"Elazig",38.6753,39.22,22.3571428571429,6.67142857142857,0.308142857142857,58.4285714285714,45.8871428571429,NA,343,95,299,61,43,416,248,117
2019,13,34,"Elazig",38.6753,39.22,20,7.04285714285714,5.36414285714286,86.5428571428571,36.5728571428571,NA,256,139,77,71,57,194,117,117
2019,14,34,"Elazig",38.6753,39.22,15.4857142857143,9.1,2.481,82.1285714285714,39.4814285714286,NA,365,250,146,86,29,208,115,62
2019,15,34,"Elazig",38.6753,39.22,21.1,11.7571428571429,4.55628571428571,74.0428571428571,39.53,NA,359,111,62,83,43,183,248,121
2019,16,34,"Elazig",38.6753,39.22,25.7571428571429,8.81428571428571,8.89742857142857,80.4428571428571,29.0616666666667,NA,318,73,78,45,44,208,245,130
2019,17,34,"Elazig",38.6753,39.22,17.0285714285714,10.6,0.202285714285714,64.5142857142857,38.7057142857143,NA,412,49,15,236,147,313,363,298
2019,18,34,"Elazig",38.6753,39.22,18.5714285714286,13.5428571428571,2.16142857142857,79.1714285714286,55.7914285714286,NA,523,340,262,3,10,353,183,91
2019,19,34,"Elazig",38.6753,39.22,20.7571428571429,15.3571428571429,0.917571428571428,66.5714285714286,41.7114285714286,NA,452,223,216,41,13,386,229,170
2019,20,34,"Elazig",38.6753,39.22,16.3571428571429,19.0714285714286,0,56.5285714285714,68.8671428571429,NA,454,65,80,119,73,389,389,309
2019,21,34,"Elazig",38.6753,39.22,22.0714285714286,21.6571428571429,0.0567142857142857,46.3428571428571,60.302,NA,457,2,2,317,257,413,455,411
2019,22,34,"Elazig",38.6753,39.22,19.2571428571429,23,0.0554285714285714,43.4285714285714,64.972,NA,453,3,1,270,132,323,450,322
2019,23,34,"Elazig",38.6753,39.22,19.3857142857143,24.9714285714286,0,37.3142857142857,61.4871428571429,NA,378,116,174,140,270,532,262,358
2019,24,34,"Elazig",38.6753,39.22,24.3857142857143,23.6571428571429,0.812,46.6142857142857,56.7342857142857,NA,378,88,45,0,0,244,290,199
2019,25,34,"Elazig",38.6753,39.22,18.8571428571429,24.1714285714286,0.740857142857143,50.4714285714286,50.9414285714286,NA,306,2,12,162,124,325,304,313
2019,26,34,"Elazig",38.6753,39.22,24.5714285714286,27.7285714285714,0,35.7285714285714,45.2128571428571,NA,377,62,32,25,50,342,315,310
2019,27,34,"Elazig",38.6753,39.22,18.7,25.7857142857143,0,31.6714285714286,41.5557142857143,NA,456,69,15,206,73,222,387,207
2019,28,34,"Elazig",38.6753,39.22,29.1285714285714,26.6714285714286,0.0854285714285714,33.1428571428571,49.9971428571429,NA,398,0,0,279,347,421,398,421
2019,29,34,"Elazig",38.6753,39.22,23.4142857142857,26.9,0,35.6571428571429,40.6614285714286,NA,453,0,0,380,171,203,453,203
2019,30,34,"Elazig",38.6753,39.22,21.8571428571429,28.2142857142857,0,32.6142857142857,34.6542857142857,NA,456,0,0,367,293,335,456,335
2019,31,34,"Elazig",38.6753,39.22,23.6857142857143,29.6428571428571,0,25.8857142857143,50.9014285714286,NA,334,64,35,158,200,375,270,340
2019,32,34,"Elazig",38.6753,39.22,23.6428571428571,28.0857142857143,0.0554285714285714,28.5285714285714,36.7157142857143,NA,346,0,0,167,179,395,346,395
2019,33,34,"Elazig",38.6753,39.22,18.1,29.2571428571429,0,27.9142857142857,52.8233333333333,NA,337,2,1,178,276,531,335,530
2019,34,34,"Elazig",38.6753,39.22,22.8285714285714,27.0857142857143,0,36.7142857142857,54.8314285714286,NA,299,0,0,131,102,345,299,345
2019,35,34,"Elazig",38.6753,39.22,24.0857142857143,25.4857142857143,1.11171428571429,43.5428571428571,55.1214285714286,NA,307,52,75,239,313,415,255,340
2019,36,34,"Elazig",38.6753,39.22,19.6714285714286,24.5285714285714,0,31.3428571428571,37.6342857142857,NA,171,0,0,153,54,67,171,67
2019,37,34,"Elazig",38.6753,39.22,16.8285714285714,22.6714285714286,0.0162857142857143,35.2571428571429,48.6216666666667,NA,218,30,1,156,35,55,188,54
2019,38,34,"Elazig",38.6753,39.22,22.4571428571429,20.7714285714286,0.0661428571428571,41.0571428571429,51.9528571428571,NA,266,0,0,155,54,91,266,91
2019,39,34,"Elazig",38.6753,39.22,18.0857142857143,20.0857142857143,0,35.6714285714286,54.8428571428571,NA,237,28,16,168,43,79,209,63
2019,40,34,"Elazig",38.6753,39.22,17.5285714285714,19.9714285714286,0,35.4285714285714,84.4314285714286,NA,241,29,5,166,88,111,212,106
2019,41,34,"Elazig",38.6753,39.22,16.0285714285714,19.5285714285714,0,39.4571428571429,73.76,NA,416,0,0,285,304,448,416,448
2019,42,34,"Elazig",38.6753,39.22,16.5285714285714,16.7857142857143,0.303571428571429,50.3428571428571,82.31,NA,356,42,31,158,150,408,314,377
2019,43,34,"Elazig",38.6753,39.22,16.2714285714286,13.9,1.01614285714286,72.2714285714286,62.7185714285714,NA,306,0,0,228,170,300,306,300
2019,44,34,"Elazig",38.6753,39.22,16.5857142857143,10.6714285714286,0.154428571428571,69.7571428571429,54.8185714285714,NA,350,52,45,210,128,250,298,205
2019,45,34,"Elazig",38.6753,39.22,12.1714285714286,8.31428571428571,0,61.7285714285714,108.198571428571,NA,417,0,0,336,224,328,417,328
2019,46,34,"Elazig",38.6753,39.22,12.6857142857143,7.72857142857143,0,50.8,112.632857142857,NA,401,0,0,342,254,337,401,337
2019,47,34,"Elazig",38.6753,39.22,13.2285714285714,4.54285714285714,0,49.5,97.0428571428571,NA,391,0,0,359,298,339,391,339
2019,48,34,"Elazig",38.6753,39.22,15.2714285714286,7.9,0.934142857142857,70.4,75.8485714285714,NA,320,75,63,51,18,251,245,188
2019,49,34,"Elazig",38.6753,39.22,15.5428571428571,3.57142857142857,7.08442857142857,85.8714285714286,41.4228571428571,NA,393,0,0,375,257,274,393,274
2019,50,34,"Elazig",38.6753,39.22,15.7,5.71428571428571,1.30028571428571,84.4428571428572,46.2657142857143,NA,218,140,81,63,36,119,78,38
2019,51,34,"Elazig",38.6753,39.22,11.9142857142857,2.34285714285714,0,94.8857142857143,106.121428571429,NA,361,0,0,335,443,488,361,488
2019,52,34,"Elazig",38.6753,39.22,26.7428571428571,5.98571428571429,1.44514285714286,75.4142857142857,41.2283333333333,NA,279,184,141,0,0,281,95,140
2020,1,34,"Elazig",38.6753,39.22,15.4,3.2,1.5958,89.68,41.408,NA,160,82,78,53,37,126,78,48
2020,2,34,"Elazig",38.6753,39.22,20.4857142857143,2.87142857142857,3.52842857142857,79.1285714285714,37.8085714285714,NA,240,59,48,160,110,173,181,125
2020,3,34,"Elazig",38.6753,39.22,17.3571428571429,0.371428571428571,0,69.5142857142857,53.0742857142857,NA,270,27,78,193,263,382,243,304
2020,4,34,"Elazig",38.6753,39.22,18.9,0.357142857142857,0.448428571428571,64.5857142857143,35.4685714285714,NA,358,6,13,260,224,295,352,282
2020,5,34,"Elazig",38.6753,39.22,19.8857142857143,2.1,1.72885714285714,72.9571428571429,71.7683333333333,NA,331,95,97,159,105,272,236,175
2020,6,34,"Elazig",38.6753,39.22,29.4285714285714,3.64285714285714,0.984714285714286,68,50.6042857142857,NA,343,197,152,44,12,267,146,115
2020,7,34,"Elazig",38.6753,39.22,15.3142857142857,-4.65714285714286,1.88085714285714,72.3857142857143,53.0214285714286,NA,341,56,34,155,136,338,285,304
2020,8,34,"Elazig",38.6753,39.22,14.2571428571429,3.45714285714286,1.18357142857143,87.0857142857143,73.0542857142857,NA,283,34,13,146,101,187,249,174
2020,9,34,"Elazig",38.6753,39.22,20.4857142857143,6.17142857142857,1.51257142857143,66.2,73.7771428571428,NA,393,119,201,53,22,528,274,327
2020,10,34,"Elazig",38.6753,39.22,15.8428571428571,7.88571428571429,0.000857142857142857,60.0714285714286,82.1157142857143,NA,205,33,28,135,158,210,172,182
2020,11,34,"Elazig",38.6753,39.22,21.4428571428571,11.6857142857143,0.911428571428571,63.7285714285714,81.1657142857143,NA,115,86,72,0,0,94,29,22
2020,12,34,"Elazig",38.6753,39.22,20.4571428571429,6.91428571428571,7.79428571428571,81.5571428571428,33.0242857142857,NA,117,26,24,51,65,118,91,94
2020,13,34,"Elazig",38.6753,39.22,19.8571428571429,9.08571428571429,2.17742857142857,78.6142857142857,43.4614285714286,NA,136,62,65,30,5,92,74,27
2020,14,34,"Elazig",38.6753,39.22,21.2714285714286,8.58571428571429,4.38728571428571,75.3142857142857,35.2542857142857,NA,155,103,84,33,33,121,52,37
2020,15,34,"Elazig",38.6753,39.22,23.8857142857143,11.2142857142857,3.22414285714286,64.3428571428571,42.5571428571429,NA,133,20,5,72,40,118,113,113
2020,16,34,"Elazig",38.6753,39.22,19.9,12.9571428571429,0.925142857142857,60.0285714285714,43.8371428571429,NA,141,20,10,83,67,106,121,96
2020,17,34,"Elazig",38.6753,39.22,25.2,13.6571428571429,0.197428571428571,59.8714285714286,44.2428571428571,NA,137,12,16,60,51,123,125,107
2020,18,34,"Elazig",38.6753,39.22,21.7142857142857,13.1571428571429,1.24114285714286,65.8714285714286,37.0857142857143,NA,146,42,37,39,19,164,104,127
2020,19,34,"Elazig",38.6753,39.22,20.4571428571429,14.7142857142857,2.90385714285714,64.7571428571429,34.6825,NA,137,25,1,48,97,157,112,156
2020,20,34,"Elazig",38.6753,39.22,19.8857142857143,19.5,0,49.5142857142857,NA,NA,164,6,15,100,116,164,158,149
2020,21,34,"Elazig",38.6753,39.22,24.6428571428571,20.6,2.64971428571429,42.4714285714286,NA,NA,146,0,0,93,63,96,146,96
2020,22,34,"Elazig",38.6753,39.22,19.2714285714286,17.5,2.05385714285714,57.6714285714286,NA,NA,118,14,29,42,24,100,104,71
2020,23,34,"Elazig",38.6753,39.22,19.3714285714286,19.8,0.0957142857142857,45.9428571428571,44.2033333333333,NA,112,0,0,75,32,70,112,70
2020,24,34,"Elazig",38.6753,39.22,26.5285714285714,22.5285714285714,0.0727142857142857,41.2571428571429,60.9757142857143,NA,140,7,4,85,74,150,133,146
2020,25,34,"Elazig",38.6753,39.22,19.8857142857143,22.7,0.721285714285714,44.6285714285714,53.715,NA,137,0,0,107,101,108,137,108
2020,26,34,"Elazig",38.6753,39.22,18.6857142857143,25.5,0,36.1714285714286,48.035,NA,173,0,0,101,73,133,173,133
2020,27,34,"Elazig",38.6753,39.22,22.0285714285714,26.7,0,33.1,59.7228571428571,NA,113,14,9,76,42,113,99,104
2020,28,34,"Elazig",38.6753,39.22,21.9714285714286,27.9714285714286,0,33.3,57.8314285714286,NA,164,13,6,91,63,122,151,116
2020,29,34,"Elazig",38.6753,39.22,17.5428571428571,28.1714285714286,0.277428571428571,28.9,55.87,NA,186,0,0,130,91,111,186,111
2020,30,34,"Elazig",38.6753,39.22,21.9714285714286,29.7857142857143,0.000428571428571429,28.2285714285714,72.55,NA,190,8,11,88,75,142,182,131
2020,31,34,"Elazig",38.6753,39.22,24.4714285714286,29.3142857142857,0.113571428571429,30.2,50.225,NA,150,16,28,105,85,127,134,99
2020,32,34,"Elazig",38.6753,39.22,17.8571428571429,28.7142857142857,0,23.5571428571429,39.425,NA,146,5,4,104,94,107,141,103
2020,33,34,"Elazig",38.6753,39.22,21.5,27.2285714285714,0,30.5142857142857,31.6471428571429,NA,183,0,0,138,75,83,183,83
2020,34,34,"Elazig",38.6753,39.22,28.0714285714286,26.1428571428571,0,27.8428571428571,37.3685714285714,NA,197,0,0,130,67,97,197,97
2020,35,34,"Elazig",38.6753,39.22,15.1857142857143,25.3,0,24.0142857142857,39.9057142857143,NA,164,0,0,157,139,157,164,157
2020,36,34,"Elazig",38.6753,39.22,21.9571428571429,27.1857142857143,0.000428571428571429,24.2571428571429,61.7071428571429,NA,179,20,4,116,61,112,159,108
2020,37,34,"Elazig",38.6753,39.22,17.3857142857143,25.9428571428571,0,29.2571428571429,51.0171428571429,NA,193,0,0,139,58,91,193,91
2020,38,34,"Elazig",38.6753,39.22,16.5571428571429,24.4571428571429,0,25.5142857142857,64.8928571428571,NA,235,7,21,134,76,157,228,136
2020,39,34,"Elazig",38.6753,39.22,18.7,22.6285714285714,0.112142857142857,38.4571428571429,56.3342857142857,NA,220,0,0,170,101,129,220,129
2020,40,34,"Elazig",38.6753,39.22,18.7857142857143,21.9285714285714,0.00214285714285714,34.1714285714286,47.5085714285714,NA,187,2,3,154,135,154,185,151
2020,41,34,"Elazig",38.6753,39.22,15.1428571428571,17.2285714285714,0,29.9285714285714,52.5028571428571,NA,182,0,0,128,97,127,182,127
2020,42,34,"Elazig",38.6753,39.22,11.2571428571429,17,0,32.4285714285714,73.0142857142857,NA,177,0,0,150,97,111,177,111
2020,43,34,"Elazig",38.6753,39.22,13.3857142857143,15.5142857142857,0.557285714285714,48.4,65.3471428571429,NA,194,0,0,165,153,161,194,161
2020,44,34,"Elazig",38.6753,39.22,17.8142857142857,17.0285714285714,0.0151428571428571,32.3571428571429,94.4342857142857,NA,255,33,31,120,152,233,222,202
2020,45,34,"Elazig",38.6753,39.22,19.6285714285714,12.5285714285714,4.39428571428571,75.5714285714286,40.54,NA,156,74,52,68,44,103,82,51
2020,46,34,"Elazig",38.6753,39.22,11.5428571428571,8.31428571428571,0.346714285714286,72.5714285714286,57.6185714285714,NA,208,0,0,163,75,109,208,109
2020,47,34,"Elazig",38.6753,39.22,13.1142857142857,5.87142857142857,1.75828571428571,74.7714285714286,46.0714285714286,NA,173,22,18,122,49,83,151,65
2020,48,34,"Elazig",38.6753,39.22,12.5571428571429,3.75714285714286,0,73.2142857142857,56.8128571428571,NA,199,0,0,179,234,262,199,262
2020,49,34,"Elazig",38.6753,39.22,13.3142857142857,5.8,2.33085714285714,84.7571428571429,41.1857142857143,NA,207,24,7,147,85,116,183,109
2020,50,34,"Elazig",38.6753,39.22,16.5714285714286,4.68571428571429,1.92014285714286,82.8857142857143,46.3814285714286,NA,181,80,37,36,8,98,101,61
2020,51,34,"Elazig",38.6753,39.22,16.8142857142857,5.35714285714286,2.72385714285714,86.6571428571429,37.6414285714286,NA,171,39,13,110,66,90,132,77
2020,52,34,"Elazig",38.6753,39.22,16.7571428571429,0.371428571428571,1.54142857142857,76.8714285714286,45.1614285714286,NA,203,0,0,162,99,113,203,113
2020,53,34,"Elazig",38.6753,39.22,14.55,-0.025,0,84.35,76.075,NA,122,0,0,101,96,111,122,111
2017,1,35,"Erzincan",39.7477,39.4913,17.1714285714286,-1.45714285714286,0.018,70.1714285714286,85.7225,26.43,563,44,53,67,51,847,519,794
2017,2,35,"Erzincan",39.7477,39.4913,14.3285714285714,-2.45714285714286,0.269857142857143,75.0714285714286,69.1585714285714,25.14,757,14,35,263,456,1214,743,1179
2017,3,35,"Erzincan",39.7477,39.4913,5.54285714285714,-2.97142857142857,0.000142857142857143,72.6571428571429,109.315714285714,32.3342857142857,762,3,5,352,631,1449,759,1444
2017,4,35,"Erzincan",39.7477,39.4913,15.1714285714286,-5.47142857142857,0.355142857142857,73.7,60.5128571428571,20.9471428571429,639,109,126,179,290,889,530,763
2017,5,35,"Erzincan",39.7477,39.4913,16.0714285714286,-6.21428571428571,0.116714285714286,64.6428571428571,58.6514285714286,19.88,588,19,27,99,196,1163,569,1136
2017,6,35,"Erzincan",39.7477,39.4913,8.91428571428571,-0.728571428571428,0.0282857142857143,76.4,90.4342857142857,28.75,736,134,412,32,35,1519,602,1107
2017,7,35,"Erzincan",39.7477,39.4913,16.9142857142857,-4.72857142857143,0.000428571428571429,54.1,49.8557142857143,19.2757142857143,492,63,121,95,197,717,429,596
2017,8,35,"Erzincan",39.7477,39.4913,9.81428571428571,0.414285714285714,0.861571428571429,64.6428571428571,97.4857142857143,33.6285714285714,739,18,28,187,378,1747,721,1719
2017,9,35,"Erzincan",39.7477,39.4913,15.5857142857143,5.31428571428571,0.613,69,90.4542857142857,31.0428571428571,574,25,27,12,7,866,549,839
2017,10,35,"Erzincan",39.7477,39.4913,22.4857142857143,6.72857142857143,0.436,59.3285714285714,68.524,24.7957142857143,712,95,137,100,150,1043,617,906
2017,11,35,"Erzincan",39.7477,39.4913,21.9857142857143,4.4,1.46285714285714,66.7142857142857,42.7771428571429,18.8385714285714,525,2,0,167,256,725,523,725
2017,12,35,"Erzincan",39.7477,39.4913,14.7857142857143,4,0.654571428571429,64.9571428571429,68.9875,27.2725,589,76,90,273,410,1077,513,987
2017,13,35,"Erzincan",39.7477,39.4913,21.1428571428571,8.75714285714286,0.994714285714286,57.6714285714286,51.328,20.2033333333333,574,0,0,358,581,887,574,887
2017,14,35,"Erzincan",39.7477,39.4913,20.4428571428571,7.64285714285714,3.85842857142857,57.8428571428571,52.9242857142857,21.7385714285714,639,31,99,3,2,1336,608,1237
2017,15,35,"Erzincan",39.7477,39.4913,20.5285714285714,8.42857142857143,2.96185714285714,62.5714285714286,55.0533333333333,21.0228571428571,587,0,0,473,781,1187,587,1187
2017,16,35,"Erzincan",39.7477,39.4913,27.2285714285714,13.0428571428571,1.71114285714286,56.5285714285714,69.81,22.4657142857143,717,17,8,279,443,920,700,912
2017,17,35,"Erzincan",39.7477,39.4913,18.8142857142857,12.2714285714286,0.0294285714285714,39.6857142857143,53.64,18.8683333333333,731,26,86,256,733,1478,705,1392
2017,18,35,"Erzincan",39.7477,39.4913,21.1428571428571,14.7428571428571,1.83785714285714,58.1571428571429,70.366,20.898,506,6,36,99,175,923,500,887
2017,19,35,"Erzincan",39.7477,39.4913,23.5857142857143,15.5571428571429,1.55514285714286,58.1857142857143,67.4733333333333,19.505,471,0,0,288,612,966,471,966
2017,20,35,"Erzincan",39.7477,39.4913,21.9428571428571,14.4,4.84157142857143,64.0285714285714,44.0428571428571,16.2571428571429,472,2,1,255,793,1205,470,1204
2017,21,35,"Erzincan",39.7477,39.4913,21.1571428571429,13.2714285714286,4.51114285714286,67.8428571428571,43.4585714285714,18.04,448,8,23,152,314,849,440,826
2017,22,35,"Erzincan",39.7477,39.4913,18.5428571428571,16.9571428571429,1.50271428571429,56.0714285714286,54.0828571428571,18.84,522,11,62,138,298,1015,511,953
2017,23,35,"Erzincan",39.7477,39.4913,19.8428571428571,21.5285714285714,0.0427142857142857,48.4714285714286,56.9228571428571,17.2114285714286,578,7,12,385,959,1388,571,1376
2017,24,35,"Erzincan",39.7477,39.4913,17.9142857142857,18.7857142857143,0.6,51.8857142857143,35.8133333333333,15.0328571428571,552,0,0,271,687,1139,552,1139
2017,25,35,"Erzincan",39.7477,39.4913,23.0285714285714,19.2857142857143,0.488857142857143,50.7571428571429,38.5842857142857,13.8742857142857,584,0,0,268,604,1041,584,1041
2017,26,35,"Erzincan",39.7477,39.4913,18.2285714285714,25.1857142857143,0,39.7285714285714,45.9328571428571,14.7057142857143,564,13,27,132,312,971,551,944
2017,27,35,"Erzincan",39.7477,39.4913,22.2571428571429,24.0714285714286,0,43.9,64.8733333333333,14.8642857142857,511,0,0,263,334,642,511,642
2017,28,35,"Erzincan",39.7477,39.4913,19.0714285714286,24.8142857142857,0,33.9857142857143,38.5314285714286,11.9728571428571,481,0,0,179,402,864,481,864
2017,29,35,"Erzincan",39.7477,39.4913,20.9,26.6,0,35.9428571428571,60.42,20.3728571428571,532,0,0,152,353,1272,532,1272
2017,30,35,"Erzincan",39.7477,39.4913,22.2,25.3,0,39.2857142857143,58.6985714285714,16.2642857142857,531,1,1,138,330,928,530,927
2017,31,35,"Erzincan",39.7477,39.4913,16.6428571428571,26.8285714285714,0,31.8,73.0071428571429,25.17,559,58,211,248,462,1047,501,836
2017,32,35,"Erzincan",39.7477,39.4913,19.2714285714286,26.7428571428571,0,29.7,76.8857142857143,25.6471428571429,567,1,2,232,590,1092,566,1090
2017,33,35,"Erzincan",39.7477,39.4913,19.8571428571429,24.9,0.436714285714286,45.7428571428571,62.8642857142857,20.0114285714286,596,0,0,290,649,1199,596,1199
2017,34,35,"Erzincan",39.7477,39.4913,22.7,24.8285714285714,0.0282857142857143,43.3285714285714,60.3814285714286,15.4771428571429,601,0,0,358,675,1280,601,1280
2017,35,35,"Erzincan",39.7477,39.4913,19.0285714285714,23.6571428571429,0.00114285714285714,39.8857142857143,53.2842857142857,15.5771428571429,493,71,123,226,492,1014,422,891
2017,36,35,"Erzincan",39.7477,39.4913,14.2571428571429,20.9714285714286,0.311714285714286,39.6428571428571,75.7671428571429,25.5114285714286,507,16,41,274,624,1321,491,1280
2017,37,35,"Erzincan",39.7477,39.4913,12.1571428571429,22.1428571428571,0,33.2571428571429,103.53,29.2342857142857,589,0,0,269,701,1138,589,1138
2017,38,35,"Erzincan",39.7477,39.4913,12.3285714285714,21.1285714285714,0.0565714285714286,38.0571428571429,125.206666666667,30.6614285714286,671,36,66,343,705,1312,635,1246
2017,39,35,"Erzincan",39.7477,39.4913,19.2571428571429,17.9285714285714,0.145428571428571,47.5142857142857,78.8357142857143,22.38,782,31,74,433,1178,1630,751,1556
2017,40,35,"Erzincan",39.7477,39.4913,10.9857142857143,11.7714285714286,1.93785714285714,59.2571428571429,73.5228571428571,25.8071428571429,543,51,187,226,457,1137,492,950
2017,41,35,"Erzincan",39.7477,39.4913,18.2,12.5285714285714,0.891857142857143,62.7142857142857,61.09,20.79,487,36,37,380,745,843,451,806
2017,42,35,"Erzincan",39.7477,39.4913,16.7714285714286,9.51428571428571,0.144285714285714,55.5142857142857,91.7485714285714,28.3357142857143,530,13,8,378,570,815,517,807
2017,43,35,"Erzincan",39.7477,39.4913,17.9857142857143,13.1142857142857,0.433,52.6,118.367142857143,28.3185714285714,506,199,567,120,197,919,307,352
2017,44,35,"Erzincan",39.7477,39.4913,15.3285714285714,7.22857142857143,0.253857142857143,58.4285714285714,82.6114285714286,31.5457142857143,561,25,143,252,428,1102,536,959
2017,45,35,"Erzincan",39.7477,39.4913,7.87142857142857,6.98571428571429,0.882571428571428,75.8714285714286,161.06,35.7971428571429,577,113,176,119,125,829,464,653
2017,46,35,"Erzincan",39.7477,39.4913,11.3428571428571,6.37142857142857,0.0325714285714286,66.1857142857143,178.864285714286,48.6585714285714,587,0,0,158,237,1085,587,1085
2017,47,35,"Erzincan",39.7477,39.4913,20.8714285714286,1.62857142857143,1.13214285714286,72.1285714285714,66.1414285714286,29.3957142857143,418,0,0,33,32,804,418,804
2017,48,35,"Erzincan",39.7477,39.4913,9.74285714285714,1.31428571428571,0.471285714285714,79.7428571428571,136.572857142857,45.8814285714286,386,0,0,242,369,619,386,619
2017,49,35,"Erzincan",39.7477,39.4913,21.1142857142857,0.5,0.0147142857142857,70.1714285714286,91.5471428571429,32.2757142857143,407,126,271,33,63,645,281,374
2017,50,35,"Erzincan",39.7477,39.4913,7.4,-1.6,0.001,77.9714285714286,188.788571428571,54.6585714285714,346,0,0,136,135,442,346,442
2017,51,35,"Erzincan",39.7477,39.4913,19.3142857142857,4.71428571428571,1.09628571428571,78.4285714285714,157.667142857143,38.9185714285714,386,6,32,119,100,349,380,317
2017,52,35,"Erzincan",39.7477,39.4913,19.375,3.2625,1.501,69.0625,79.16625,32.3175,528,16,9,149,123,507,512,498
2018,1,35,"Erzincan",39.7477,39.4913,17.125,1.4625,0.387375,79.125,NA,29.89,618,5,38,153,232,914,613,876
2018,2,35,"Erzincan",39.7477,39.4913,10.8714285714286,0.157142857142857,0.0332857142857143,75.9285714285714,114.71,36.7942857142857,624,7,8,96,602,1309,617,1301
2018,3,35,"Erzincan",39.7477,39.4913,27.4857142857143,1.98571428571429,0.727285714285714,75.1428571428571,61.2085714285714,25.1028571428571,639,9,47,143,348,655,630,608
2018,4,35,"Erzincan",39.7477,39.4913,21.6857142857143,1.82857142857143,1.42628571428571,78.3428571428571,82.43,25.7883333333333,604,13,7,247,297,764,591,757
2018,5,35,"Erzincan",39.7477,39.4913,16.4142857142857,0.385714285714286,0.0344285714285714,68.8142857142857,71.09,25.1614285714286,670,2,0,142,197,819,668,819
2018,6,35,"Erzincan",39.7477,39.4913,15.3285714285714,3.11428571428571,0.0565714285714286,69.5142857142857,151.825714285714,46.6066666666667,704,114,188,0,0,1022,590,834
2018,7,35,"Erzincan",39.7477,39.4913,23.5142857142857,5.14285714285714,1.18028571428571,67.0142857142857,78.7085714285714,27.832,478,14,45,93,112,557,464,512
2018,8,35,"Erzincan",39.7477,39.4913,16.6571428571429,4.32857142857143,0.441285714285714,65.6714285714286,78.7157142857143,33.1085714285714,711,12,35,207,421,1321,699,1286
2018,9,35,"Erzincan",39.7477,39.4913,26.7,4.81428571428571,0.627142857142857,68.5714285714286,63.5557142857143,26.4628571428571,621,242,347,200,318,956,379,609
2018,10,35,"Erzincan",39.7477,39.4913,23.8714285714286,7.08571428571429,3.79042857142857,72.0714285714286,88.8385714285714,28.3557142857143,556,89,159,462,1156,1330,467,1171
2018,11,35,"Erzincan",39.7477,39.4913,24.2428571428571,9.05714285714286,1.54271428571429,59.9428571428571,59.8083333333333,24.06,551,92,130,316,1055,1426,459,1296
2018,12,35,"Erzincan",39.7477,39.4913,34.3857142857143,13.3571428571429,0.0885714285714286,43.7,127.155,21.5114285714286,425,100,428,77,277,1187,325,759
2018,13,35,"Erzincan",39.7477,39.4913,28.3285714285714,11.9857142857143,1.06957142857143,50.6714285714286,77.7728571428571,19.855,356,45,106,94,113,428,311,322
2018,14,35,"Erzincan",39.7477,39.4913,22.4857142857143,9.95714285714286,2.30285714285714,53.1714285714286,60.6728571428571,25.3542857142857,407,0,0,171,309,486,407,486
2018,15,35,"Erzincan",39.7477,39.4913,27.7,13.7142857142857,0.038,48.4714285714286,71.7057142857143,21.1614285714286,374,57,45,183,179,450,317,405
2018,16,35,"Erzincan",39.7477,39.4913,28.8285714285714,12.5571428571429,0.000142857142857143,33.9285714285714,55.7085714285714,21.4583333333333,411,0,0,383,565,648,411,648
2018,17,35,"Erzincan",39.7477,39.4913,26,15.8142857142857,0.000857142857142857,39.7428571428571,69.5542857142857,20.1485714285714,419,136,279,120,200,652,283,373
2018,18,35,"Erzincan",39.7477,39.4913,30.1285714285714,16.1,1.525,61.1857142857143,58.2471428571429,22.9571428571429,303,115,152,57,86,474,188,322
2018,19,35,"Erzincan",39.7477,39.4913,29,13.7,3.41585714285714,71.1857142857143,40.5442857142857,19.1314285714286,275,58,169,95,87,467,217,298
2018,20,35,"Erzincan",39.7477,39.4913,21.4571428571429,16.6285714285714,3.61128571428571,63.9428571428571,43.59,18.76,204,54,104,101,147,306,150,202
2018,21,35,"Erzincan",39.7477,39.4913,22.4,17.4714285714286,0.775428571428571,67.1142857142857,69.06,18.762,252,38,91,71,63,281,214,190
2018,22,35,"Erzincan",39.7477,39.4913,31.5142857142857,16.5857142857143,1.98357142857143,70.3,52.5328571428571,17.3157142857143,249,95,195,67,108,427,154,232
2018,23,35,"Erzincan",39.7477,39.4913,22.4428571428571,18.5,2.52357142857143,62.0428571428571,49.2728571428571,22.57,267,46,139,131,367,812,221,673
2018,24,35,"Erzincan",39.7477,39.4913,22.2,19.9,1.12385714285714,59.3428571428571,52.6842857142857,28.0685714285714,267,0,0,243,254,448,267,448
2018,25,35,"Erzincan",39.7477,39.4913,26.4,19.4285714285714,0.837142857142857,62.4571428571429,46.4885714285714,27.7271428571429,358,0,0,229,304,518,358,518
2018,26,35,"Erzincan",39.7477,39.4913,22.7571428571429,24.9,0.00114285714285714,45.1285714285714,69.41,25.206,355,29,53,147,274,587,326,534
2018,27,35,"Erzincan",39.7477,39.4913,29.4142857142857,24.9142857142857,0.994571428571429,49.1142857142857,54.0471428571429,15.63,342,0,0,320,349,418,342,418
2018,28,35,"Erzincan",39.7477,39.4913,22.7714285714286,25.2285714285714,2.17385714285714,49.1857142857143,72.2814285714286,23.7783333333333,286,56,114,150,351,585,230,471
2018,29,35,"Erzincan",39.7477,39.4913,27.7571428571429,22.6,0.572571428571429,50.3142857142857,42.3766666666667,14.14,260,0,0,239,687,756,260,756
2018,30,35,"Erzincan",39.7477,39.4913,21.7,25.1142857142857,0,39.8142857142857,96.585,30.72,265,40,72,126,313,822,225,750
2018,31,35,"Erzincan",39.7477,39.4913,28.0428571428571,25.5428571428571,0,45.7,59.8914285714286,17.8714285714286,267,0,0,200,297,499,267,499
2018,32,35,"Erzincan",39.7477,39.4913,30.9857142857143,24.0142857142857,0.283571428571429,45.1428571428571,51.0328571428571,18.9966666666667,297,0,0,257,383,403,297,403
2018,33,35,"Erzincan",39.7477,39.4913,28.0142857142857,24.0428571428571,0,39.5285714285714,52.794,15.5166666666667,216,0,0,205,329,332,216,332
2018,34,35,"Erzincan",39.7477,39.4913,24.8428571428571,24.8142857142857,0.0852857142857143,42.3,42.57,20.2028571428571,144,0,0,144,227,227,144,227
2018,35,35,"Erzincan",39.7477,39.4913,22.5,24.4857142857143,0,36.7428571428571,74.5928571428571,36.3666666666667,201,60,75,101,212,314,141,239
2018,36,35,"Erzincan",39.7477,39.4913,26.4714285714286,21.5142857142857,0.920428571428571,51.3857142857143,60.5957142857143,28.8866666666667,341,53,73,197,183,370,288,297
2018,37,35,"Erzincan",39.7477,39.4913,25.1714285714286,18.7714285714286,0.492142857142857,57.4571428571429,68.8957142857143,41.7957142857143,241,27,101,114,163,419,214,318
2018,38,35,"Erzincan",39.7477,39.4913,20.7857142857143,19.6285714285714,0.0184285714285714,45.3,55.0971428571429,32.3957142857143,189,50,60,134,262,344,139,284
2018,39,35,"Erzincan",39.7477,39.4913,19.6857142857143,17.9714285714286,0,47.9857142857143,77.5171428571429,33.9271428571429,180,27,110,94,142,353,153,243
2018,40,35,"Erzincan",39.7477,39.4913,24.6,15.8142857142857,0.113714285714286,50.1428571428571,72.5028571428571,31.8157142857143,191,8,15,110,200,341,183,326
2018,41,35,"Erzincan",39.7477,39.4913,20.3,16.1142857142857,1.08585714285714,62.3285714285714,94.1985714285714,30.8614285714286,187,16,37,16,17,422,171,385
2018,42,35,"Erzincan",39.7477,39.4913,15.5571428571429,14.7,0.776428571428571,65.7571428571429,116.018,36.5685714285714,168,60,206,34,52,381,108,175
2018,43,35,"Erzincan",39.7477,39.4913,20.7,10.2714285714286,3.05285714285714,74.3142857142857,66.2542857142857,28.3371428571429,187,38,134,54,156,402,149,268
2018,44,35,"Erzincan",39.7477,39.4913,13.8285714285714,8.45714285714286,0,67.4428571428572,150.5,40.07,196,46,49,0,0,264,150,215
2018,45,35,"Erzincan",39.7477,39.4913,11.2,6.68571428571429,0.000428571428571429,67.7,144.322857142857,44.2871428571429,231,76,182,17,29,473,155,291
2018,46,35,"Erzincan",39.7477,39.4913,16.5857142857143,3.48571428571429,4.18385714285714,75.2714285714286,85.392,36.8185714285714,230,42,44,124,245,465,188,421
2018,47,35,"Erzincan",39.7477,39.4913,10.7285714285714,4.78571428571429,1.11714285714286,82.1714285714286,99.1075,38.2757142857143,270,13,6,187,148,499,257,493
2018,48,35,"Erzincan",39.7477,39.4913,21.9571428571429,6.61428571428571,2.26628571428571,79.8571428571429,77.8128571428571,29.9066666666667,245,115,142,54,18,201,130,59
2018,49,35,"Erzincan",39.7477,39.4913,14.8428571428571,4.21428571428571,0.413857142857143,82.9142857142857,91.89,32.6014285714286,257,34,60,106,257,420,223,360
2018,50,35,"Erzincan",39.7477,39.4913,25.1142857142857,2.44285714285714,4.46042857142857,82.4285714285714,81.4014285714286,34.2357142857143,256,46,70,176,198,305,210,235
2018,51,35,"Erzincan",39.7477,39.4913,20.6428571428571,3.77142857142857,0.253571428571429,79.5857142857143,87.9742857142857,43.5442857142857,250,128,97,69,69,248,122,151
2018,52,35,"Erzincan",39.7477,39.4913,21.9714285714286,-1.25714285714286,2.99128571428571,82.7714285714286,60.3625,44.3033333333333,244,128,135,42,86,273,116,138
2019,1,35,"Erzincan",39.7477,39.4913,27.1125,1.85,0.571875,77.4,62.46,39.955,343,138,300,90,142,784,205,484
2019,2,35,"Erzincan",39.7477,39.4913,19,-8.05714285714286,1.28571428571429,83.1857142857143,75.095,55.3166666666667,255,70,60,158,108,208,185,148
2019,3,35,"Erzincan",39.7477,39.4913,28.3428571428571,-4.52857142857143,0.804714285714286,78,99.1914285714286,52.7814285714286,192,44,61,49,66,198,148,137
2019,4,35,"Erzincan",39.7477,39.4913,22.7571428571429,-0.757142857142857,0.0897142857142857,74.1571428571429,115.784,49.446,308,89,202,29,7,314,219,112
2019,5,35,"Erzincan",39.7477,39.4913,21.6714285714286,1.72857142857143,0.141571428571429,76.5571428571429,106.031428571429,47.3628571428571,253,36,10,114,71,143,217,133
2019,6,35,"Erzincan",39.7477,39.4913,21.8714285714286,1.32857142857143,0.233428571428571,75.3285714285714,80.9885714285714,39.7828571428571,276,97,50,8,6,127,179,77
2019,7,35,"Erzincan",39.7477,39.4913,18.7428571428571,1.54285714285714,0.125142857142857,71.6571428571429,70.2357142857143,39.765,325,82,40,230,167,234,243,194
2019,8,35,"Erzincan",39.7477,39.4913,21.4714285714286,2.15714285714286,0.00242857142857143,58.4714285714286,69.9828571428571,36.8642857142857,305,8,17,50,39,219,297,202
2019,9,35,"Erzincan",39.7477,39.4913,21.1,2.07142857142857,0.360571428571429,66.7714285714286,54.5514285714286,33.8414285714286,331,45,93,182,100,310,286,217
2019,10,35,"Erzincan",39.7477,39.4913,17.9428571428571,3.51428571428571,0.342714285714286,60.0428571428571,57.2942857142857,37.0828571428571,359,23,80,91,77,252,336,172
2019,11,35,"Erzincan",39.7477,39.4913,36.5,6.84285714285714,1.32328571428571,65.1285714285714,61.3828571428571,34.2057142857143,373,256,317,22,29,400,117,83
2019,12,35,"Erzincan",39.7477,39.4913,23.0285714285714,4.8,0.176142857142857,47.9142857142857,49.725,32.1185714285714,343,44,11,193,110,416,299,405
2019,13,35,"Erzincan",39.7477,39.4913,21.3571428571429,4.71428571428571,2.261,75.9,42.904,36.3085714285714,256,83,71,98,105,194,173,123
2019,14,35,"Erzincan",39.7477,39.4913,21.6714285714286,7.9,1.79814285714286,68.4142857142857,56.9528571428571,38.8728571428571,365,115,86,74,50,208,250,122
2019,15,35,"Erzincan",39.7477,39.4913,25.1857142857143,10.9714285714286,1.40971428571429,60.7428571428571,48.7928571428571,32.6271428571429,359,95,70,50,33,183,264,113
2019,16,35,"Erzincan",39.7477,39.4913,24.6285714285714,7.74285714285714,2.17457142857143,70.3714285714286,29.4685714285714,21.0542857142857,318,57,53,118,75,208,261,155
2019,17,35,"Erzincan",39.7477,39.4913,24.9,9.7,0.406571428571429,51.4428571428571,40.0842857142857,26.0928571428571,412,6,17,333,235,313,406,296
2019,18,35,"Erzincan",39.7477,39.4913,19.5142857142857,12.3,3.50314285714286,70.5714285714286,48.9516666666667,29.7871428571429,523,12,19,86,34,353,511,334
2019,19,35,"Erzincan",39.7477,39.4913,26.1571428571429,14.7857142857143,0.925714285714286,55.7571428571429,33.302,21.23,452,49,50,43,22,386,403,336
2019,20,35,"Erzincan",39.7477,39.4913,17.2714285714286,18.6571428571429,0,46.6428571428571,55.7,35.8271428571429,454,21,56,51,44,389,433,333
2019,21,35,"Erzincan",39.7477,39.4913,25.3714285714286,18.3142857142857,0.572285714285714,55.4142857142857,57.445,31.698,457,0,0,314,314,413,457,413
2019,22,35,"Erzincan",39.7477,39.4913,20.0571428571429,21.6,0.003,39.5142857142857,50.5242857142857,31.6714285714286,453,7,54,328,191,323,446,269
2019,23,35,"Erzincan",39.7477,39.4913,17.1714285714286,23.4714285714286,0.000714285714285714,41.0857142857143,63.0614285714286,29.6485714285714,378,6,7,87,125,532,372,525
2019,24,35,"Erzincan",39.7477,39.4913,32.5571428571429,21.3285714285714,1.378,51.8285714285714,49.22,32.446,378,60,73,172,65,244,318,171
2019,25,35,"Erzincan",39.7477,39.4913,27.1571428571429,21.0285714285714,1.41542857142857,61.1428571428571,37.78,25.6085714285714,306,3,6,176,92,325,303,319
2019,26,35,"Erzincan",39.7477,39.4913,24.6142857142857,23.9,0.424571428571429,49.1285714285714,35.1057142857143,14.24,377,0,0,312,326,342,377,342
2019,27,35,"Erzincan",39.7477,39.4913,25.1142857142857,22.0714285714286,0.0282857142857143,41.2428571428571,38.1842857142857,19.7333333333333,456,51,76,153,49,222,405,146
2019,28,35,"Erzincan",39.7477,39.4913,22.4428571428571,22.5714285714286,0.893428571428571,47.2714285714286,34.3985714285714,23.0571428571429,398,56,25,277,336,421,342,396
2019,29,35,"Erzincan",39.7477,39.4913,25.9428571428571,23.4142857142857,0,44.7142857142857,44.4871428571429,23.24,453,0,0,345,168,203,453,203
2019,30,35,"Erzincan",39.7477,39.4913,25.9571428571429,23.9571428571429,0.0571428571428571,45.2285714285714,36.7571428571429,13.0557142857143,456,0,0,456,335,335,456,335
2019,31,35,"Erzincan",39.7477,39.4913,23.2571428571429,25.7,0.000285714285714286,37.0857142857143,50.78,23.1571428571429,334,0,0,286,332,375,334,375
2019,32,35,"Erzincan",39.7477,39.4913,26.7428571428571,23.1142857142857,0.000285714285714286,42.3,45.3171428571429,15.3042857142857,346,0,0,241,220,395,346,395
2019,33,35,"Erzincan",39.7477,39.4913,20.8857142857143,25.7571428571429,0,39.8571428571429,60.2085714285714,24.7128571428571,337,61,97,144,231,531,276,434
2019,34,35,"Erzincan",39.7477,39.4913,26.4428571428571,23.4714285714286,0.00814285714285714,49.2571428571429,52.84,20.64,299,6,4,181,174,345,293,341
2019,35,35,"Erzincan",39.7477,39.4913,24.0857142857143,21.9,0.176285714285714,53.6857142857143,51.0728571428571,25.8828571428571,307,3,2,190,223,415,304,413
2019,36,35,"Erzincan",39.7477,39.4913,22.5,21.5428571428571,0,42.2142857142857,38.2075,15.8114285714286,171,0,0,167,66,67,171,67
2019,37,35,"Erzincan",39.7477,39.4913,21.3571428571429,19.4428571428571,0.0605714285714286,49.4857142857143,41.3257142857143,21.5714285714286,218,0,0,148,48,55,218,55
2019,38,35,"Erzincan",39.7477,39.4913,20.1142857142857,17.4714285714286,0.487714285714286,52.4571428571429,55.7771428571429,30.5942857142857,266,0,0,130,61,91,266,91
2019,39,35,"Erzincan",39.7477,39.4913,16.1428571428571,17.5285714285714,0,43.2142857142857,55.1614285714286,30.0542857142857,237,2,0,125,42,79,235,79
2019,40,35,"Erzincan",39.7477,39.4913,16.3142857142857,17.2,0.286142857142857,44.0142857142857,69.4185714285714,40.5285714285714,241,2,0,195,92,111,239,111
2019,41,35,"Erzincan",39.7477,39.4913,15.8714285714286,16.5714285714286,0.141857142857143,49.5571428571429,68.4414285714286,33.24,416,47,95,131,228,448,369,353
2019,42,35,"Erzincan",39.7477,39.4913,9.02857142857143,13.6,0.576857142857143,55.1571428571429,86.14,45.6228571428571,356,6,30,100,98,408,350,378
2019,43,35,"Erzincan",39.7477,39.4913,10.3714285714286,12.0285714285714,1.29485714285714,72.3,77.97,43.76,306,63,55,102,138,300,243,245
2019,44,35,"Erzincan",39.7477,39.4913,15.9285714285714,7.92857142857143,1.36,71.6142857142857,81.8457142857143,42.9085714285714,350,79,47,188,164,250,271,203
2019,45,35,"Erzincan",39.7477,39.4913,6.55714285714286,5.12857142857143,0.0282857142857143,68.2285714285714,139.648333333333,52.9071428571429,417,1,1,0,0,328,416,327
2019,46,35,"Erzincan",39.7477,39.4913,7.25714285714286,4.54285714285714,0.0282857142857143,59.6714285714286,171.811666666667,65.9085714285714,401,22,20,7,14,337,379,317
2019,47,35,"Erzincan",39.7477,39.4913,6.91428571428571,1.18571428571429,0,57.5428571428571,186.768571428571,65.4785714285714,391,3,16,94,62,339,388,323
2019,48,35,"Erzincan",39.7477,39.4913,20.1714285714286,5.3,1.12571428571429,73.5142857142857,133.978571428571,52.8442857142857,320,103,64,128,141,251,217,187
2019,49,35,"Erzincan",39.7477,39.4913,13.9571428571429,0.3,0.280714285714286,81.3142857142857,99.3642857142857,45.9333333333333,393,47,26,212,137,274,346,248
2019,50,35,"Erzincan",39.7477,39.4913,14.8285714285714,1.88571428571429,0.112428571428571,78.3714285714286,86.2728571428571,36.1657142857143,218,66,42,63,15,119,152,77
2019,51,35,"Erzincan",39.7477,39.4913,9.54285714285714,0.742857142857143,0.002,75.7714285714286,139.087142857143,54.8,361,10,16,134,127,488,351,472
2019,52,35,"Erzincan",39.7477,39.4913,36.7428571428571,5.25714285714286,0.104571428571429,63.6142857142857,63.6085714285714,24.9285714285714,279,188,217,41,22,281,91,64
2020,1,35,"Erzincan",39.7477,39.4913,10.78,1.06,0.0412,79.76,63.11,39.542,160,0,0,100,81,126,160,126
2020,2,35,"Erzincan",39.7477,39.4913,25.3428571428571,1.42857142857143,0.105714285714286,66.1142857142857,46.12,32.2142857142857,240,34,36,125,107,173,206,137
2020,3,35,"Erzincan",39.7477,39.4913,13.5571428571429,-3.44285714285714,0.000142857142857143,62.8571428571429,81.2016666666667,47.7371428571429,270,48,98,125,173,382,222,284
2020,4,35,"Erzincan",39.7477,39.4913,19.6285714285714,-2.74285714285714,0.176142857142857,63.8285714285714,59.0428571428571,37.2014285714286,358,0,0,203,157,295,358,295
2020,5,35,"Erzincan",39.7477,39.4913,25.7142857142857,0.714285714285714,2.44957142857143,62.0428571428571,68.5333333333333,36.3728571428571,331,30,37,78,42,272,301,235
2020,6,35,"Erzincan",39.7477,39.4913,31.2571428571429,0.871428571428572,1.60357142857143,73.4428571428572,73.1075,31.6533333333333,343,134,144,139,74,267,209,123
2020,7,35,"Erzincan",39.7477,39.4913,10.5571428571429,-8.45714285714286,4.40257142857143,76.6142857142857,NA,53.5071428571429,341,11,16,119,111,338,330,322
2020,8,35,"Erzincan",39.7477,39.4913,16.1571428571429,0.228571428571429,0.153714285714286,77.3571428571429,NA,71.4371428571429,283,9,10,84,99,187,274,177
2020,9,35,"Erzincan",39.7477,39.4913,21.1571428571429,3.98571428571429,2.02757142857143,65.1571428571429,NA,32.0314285714286,393,6,5,118,201,528,387,523
2020,10,35,"Erzincan",39.7477,39.4913,20.3857142857143,7,0.000142857142857143,54.0857142857143,NA,38.8471428571429,205,80,63,40,69,210,125,147
2020,11,35,"Erzincan",39.7477,39.4913,33.8285714285714,11.6142857142857,0.279857142857143,53.5857142857143,64.1625,23.7228571428571,115,71,49,18,13,94,44,45
2020,12,35,"Erzincan",39.7477,39.4913,26.4142857142857,4.55714285714286,2.24885714285714,74.8428571428571,34.8714285714286,24.4271428571429,117,52,69,38,38,118,65,49
2020,13,35,"Erzincan",39.7477,39.4913,28.0285714285714,8.7,0.830857142857143,64.4,43.56,27.1933333333333,136,70,58,0,0,92,66,34
2020,14,35,"Erzincan",39.7477,39.4913,22.4142857142857,7.97142857142857,4.78871428571429,68.1571428571429,25.0514285714286,19.9671428571429,155,63,66,36,34,121,92,55
2020,15,35,"Erzincan",39.7477,39.4913,27.1714285714286,10.5,0.00271428571428571,45.9,36.8242857142857,14.5314285714286,133,15,54,47,36,118,118,64
2020,16,35,"Erzincan",39.7477,39.4913,21.4285714285714,11.7,0.0594285714285714,47.3,44.7616666666667,25.6185714285714,141,0,0,100,81,106,141,106
2020,17,35,"Erzincan",39.7477,39.4913,22.5,11.2857142857143,1.679,59.8714285714286,30.7028571428571,20.9042857142857,137,4,4,118,113,123,133,119
2020,18,35,"Erzincan",39.7477,39.4913,33.0142857142857,12.5285714285714,0.513857142857143,57.6571428571429,30.5842857142857,17.695,146,35,33,65,104,164,111,131
2020,19,35,"Erzincan",39.7477,39.4913,27,11.5285714285714,3.56328571428571,69.8428571428571,27.08,NA,137,5,11,108,121,157,132,146
2020,20,35,"Erzincan",39.7477,39.4913,26.6571428571429,17.9428571428571,0,45.0571428571429,75.5842857142857,NA,164,0,0,117,129,164,164,164
2020,21,35,"Erzincan",39.7477,39.4913,28.8142857142857,17.8428571428571,2.84414285714286,43.8,51.6757142857143,NA,146,1,3,83,56,96,145,93
2020,22,35,"Erzincan",39.7477,39.4913,21.4714285714286,16.3857142857143,1.23057142857143,54.4428571428571,34.8842857142857,NA,118,16,30,42,19,100,102,70
2020,23,35,"Erzincan",39.7477,39.4913,23.8571428571429,18.6285714285714,0.0618571428571429,45.8571428571429,40.7942857142857,NA,112,4,14,28,15,70,108,56
2020,24,35,"Erzincan",39.7477,39.4913,26.1428571428571,19.8142857142857,1.24957142857143,52.4285714285714,62.2485714285714,17.645,140,20,10,31,49,150,120,140
2020,25,35,"Erzincan",39.7477,39.4913,26.9714285714286,18.8428571428571,1.76614285714286,60.2571428571429,53.37,21.0228571428571,137,16,26,86,65,108,121,82
2020,26,35,"Erzincan",39.7477,39.4913,27.8571428571429,22.3285714285714,0.00185714285714286,47.4428571428571,55.8471428571429,17.12,173,38,43,98,87,133,135,90
2020,27,35,"Erzincan",39.7477,39.4913,24.6,23.4285714285714,0.00357142857142857,46.2571428571429,52.0228571428571,19.3971428571429,113,34,47,68,57,113,79,66
2020,28,35,"Erzincan",39.7477,39.4913,28.8571428571429,24,0.00114285714285714,48.8285714285714,50.6128571428571,18.8442857142857,164,20,7,51,35,122,144,115
2020,29,35,"Erzincan",39.7477,39.4913,19.8714285714286,24.1714285714286,0.142142857142857,44.2857142857143,54.8685714285714,26.16,186,40,31,96,57,111,146,80
2020,30,35,"Erzincan",39.7477,39.4913,24.6714285714286,25.8428571428571,0.000428571428571429,41.7142857142857,76.0628571428571,25.6742857142857,190,2,0,83,57,142,188,142
2020,31,35,"Erzincan",39.7477,39.4913,27.7857142857143,25.7857142857143,0.00442857142857143,42.7857142857143,67.5685714285714,22.3671428571429,150,39,51,77,58,127,111,76
2020,32,35,"Erzincan",39.7477,39.4913,25.0857142857143,24.9142857142857,0,35.3571428571429,47.6942857142857,20.8714285714286,146,20,7,106,83,107,126,100
2020,33,35,"Erzincan",39.7477,39.4913,30.1571428571429,23,0.000428571428571429,43.0857142857143,56.5542857142857,16.38,183,0,0,126,76,83,183,83
2020,34,35,"Erzincan",39.7477,39.4913,28.3,22.5,0.286428571428571,41.5857142857143,43.5271428571429,NA,197,0,0,183,92,97,197,97
2020,35,35,"Erzincan",39.7477,39.4913,19.3142857142857,21.6714285714286,0,37.4428571428571,56.09,32.31,164,5,9,89,87,157,159,148
2020,36,35,"Erzincan",39.7477,39.4913,21.1285714285714,24.2285714285714,0.000428571428571429,33.8142857142857,84.8371428571429,40.4385714285714,179,23,11,93,47,112,156,101
2020,37,35,"Erzincan",39.7477,39.4913,29.9,22.4285714285714,0.000285714285714286,44.0428571428571,72.45,23.9442857142857,193,8,9,95,50,91,185,82
2020,38,35,"Erzincan",39.7477,39.4913,18.7857142857143,21.8285714285714,0,37.8714285714286,83.5528571428571,30.98,235,2,2,128,63,157,233,155
2020,39,35,"Erzincan",39.7477,39.4913,19.1285714285714,19.4142857142857,2.13642857142857,52.4285714285714,78.4928571428571,32.81,220,10,7,153,97,129,210,122
2020,40,35,"Erzincan",39.7477,39.4913,22.4428571428571,18.8,0.00142857142857143,50.4142857142857,79.4042857142857,27.8685714285714,187,24,11,135,126,154,163,143
2020,41,35,"Erzincan",39.7477,39.4913,14.5857142857143,14.4571428571429,0,47.8142857142857,85.4914285714286,36.8885714285714,182,38,27,67,50,127,144,100
2020,42,35,"Erzincan",39.7477,39.4913,6.92857142857143,14.0285714285714,0,50.7,142.48,56.9857142857143,177,30,31,0,0,111,147,80
2020,43,35,"Erzincan",39.7477,39.4913,11.6571428571429,12.5571428571429,0.287428571428571,61.1571428571429,92.266,38.9814285714286,194,25,19,52,85,161,169,142
2020,44,35,"Erzincan",39.7477,39.4913,22.9857142857143,14.7428571428571,0.000428571428571429,42.3285714285714,97.4957142857143,39.3814285714286,255,58,91,0,0,233,197,142
2020,45,35,"Erzincan",39.7477,39.4913,28.8428571428571,10.4571428571429,2.88828571428571,72.2857142857143,42.7114285714286,28.7057142857143,156,34,36,47,29,103,122,67
2020,46,35,"Erzincan",39.7477,39.4913,9.28571428571429,4.97142857142857,0.0848571428571429,69.5571428571429,88.2871428571429,45.5214285714286,208,2,0,75,35,109,206,109
2020,47,35,"Erzincan",39.7477,39.4913,16.3285714285714,3.67142857142857,0.0892857142857143,69.5,70.0985714285714,41.4742857142857,173,8,4,118,57,83,165,79
2020,48,35,"Erzincan",39.7477,39.4913,13.4,0.557142857142857,0,65.6714285714286,105.218571428571,50.0785714285714,199,8,2,58,80,262,191,260
2020,49,35,"Erzincan",39.7477,39.4913,7.75714285714286,1.57142857142857,0.077,77.4285714285714,100.12,51.5114285714286,207,15,1,58,43,116,192,115
2020,50,35,"Erzincan",39.7477,39.4913,15.3428571428571,1.5,0.225,76.6,91.1185714285714,55.8628571428571,181,30,5,65,47,98,151,93
2020,51,35,"Erzincan",39.7477,39.4913,20.6428571428571,2.61428571428571,0.0455714285714286,73.7857142857143,69.9385714285714,46.0657142857143,171,37,13,101,51,90,134,77
2020,52,35,"Erzincan",39.7477,39.4913,12.7142857142857,-2.1,0.096,68.3714285714286,73.8171428571429,51.6571428571429,203,1,0,62,51,113,202,113
2020,53,35,"Erzincan",39.7477,39.4913,7,-2.625,0,67.1,166.1975,65.0675,122,12,12,0,0,111,110,99
2017,1,36,"Erzurum",39.9043,41.2679,7.1,-8.14285714285714,0.112142857142857,79.3,72.4542857142857,89.72,563,147,204,126,143,847,416,643
2017,2,36,"Erzurum",39.9043,41.2679,6.85714285714286,-9.04285714285714,35.3318571428571,81.6571428571429,96.858,107.59,757,0,0,491,883,1214,757,1214
2017,3,36,"Erzurum",39.9043,41.2679,3.68571428571429,-10.2428571428571,0,86.5714285714286,128.888571428571,118.235714285714,762,0,0,409,843,1449,762,1449
2017,4,36,"Erzurum",39.9043,41.2679,9.52857142857143,-10.9285714285714,1.86914285714286,86.8714285714286,64.4471428571429,80.1928571428572,639,148,140,285,453,889,491,749
2017,5,36,"Erzurum",39.9043,41.2679,8.01428571428571,-11.8285714285714,0.813714285714286,81.1857142857143,69.8657142857143,87.3471428571429,588,82,184,375,741,1163,506,979
2017,6,36,"Erzurum",39.9043,41.2679,4.55714285714286,-7.72857142857143,0.113285714285714,91.8571428571429,80.5957142857143,106.321428571429,736,0,0,409,943,1519,736,1519
2017,7,36,"Erzurum",39.9043,41.2679,10.1,-12.8428571428571,0.0701428571428571,80.2,58.0257142857143,78.5428571428571,492,120,250,311,408,717,372,467
2017,8,36,"Erzurum",39.9043,41.2679,7.98571428571428,-6.1,0.141714285714286,75.9571428571429,70.92,94.6442857142857,739,0,0,480,1129,1747,739,1747
2017,9,36,"Erzurum",39.9043,41.2679,7.91428571428571,-0.0142857142857143,28.8882857142857,78.8285714285714,54.3271428571429,78.6871428571429,574,0,0,326,397,866,574,866
2017,10,36,"Erzurum",39.9043,41.2679,11.4857142857143,-0.985714285714286,0.779142857142857,79,46.0683333333333,71.2214285714286,712,53,148,608,855,1043,659,895
2017,11,36,"Erzurum",39.9043,41.2679,12.2142857142857,-0.485714285714286,1.08128571428571,73.8428571428571,26.1428571428571,57.9757142857143,525,60,61,377,418,725,465,664
2017,12,36,"Erzurum",39.9043,41.2679,14.0571428571429,-0.614285714285714,0.169285714285714,63.1428571428571,43.8928571428571,60.4685714285714,589,154,244,363,744,1077,435,833
2017,13,36,"Erzurum",39.9043,41.2679,14.8428571428571,3.61428571428571,1.27628571428571,67.6714285714286,31.5214285714286,52.1414285714286,574,170,192,333,581,887,404,695
2017,14,36,"Erzurum",39.9043,41.2679,15.6857142857143,4.08571428571429,0.856571428571429,57.3142857142857,28.0071428571429,53.9542857142857,639,199,477,439,859,1336,440,859
2017,15,36,"Erzurum",39.9043,41.2679,11.7571428571429,4.58571428571429,2.93171428571429,64.2857142857143,21.5442857142857,44.9485714285714,587,93,437,358,453,1187,494,750
2017,16,36,"Erzurum",39.9043,41.2679,21.8,8.61428571428571,1.20071428571429,53.6571428571429,33.4628571428571,46.8971428571429,717,46,33,369,435,920,671,887
2017,17,36,"Erzurum",39.9043,41.2679,16.4285714285714,7.34285714285714,1.56614285714286,43.8714285714286,20.4185714285714,41.5942857142857,731,454,957,276,521,1478,277,521
2017,18,36,"Erzurum",39.9043,41.2679,14.5285714285714,10.1285714285714,3.63971428571429,58.3714285714286,25.9814285714286,46.0385714285714,506,79,164,317,613,923,427,759
2017,19,36,"Erzurum",39.9043,41.2679,20.4857142857143,11.6428571428571,0.672857142857143,52.5285714285714,27.67,42.16,471,0,0,417,835,966,471,966
2017,20,36,"Erzurum",39.9043,41.2679,16.5857142857143,11.0571428571429,2.20871428571429,57.5714285714286,20.8842857142857,39.4671428571429,472,149,529,260,591,1205,323,676
2017,21,36,"Erzurum",39.9043,41.2679,17.1,9.9,3.178,57.3571428571429,16.19,41.0371428571429,448,0,0,376,665,849,448,849
2017,22,36,"Erzurum",39.9043,41.2679,11.5285714285714,13.0428571428571,0.0851428571428571,50.6571428571429,23.9585714285714,42.27,522,55,85,246,358,1015,467,930
2017,23,36,"Erzurum",39.9043,41.2679,15.2714285714286,17.8428571428571,0,42.4571428571429,31.3128571428571,37.5257142857143,578,66,161,301,759,1388,512,1227
2017,24,36,"Erzurum",39.9043,41.2679,13.0714285714286,15.2428571428571,1.16928571428571,49.6142857142857,17.81,35.4228571428571,552,0,0,437,929,1139,552,1139
2017,25,36,"Erzurum",39.9043,41.2679,10.9571428571429,15.2428571428571,1.26757142857143,51.9285714285714,21.6614285714286,36.1685714285714,584,19,28,290,455,1041,565,1013
2017,26,36,"Erzurum",39.9043,41.2679,13.8285714285714,21.4142857142857,0,36.8285714285714,26.4542857142857,27.3128571428571,564,305,529,64,134,971,259,442
2017,27,36,"Erzurum",39.9043,41.2679,11.7,21.1428571428571,0.0561428571428571,39.5571428571429,30.0457142857143,29.5757142857143,511,274,281,83,116,642,237,361
2017,28,36,"Erzurum",39.9043,41.2679,11.9142857142857,20.9,0.113285714285714,38.3142857142857,28.9428571428571,33.5228571428571,481,149,230,14,26,864,332,634
2017,29,36,"Erzurum",39.9043,41.2679,13.1571428571429,23.7285714285714,0,29.7,38.4714285714286,41.93,532,171,423,160,321,1272,361,849
2017,30,36,"Erzurum",39.9043,41.2679,12.3428571428571,21.4714285714286,0.579428571428571,37.9285714285714,30.3571428571429,39.9628571428571,531,223,482,150,173,928,308,446
2017,31,36,"Erzurum",39.9043,41.2679,17.9857142857143,24.4571428571429,0.0145714285714286,27.7428571428571,39.7757142857143,33.1442857142857,559,196,388,72,209,1047,363,659
2017,32,36,"Erzurum",39.9043,41.2679,15.1857142857143,24.2285714285714,0,23.7285714285714,36.4928571428571,41.3942857142857,567,181,430,225,348,1092,386,662
2017,33,36,"Erzurum",39.9043,41.2679,14.5714285714286,20.3571428571429,3.82428571428571,46.1714285714286,28.3814285714286,33.58,596,125,219,182,416,1199,471,980
2017,34,36,"Erzurum",39.9043,41.2679,12.5142857142857,21.6142857142857,0,36.5285714285714,34.9714285714286,25.1428571428571,601,309,606,171,459,1280,292,674
2017,35,36,"Erzurum",39.9043,41.2679,15.3857142857143,20.3142857142857,0,30.0428571428571,31.7671428571429,37.1842857142857,493,0,0,323,735,1014,493,1014
2017,36,36,"Erzurum",39.9043,41.2679,12.2285714285714,18.6714285714286,0.001,28.4714285714286,24.47,39.59,507,148,480,179,484,1321,359,841
2017,37,36,"Erzurum",39.9043,41.2679,7.82857142857143,19.8142857142857,0,25.6428571428571,43.86,45.9842857142857,589,320,648,73,185,1138,269,490
2017,38,36,"Erzurum",39.9043,41.2679,12.8142857142857,18.8428571428571,4.62657142857143,29.6857142857143,60.75,51.8471428571429,671,71,160,337,587,1312,600,1152
2017,39,36,"Erzurum",39.9043,41.2679,12.2428571428571,14.1714285714286,0.147142857142857,45.9571428571429,40.4671428571429,45.2357142857143,782,86,392,261,438,1630,696,1238
2017,40,36,"Erzurum",39.9043,41.2679,11.1714285714286,8.21428571428571,1.41628571428571,55.9285714285714,24.0357142857143,44.3428571428571,543,156,407,238,470,1137,387,730
2017,41,36,"Erzurum",39.9043,41.2679,10.8,8.12857142857143,4.17642857142857,67.8857142857143,27.2957142857143,49.4714285714286,487,85,241,224,291,843,402,602
2017,42,36,"Erzurum",39.9043,41.2679,15.1571428571429,6.18571428571429,0,54.3714285714286,31.1214285714286,53.1928571428571,530,49,111,290,424,815,481,704
2017,43,36,"Erzurum",39.9043,41.2679,14.9857142857143,9.12857142857143,0.283,51.0142857142857,57.7928571428571,57.2685714285714,506,0,0,444,696,919,506,919
2017,44,36,"Erzurum",39.9043,41.2679,12.5714285714286,3.62857142857143,1.24157142857143,61.9142857142857,34.0171428571429,55.9957142857143,561,69,129,375,738,1102,492,973
2017,45,36,"Erzurum",39.9043,41.2679,5.87142857142857,5.31428571428571,3.56157142857143,74.6142857142857,45.042,57.8342857142857,577,0,0,416,583,829,577,829
2017,46,36,"Erzurum",39.9043,41.2679,4.12857142857143,4.47142857142857,0.100857142857143,63.5285714285714,68.735,59.83,587,223,443,61,98,1085,364,642
2017,47,36,"Erzurum",39.9043,41.2679,15.6857142857143,-2.51428571428571,1.47142857142857,70.7571428571429,25.48,46.3528571428571,418,0,0,416,804,804,418,804
2017,48,36,"Erzurum",39.9043,41.2679,6.02857142857143,-2.51428571428571,1.03757142857143,80.4428571428571,64.4557142857143,70.4157142857143,386,52,109,132,211,619,334,510
2017,49,36,"Erzurum",39.9043,41.2679,9.4,-3.88571428571429,0.595714285714286,77.3285714285714,63.0514285714286,62.9842857142857,407,66,111,142,254,645,341,534
2017,50,36,"Erzurum",39.9043,41.2679,1.98571428571429,-4.77142857142857,9.82914285714286,77.1571428571429,116.254285714286,98.4442857142857,346,5,3,31,122,442,341,439
2017,51,36,"Erzurum",39.9043,41.2679,15.5285714285714,2.5,9.05085714285714,76.2857142857143,62.2371428571429,60.6542857142857,386,0,0,214,211,349,386,349
2017,52,36,"Erzurum",39.9043,41.2679,8.7125,-0.675,0.016375,69.4875,59.1,69.68,528,51,122,154,168,507,477,385
2018,1,36,"Erzurum",39.9043,41.2679,3.1625,-4.65,2.98625,85.95,79.6242857142857,84.69375,618,166,187,52,110,914,452,727
2018,2,36,"Erzurum",39.9043,41.2679,9.81428571428571,-6.32857142857143,20.4065714285714,78.1142857142857,93.8716666666667,84.93,624,0,0,315,291,1309,624,1309
2018,3,36,"Erzurum",39.9043,41.2679,7.37142857142857,-4.55714285714286,0.361,81.4142857142857,78.43,66.9942857142857,639,135,285,96,89,655,504,370
2018,4,36,"Erzurum",39.9043,41.2679,11.9571428571429,-1.88571428571429,37.5947142857143,78.2857142857143,49.72,48.8128571428571,604,100,154,48,116,764,504,610
2018,5,36,"Erzurum",39.9043,41.2679,8.45714285714286,-6.84285714285714,35.19,75.6857142857143,59.338,85.5985714285714,670,0,0,256,263,819,670,819
2018,6,36,"Erzurum",39.9043,41.2679,5.57142857142857,-2.61428571428571,0.100285714285714,75.9571428571429,107.676,95.6357142857143,704,121,147,31,96,1022,583,875
2018,7,36,"Erzurum",39.9043,41.2679,10.0285714285714,0.214285714285714,18.9218571428571,76.4142857142857,43.5,66.7971428571429,478,98,122,89,118,557,380,435
2018,8,36,"Erzurum",39.9043,41.2679,5.31428571428571,-1.08571428571429,0.172571428571429,72.8142857142857,66.5885714285714,79.17,711,105,171,89,277,1321,606,1150
2018,9,36,"Erzurum",39.9043,41.2679,13.7285714285714,0.257142857142857,1.451,76.5,32.2285714285714,63.2242857142857,621,85,98,275,461,956,536,858
2018,10,36,"Erzurum",39.9043,41.2679,16.6142857142857,2.87142857142857,2.33442857142857,70.0285714285714,37.776,56.9114285714286,556,0,0,402,1096,1330,556,1330
2018,11,36,"Erzurum",39.9043,41.2679,16.3142857142857,4.45714285714286,0.0882857142857143,59.9571428571429,38.07,60.8271428571429,551,0,0,432,986,1426,551,1426
2018,12,36,"Erzurum",39.9043,41.2679,22.9,8.2,1.00642857142857,48.0285714285714,62.2866666666667,52.7114285714286,425,0,0,390,1101,1187,425,1187
2018,13,36,"Erzurum",39.9043,41.2679,13.9571428571429,6.71428571428571,0.824571428571429,58.2,43.4814285714286,55.1042857142857,356,0,0,306,371,428,356,428
2018,14,36,"Erzurum",39.9043,41.2679,8.81428571428571,5.98571428571429,2.12042857142857,52.4714285714286,31.9257142857143,63.1671428571429,407,0,0,170,289,486,407,486
2018,15,36,"Erzurum",39.9043,41.2679,13.5857142857143,8.94285714285714,0.155857142857143,51.8428571428571,29.5528571428571,46.9585714285714,374,12,16,14,67,450,362,434
2018,16,36,"Erzurum",39.9043,41.2679,13.0714285714286,7.2,1.92728571428571,42.8571428571429,23.89,41.3542857142857,411,121,130,87,311,648,290,518
2018,17,36,"Erzurum",39.9043,41.2679,14.0428571428571,10.8,0.112714285714286,48.2142857142857,26.8457142857143,33.6657142857143,419,49,83,128,198,652,370,569
2018,18,36,"Erzurum",39.9043,41.2679,13.5857142857143,11.3428571428571,4.70142857142857,67.0428571428571,29.0442857142857,37.8414285714286,303,44,186,97,165,474,259,288
2018,19,36,"Erzurum",39.9043,41.2679,11.4714285714286,8.74285714285714,7.77642857142857,77.6857142857143,23.6557142857143,36.6314285714286,275,75,235,62,82,467,200,232
2018,20,36,"Erzurum",39.9043,41.2679,10.8,11.6571428571429,3.00385714285714,70.1857142857143,24.605,39.5528571428571,204,76,135,69,127,306,128,171
2018,21,36,"Erzurum",39.9043,41.2679,11.7857142857143,12.4571428571429,7.86185714285714,73.6285714285714,32.6214285714286,47.33,252,36,92,63,55,281,216,189
2018,22,36,"Erzurum",39.9043,41.2679,14.6571428571429,12.3,4.22828571428571,73.7285714285714,29.5728571428571,50.4485714285714,249,27,70,125,212,427,222,357
2018,23,36,"Erzurum",39.9043,41.2679,11.6142857142857,14.0142857142857,1.51357142857143,65.2857142857143,23.6642857142857,55.7785714285714,267,48,117,72,371,812,219,695
2018,24,36,"Erzurum",39.9043,41.2679,13.9142857142857,15.4428571428571,0.830142857142857,61.6714285714286,27.26,47.776,267,42,109,58,190,448,225,339
2018,25,36,"Erzurum",39.9043,41.2679,13.0142857142857,14.3857142857143,4.71028571428571,70.9285714285714,22.9257142857143,46.8028571428571,358,13,67,173,220,518,345,451
2018,26,36,"Erzurum",39.9043,41.2679,12.7714285714286,21.0142857142857,0.281,47.2857142857143,33.8085714285714,45.0671428571429,355,141,280,94,157,587,214,307
2018,27,36,"Erzurum",39.9043,41.2679,13.3428571428571,22.0714285714286,0.313142857142857,47.7,42.9485714285714,40.8528571428571,342,39,55,53,82,418,303,363
2018,28,36,"Erzurum",39.9043,41.2679,13.3285714285714,21.9571428571429,4.505,47.7,38.7528571428571,45.6557142857143,286,106,179,55,111,585,180,406
2018,29,36,"Erzurum",39.9043,41.2679,11.1714285714286,18.5857142857143,1.284,54.0142857142857,21.0983333333333,36.2585714285714,260,77,302,48,141,756,183,454
2018,30,36,"Erzurum",39.9043,41.2679,12.8428571428571,21.7714285714286,0.00271428571428571,37.7428571428571,37.7471428571429,53.5842857142857,265,70,121,126,516,822,195,701
2018,31,36,"Erzurum",39.9043,41.2679,12.0285714285714,20.3142857142857,2.62728571428571,54.6857142857143,31.0985714285714,49.7328571428571,267,122,203,46,120,499,145,296
2018,32,36,"Erzurum",39.9043,41.2679,10.5714285714286,20.0142857142857,1.05242857142857,54.9285714285714,22.1442857142857,30.4371428571429,297,105,197,0,0,403,192,206
2018,33,36,"Erzurum",39.9043,41.2679,12.7857142857143,19.9857142857143,1.54214285714286,46.3142857142857,26.0114285714286,27.5757142857143,216,108,191,0,0,332,108,141
2018,34,36,"Erzurum",39.9043,41.2679,12.9571428571429,20.0571428571429,1.04328571428571,51.6,20.4171428571429,34.8114285714286,144,52,112,15,32,227,92,115
2018,35,36,"Erzurum",39.9043,41.2679,10.9142857142857,21.3142857142857,0.112428571428571,37.7428571428571,36.0728571428571,44.8957142857143,201,84,186,32,60,314,117,128
2018,36,36,"Erzurum",39.9043,41.2679,18.0571428571429,17.9428571428571,0.300142857142857,48.4,34.2171428571429,51.9414285714286,341,10,27,264,246,370,331,343
2018,37,36,"Erzurum",39.9043,41.2679,16.6714285714286,14.9142857142857,0.811285714285714,60,36.642,65.0314285714286,241,9,60,137,272,419,232,359
2018,38,36,"Erzurum",39.9043,41.2679,22.8714285714286,14.7142857142857,0.142857142857143,53.2571428571429,27.4242857142857,61.8457142857143,189,119,216,12,32,344,70,128
2018,39,36,"Erzurum",39.9043,41.2679,9.82857142857143,14.5714285714286,0,49.3857142857143,35.7757142857143,76.9671428571429,180,72,160,12,71,353,108,193
2018,40,36,"Erzurum",39.9043,41.2679,16.4,12.6142857142857,0.0711428571428571,46.4285714285714,31.4171428571429,67.8371428571429,191,16,62,88,204,341,175,279
2018,41,36,"Erzurum",39.9043,41.2679,11.8285714285714,12.0714285714286,1.16785714285714,62.9285714285714,54.9383333333333,70.2185714285714,187,54,307,22,17,422,133,115
2018,42,36,"Erzurum",39.9043,41.2679,7.91428571428571,11.5,0.715571428571429,54.8857142857143,86.4814285714286,79.58,168,53,109,18,67,381,115,272
2018,43,36,"Erzurum",39.9043,41.2679,14.9714285714286,6.25714285714286,8.69571428571428,78.2428571428571,37.1828571428571,68.9757142857143,187,0,0,176,388,402,187,402
2018,44,36,"Erzurum",39.9043,41.2679,11.8714285714286,6.37142857142857,0,57.2142857142857,35.98,72.9214285714286,196,31,95,0,0,264,165,169
2018,45,36,"Erzurum",39.9043,41.2679,8.74285714285714,3.1,0.618428571428571,69.0285714285714,40.5114285714286,76.8971428571429,231,118,306,43,109,473,113,167
2018,46,36,"Erzurum",39.9043,41.2679,9.68571428571429,1.21428571428571,1.54442857142857,73.8285714285714,32.0685714285714,78.2142857142857,230,22,87,128,241,465,208,378
2018,47,36,"Erzurum",39.9043,41.2679,10.2428571428571,2.05714285714286,0.175,78.3,37.01,65.9128571428571,270,7,50,91,154,499,263,449
2018,48,36,"Erzurum",39.9043,41.2679,13.1428571428571,3.01428571428571,1.44414285714286,79.7142857142857,NA,59.4771428571429,245,14,49,114,95,201,231,152
2018,49,36,"Erzurum",39.9043,41.2679,6.77142857142857,0.0714285714285714,0.641428571428571,85.2,NA,93.9285714285714,257,80,184,20,44,420,177,236
2018,50,36,"Erzurum",39.9043,41.2679,13.7571428571429,-1.21428571428571,13.0858571428571,83.1571428571429,NA,64.2342857142857,256,0,0,115,210,305,256,305
2018,51,36,"Erzurum",39.9043,41.2679,4.38571428571429,-2.57142857142857,5.86228571428571,90.4142857142857,NA,89.31,250,10,28,65,165,248,240,220
2018,52,36,"Erzurum",39.9043,41.2679,8.6,-5.1,9.715,83.3428571428571,NA,84.0385714285714,244,71,107,98,129,273,173,166
2019,1,36,"Erzurum",39.9043,41.2679,8.3375,-2.8375,40.660875,75.9125,NA,85.6375,343,0,0,133,322,784,343,784
2019,2,36,"Erzurum",39.9043,41.2679,8.4,-8.22857142857143,1.43471428571429,75.9857142857143,NA,103.295714285714,255,6,12,94,131,208,249,196
2019,3,36,"Erzurum",39.9043,41.2679,8.64285714285714,-7.74285714285714,30.1625714285714,78.1857142857143,NA,102.288571428571,192,0,0,31,71,198,192,198
2019,4,36,"Erzurum",39.9043,41.2679,6.15714285714286,-5.04285714285714,27.6075714285714,75.9,NA,121.025714285714,308,4,64,90,123,314,304,250
2019,5,36,"Erzurum",39.9043,41.2679,4.24285714285714,-4.21428571428571,54.017,80.9857142857143,NA,103.825714285714,253,36,9,52,60,143,217,134
2019,6,36,"Erzurum",39.9043,41.2679,3.48571428571429,-5.27142857142857,0.600714285714286,83.3571428571429,NA,119.581428571429,276,7,5,29,14,127,269,122
2019,7,36,"Erzurum",39.9043,41.2679,7.02857142857143,-5.62857142857143,0.868714285714286,80.9714285714286,NA,111.511428571429,325,3,14,70,52,234,322,220
2019,8,36,"Erzurum",39.9043,41.2679,7.65714285714286,-5.68571428571429,25.2501428571429,73.4714285714286,NA,109.817142857143,305,0,0,72,43,219,305,219
2019,9,36,"Erzurum",39.9043,41.2679,11.6285714285714,-4.05714285714286,3.87714285714286,79.6428571428571,NA,79.2928571428571,331,35,22,142,215,310,296,288
2019,10,36,"Erzurum",39.9043,41.2679,4.38571428571429,-4.07142857142857,0.737,77.8428571428571,NA,96.9757142857143,359,0,0,16,23,252,359,252
2019,11,36,"Erzurum",39.9043,41.2679,13.5428571428571,1.14285714285714,0.220142857142857,75.6714285714286,NA,62.0971428571429,373,47,74,142,258,400,326,326
2019,12,36,"Erzurum",39.9043,41.2679,8.47142857142857,-2.11428571428571,0.523,65.7714285714286,NA,74.1657142857143,343,0,0,51,31,416,343,416
2019,13,36,"Erzurum",39.9043,41.2679,13.1285714285714,0.471428571428571,2.85042857142857,82.3714285714286,NA,48.8657142857143,256,21,37,64,70,194,235,157
2019,14,36,"Erzurum",39.9043,41.2679,11.8714285714286,2.94285714285714,1.26185714285714,77.9571428571429,NA,59.8828571428571,365,5,3,205,152,208,360,205
2019,15,36,"Erzurum",39.9043,41.2679,11.9285714285714,5.95714285714286,0.958428571428571,63.7142857142857,NA,61.9685714285714,359,53,29,221,136,183,306,154
2019,16,36,"Erzurum",39.9043,41.2679,13.1571428571429,3.31428571428571,6.87542857142857,79.9857142857143,NA,48.7985714285714,318,21,35,136,107,208,297,173
2019,17,36,"Erzurum",39.9043,41.2679,10.0428571428571,4.44285714285714,0.425428571428571,57.2714285714286,NA,56.2957142857143,412,135,108,85,84,313,277,205
2019,18,36,"Erzurum",39.9043,41.2679,16.7857142857143,8.21428571428571,4.79314285714286,69.0142857142857,NA,58.8242857142857,523,5,2,372,305,353,518,351
2019,19,36,"Erzurum",39.9043,41.2679,14.9285714285714,10.2142857142857,4.68471428571429,58.7428571428571,NA,55.8428571428571,452,0,0,444,375,386,452,386
2019,20,36,"Erzurum",39.9043,41.2679,11.7857142857143,14.7714285714286,0.126142857142857,45.0142857142857,NA,62.4314285714286,454,54,61,96,91,389,400,328
2019,21,36,"Erzurum",39.9043,41.2679,18.6857142857143,13.3142857142857,0.852714285714286,58,NA,48.22,457,0,0,98,71,413,457,413
2019,22,36,"Erzurum",39.9043,41.2679,9.4,16.4428571428571,0.199,43.0857142857143,NA,50.0514285714286,453,85,26,74,94,323,368,297
2019,23,36,"Erzurum",39.9043,41.2679,17,19.0428571428571,0.0571428571428571,40.5857142857143,NA,48.6957142857143,378,5,3,259,278,532,373,529
2019,24,36,"Erzurum",39.9043,41.2679,14.2714285714286,18.4428571428571,0.255857142857143,43.3714285714286,NA,37.7328571428571,378,99,57,48,13,244,279,187
2019,25,36,"Erzurum",39.9043,41.2679,12.7142857142857,17.4285714285714,2.54557142857143,59.0142857142857,NA,39.6357142857143,306,94,84,54,31,325,212,241
2019,26,36,"Erzurum",39.9043,41.2679,10.9714285714286,19.7428571428571,0.140142857142857,48.9857142857143,NA,27.7671428571429,377,203,248,2,1,342,174,94
2019,27,36,"Erzurum",39.9043,41.2679,13.8857142857143,17.3285714285714,0.623142857142857,46.1142857142857,NA,15.9814285714286,456,267,109,0,0,222,189,113
2019,28,36,"Erzurum",39.9043,41.2679,13.6285714285714,18.7428571428571,1.01157142857143,47.2571428571429,NA,20.6528571428571,398,125,83,28,28,421,273,338
2019,29,36,"Erzurum",39.9043,41.2679,14.9142857142857,20.6571428571429,0.014,42.1714285714286,NA,20.4185714285714,453,71,30,166,44,203,382,173
2019,30,36,"Erzurum",39.9043,41.2679,10.3714285714286,21.0571428571429,0,44.3571428571429,NA,26.945,456,62,95,65,60,335,394,240
2019,31,36,"Erzurum",39.9043,41.2679,14.8571428571429,22.3142857142857,0,35.1714285714286,NA,41.7585714285714,334,30,39,128,129,375,304,336
2019,32,36,"Erzurum",39.9043,41.2679,14.5571428571429,19.8714285714286,0,41.4571428571429,NA,20.32,346,233,303,3,21,395,113,92
2019,33,36,"Erzurum",39.9043,41.2679,14.1142857142857,23.1571428571429,0,31.5142857142857,NA,45.1457142857143,337,90,94,194,368,531,247,437
2019,34,36,"Erzurum",39.9043,41.2679,14.3142857142857,20.9142857142857,1.02585714285714,41.3285714285714,NA,47.6628571428571,299,34,38,75,101,345,265,307
2019,35,36,"Erzurum",39.9043,41.2679,11.2142857142857,18.4428571428571,3.57685714285714,53.2142857142857,NA,35.0642857142857,307,135,173,54,76,415,172,242
2019,36,36,"Erzurum",39.9043,41.2679,12.8428571428571,17.2571428571429,0.014,47.1,NA,38.0933333333333,171,57,38,24,7,67,114,29
2019,37,36,"Erzurum",39.9043,41.2679,15.1571428571429,14.2,1.76771428571429,54.7142857142857,NA,25.305,218,39,16,0,0,55,179,39
2019,38,36,"Erzurum",39.9043,41.2679,16.4428571428571,13.8428571428571,0.530571428571428,50.0428571428571,NA,53.835,266,33,7,58,36,91,233,84
2019,39,36,"Erzurum",39.9043,41.2679,15.0428571428571,13.9285714285714,0.425857142857143,41.4,NA,NA,237,0,0,122,50,79,237,79
2019,40,36,"Erzurum",39.9043,41.2679,12.5428571428571,13.6571428571429,1.03085714285714,42.9142857142857,NA,47.64,241,7,2,76,57,111,234,109
2019,41,36,"Erzurum",39.9043,41.2679,11.8,13.0285714285714,0.042,48.6714285714286,NA,NA,416,11,44,188,164,448,405,404
2019,42,36,"Erzurum",39.9043,41.2679,7.12857142857143,11.6142857142857,0.436714285714286,41.9571428571429,NA,45.38,356,32,75,93,134,408,324,333
2019,43,36,"Erzurum",39.9043,41.2679,9.5,8.67142857142857,0.598428571428571,62.1571428571429,NA,46.424,306,99,137,0,0,300,207,163
2019,44,36,"Erzurum",39.9043,41.2679,10.0714285714286,4.65714285714286,4.81171428571429,68.7285714285714,NA,53.7271428571429,350,10,16,214,166,250,340,234
2019,45,36,"Erzurum",39.9043,41.2679,5.1,3.75714285714286,0,55.2571428571429,NA,74.4271428571429,417,31,40,18,26,328,386,288
2019,46,36,"Erzurum",39.9043,41.2679,7.98571428571429,3.6,0,46.4714285714286,NA,87.1057142857143,401,69,74,124,134,337,332,263
2019,47,36,"Erzurum",39.9043,41.2679,5.21428571428571,0.414285714285714,0,47.0714285714286,NA,70.1371428571429,391,47,29,59,32,339,344,310
2019,48,36,"Erzurum",39.9043,41.2679,9.87142857142857,1.74285714285714,3.30771428571429,77.3285714285714,NA,64.4385714285714,320,59,19,143,128,251,261,232
2019,49,36,"Erzurum",39.9043,41.2679,9.32857142857143,-3.05714285714286,4.08414285714286,83.7,NA,57.2457142857143,393,154,106,94,52,274,239,168
2019,50,36,"Erzurum",39.9043,41.2679,4.2,-2.88571428571429,0.202142857142857,87.5428571428571,NA,84.7128571428571,218,16,15,4,0,119,202,104
2019,51,36,"Erzurum",39.9043,41.2679,3.22857142857143,-3.15714285714286,0.280428571428571,78.8,NA,92.3625,361,0,0,66,120,488,361,488
2019,52,36,"Erzurum",39.9043,41.2679,11.2285714285714,0.557142857142857,1.13914285714286,70.2857142857143,NA,43.6933333333333,279,63,32,43,88,281,216,249
2020,1,36,"Erzurum",39.9043,41.2679,4.92,-5.06,0.474,83.42,NA,61.166,160,21,3,46,29,126,139,123
2020,2,36,"Erzurum",39.9043,41.2679,7.35714285714286,-5.31428571428571,0.125,78.2714285714286,NA,68.8414285714286,240,53,45,17,4,173,187,128
2020,3,36,"Erzurum",39.9043,41.2679,8.71428571428571,-9.08571428571429,0.347571428571429,73.0571428571429,NA,91.98,270,7,16,73,142,382,263,366
2020,4,36,"Erzurum",39.9043,41.2679,6.62857142857143,-8.71428571428572,0.351857142857143,74.9857142857143,NA,75.326,358,16,2,100,59,295,342,293
2020,5,36,"Erzurum",39.9043,41.2679,12.0428571428571,-4.1,0.580714285714286,68.1714285714286,NA,69.34,331,0,0,132,101,272,331,272
2020,6,36,"Erzurum",39.9043,41.2679,19.1,-2.85714285714286,12.9408571428571,70.3428571428571,NA,35.7975,343,0,0,293,204,267,343,267
2020,7,36,"Erzurum",39.9043,41.2679,9.24285714285714,-11.7428571428571,0.566571428571429,72.0428571428571,NA,NA,341,38,88,41,18,338,303,250
2020,8,36,"Erzurum",39.9043,41.2679,9.61428571428571,-2.07142857142857,41.0195714285714,80.9285714285714,NA,NA,283,14,16,10,11,187,269,171
2020,9,36,"Erzurum",39.9043,41.2679,11.1428571428571,-1.55714285714286,4.98471428571429,74.2571428571429,NA,NA,393,123,214,96,106,528,270,314
2020,10,36,"Erzurum",39.9043,41.2679,7.18571428571429,0.942857142857143,0.0797142857142857,68.2714285714286,NA,NA,205,43,71,22,24,210,162,139
2020,11,36,"Erzurum",39.9043,41.2679,13.4,5.21428571428571,0.629714285714286,70.4285714285714,NA,NA,115,5,5,85,62,94,110,89
2020,12,36,"Erzurum",39.9043,41.2679,11.7,1.44285714285714,4.36028571428572,81.9142857142857,NA,NA,117,25,44,11,6,118,92,74
2020,13,36,"Erzurum",39.9043,41.2679,14.2571428571429,4.11428571428571,1.37971428571429,71.0142857142857,30.645,NA,136,15,17,33,11,92,121,75
2020,14,36,"Erzurum",39.9043,41.2679,15.7571428571429,3.24285714285714,3.51257142857143,75.1571428571429,19.6714285714286,NA,155,0,0,116,110,121,155,121
2020,15,36,"Erzurum",39.9043,41.2679,15.4142857142857,4.5,0.143857142857143,61.2571428571429,27.6514285714286,NA,133,38,86,8,4,118,95,32
2020,16,36,"Erzurum",39.9043,41.2679,13.9285714285714,6.72857142857143,1.425,55.1714285714286,28.3542857142857,NA,141,0,0,111,96,106,141,106
2020,17,36,"Erzurum",39.9043,41.2679,15.9857142857143,6.18571428571429,3.87928571428571,72,19.7671428571429,NA,137,28,13,78,75,123,109,110
2020,18,36,"Erzurum",39.9043,41.2679,14.6285714285714,8,1.17085714285714,62.7571428571429,21.0557142857143,NA,146,0,0,110,99,164,146,164
2020,19,36,"Erzurum",39.9043,41.2679,16.2857142857143,7.1,11.9072857142857,76.3,19.9485714285714,NA,137,9,4,105,134,157,128,153
2020,20,36,"Erzurum",39.9043,41.2679,11.6,12.5142857142857,0,48.0857142857143,35.9785714285714,NA,164,0,0,43,58,164,164,164
2020,21,36,"Erzurum",39.9043,41.2679,14.3428571428571,13.7857142857143,5.04528571428571,48.7142857142857,37.0285714285714,NA,146,7,0,72,38,96,139,96
2020,22,36,"Erzurum",39.9043,41.2679,14.4285714285714,13.7428571428571,1.816,51.3,24.9171428571429,NA,118,11,4,65,51,100,107,96
2020,23,36,"Erzurum",39.9043,41.2679,15.4428571428571,14.9857142857143,0.028,42.9428571428571,32.3485714285714,NA,112,13,15,79,50,70,99,55
2020,24,36,"Erzurum",39.9043,41.2679,13.8285714285714,17.1428571428571,1.27671428571429,44.1714285714286,34.7042857142857,16.53,140,18,45,48,37,150,122,105
2020,25,36,"Erzurum",39.9043,41.2679,12.9857142857143,14.9571428571429,2.00742857142857,62.8285714285714,27.4428571428571,31.2328571428571,137,30,27,30,41,108,107,81
2020,26,36,"Erzurum",39.9043,41.2679,11.6857142857143,18.0142857142857,0.342,52.6857142857143,24.8557142857143,28.6514285714286,173,59,40,49,57,133,114,93
2020,27,36,"Erzurum",39.9043,41.2679,13.8714285714286,17.9142857142857,1.295,51.3857142857143,24.7314285714286,24.0871428571429,113,32,16,0,0,113,81,97
2020,28,36,"Erzurum",39.9043,41.2679,15.4285714285714,19.5285714285714,0.943142857142857,51.9,27.8971428571429,23.7828571428571,164,75,67,30,9,122,89,55
2020,29,36,"Erzurum",39.9043,41.2679,11.7714285714286,20.7428571428571,0.256142857142857,47.9857142857143,27.7971428571429,30.7071428571429,186,144,87,0,0,111,42,24
2020,30,36,"Erzurum",39.9043,41.2679,15.4,21.9428571428571,0.718285714285714,43.1714285714286,39.2971428571429,32.8657142857143,190,89,89,38,25,142,101,53
2020,31,36,"Erzurum",39.9043,41.2679,18.9714285714286,21.4,1.36228571428571,44.7571428571429,38.275,30.4442857142857,150,45,37,61,69,127,105,90
2020,32,36,"Erzurum",39.9043,41.2679,13.5,20.7,0.014,37.4,NA,17.7342857142857,146,66,73,0,0,107,80,34
2020,33,36,"Erzurum",39.9043,41.2679,13.3714285714286,19.1428571428571,0.581571428571429,47.6714285714286,NA,22.4685714285714,183,124,65,0,0,83,59,18
2020,34,36,"Erzurum",39.9043,41.2679,12.0714285714286,18.7285714285714,0.413,48.6142857142857,NA,31.842,197,47,53,31,18,97,150,44
2020,35,36,"Erzurum",39.9043,41.2679,10.8142857142857,18.5142857142857,0,37.5,NA,37.11,164,85,71,0,0,157,79,86
2020,36,36,"Erzurum",39.9043,41.2679,12.9571428571429,21.1714285714286,0.0561428571428571,30.3285714285714,52.9066666666667,51.8885714285714,179,51,24,82,53,112,128,88
2020,37,36,"Erzurum",39.9043,41.2679,11.4142857142857,19.3714285714286,0,40.1285714285714,34.7271428571429,38.6685714285714,193,64,22,46,40,91,129,69
2020,38,36,"Erzurum",39.9043,41.2679,9.84285714285714,18.4571428571429,0,36.3,44.6271428571429,54.6371428571429,235,99,42,34,32,157,136,115
2020,39,36,"Erzurum",39.9043,41.2679,9.84285714285714,15.5,3.586,54,40.2285714285714,48.4142857142857,220,32,28,120,38,129,188,101
2020,40,36,"Erzurum",39.9043,41.2679,10.6285714285714,14.3428571428571,0.05,52.1142857142857,41.1942857142857,44.42,187,110,91,76,63,154,77,63
2020,41,36,"Erzurum",39.9043,41.2679,10,10.3,0,52.1142857142857,24.2228571428571,27.7714285714286,182,88,54,0,0,127,94,73
2020,42,36,"Erzurum",39.9043,41.2679,5.51428571428571,12.4857142857143,0,39.2285714285714,59.4728571428571,66.2342857142857,177,72,35,17,13,111,105,76
2020,43,36,"Erzurum",39.9043,41.2679,7.45714285714286,10.1571428571429,0.984,52.3714285714286,51.4685714285714,62.9614285714286,194,52,29,65,41,161,142,132
2020,44,36,"Erzurum",39.9043,41.2679,13.7142857142857,11.1714285714286,0,39.2,73.2042857142857,66.0385714285714,255,34,44,162,139,233,221,189
2020,45,36,"Erzurum",39.9043,41.2679,11.8571428571429,5.88571428571429,4.25385714285714,81.8285714285714,27.0014285714286,36.9757142857143,156,69,39,30,22,103,87,64
2020,46,36,"Erzurum",39.9043,41.2679,4.15714285714286,2.75714285714286,0,66.4857142857143,56.3014285714286,66.3014285714286,208,99,63,31,4,109,109,46
2020,47,36,"Erzurum",39.9043,41.2679,6.57142857142857,0.757142857142857,0.510857142857143,75.3571428571429,52.7071428571429,66.6,173,35,29,82,32,83,138,54
2020,48,36,"Erzurum",39.9043,41.2679,7.64285714285714,-2.15714285714286,0,68.6285714285714,58.7214285714286,71.3057142857143,199,49,70,56,99,262,150,192
2020,49,36,"Erzurum",39.9043,41.2679,6.88571428571429,-1.28571428571429,0.0151428571428571,80.4285714285714,50.1714285714286,53.5242857142857,207,45,57,61,24,116,162,59
2020,50,36,"Erzurum",39.9043,41.2679,4.8,-2.34285714285714,0.764142857142857,85.4857142857143,45.4442857142857,63.4057142857143,181,32,10,27,12,98,149,88
2020,51,36,"Erzurum",39.9043,41.2679,7.32857142857143,-0.5,1.10842857142857,82.8,35.2885714285714,52.0785714285714,171,34,14,104,52,90,137,76
2020,52,36,"Erzurum",39.9043,41.2679,4.67142857142857,-7.71428571428571,1.80728571428571,79.4,59.8428571428571,67.6414285714286,203,37,13,49,49,113,166,100
2020,53,36,"Erzurum",39.9043,41.2679,1.95,-7.175,0,79.5,105.285,124.3675,122,8,3,63,69,111,114,108
2017,1,37,"Tepebasi",39.7667,30.5256,21.5142857142857,-3.65714285714286,0.818285714285714,83.4714285714286,17.5285714285714,NA,563,362,521,186,310,847,201,326
2017,2,37,"Tepebasi",39.7667,30.5256,24.7142857142857,-1.9,0.485428571428571,80.2428571428571,23.3228571428571,NA,757,684,1153,0,0,1214,73,61
2017,3,37,"Tepebasi",39.7667,30.5256,18.5571428571429,1.68571428571429,1.74885714285714,85.8571428571429,16.514,NA,762,407,901,230,348,1449,355,548
2017,4,37,"Tepebasi",39.7667,30.5256,20.4714285714286,-2.8,0.183285714285714,82.2571428571429,20.2566666666667,NA,639,308,492,234,258,889,331,397
2017,5,37,"Tepebasi",39.7667,30.5256,15.4142857142857,-3.68571428571429,0.738285714285714,74.0857142857143,38.1642857142857,NA,588,384,580,18,53,1163,204,583
2017,6,37,"Tepebasi",39.7667,30.5256,18.4,3.18571428571429,0.144,83.2,22.2585714285714,NA,736,350,667,383,852,1519,386,852
2017,7,37,"Tepebasi",39.7667,30.5256,20.0571428571429,-1.47142857142857,0.128857142857143,68.2142857142857,24.3628571428571,NA,492,208,216,257,462,717,284,501
2017,8,37,"Tepebasi",39.7667,30.5256,21.5428571428571,5.7,0.126571428571429,73.4285714285714,29.4742857142857,NA,739,118,263,335,835,1747,621,1484
2017,9,37,"Tepebasi",39.7667,30.5256,19.9142857142857,7.32857142857143,0.851857142857143,68.7857142857143,32.1042857142857,NA,574,302,547,131,138,866,272,319
2017,10,37,"Tepebasi",39.7667,30.5256,26.5714285714286,9.35714285714286,0.405,62.2714285714286,23.1571428571429,NA,712,712,1043,0,0,1043,0,0
2017,11,37,"Tepebasi",39.7667,30.5256,22.6142857142857,3.12857142857143,1.12842857142857,78.7,17.9357142857143,NA,525,0,0,457,588,725,525,725
2017,12,37,"Tepebasi",39.7667,30.5256,19.6571428571429,9.65714285714286,0.113857142857143,58.6,25.4,NA,589,0,0,533,993,1077,589,1077
2017,13,37,"Tepebasi",39.7667,30.5256,20.5285714285714,8.04285714285714,0.0571428571428571,58.1428571428571,23.07,NA,574,119,213,389,569,887,455,674
2017,14,37,"Tepebasi",39.7667,30.5256,22.5,9.07142857142857,2.07814285714286,64.0285714285714,25.59,NA,639,25,79,440,859,1336,614,1257
2017,15,37,"Tepebasi",39.7667,30.5256,19.5714285714286,9.61428571428571,0.283142857142857,57.9142857142857,29.5014285714286,NA,587,213,372,281,639,1187,374,815
2017,16,37,"Tepebasi",39.7667,30.5256,24.7428571428571,7.97142857142857,5.15,73.8142857142857,16.7871428571429,NA,717,207,190,226,200,920,510,730
2017,17,37,"Tepebasi",39.7667,30.5256,16.8714285714286,11.6857142857143,0.00114285714285714,58.1142857142857,30.7,NA,731,335,558,355,785,1478,396,920
2017,18,37,"Tepebasi",39.7667,30.5256,26.8857142857143,15.3571428571429,1.61528571428571,65.5142857142857,30.9885714285714,NA,506,54,75,237,367,923,452,848
2017,19,37,"Tepebasi",39.7667,30.5256,28.6428571428571,16.3714285714286,0.178,60.3571428571429,25.182,NA,471,0,0,281,595,966,471,966
2017,20,37,"Tepebasi",39.7667,30.5256,23.1285714285714,12.3142857142857,4.03328571428571,72.7714285714286,14.9633333333333,NA,472,63,80,406,1122,1205,409,1125
2017,21,37,"Tepebasi",39.7667,30.5256,18.6714285714286,13.2285714285714,1.59028571428571,73.2714285714286,14.826,NA,448,0,0,448,849,849,448,849
2017,22,37,"Tepebasi",39.7667,30.5256,20.6571428571429,16.2714285714286,2.57528571428571,77.3142857142857,20.026,NA,522,0,0,447,806,1015,522,1015
2017,23,37,"Tepebasi",39.7667,30.5256,19.6142857142857,17.6714285714286,2.24928571428571,76.2428571428571,21.9783333333333,NA,578,0,0,490,1203,1388,578,1388
2017,24,37,"Tepebasi",39.7667,30.5256,20.3857142857143,17.8142857142857,0.984714285714286,69.0857142857143,22.8242857142857,NA,552,0,0,499,1048,1139,552,1139
2017,25,37,"Tepebasi",39.7667,30.5256,20.7,17.9142857142857,1.434,70.5714285714286,16.22,NA,584,0,0,584,1041,1041,584,1041
2017,26,37,"Tepebasi",39.7667,30.5256,17.6142857142857,24.4571428571429,0,55.7428571428571,28.3328571428571,NA,564,0,0,492,888,971,564,971
2017,27,37,"Tepebasi",39.7667,30.5256,25.6714285714286,21.6428571428571,0.000714285714285714,58.4571428571429,22.28,NA,511,0,0,480,535,642,511,642
2017,28,37,"Tepebasi",39.7667,30.5256,22.2857142857143,23.2142857142857,0,54.5285714285714,23.9914285714286,NA,481,0,0,481,864,864,481,864
2017,29,37,"Tepebasi",39.7667,30.5256,25.1428571428571,22.0571428571429,0.746142857142857,65.7142857142857,21.1585714285714,NA,532,0,0,528,1262,1272,532,1272
2017,30,37,"Tepebasi",39.7667,30.5256,20.9,22.9142857142857,2.402,54.8857142857143,38.1614285714286,NA,531,0,0,348,567,928,531,928
2017,31,37,"Tepebasi",39.7667,30.5256,23.5285714285714,22.4142857142857,3.28042857142857,65.1142857142857,23.2157142857143,NA,559,0,0,559,1047,1047,559,1047
2017,32,37,"Tepebasi",39.7667,30.5256,23.1285714285714,24.9285714285714,0.00185714285714286,62.5857142857143,30.3714285714286,NA,567,0,0,567,1092,1092,567,1092
2017,33,37,"Tepebasi",39.7667,30.5256,22.2142857142857,21.9714285714286,0,65.1142857142857,26.3985714285714,NA,596,0,0,596,1199,1199,596,1199
2017,34,37,"Tepebasi",39.7667,30.5256,20.3,19.1714285714286,0.727857142857143,67.3428571428571,19.028,NA,601,0,0,601,1280,1280,601,1280
2017,35,37,"Tepebasi",39.7667,30.5256,18.4571428571429,18.9714285714286,0,56.5285714285714,22.6785714285714,NA,493,37,67,425,818,1014,456,947
2017,36,37,"Tepebasi",39.7667,30.5256,18.8714285714286,18.6142857142857,0.00557142857142857,55.7285714285714,45.7371428571429,NA,507,79,105,313,664,1321,428,1216
2017,37,37,"Tepebasi",39.7667,30.5256,19.3,22.8,0,53.1714285714286,63.1785714285714,NA,589,0,0,425,808,1138,589,1138
2017,38,37,"Tepebasi",39.7667,30.5256,17.5714285714286,19.7714285714286,0,48.5857142857143,45.4142857142857,NA,671,0,0,616,1104,1312,671,1312
2017,39,37,"Tepebasi",39.7667,30.5256,19.1,15.5,1.87542857142857,73.4285714285714,32.475,NA,782,135,208,543,1087,1630,647,1422
2017,40,37,"Tepebasi",39.7667,30.5256,17.1428571428571,11.8142857142857,1.288,69.5285714285714,34.162,NA,543,237,526,271,451,1137,306,611
2017,41,37,"Tepebasi",39.7667,30.5256,16.7428571428571,9.95714285714286,0.033,65,23.6557142857143,NA,487,0,0,426,718,843,487,843
2017,42,37,"Tepebasi",39.7667,30.5256,16.9,11.6,0,59.5,38.9028571428571,NA,530,155,318,305,397,815,375,497
2017,43,37,"Tepebasi",39.7667,30.5256,18.7857142857143,9.65714285714286,3.95514285714286,82.9571428571429,32.7257142857143,NA,506,284,363,143,245,919,222,556
2017,44,37,"Tepebasi",39.7667,30.5256,17.2,4.51428571428571,0.710428571428572,72.5285714285714,23.394,NA,561,116,223,417,830,1102,445,879
2017,45,37,"Tepebasi",39.7667,30.5256,14.9,4.98571428571429,0.141857142857143,91.0285714285714,32.1885714285714,NA,577,384,526,144,167,829,193,303
2017,46,37,"Tepebasi",39.7667,30.5256,17.3,8.34285714285714,0,75.9571428571429,48.38,NA,587,583,1076,0,0,1085,4,9
2017,47,37,"Tepebasi",39.7667,30.5256,18.8714285714286,3.67142857142857,1.10614285714286,85.3571428571429,26.23,NA,418,102,305,172,285,804,316,499
2017,48,37,"Tepebasi",39.7667,30.5256,22.9571428571429,6.75714285714286,0.125285714285714,78.5428571428571,30.5928571428571,NA,386,308,478,7,35,619,78,141
2017,49,37,"Tepebasi",39.7667,30.5256,20.5142857142857,3.57142857142857,2.29514285714286,79.4714285714286,22.92,NA,407,170,240,154,253,645,237,405
2017,50,37,"Tepebasi",39.7667,30.5256,15.4,4.75714285714286,0.0574285714285714,84.5142857142857,31.95,NA,346,296,340,17,17,442,50,102
2017,51,37,"Tepebasi",39.7667,30.5256,18.6571428571429,3.05714285714286,2.66842857142857,86.0857142857143,14.6671428571429,NA,386,0,0,204,188,349,386,349
2017,52,37,"Tepebasi",39.7667,30.5256,18.7625,1.1125,0.078875,81.775,25.4371428571429,NA,528,489,468,39,39,507,39,39
2018,1,37,"Tepebasi",39.7667,30.5256,17.0875,1.95,0.258,86.8875,26.535,NA,618,449,704,102,133,914,169,210
2018,2,37,"Tepebasi",39.7667,30.5256,18.8428571428571,2.22857142857143,1.57028571428571,93.4714285714286,22.1228571428571,NA,624,512,1256,107,49,1309,112,53
2018,3,37,"Tepebasi",39.7667,30.5256,23.8428571428571,1.77142857142857,1.42414285714286,79.8285714285714,16.7914285714286,NA,639,360,505,277,150,655,279,150
2018,4,37,"Tepebasi",39.7667,30.5256,22.8285714285714,-0.614285714285714,0.0381428571428571,73.3714285714286,16.1616666666667,NA,604,258,354,308,365,764,346,410
2018,5,37,"Tepebasi",39.7667,30.5256,16.6,3.4,0.000142857142857143,73.9,35.45,NA,670,349,592,257,214,819,321,227
2018,6,37,"Tepebasi",39.7667,30.5256,20.1571428571429,6.77142857142857,0.930428571428571,81.1857142857143,42.996,NA,704,346,603,157,261,1022,358,419
2018,7,37,"Tepebasi",39.7667,30.5256,21.6285714285714,4.7,0.175142857142857,79.1571428571429,17.67,NA,478,192,243,270,308,557,286,314
2018,8,37,"Tepebasi",39.7667,30.5256,16.8428571428571,5.85714285714286,1.16142857142857,78.3142857142857,22.77,NA,711,404,705,210,395,1321,307,616
2018,9,37,"Tepebasi",39.7667,30.5256,28.9714285714286,5.67142857142857,3.13457142857143,76.0142857142857,18.27,NA,621,183,301,117,248,956,438,655
2018,10,37,"Tepebasi",39.7667,30.5256,22.8857142857143,9.2,1.22871428571429,73.7857142857143,24.294,NA,556,140,381,268,552,1330,416,949
2018,11,37,"Tepebasi",39.7667,30.5256,20.5571428571429,9.07142857142857,2.41742857142857,74.3428571428571,27.8957142857143,NA,551,246,668,73,109,1426,305,758
2018,12,37,"Tepebasi",39.7667,30.5256,26.6285714285714,10.8571428571429,0.570428571428571,58.5857142857143,89.0933333333333,NA,425,57,105,16,31,1187,368,1082
2018,13,37,"Tepebasi",39.7667,30.5256,25.9571428571429,9.48571428571429,0.359,68.1428571428571,37.8516666666667,NA,356,189,177,84,114,428,167,251
2018,14,37,"Tepebasi",39.7667,30.5256,20.0285714285714,10.5714285714286,0.125285714285714,60.4142857142857,34.9271428571429,NA,407,237,344,168,142,486,170,142
2018,15,37,"Tepebasi",39.7667,30.5256,17.4571428571429,14.5,0.199,67.3428571428571,36.3085714285714,NA,374,0,0,329,305,450,374,450
2018,16,37,"Tepebasi",39.7667,30.5256,22.2,12.4,0.0357142857142857,57.0857142857143,28.1871428571429,NA,411,122,127,274,487,648,289,521
2018,17,37,"Tepebasi",39.7667,30.5256,19.4857142857143,16.4714285714286,0.003,49.7285714285714,31.015,NA,419,76,82,338,568,652,343,570
2018,18,37,"Tepebasi",39.7667,30.5256,24.7285714285714,17.9571428571429,1.18157142857143,60.0857142857143,36.2085714285714,NA,303,104,152,159,195,474,199,322
2018,19,37,"Tepebasi",39.7667,30.5256,22.1428571428571,12.7428571428571,2.96714285714286,80.4142857142857,16.3675,NA,275,45,70,218,391,467,230,397
2018,20,37,"Tepebasi",39.7667,30.5256,17.4857142857143,17.4,1.20114285714286,65.9428571428571,23.59,NA,204,13,9,123,225,306,191,297
2018,21,37,"Tepebasi",39.7667,30.5256,19.5428571428571,17.9,1.40757142857143,76.8571428571429,20.7983333333333,NA,252,0,0,213,216,281,252,281
2018,22,37,"Tepebasi",39.7667,30.5256,24.3571428571429,17.2857142857143,0.932714285714286,69.9285714285714,15.2814285714286,NA,249,0,0,249,427,427,249,427
2018,23,37,"Tepebasi",39.7667,30.5256,18.4571428571429,19.6571428571429,0.949571428571429,64.6714285714286,22.2871428571429,NA,267,0,0,163,402,812,267,812
2018,24,37,"Tepebasi",39.7667,30.5256,22.1,19.6428571428571,2.20014285714286,64.8571428571429,20.2471428571429,NA,267,29,21,211,400,448,238,427
2018,25,37,"Tepebasi",39.7667,30.5256,19.7428571428571,19.1714285714286,3.72585714285714,75.7714285714286,15.926,NA,358,0,0,324,436,518,358,518
2018,26,37,"Tepebasi",39.7667,30.5256,19.9,20.5714285714286,0.00342857142857143,66.1285714285714,21.62,NA,355,110,194,187,349,587,245,393
2018,27,37,"Tepebasi",39.7667,30.5256,21.8428571428571,22.5428571428571,0,51.5285714285714,23.7385714285714,NA,342,0,0,342,418,418,342,418
2018,28,37,"Tepebasi",39.7667,30.5256,24.9571428571429,22.6285714285714,1.70371428571429,65.5142857142857,18.3628571428571,NA,286,0,0,286,585,585,286,585
2018,29,37,"Tepebasi",39.7667,30.5256,23.0428571428571,21.5142857142857,0.481857142857143,62.3428571428571,18.95,NA,260,0,0,260,756,756,260,756
2018,30,37,"Tepebasi",39.7667,30.5256,19.3428571428571,21.5,3.08171428571429,69.9,19.35,NA,265,0,0,263,820,822,265,822
2018,31,37,"Tepebasi",39.7667,30.5256,20.9285714285714,22.8714285714286,1.34471428571429,69.0714285714286,19.04,NA,267,0,0,267,499,499,267,499
2018,32,37,"Tepebasi",39.7667,30.5256,21.2571428571429,22.1857142857143,0.005,60.7428571428571,19.0042857142857,NA,297,0,0,297,403,403,297,403
2018,33,37,"Tepebasi",39.7667,30.5256,20.9571428571429,22.8285714285714,0.198285714285714,55.5428571428571,22.0425,NA,216,0,0,199,290,332,216,332
2018,34,37,"Tepebasi",39.7667,30.5256,20.2857142857143,23.4428571428571,0.0271428571428571,56.0428571428571,NA,NA,144,2,34,81,105,227,142,193
2018,35,37,"Tepebasi",39.7667,30.5256,23.0285714285714,23.5714285714286,0.0201428571428571,59.6714285714286,19.3483333333333,NA,201,0,0,140,228,314,201,314
2018,36,37,"Tepebasi",39.7667,30.5256,24.0428571428571,20.5714285714286,0.0417142857142857,61.5428571428571,23.7033333333333,NA,341,0,0,331,350,370,341,370
2018,37,37,"Tepebasi",39.7667,30.5256,22.9142857142857,16.5857142857143,3.46171428571429,68.9857142857143,15.59,NA,241,0,0,195,321,419,241,419
2018,38,37,"Tepebasi",39.7667,30.5256,20.8142857142857,18.0285714285714,0.0142857142857143,61.9142857142857,16.03,NA,189,0,0,183,336,344,189,344
2018,39,37,"Tepebasi",39.7667,30.5256,22.5,16.3428571428571,0.00157142857142857,59.3285714285714,20.0571428571429,NA,180,5,18,92,161,353,175,335
2018,40,37,"Tepebasi",39.7667,30.5256,18.6285714285714,14.3428571428571,0.350571428571429,68.0428571428571,18.6475,NA,191,21,66,66,109,341,170,275
2018,41,37,"Tepebasi",39.7667,30.5256,17.3714285714286,14.2428571428571,0.0762857142857143,72.2285714285714,21.9816666666667,NA,187,0,0,134,329,422,187,422
2018,42,37,"Tepebasi",39.7667,30.5256,17.5857142857143,15.3,2.29,79.2142857142857,47.6614285714286,NA,168,3,14,116,171,381,165,367
2018,43,37,"Tepebasi",39.7667,30.5256,19.6714285714286,9.52857142857143,1.81814285714286,76.4,30.4,NA,187,22,10,52,67,402,165,392
2018,44,37,"Tepebasi",39.7667,30.5256,12.3428571428571,9.7,0,69.0571428571429,NA,NA,196,33,72,53,58,264,163,192
2018,45,37,"Tepebasi",39.7667,30.5256,12.9571428571429,8.52857142857143,0,76.7714285714286,NA,NA,231,35,60,93,237,473,196,413
2018,46,37,"Tepebasi",39.7667,30.5256,19.4142857142857,4.62857142857143,0.761,80.8857142857143,26,NA,230,40,57,103,267,465,190,408
2018,47,37,"Tepebasi",39.7667,30.5256,17.6857142857143,7.34285714285714,0.0868571428571429,80.8857142857143,45.5242857142857,NA,270,61,33,58,121,499,209,466
2018,48,37,"Tepebasi",39.7667,30.5256,17.9,6.51428571428571,1.86871428571429,82.4714285714286,28.5185714285714,NA,245,100,67,78,82,201,145,134
2018,49,37,"Tepebasi",39.7667,30.5256,18.8428571428571,3.98571428571429,0.481428571428571,81.7285714285714,33.19,NA,257,50,27,115,274,420,207,393
2018,50,37,"Tepebasi",39.7667,30.5256,20.7285714285714,2.64285714285714,2.53028571428571,88.8428571428571,34.5157142857143,NA,256,104,55,33,52,305,152,250
2018,51,37,"Tepebasi",39.7667,30.5256,17.0428571428571,3.11428571428571,2.02128571428571,88.6142857142857,43.68,NA,250,19,18,74,37,248,231,230
2018,52,37,"Tepebasi",39.7667,30.5256,15.1714285714286,-0.9,0.893285714285714,82.2857142857143,36.7757142857143,NA,244,38,54,124,110,273,206,219
2019,1,37,"Tepebasi",39.7667,30.5256,20.425,0.5375,3.009625,88.45,36.23,NA,343,118,318,35,98,784,225,466
2019,2,37,"Tepebasi",39.7667,30.5256,20.9142857142857,-1.27142857142857,1.71071428571429,82.8285714285714,NA,NA,255,54,7,54,28,208,201,201
2019,3,37,"Tepebasi",39.7667,30.5256,18.4857142857143,-0.657142857142857,2.49228571428571,85.5714285714286,NA,NA,192,105,143,29,31,198,87,55
2019,4,37,"Tepebasi",39.7667,30.5256,19.3428571428571,4.6,0.839857142857143,84.1428571428571,NA,NA,308,207,141,0,0,314,101,173
2019,5,37,"Tepebasi",39.7667,30.5256,20.8714285714286,4.51428571428571,0.037,74.6714285714286,NA,NA,253,125,34,0,0,143,128,109
2019,6,37,"Tepebasi",39.7667,30.5256,18.7,4.24285714285714,2.67528571428571,79.5142857142857,NA,NA,276,32,15,67,54,127,244,112
2019,7,37,"Tepebasi",39.7667,30.5256,21.2428571428571,2.97142857142857,2.41828571428571,76.4428571428571,NA,NA,325,83,33,138,79,234,242,201
2019,8,37,"Tepebasi",39.7667,30.5256,17.2,3.11428571428571,0.000428571428571429,72.5571428571428,NA,NA,305,0,0,299,213,219,305,219
2019,9,37,"Tepebasi",39.7667,30.5256,23.9857142857143,2.24285714285714,0.0374285714285714,74.8571428571429,NA,NA,331,63,20,251,268,310,268,290
2019,10,37,"Tepebasi",39.7667,30.5256,19.2142857142857,6.35714285714286,0.685714285714286,62.3714285714286,NA,NA,359,78,36,56,25,252,281,216
2019,11,37,"Tepebasi",39.7667,30.5256,22.7142857142857,7.02857142857143,0.390571428571429,73.1142857142857,NA,NA,373,0,0,131,175,400,373,400
2019,12,37,"Tepebasi",39.7667,30.5256,22.5714285714286,7.5,0.00214285714285714,58.6857142857143,NA,NA,343,38,10,253,112,416,305,406
2019,13,37,"Tepebasi",39.7667,30.5256,23.3571428571429,4.91428571428571,0,55.0857142857143,NA,NA,256,51,33,200,155,194,205,161
2019,14,37,"Tepebasi",39.7667,30.5256,24.4428571428571,8.21428571428571,0.00142857142857143,67.1857142857143,NA,NA,365,65,25,133,95,208,300,183
2019,15,37,"Tepebasi",39.7667,30.5256,21.3714285714286,10.3714285714286,5.18742857142857,76.4285714285714,NA,NA,359,280,150,54,27,183,79,33
2019,16,37,"Tepebasi",39.7667,30.5256,25.8714285714286,5.25714285714286,0.266142857142857,70.7142857142857,NA,NA,318,0,0,318,208,208,318,208
2019,17,37,"Tepebasi",39.7667,30.5256,17.8714285714286,11.7714285714286,0.961142857142857,57.5,80.0766666666667,NA,412,42,12,292,227,313,370,301
2019,18,37,"Tepebasi",39.7667,30.5256,24.8571428571429,13.9142857142857,0.681571428571429,59.9428571428571,76.9242857142857,NA,523,149,67,139,76,353,374,286
2019,19,37,"Tepebasi",39.7667,30.5256,18.1142857142857,11.7428571428571,2.28785714285714,69.9285714285714,90.1075,NA,452,82,54,173,138,386,370,332
2019,20,37,"Tepebasi",39.7667,30.5256,20.0142857142857,17.3,1.82457142857143,63.3285714285714,NA,NA,454,130,131,58,48,389,324,258
2019,21,37,"Tepebasi",39.7667,30.5256,21.7,17.4857142857143,0.517,65.7142857142857,NA,NA,457,40,55,198,171,413,417,358
2019,22,37,"Tepebasi",39.7667,30.5256,19.9571428571429,21.1857142857143,0.00185714285714286,56.7,NA,NA,453,210,119,220,152,323,243,204
2019,23,37,"Tepebasi",39.7667,30.5256,24.7571428571429,20.2857142857143,0.556142857142857,59.7285714285714,NA,NA,378,0,0,325,432,532,378,532
2019,24,37,"Tepebasi",39.7667,30.5256,23.4285714285714,19.4142857142857,1.58285714285714,72.0285714285714,NA,NA,378,0,0,374,244,244,378,244
2019,25,37,"Tepebasi",39.7667,30.5256,21.9,20.2714285714286,0.842285714285714,70.7285714285714,NA,NA,306,0,0,300,311,325,306,325
2019,26,37,"Tepebasi",39.7667,30.5256,23.0285714285714,21.7,1.60657142857143,59.9714285714286,NA,NA,377,0,0,366,331,342,377,342
2019,27,37,"Tepebasi",39.7667,30.5256,21.6714285714286,22.3,0,53.1571428571429,NA,NA,456,0,0,403,186,222,456,222
2019,28,37,"Tepebasi",39.7667,30.5256,23.5,19.7142857142857,1.46185714285714,60.1428571428571,NA,NA,398,0,0,396,421,421,398,421
2019,29,37,"Tepebasi",39.7667,30.5256,19.7428571428571,19.1285714285714,1.58557142857143,68.8571428571429,NA,NA,453,0,0,316,158,203,453,203
2019,30,37,"Tepebasi",39.7667,30.5256,21.0428571428571,21.6,0.00285714285714286,58.7428571428571,NA,NA,456,0,0,456,335,335,456,335
2019,31,37,"Tepebasi",39.7667,30.5256,23.3,23.8,0.000714285714285714,57.0857142857143,NA,NA,334,0,0,310,362,375,334,375
2019,32,37,"Tepebasi",39.7667,30.5256,21.8857142857143,21.4857142857143,0,52.4142857142857,NA,NA,346,0,0,303,332,395,346,395
2019,33,37,"Tepebasi",39.7667,30.5256,25.2142857142857,22.5,0.03,57.8857142857143,NA,NA,337,49,68,206,385,531,288,463
2019,34,37,"Tepebasi",39.7667,30.5256,24.3428571428571,21.4428571428571,0.00428571428571429,63.9428571428571,NA,NA,299,0,0,286,332,345,299,345
2019,35,37,"Tepebasi",39.7667,30.5256,22.7285714285714,21.7714285714286,0,60.7,13.65,NA,307,0,0,305,415,415,307,415
2019,36,37,"Tepebasi",39.7667,30.5256,21.7428571428571,20.6571428571429,0.00128571428571429,60.5142857142857,NA,NA,171,0,0,159,63,67,171,67
2019,37,37,"Tepebasi",39.7667,30.5256,23.3857142857143,19.1857142857143,0,58.8142857142857,NA,NA,218,0,0,216,55,55,218,55
2019,38,37,"Tepebasi",39.7667,30.5256,21.4571428571429,15.9428571428571,0.00285714285714286,57.2428571428571,NA,NA,266,2,1,225,85,91,264,90
2019,39,37,"Tepebasi",39.7667,30.5256,16.0857142857143,15.8571428571429,0.934285714285714,64.8142857142857,NA,NA,237,0,0,192,62,79,237,79
2019,40,37,"Tepebasi",39.7667,30.5256,19.8857142857143,17.1571428571429,0.185142857142857,56.1142857142857,NA,NA,241,25,18,131,65,111,216,93
2019,41,37,"Tepebasi",39.7667,30.5256,15.7285714285714,13.8285714285714,0.305142857142857,75.9571428571429,NA,NA,416,4,2,121,147,448,412,446
2019,42,37,"Tepebasi",39.7667,30.5256,14.4285714285714,14.3714285714286,0.114428571428571,67.0714285714286,55.455,NA,356,57,43,43,24,408,299,365
2019,43,37,"Tepebasi",39.7667,30.5256,16.1857142857143,12.6,0,72.0714285714286,47.0671428571429,NA,306,0,0,195,152,300,306,300
2019,44,37,"Tepebasi",39.7667,30.5256,17.2,8.65714285714286,0.207428571428571,75.9428571428571,42.2414285714286,NA,350,63,18,132,68,250,287,232
2019,45,37,"Tepebasi",39.7667,30.5256,19.2142857142857,11,0,64.2285714285714,67.6928571428571,NA,417,270,183,0,0,328,147,145
2019,46,37,"Tepebasi",39.7667,30.5256,16.2857142857143,10.0857142857143,0.00442857142857143,66.3428571428571,83.7166666666667,NA,401,175,156,0,0,337,226,181
2019,47,37,"Tepebasi",39.7667,30.5256,13.1,4.32857142857143,0.0314285714285714,77.7714285714286,NA,NA,391,185,115,0,0,339,206,224
2019,48,37,"Tepebasi",39.7667,30.5256,18.3714285714286,7.94285714285714,4.08785714285714,83.7285714285714,NA,NA,320,122,42,85,92,251,198,209
2019,49,37,"Tepebasi",39.7667,30.5256,15.3857142857143,-0.0142857142857143,3.36971428571429,86.6,NA,NA,393,97,56,57,31,274,296,218
2019,50,37,"Tepebasi",39.7667,30.5256,17.6571428571429,4.72857142857143,1.27,86.8,NA,NA,218,119,73,0,0,119,99,46
2019,51,37,"Tepebasi",39.7667,30.5256,14.8285714285714,1.87142857142857,0,95.3857142857143,NA,NA,361,192,297,0,0,488,169,191
2019,52,37,"Tepebasi",39.7667,30.5256,19.3857142857143,3.85714285714286,1.93142857142857,82.2142857142857,NA,NA,279,49,66,202,177,281,230,215
2020,1,37,"Tepebasi",39.7667,30.5256,18.5,0.42,0.0812,76.78,NA,NA,160,12,0,90,71,126,148,126
2020,2,37,"Tepebasi",39.7667,30.5256,21.4,-0.942857142857143,5.13642857142857,85.1285714285714,NA,NA,240,38,31,69,76,173,202,142
2020,3,37,"Tepebasi",39.7667,30.5256,11.2428571428571,-1.81428571428571,0.00214285714285714,89.6428571428571,NA,NA,270,41,85,99,153,382,229,297
2020,4,37,"Tepebasi",39.7667,30.5256,18.5714285714286,-1.77142857142857,0.270285714285714,78.8571428571429,NA,NA,358,52,83,208,122,295,306,212
2020,5,37,"Tepebasi",39.7667,30.5256,18.7714285714286,2.97142857142857,1.03628571428571,80.3,NA,NA,331,146,145,61,37,272,185,127
2020,6,37,"Tepebasi",39.7667,30.5256,25.7285714285714,2.75714285714286,1.19442857142857,76.5857142857143,NA,NA,343,63,75,119,95,267,280,192
2020,7,37,"Tepebasi",39.7667,30.5256,20.1571428571429,0.842857142857143,1.482,81.5857142857143,NA,NA,341,17,27,130,101,338,324,311
2020,8,37,"Tepebasi",39.7667,30.5256,19.0571428571429,2.94285714285714,0.903,75.8142857142857,NA,NA,283,71,77,138,75,187,212,110
2020,9,37,"Tepebasi",39.7667,30.5256,27.5428571428571,5.92857142857143,0.877285714285714,64.8285714285714,NA,NA,393,167,133,155,235,528,226,395
2020,10,37,"Tepebasi",39.7667,30.5256,21.4857142857143,9.24285714285714,0.00771428571428571,59,NA,NA,205,165,180,0,0,210,40,30
2020,11,37,"Tepebasi",39.7667,30.5256,22.5571428571429,9.57142857142857,0.319428571428572,65.0285714285714,NA,NA,115,20,10,41,24,94,95,84
2020,12,37,"Tepebasi",39.7667,30.5256,22.8142857142857,2.34285714285714,0.0405714285714286,66.3285714285714,NA,NA,117,6,1,96,103,118,111,117
2020,13,37,"Tepebasi",39.7667,30.5256,24.1,7.85714285714286,1.85114285714286,78.4142857142857,NA,NA,136,7,6,34,52,92,129,86
2020,14,37,"Tepebasi",39.7667,30.5256,22.5571428571429,7.92857142857143,0.985428571428571,76.0142857142857,NA,NA,155,31,32,38,26,121,124,89
2020,15,37,"Tepebasi",39.7667,30.5256,22.9571428571429,8.34285714285714,1.58842857142857,63.7714285714286,NA,NA,133,0,0,111,104,118,133,118
2020,16,37,"Tepebasi",39.7667,30.5256,19.3714285714286,11.0571428571429,0.203,56.2571428571429,NA,NA,141,8,3,95,78,106,133,103
2020,17,37,"Tepebasi",39.7667,30.5256,20.2,9.94285714285714,0.001,60.4285714285714,NA,NA,137,1,1,112,86,123,136,122
2020,18,37,"Tepebasi",39.7667,30.5256,23.2428571428571,12.8714285714286,0.167571428571429,62.7142857142857,NA,NA,146,23,18,81,108,164,123,146
2020,19,37,"Tepebasi",39.7667,30.5256,19.0571428571429,11.1714285714286,1.32957142857143,69.1,NA,NA,137,0,0,126,139,157,137,157
2020,20,37,"Tepebasi",39.7667,30.5256,20.4142857142857,20.2142857142857,0,49.0714285714286,NA,NA,164,0,0,84,67,164,164,164
2020,21,37,"Tepebasi",39.7667,30.5256,23.5285714285714,17.0285714285714,0.336142857142857,58,NA,NA,146,27,7,89,76,96,119,89
2020,22,37,"Tepebasi",39.7667,30.5256,21.8571428571429,12.3714285714286,2.47014285714286,72.0142857142857,NA,NA,118,0,0,72,74,100,118,100
2020,23,37,"Tepebasi",39.7667,30.5256,19.9,15.9714285714286,2.33342857142857,65.5,NA,NA,112,29,16,59,33,70,83,54
2020,24,37,"Tepebasi",39.7667,30.5256,20.1714285714286,18.7142857142857,1.23214285714286,67.5,NA,NA,140,0,0,114,120,150,140,150
2020,25,37,"Tepebasi",39.7667,30.5256,24.0714285714286,18.6142857142857,14.767,72.2142857142857,NA,NA,137,0,0,81,58,108,137,108
2020,26,37,"Tepebasi",39.7667,30.5256,19.9,18.9571428571429,4.53771428571429,74.0428571428571,NA,NA,173,0,0,136,101,133,173,133
2020,27,37,"Tepebasi",39.7667,30.5256,20.2857142857143,23.0285714285714,0.015,59.5857142857143,NA,NA,113,0,0,101,111,113,113,113
2020,28,37,"Tepebasi",39.7667,30.5256,27.0428571428571,22.4,0.424714285714286,64.8142857142857,NA,NA,164,0,0,130,115,122,164,122
2020,29,37,"Tepebasi",39.7667,30.5256,24.1285714285714,20.8142857142857,0,66.9,NA,NA,186,0,0,158,89,111,186,111
2020,30,37,"Tepebasi",39.7667,30.5256,22.7285714285714,22.3428571428571,0,59.8,NA,NA,190,0,0,164,136,142,190,142
2020,31,37,"Tepebasi",39.7667,30.5256,24.1,23.4428571428571,0,53.5571428571429,NA,NA,150,0,0,146,116,127,150,127
2020,32,37,"Tepebasi",39.7667,30.5256,22,23.9,0.144,56,NA,NA,146,0,0,143,105,107,146,107
2020,33,37,"Tepebasi",39.7667,30.5256,22.0285714285714,21.4142857142857,0.150285714285714,57.2857142857143,NA,NA,183,0,0,168,75,83,183,83
2020,34,37,"Tepebasi",39.7667,30.5256,22.2428571428571,21.1142857142857,0.00657142857142857,58.7428571428571,NA,NA,197,0,0,185,86,97,197,97
2020,35,37,"Tepebasi",39.7667,30.5256,19.7142857142857,22.7,0,51.3857142857143,NA,NA,164,16,5,102,81,157,148,152
2020,36,37,"Tepebasi",39.7667,30.5256,19.8714285714286,22.8857142857143,0.000142857142857143,55.9857142857143,NA,NA,179,0,0,160,86,112,179,112
2020,37,37,"Tepebasi",39.7667,30.5256,20.4714285714286,21.2428571428571,0.130714285714286,62.9857142857143,NA,NA,193,41,14,140,76,91,152,77
2020,38,37,"Tepebasi",39.7667,30.5256,19.6,20.1857142857143,0.198857142857143,66.3428571428571,NA,NA,235,0,0,217,152,157,235,157
2020,39,37,"Tepebasi",39.7667,30.5256,16.5714285714286,18.9285714285714,0.329571428571429,65.1857142857143,NA,NA,220,24,8,86,39,129,196,121
2020,40,37,"Tepebasi",39.7667,30.5256,17.1285714285714,16.4571428571429,0.000142857142857143,58.1571428571429,NA,NA,187,0,0,148,108,154,187,154
2020,41,37,"Tepebasi",39.7667,30.5256,14.9285714285714,17.6285714285714,1.42757142857143,60.8857142857143,NA,NA,182,2,1,64,47,127,180,126
2020,42,37,"Tepebasi",39.7667,30.5256,18.9142857142857,15.2857142857143,1.449,66.2,NA,NA,177,81,36,28,9,111,96,75
2020,43,37,"Tepebasi",39.7667,30.5256,18.0285714285714,13.2714285714286,0.829571428571429,79.7,NA,NA,194,20,67,24,20,161,174,94
2020,44,37,"Tepebasi",39.7667,30.5256,17.1142857142857,11.3857142857143,0.994857142857143,78.7142857142857,NA,NA,255,33,60,71,51,233,222,173
2020,45,37,"Tepebasi",39.7667,30.5256,21.9142857142857,7.91428571428571,0.00114285714285714,75.4571428571429,NA,NA,156,7,9,83,53,103,149,94
2020,46,37,"Tepebasi",39.7667,30.5256,17.5285714285714,6.44285714285714,0.145142857142857,78.2428571428571,NA,NA,208,41,13,81,32,109,167,96
2020,47,37,"Tepebasi",39.7667,30.5256,14.0857142857143,3.78571428571429,0.000857142857142857,77.9571428571429,NA,NA,173,27,5,59,38,83,146,78
2020,48,37,"Tepebasi",39.7667,30.5256,14.9,0.671428571428571,0,74.5285714285714,NA,NA,199,20,7,83,136,262,179,255
2020,49,37,"Tepebasi",39.7667,30.5256,14.0857142857143,3.14285714285714,0.000142857142857143,75.6142857142857,NA,NA,207,55,25,58,36,116,152,91
2020,50,37,"Tepebasi",39.7667,30.5256,20.0857142857143,5.88571428571429,0.429571428571429,78.6285714285714,NA,NA,181,87,33,0,0,98,94,65
2020,51,37,"Tepebasi",39.7667,30.5256,16.7714285714286,5.31428571428571,0.876428571428571,85.1428571428571,NA,NA,171,63,44,41,16,90,108,46
2020,52,37,"Tepebasi",39.7667,30.5256,15.5857142857143,2.77142857142857,0,79.3,NA,NA,203,94,54,69,52,113,109,59
2020,53,37,"Tepebasi",39.7667,30.5256,18.275,5.725,1.3575,79.95,NA,NA,122,62,37,0,0,111,60,74
2017,1,38,"Gaziantep",37.0662,37.3833,14.9428571428571,4.05714285714286,0.639571428571429,86.1857142857143,71.12,NA,563,322,525,42,38,847,241,322
2017,2,38,"Gaziantep",37.0662,37.3833,14.9857142857143,2.92857142857143,1.27542857142857,74.8428571428571,81.9225,NA,757,222,287,42,132,1214,535,927
2017,3,38,"Gaziantep",37.0662,37.3833,14.0285714285714,3.88571428571429,0,63.0714285714286,90.7714285714286,NA,762,73,45,143,357,1449,689,1404
2017,4,38,"Gaziantep",37.0662,37.3833,19.7714285714286,2.17142857142857,1.17742857142857,62.4857142857143,78.2528571428571,NA,639,167,106,56,96,889,472,783
2017,5,38,"Gaziantep",37.0662,37.3833,23.0142857142857,1.65714285714286,0.107571428571429,52.0428571428571,69.8771428571429,NA,588,195,376,141,256,1163,393,787
2017,6,38,"Gaziantep",37.0662,37.3833,14.5,6.42857142857143,0.0892857142857143,67.7,87.0128571428571,NA,736,271,451,144,219,1519,465,1068
2017,7,38,"Gaziantep",37.0662,37.3833,22.4714285714286,2.45714285714286,0.0151428571428571,39.5571428571429,43.3585714285714,NA,492,53,46,77,125,717,439,671
2017,8,38,"Gaziantep",37.0662,37.3833,13.4142857142857,6.72857142857143,0.127714285714286,51.6857142857143,78.9271428571429,NA,739,119,300,347,869,1747,620,1447
2017,9,38,"Gaziantep",37.0662,37.3833,22.9714285714286,10.3571428571429,0.991571428571429,56.6285714285714,80.9157142857143,NA,574,325,527,68,82,866,249,339
2017,10,38,"Gaziantep",37.0662,37.3833,20.9428571428571,11.3571428571429,3.37128571428571,59.8428571428571,125.404285714286,NA,712,624,888,0,0,1043,88,155
2017,11,38,"Gaziantep",37.0662,37.3833,23.6571428571429,7.87142857142857,15.7554285714286,74.9571428571429,37.0442857142857,NA,525,20,22,345,479,725,505,703
2017,12,38,"Gaziantep",37.0662,37.3833,22.4285714285714,10.8857142857143,0.555571428571429,59.4857142857143,34.6271428571429,NA,589,144,260,300,577,1077,445,817
2017,13,38,"Gaziantep",37.0662,37.3833,17.6571428571429,11.5428571428571,4.56485714285714,69.8571428571429,38.5171428571429,NA,574,99,163,232,346,887,475,724
2017,14,38,"Gaziantep",37.0662,37.3833,24.4285714285714,12.7428571428571,0.721,59.2,32.1628571428571,NA,639,191,351,236,422,1336,448,985
2017,15,38,"Gaziantep",37.0662,37.3833,18.9571428571429,12.3857142857143,2.24814285714286,63.5142857142857,37.2471428571429,NA,587,147,162,238,626,1187,440,1025
2017,16,38,"Gaziantep",37.0662,37.3833,22.0142857142857,15.3857142857143,0.0511428571428571,60.0285714285714,43.0085714285714,NA,717,106,72,427,505,920,611,848
2017,17,38,"Gaziantep",37.0662,37.3833,17.4857142857143,16.7142857142857,0.0127142857142857,38.3571428571429,39.7328571428571,NA,731,69,188,313,679,1478,662,1290
2017,18,38,"Gaziantep",37.0662,37.3833,21.5428571428571,17.0285714285714,2.79214285714286,66.2,41.4214285714286,NA,506,3,10,313,589,923,503,913
2017,19,38,"Gaziantep",37.0662,37.3833,20.5428571428571,20.9142857142857,0.0255714285714286,46.0428571428571,37.1542857142857,NA,471,0,0,323,623,966,471,966
2017,20,38,"Gaziantep",37.0662,37.3833,25.4857142857143,19.7,0.991714285714286,49.3571428571429,22.1471428571429,NA,472,0,0,254,842,1205,472,1205
2017,21,38,"Gaziantep",37.0662,37.3833,21.5857142857143,18.0428571428571,0.544714285714286,57.1142857142857,20.7585714285714,NA,448,45,48,246,381,849,403,801
2017,22,38,"Gaziantep",37.0662,37.3833,22.9857142857143,22.1857142857143,0.00614285714285714,41.1285714285714,19.5128571428571,NA,522,0,0,288,528,1015,522,1015
2017,23,38,"Gaziantep",37.0662,37.3833,25.6,25.8428571428571,0,41.0714285714286,29.9414285714286,NA,578,1,0,304,810,1388,577,1388
2017,24,38,"Gaziantep",37.0662,37.3833,25.4428571428571,24.8,0.00157142857142857,43.8,22.0571428571429,NA,552,0,0,423,870,1139,552,1139
2017,25,38,"Gaziantep",37.0662,37.3833,26.4285714285714,25.1714285714286,0.316142857142857,41.5428571428571,19.5485714285714,NA,584,0,0,314,499,1041,584,1041
2017,26,38,"Gaziantep",37.0662,37.3833,26.4428571428571,30.9714285714286,0,28.2428571428571,26.7033333333333,NA,564,8,11,220,454,971,556,960
2017,27,38,"Gaziantep",37.0662,37.3833,25.2714285714286,30.7857142857143,0,28.1714285714286,30.8683333333333,NA,511,0,0,438,452,642,511,642
2017,28,38,"Gaziantep",37.0662,37.3833,25.2428571428571,31.5571428571429,0,25.8714285714286,27.5671428571429,NA,481,0,0,308,442,864,481,864
2017,29,38,"Gaziantep",37.0662,37.3833,23.8571428571429,30.3142857142857,0,37.9714285714286,34.21,NA,532,0,0,364,813,1272,532,1272
2017,30,38,"Gaziantep",37.0662,37.3833,26.4428571428571,30.6142857142857,0,30.2571428571429,NA,NA,531,0,0,332,596,928,531,928
2017,31,38,"Gaziantep",37.0662,37.3833,22.4285714285714,29.8142857142857,0,37.7428571428571,31.5025,NA,559,0,0,401,543,1047,559,1047
2017,32,38,"Gaziantep",37.0662,37.3833,21.1,29.7571428571429,0,39.1285714285714,42.9171428571429,NA,567,72,90,301,462,1092,495,1002
2017,33,38,"Gaziantep",37.0662,37.3833,22.9714285714286,28.7428571428571,0,47.5142857142857,39.54,NA,596,0,0,469,524,1199,596,1199
2017,34,38,"Gaziantep",37.0662,37.3833,21.0428571428571,29.0142857142857,0,43.9428571428571,43.7385714285714,NA,601,0,0,457,555,1280,601,1280
2017,35,38,"Gaziantep",37.0662,37.3833,19.1428571428571,27.2142857142857,0,47.1428571428571,34.8657142857143,NA,493,17,123,291,315,1014,476,891
2017,36,38,"Gaziantep",37.0662,37.3833,18.7,26.3,0,31.2428571428571,32.0342857142857,NA,507,0,0,354,601,1321,507,1321
2017,37,38,"Gaziantep",37.0662,37.3833,15.4571428571429,28.8142857142857,0,27.7714285714286,53.1428571428571,NA,589,257,559,64,56,1138,332,579
2017,38,38,"Gaziantep",37.0662,37.3833,20.0571428571429,25.4,0,47.2428571428571,47.0228571428571,NA,671,45,158,377,533,1312,626,1154
2017,39,38,"Gaziantep",37.0662,37.3833,19.7285714285714,22.8857142857143,0,45.9428571428571,40.4914285714286,NA,782,141,223,425,626,1630,641,1407
2017,40,38,"Gaziantep",37.0662,37.3833,15.1571428571429,17.8857142857143,0,35.8285714285714,46.3314285714286,NA,543,90,255,141,496,1137,453,882
2017,41,38,"Gaziantep",37.0662,37.3833,15.6571428571429,18.1428571428571,0.694285714285714,44.2571428571429,36.9071428571429,NA,487,2,0,280,461,843,485,843
2017,42,38,"Gaziantep",37.0662,37.3833,15.3428571428571,17.1428571428571,0,33.0571428571429,48.0971428571429,NA,530,13,13,216,334,815,517,802
2017,43,38,"Gaziantep",37.0662,37.3833,16.0857142857143,16.3142857142857,0.583571428571429,52.4,120.122857142857,NA,506,175,260,77,102,919,331,659
2017,44,38,"Gaziantep",37.0662,37.3833,16.2857142857143,13.0857142857143,2.30871428571429,76.2857142857143,50.4142857142857,NA,561,153,432,100,112,1102,408,670
2017,45,38,"Gaziantep",37.0662,37.3833,10.9571428571429,12.1857142857143,0.0304285714285714,65.5857142857143,71.89,NA,577,5,2,302,488,829,572,827
2017,46,38,"Gaziantep",37.0662,37.3833,15.7714285714286,12.7714285714286,0.0511428571428571,54.8285714285714,95.3728571428571,NA,587,210,302,22,58,1085,377,783
2017,47,38,"Gaziantep",37.0662,37.3833,22.5142857142857,8.05714285714286,1.23728571428571,61.8714285714286,43.3928571428571,NA,418,130,246,144,178,804,288,558
2017,48,38,"Gaziantep",37.0662,37.3833,9.47142857142857,8.01428571428571,2.89214285714286,80.2428571428571,60.9828571428571,NA,386,85,88,126,171,619,301,531
2017,49,38,"Gaziantep",37.0662,37.3833,14.5428571428571,5.5,0.492428571428571,67.3142857142857,48.34,NA,407,55,23,101,193,645,352,622
2017,50,38,"Gaziantep",37.0662,37.3833,10.3857142857143,7.5,0.0121428571428571,68.9857142857143,66.78,NA,346,33,10,111,119,442,313,432
2017,51,38,"Gaziantep",37.0662,37.3833,15.5142857142857,9.61428571428571,0.438285714285714,75.8714285714286,184.614285714286,NA,386,105,92,43,40,349,281,257
2017,52,38,"Gaziantep",37.0662,37.3833,16.0875,7.4125,0.455375,68.225,83.6325,NA,528,174,145,125,83,507,354,362
2018,1,38,"Gaziantep",37.0662,37.3833,18.65,6.5625,1.510125,74.9375,61.1,NA,618,137,156,130,273,914,481,758
2018,2,38,"Gaziantep",37.0662,37.3833,14.8428571428571,7.1,0.0541428571428571,60.2857142857143,100.927142857143,NA,624,209,320,87,573,1309,415,989
2018,3,38,"Gaziantep",37.0662,37.3833,17.9142857142857,5.75714285714286,10.8055714285714,78.5285714285714,48.1571428571429,NA,639,168,172,109,302,655,471,483
2018,4,38,"Gaziantep",37.0662,37.3833,18.0142857142857,6.52857142857143,4.90342857142857,82.2571428571429,81.6,NA,604,317,428,8,20,764,287,336
2018,5,38,"Gaziantep",37.0662,37.3833,9.7,5.62857142857143,0.0285714285714286,70.5857142857143,51.5,NA,670,113,158,133,197,819,557,661
2018,6,38,"Gaziantep",37.0662,37.3833,10.0285714285714,8.97142857142857,0.0127142857142857,67.3428571428571,86.4614285714286,NA,704,160,121,115,234,1022,544,901
2018,7,38,"Gaziantep",37.0662,37.3833,24.8714285714286,8.75714285714286,7.258,74.7428571428571,40.2457142857143,NA,478,139,166,197,186,557,339,391
2018,8,38,"Gaziantep",37.0662,37.3833,15.6571428571429,7.77142857142857,4.61314285714286,80.2714285714286,37.0671428571429,NA,711,185,303,181,472,1321,526,1018
2018,9,38,"Gaziantep",37.0662,37.3833,13.8857142857143,9.08571428571429,3.56542857142857,84.7571428571429,45.5328571428571,NA,621,351,521,151,246,956,270,435
2018,10,38,"Gaziantep",37.0662,37.3833,18.8714285714286,12.0857142857143,1.27785714285714,69.7285714285714,68.3271428571429,NA,556,135,368,279,736,1330,421,962
2018,11,38,"Gaziantep",37.0662,37.3833,18.1142857142857,11.8142857142857,0.597,69.6857142857143,23.9028571428571,NA,551,4,3,449,1194,1426,547,1423
2018,12,38,"Gaziantep",37.0662,37.3833,23.0571428571429,14.1571428571429,0,58,66.8,NA,425,103,289,267,805,1187,322,898
2018,13,38,"Gaziantep",37.0662,37.3833,19.8142857142857,13.4571428571429,0.926571428571429,60.3142857142857,NA,NA,356,75,83,178,144,428,281,345
2018,14,38,"Gaziantep",37.0662,37.3833,15.4,14.9857142857143,0.0851428571428571,41.5142857142857,41.395,NA,407,1,0,210,318,486,406,486
2018,15,38,"Gaziantep",37.0662,37.3833,23.8142857142857,16.7,6.832,60.2714285714286,28.8714285714286,NA,374,95,199,38,58,450,279,251
2018,16,38,"Gaziantep",37.0662,37.3833,20.8285714285714,16.3285714285714,0.322857142857143,48.9428571428571,30.7485714285714,NA,411,0,0,245,384,648,411,648
2018,17,38,"Gaziantep",37.0662,37.3833,17.4714285714286,18.2428571428571,0.500285714285714,54.2428571428571,39.2728571428571,NA,419,169,295,56,70,652,250,357
2018,18,38,"Gaziantep",37.0662,37.3833,19.0571428571429,19.5428571428571,2.49728571428571,61.9714285714286,37.6328571428571,NA,303,31,15,21,46,474,272,459
2018,19,38,"Gaziantep",37.0662,37.3833,17.2428571428571,15.6428571428571,3.16271428571429,79.2142857142857,27.0616666666667,NA,275,5,21,107,125,467,270,446
2018,20,38,"Gaziantep",37.0662,37.3833,14.5,21.7428571428571,0,47.5,23.9233333333333,NA,204,10,29,42,70,306,194,277
2018,21,38,"Gaziantep",37.0662,37.3833,21.8428571428571,23.3142857142857,0.280857142857143,45.0571428571429,40.48,NA,252,29,36,102,161,281,223,245
2018,22,38,"Gaziantep",37.0662,37.3833,20.5,21.0428571428571,0.956285714285714,57.7428571428571,33.9628571428571,NA,249,21,29,140,199,427,228,398
2018,23,38,"Gaziantep",37.0662,37.3833,19.6285714285714,24.3714285714286,3.98757142857143,47.0428571428571,28.5771428571429,NA,267,0,0,166,465,812,267,812
2018,24,38,"Gaziantep",37.0662,37.3833,28.3142857142857,23.7857142857143,2.29728571428571,56.2571428571429,27.8957142857143,NA,267,0,0,154,168,448,267,448
2018,25,38,"Gaziantep",37.0662,37.3833,30.9571428571429,24.9714285714286,0.133857142857143,51.4857142857143,18.4214285714286,NA,358,0,0,313,387,518,358,518
2018,26,38,"Gaziantep",37.0662,37.3833,24.9142857142857,26.8857142857143,0.146,45.3285714285714,26.6728571428571,NA,355,0,0,317,496,587,355,587
2018,27,38,"Gaziantep",37.0662,37.3833,24.5857142857143,29.8571428571429,0,38.9,29.6385714285714,NA,342,0,0,280,365,418,342,418
2018,28,38,"Gaziantep",37.0662,37.3833,26.5428571428571,29.4571428571429,0,42.9,32.9814285714286,NA,286,0,0,219,420,585,286,585
2018,29,38,"Gaziantep",37.0662,37.3833,28.0714285714286,28.8428571428571,0.0127142857142857,37.2428571428571,24.71,NA,260,0,0,107,269,756,260,756
2018,30,38,"Gaziantep",37.0662,37.3833,28.5,28.1857142857143,0,44.3,30.9257142857143,NA,265,0,0,208,696,822,265,822
2018,31,38,"Gaziantep",37.0662,37.3833,27.7571428571429,29.6714285714286,0,46.1428571428571,21.4285714285714,NA,267,0,0,214,416,499,267,499
2018,32,38,"Gaziantep",37.0662,37.3833,27.0142857142857,29.5,0.121571428571429,36.7142857142857,21.0371428571429,NA,297,0,0,134,209,403,297,403
2018,33,38,"Gaziantep",37.0662,37.3833,26.8428571428571,29.7571428571429,0,34.8571428571429,30.0442857142857,NA,216,0,0,132,208,332,216,332
2018,34,38,"Gaziantep",37.0662,37.3833,21.7,29.6428571428571,0,40.2,25.4357142857143,NA,144,0,0,98,169,227,144,227
2018,35,38,"Gaziantep",37.0662,37.3833,18.5714285714286,28.4428571428571,0,41.8,28.3128571428571,NA,201,11,42,93,177,314,190,272
2018,36,38,"Gaziantep",37.0662,37.3833,21.9714285714286,26.9857142857143,0,41.7714285714286,22.83,NA,341,0,0,256,229,370,341,370
2018,37,38,"Gaziantep",37.0662,37.3833,20.1285714285714,24.9857142857143,0.162285714285714,42.0857142857143,28.84,NA,241,43,65,107,117,419,198,354
2018,38,38,"Gaziantep",37.0662,37.3833,17.3857142857143,26.1428571428571,0.152,34.5142857142857,24.0357142857143,NA,189,21,29,78,178,344,168,315
2018,39,38,"Gaziantep",37.0662,37.3833,16.2428571428571,24.2571428571429,0,39.2571428571429,23.0514285714286,NA,180,4,5,94,191,353,176,348
2018,40,38,"Gaziantep",37.0662,37.3833,15.7714285714286,21.7285714285714,0,36.2,21.9242857142857,NA,191,21,5,78,100,341,170,336
2018,41,38,"Gaziantep",37.0662,37.3833,17.9142857142857,20.7428571428571,0.542142857142857,48.0285714285714,83.1485714285714,NA,187,94,229,11,55,422,93,193
2018,42,38,"Gaziantep",37.0662,37.3833,16.7142857142857,19.2428571428571,2.10757142857143,58.1428571428571,116.46,NA,168,64,32,5,42,381,104,349
2018,43,38,"Gaziantep",37.0662,37.3833,16.5428571428571,14.2571428571429,3.264,73.6857142857143,50.4328571428571,NA,187,53,21,30,144,402,134,381
2018,44,38,"Gaziantep",37.0662,37.3833,13.3,13.9428571428571,0.192714285714286,56.3285714285714,61.4057142857143,NA,196,60,36,42,76,264,136,228
2018,45,38,"Gaziantep",37.0662,37.3833,12.6142857142857,11.8714285714286,0.141285714285714,80.8571428571429,46.3442857142857,NA,231,153,218,2,2,473,78,255
2018,46,38,"Gaziantep",37.0662,37.3833,13.0285714285714,8.92857142857143,1.40242857142857,72.0142857142857,55.5442857142857,NA,230,57,82,23,46,465,173,383
2018,47,38,"Gaziantep",37.0662,37.3833,12.6285714285714,10.2857142857143,2.40214285714286,80.5142857142857,54.45,NA,270,85,85,93,48,499,185,414
2018,48,38,"Gaziantep",37.0662,37.3833,17.5142857142857,10.1714285714286,5.39228571428571,90.8,45.1942857142857,NA,245,149,67,27,5,201,96,134
2018,49,38,"Gaziantep",37.0662,37.3833,15.6285714285714,9.4,4.29728571428571,90.9,49.0814285714286,NA,257,169,249,26,15,420,88,171
2018,50,38,"Gaziantep",37.0662,37.3833,17.1428571428571,8.17142857142857,6.58728571428571,84.9285714285714,40.6928571428571,NA,256,91,101,62,32,305,165,204
2018,51,38,"Gaziantep",37.0662,37.3833,17.3285714285714,7.5,6.78685714285714,89.6142857142857,47.5542857142857,NA,250,93,80,69,59,248,157,168
2018,52,38,"Gaziantep",37.0662,37.3833,16.5571428571429,4.88571428571429,8.91342857142857,82.6571428571429,44.0875,NA,244,112,48,16,45,273,132,225
2019,1,38,"Gaziantep",37.0662,37.3833,20.3875,5.9,7.23975,91.175,48.51,NA,343,150,203,33,35,784,193,581
2019,2,38,"Gaziantep",37.0662,37.3833,19.2857142857143,2.64285714285714,3.51485714285714,79.7142857142857,46.7416666666667,NA,255,63,82,55,27,208,192,126
2019,3,38,"Gaziantep",37.0662,37.3833,18.4428571428571,3.3,4.52942857142857,74.1,53.6628571428571,NA,192,66,74,40,47,198,126,124
2019,4,38,"Gaziantep",37.0662,37.3833,17.1285714285714,5.38571428571429,0.0467142857142857,75.2714285714286,113.876,NA,308,209,66,1,0,314,99,248
2019,5,38,"Gaziantep",37.0662,37.3833,18.5857142857143,6.87142857142857,2.93314285714286,77.5571428571429,62.3557142857143,NA,253,27,3,132,41,143,226,140
2019,6,38,"Gaziantep",37.0662,37.3833,18.7714285714286,5.47142857142857,5.67671428571429,83.4142857142857,50.438,NA,276,186,55,1,0,127,90,72
2019,7,38,"Gaziantep",37.0662,37.3833,14.6714285714286,6.3,2.36585714285714,83.0285714285714,50.27,NA,325,81,27,138,103,234,244,207
2019,8,38,"Gaziantep",37.0662,37.3833,15.7571428571429,7.02857142857143,3.26271428571429,79.3571428571429,59.1585714285714,NA,305,61,14,88,67,219,244,205
2019,9,38,"Gaziantep",37.0662,37.3833,18.6714285714286,6.82857142857143,3.388,74.8428571428571,35.9142857142857,NA,331,9,5,136,80,310,322,305
2019,10,38,"Gaziantep",37.0662,37.3833,20.4428571428571,8.54285714285714,0.636142857142857,65.9857142857143,34.8071428571429,NA,359,82,16,156,142,252,277,236
2019,11,38,"Gaziantep",37.0662,37.3833,23.5142857142857,9.75714285714286,3.85228571428571,77.0714285714286,36.6328571428571,NA,373,129,96,131,93,400,244,304
2019,12,38,"Gaziantep",37.0662,37.3833,18.3142857142857,10.5142857142857,0.127714285714286,63.3,39.2757142857143,NA,343,66,34,137,55,416,277,382
2019,13,38,"Gaziantep",37.0662,37.3833,19.6857142857143,9.52857142857143,9.86014285714286,78.5285714285714,35.0728571428571,NA,256,55,13,117,84,194,201,181
2019,14,38,"Gaziantep",37.0662,37.3833,16.2571428571429,11.0285714285714,3.00114285714286,82.8142857142857,29.1628571428571,NA,365,199,93,103,41,208,166,115
2019,15,38,"Gaziantep",37.0662,37.3833,18.6857142857143,13.5285714285714,6.04042857142857,73.2714285714286,38.2128571428571,NA,359,91,43,143,56,183,268,140
2019,16,38,"Gaziantep",37.0662,37.3833,22.8857142857143,9.75714285714286,4.47757142857143,80.0714285714286,18.18,NA,318,0,0,251,120,208,318,208
2019,17,38,"Gaziantep",37.0662,37.3833,18.3142857142857,13.4142857142857,0.0661428571428572,56.9714285714286,30.2171428571429,NA,412,71,93,135,133,313,341,220
2019,18,38,"Gaziantep",37.0662,37.3833,16.8571428571429,17.3571428571429,0,61.8,37.4314285714286,NA,523,87,147,264,132,353,436,206
2019,19,38,"Gaziantep",37.0662,37.3833,19.0142857142857,16.6857142857143,0.176571428571429,58.7714285714286,24.52,NA,452,75,50,345,286,386,377,336
2019,20,38,"Gaziantep",37.0662,37.3833,16.4,22.6428571428571,0,44.5714285714286,40.0271428571429,NA,454,130,79,98,97,389,324,310
2019,21,38,"Gaziantep",37.0662,37.3833,24.2,23.9142857142857,0,37.7571428571429,34.804,NA,457,0,0,418,354,413,457,413
2019,22,38,"Gaziantep",37.0662,37.3833,17.0142857142857,27.4571428571429,0,32.0142857142857,47.63,NA,453,13,2,146,164,323,440,321
2019,23,38,"Gaziantep",37.0662,37.3833,21.1857142857143,26.0285714285714,0.0255714285714286,30.8285714285714,40.47,NA,378,55,119,298,387,532,323,413
2019,24,38,"Gaziantep",37.0662,37.3833,23.3857142857143,24.7428571428571,0.331857142857143,36.9,36.8066666666667,NA,378,51,39,304,185,244,327,205
2019,25,38,"Gaziantep",37.0662,37.3833,26.1142857142857,25.0571428571429,0.638285714285714,45.8142857142857,NA,NA,306,0,0,279,293,325,306,325
2019,26,38,"Gaziantep",37.0662,37.3833,23.4,29.8142857142857,0,39.0714285714286,31.646,NA,377,0,0,235,251,342,377,342
2019,27,38,"Gaziantep",37.0662,37.3833,24.2142857142857,28.1,0,33.3,29.8671428571429,NA,456,0,0,288,150,222,456,222
2019,28,38,"Gaziantep",37.0662,37.3833,28.2142857142857,28.4714285714286,0,34.3,36.3971428571429,NA,398,0,0,245,248,421,398,421
2019,29,38,"Gaziantep",37.0662,37.3833,24.6714285714286,27.0714285714286,0,40.5571428571429,28.89,NA,453,0,0,360,130,203,453,203
2019,30,38,"Gaziantep",37.0662,37.3833,22.9857142857143,29.6142857142857,0,37.0571428571429,32.37,NA,456,0,0,272,263,335,456,335
2019,31,38,"Gaziantep",37.0662,37.3833,26.9714285714286,29.5285714285714,0,37.4857142857143,43.725,NA,334,0,0,269,322,375,334,375
2019,32,38,"Gaziantep",37.0662,37.3833,25.6714285714286,30.6,0,33.6714285714286,37.1485714285714,NA,346,0,0,88,109,395,346,395
2019,33,38,"Gaziantep",37.0662,37.3833,20.1714285714286,30.1714285714286,0,32.2714285714286,43.73,NA,337,49,68,200,377,531,288,463
2019,34,38,"Gaziantep",37.0662,37.3833,16.8714285714286,27.3571428571429,0,39.1857142857143,48.38,NA,299,2,2,174,217,345,297,343
2019,35,38,"Gaziantep",37.0662,37.3833,18.3857142857143,28.3285714285714,0,38.3,51.9971428571429,NA,307,54,22,167,222,415,253,393
2019,36,38,"Gaziantep",37.0662,37.3833,21.6857142857143,27.6571428571429,0,37.3428571428571,41.4014285714286,NA,171,0,0,70,45,67,171,67
2019,37,38,"Gaziantep",37.0662,37.3833,18.1428571428571,25.9428571428571,0.0377142857142857,34.4,40.3857142857143,NA,218,59,8,45,13,55,159,47
2019,38,38,"Gaziantep",37.0662,37.3833,19.5,22.7857142857143,0.0182857142857143,37.3857142857143,40.9516666666667,NA,266,30,4,140,35,91,236,87
2019,39,38,"Gaziantep",37.0662,37.3833,13.5714285714286,21.9142857142857,0,36.8714285714286,NA,NA,237,25,15,150,34,79,212,64
2019,40,38,"Gaziantep",37.0662,37.3833,19.5142857142857,22.3,0,40.1285714285714,45.225,NA,241,30,5,182,72,111,211,106
2019,41,38,"Gaziantep",37.0662,37.3833,14.2,21.3,0,41.5857142857143,58.42,NA,416,62,21,159,230,448,354,427
2019,42,38,"Gaziantep",37.0662,37.3833,13.1285714285714,19.8857142857143,1.36885714285714,40.7714285714286,76.2342857142857,NA,356,40,32,147,248,408,316,376
2019,43,38,"Gaziantep",37.0662,37.3833,12.8285714285714,16.7714285714286,0.435857142857143,55.5714285714286,49.9885714285714,NA,306,91,49,42,53,300,215,251
2019,44,38,"Gaziantep",37.0662,37.3833,12.2,13.6714285714286,1.97271428571429,66.8428571428571,45.9528571428571,NA,350,48,29,161,106,250,302,221
2019,45,38,"Gaziantep",37.0662,37.3833,8.22857142857143,13.2142857142857,0,57.0571428571429,81.1657142857143,NA,417,152,71,77,127,328,265,257
2019,46,38,"Gaziantep",37.0662,37.3833,12.5857142857143,12.7714285714286,0.0255714285714286,42.5142857142857,99.4714285714286,NA,401,152,98,59,74,337,249,239
2019,47,38,"Gaziantep",37.0662,37.3833,11.8714285714286,8.82857142857143,0,38.2,88.1357142857143,NA,391,110,61,115,117,339,281,278
2019,48,38,"Gaziantep",37.0662,37.3833,12.6,10.5428571428571,0.599571428571429,59.6142857142857,83.2857142857143,NA,320,147,70,8,1,251,173,181
2019,49,38,"Gaziantep",37.0662,37.3833,16.5428571428571,7.4,3.043,77.1285714285714,41.4242857142857,NA,393,140,120,66,23,274,253,154
2019,50,38,"Gaziantep",37.0662,37.3833,18.3285714285714,7.32857142857143,5.09342857142857,91.8857142857143,38.6642857142857,NA,218,177,108,0,0,119,41,11
2019,51,38,"Gaziantep",37.0662,37.3833,11.2857142857143,8.25714285714286,0,68.7857142857143,102.8,NA,361,54,111,41,64,488,307,377
2019,52,38,"Gaziantep",37.0662,37.3833,19.4857142857143,6.38571428571429,8.64028571428571,88.2714285714286,58.7528571428571,NA,279,146,197,7,2,281,133,84
2020,1,38,"Gaziantep",37.0662,37.3833,15.28,5.08,5.9986,89,38.694,NA,160,59,29,28,4,126,101,97
2020,2,38,"Gaziantep",37.0662,37.3833,19.5428571428571,5.67142857142857,0.186714285714286,77.0285714285714,43.34,NA,240,65,38,53,9,173,175,135
2020,3,38,"Gaziantep",37.0662,37.3833,14.7,4.17142857142857,0.940714285714286,71.1,60.0071428571429,NA,270,103,143,11,18,382,167,239
2020,4,38,"Gaziantep",37.0662,37.3833,25.3142857142857,4.32857142857143,0.495428571428571,54.7,33.7114285714286,NA,358,0,0,126,119,295,358,295
2020,5,38,"Gaziantep",37.0662,37.3833,19.3571428571429,5.68571428571429,2.35071428571429,71.5285714285714,52.5714285714286,NA,331,138,149,113,80,272,193,123
2020,6,38,"Gaziantep",37.0662,37.3833,19.9571428571429,4.54285714285714,4.20014285714286,74.2571428571429,19.8266666666667,NA,343,222,200,24,8,267,121,67
2020,7,38,"Gaziantep",37.0662,37.3833,18.9428571428571,-0.257142857142857,1.231,65.4428571428572,39.7985714285714,NA,341,145,92,51,68,338,196,246
2020,8,38,"Gaziantep",37.0662,37.3833,18.3428571428571,7.95714285714286,1.43142857142857,76.4,64.2933333333333,NA,283,170,87,35,67,187,113,100
2020,9,38,"Gaziantep",37.0662,37.3833,18.8,9.31428571428571,1.46328571428571,67.7857142857143,48.3366666666667,NA,393,42,39,122,195,528,351,489
2020,10,38,"Gaziantep",37.0662,37.3833,19.7285714285714,11.7571428571429,0,59.8428571428571,56.6428571428571,NA,205,62,46,45,71,210,143,164
2020,11,38,"Gaziantep",37.0662,37.3833,22.3142857142857,13.7571428571429,2.17557142857143,66.5,78.63,NA,115,34,31,10,1,94,81,63
2020,12,38,"Gaziantep",37.0662,37.3833,18.5142857142857,8.45714285714286,7.91728571428571,76.1571428571429,31.5642857142857,NA,117,27,28,27,17,118,90,90
2020,13,38,"Gaziantep",37.0662,37.3833,23.6714285714286,11.7571428571429,4.20828571428571,74.9857142857143,37.6485714285714,NA,136,60,45,21,23,92,76,47
2020,14,38,"Gaziantep",37.0662,37.3833,21.1285714285714,10.5,3.99957142857143,76.6285714285714,29.2771428571429,NA,155,40,8,42,14,121,115,113
2020,15,38,"Gaziantep",37.0662,37.3833,15.2857142857143,13.3571428571429,1.61428571428571,67.0142857142857,36.0971428571429,NA,133,0,0,77,44,118,133,118
2020,16,38,"Gaziantep",37.0662,37.3833,15.8428571428571,15.3285714285714,0.157142857142857,56.3857142857143,35.2214285714286,NA,141,11,5,69,42,106,130,101
2020,17,38,"Gaziantep",37.0662,37.3833,18.5142857142857,14.7428571428571,3.11071428571429,64.1857142857143,40.04,NA,137,1,0,96,51,123,136,123
2020,18,38,"Gaziantep",37.0662,37.3833,20.4428571428571,15.2,0.288857142857143,68.2285714285714,35.88,NA,146,0,0,88,95,164,146,164
2020,19,38,"Gaziantep",37.0662,37.3833,22.1428571428571,15.8714285714286,0.419571428571429,64.2714285714286,24.9416666666667,NA,137,0,0,69,62,157,137,157
2020,20,38,"Gaziantep",37.0662,37.3833,15,23.1428571428571,0,42.7571428571429,46.6128571428571,NA,164,21,4,61,85,164,143,160
2020,21,38,"Gaziantep",37.0662,37.3833,24.4714285714286,23.5285714285714,0.241285714285714,43.3285714285714,59.39,NA,146,0,0,65,34,96,146,96
2020,22,38,"Gaziantep",37.0662,37.3833,19,19.3,0.00614285714285714,48.2,NA,NA,118,22,20,45,34,100,96,80
2020,23,38,"Gaziantep",37.0662,37.3833,14.9857142857143,21.2571428571429,0.0285714285714286,45.2714285714286,36.27,NA,112,24,22,44,26,70,88,48
2020,24,38,"Gaziantep",37.0662,37.3833,23.1285714285714,23.8857142857143,0,46.1285714285714,44.268,NA,140,0,0,96,94,150,140,150
2020,25,38,"Gaziantep",37.0662,37.3833,27.3571428571429,24.6714285714286,0,46.0285714285714,39.5185714285714,NA,137,0,0,92,96,108,137,108
2020,26,38,"Gaziantep",37.0662,37.3833,22.0285714285714,27.0714285714286,0,41.8428571428571,38.3514285714286,NA,173,0,0,97,74,133,173,133
2020,27,38,"Gaziantep",37.0662,37.3833,19.3285714285714,29.7142857142857,0,32,40.2885714285714,NA,113,0,0,49,41,113,113,113
2020,28,38,"Gaziantep",37.0662,37.3833,22.8857142857143,29.8142857142857,0,42,42.4885714285714,NA,164,0,0,130,92,122,164,122
2020,29,38,"Gaziantep",37.0662,37.3833,22.8857142857143,29.7857142857143,0,40.4714285714286,42.8285714285714,NA,186,1,0,81,59,111,185,111
2020,30,38,"Gaziantep",37.0662,37.3833,24.6714285714286,31.1857142857143,0,36.5142857142857,52.5428571428571,NA,190,0,0,113,82,142,190,142
2020,31,38,"Gaziantep",37.0662,37.3833,22.6428571428571,31.9,0,31.5,57.255,NA,150,12,19,58,58,127,138,108
2020,32,38,"Gaziantep",37.0662,37.3833,23.2,30.4428571428571,0,36.1428571428571,38.74,NA,146,0,0,77,52,107,146,107
2020,33,38,"Gaziantep",37.0662,37.3833,24.4571428571429,29.0428571428571,0,34.0714285714286,39.595,NA,183,0,0,89,38,83,183,83
2020,34,38,"Gaziantep",37.0662,37.3833,24.1857142857143,28.3428571428571,0,35.5428571428571,48.278,NA,197,0,0,109,44,97,197,97
2020,35,38,"Gaziantep",37.0662,37.3833,13.0428571428571,28.1142857142857,0,34.2714285714286,54.54,NA,164,13,1,71,90,157,151,156
2020,36,38,"Gaziantep",37.0662,37.3833,17.5571428571429,30.0142857142857,0,26.9857142857143,NA,NA,179,27,1,76,22,112,152,111
2020,37,38,"Gaziantep",37.0662,37.3833,15.1857142857143,28.2,0,32.4857142857143,98.4666666666667,NA,193,52,15,49,19,91,141,76
2020,38,38,"Gaziantep",37.0662,37.3833,15.5571428571429,25.9428571428571,0,49.5428571428571,57.3028571428571,NA,235,0,0,143,71,157,235,157
2020,39,38,"Gaziantep",37.0662,37.3833,18.3571428571429,24.6714285714286,0,51.3,47.6685714285714,NA,220,0,0,144,74,129,220,129
2020,40,38,"Gaziantep",37.0662,37.3833,17.6142857142857,24.0285714285714,0,45.5714285714286,61.5542857142857,NA,187,0,0,95,61,154,187,154
2020,41,38,"Gaziantep",37.0662,37.3833,12.4428571428571,20.6285714285714,0,31.7428571428571,70.74,NA,182,75,45,20,17,127,107,82
2020,42,38,"Gaziantep",37.0662,37.3833,9.18571428571429,20.4,0,49.1,79.5214285714286,NA,177,73,41,25,18,111,104,70
2020,43,38,"Gaziantep",37.0662,37.3833,8.72857142857143,19.8714285714286,0,44.5714285714286,87.9757142857143,NA,194,14,1,68,33,161,180,160
2020,44,38,"Gaziantep",37.0662,37.3833,9.91428571428571,18.6285714285714,0.0127142857142857,39.4714285714286,117.757142857143,NA,255,157,132,20,4,233,98,101
2020,45,38,"Gaziantep",37.0662,37.3833,14.3,13.5571428571429,8.37528571428571,77.0571428571429,56.8957142857143,NA,156,84,43,9,16,103,72,60
2020,46,38,"Gaziantep",37.0662,37.3833,5.38571428571429,12.1142857142857,0,65.9857142857143,79.3242857142857,NA,208,56,21,33,19,109,152,88
2020,47,38,"Gaziantep",37.0662,37.3833,11.3428571428571,9.31428571428571,1.00114285714286,77.3428571428571,64.5,NA,173,51,8,31,10,83,122,75
2020,48,38,"Gaziantep",37.0662,37.3833,13.9285714285714,8.07142857142857,0.138714285714286,68.5,67.2742857142857,NA,199,59,22,30,18,262,140,240
2020,49,38,"Gaziantep",37.0662,37.3833,12.2142857142857,8.51428571428571,1.66885714285714,78.2428571428571,71.5928571428571,NA,207,84,16,27,24,116,123,100
2020,50,38,"Gaziantep",37.0662,37.3833,14.1,7.51428571428571,0.904,77.4714285714286,67.0542857142857,NA,181,70,19,19,36,98,111,79
2020,51,38,"Gaziantep",37.0662,37.3833,15.2714285714286,8.37142857142857,1.26728571428571,85,68.6828571428571,NA,171,78,45,4,4,90,93,45
2020,52,38,"Gaziantep",37.0662,37.3833,12.2,5.05714285714286,0.337428571428571,66.0142857142857,65.75,NA,203,64,10,40,26,113,139,103
2020,53,38,"Gaziantep",37.0662,37.3833,10.575,6.125,0.00525,63.15,102.9975,NA,122,33,4,19,13,111,89,107
2017,1,39,"Giresun",40.9128,38.3895,19.4285714285714,9.71428571428571,2.629,54.4285714285714,40.1314285714286,NA,563,0,0,128,207,847,563,847
2017,2,39,"Giresun",40.9128,38.3895,15.8428571428571,6.91428571428571,1.71428571428571,62.7714285714286,39.6785714285714,NA,757,180,444,178,186,1214,577,770
2017,3,39,"Giresun",40.9128,38.3895,15.1714285714286,7.18571428571429,3.15642857142857,70.0428571428571,52.0314285714286,NA,762,0,0,451,968,1449,762,1449
2017,4,39,"Giresun",40.9128,38.3895,16.6857142857143,3.45714285714286,5.14285714285714,77.7285714285714,42.5414285714286,NA,639,70,215,414,556,889,569,674
2017,5,39,"Giresun",40.9128,38.3895,16.8142857142857,3.7,5.24228571428571,65.4428571428572,42.084,NA,588,1,0,174,352,1163,587,1163
2017,6,39,"Giresun",40.9128,38.3895,18.3714285714286,7.5,0.628571428571429,68.9285714285714,55.475,NA,736,0,0,386,852,1519,736,1519
2017,7,39,"Giresun",40.9128,38.3895,19.9571428571429,2.71428571428571,9.31328571428571,71.8571428571429,40.1566666666667,NA,492,28,23,349,602,717,464,694
2017,8,39,"Giresun",40.9128,38.3895,18.9857142857143,9.37142857142857,1.62828571428571,60.8285714285714,NA,NA,739,6,12,129,288,1747,733,1735
2017,9,39,"Giresun",40.9128,38.3895,12.7142857142857,9.51428571428571,2.857,72.9142857142857,93.284,NA,574,220,396,131,138,866,354,470
2017,10,39,"Giresun",40.9128,38.3895,11.5857142857143,11.7571428571429,0.257142857142857,63.0428571428571,81.1571428571429,NA,712,158,227,0,0,1043,554,816
2017,11,39,"Giresun",40.9128,38.3895,14.3571428571429,8.07142857142857,6.87085714285714,79.0142857142857,44.2842857142857,NA,525,64,53,253,338,725,461,672
2017,12,39,"Giresun",40.9128,38.3895,10.9285714285714,7.92857142857143,0.386285714285714,73.1714285714286,49.6314285714286,NA,589,395,781,80,166,1077,194,296
2017,13,39,"Giresun",40.9128,38.3895,12.7,9.05714285714286,2.72842857142857,75.0857142857143,53.68,NA,574,175,330,227,309,887,399,557
2017,14,39,"Giresun",40.9128,38.3895,13.7428571428571,10.3857142857143,2.19985714285714,76.0857142857143,58.5442857142857,NA,639,204,551,187,287,1336,435,785
2017,15,39,"Giresun",40.9128,38.3895,10.3571428571429,10.2857142857143,0.600571428571429,79.5,46.16,NA,587,363,729,18,21,1187,224,458
2017,16,39,"Giresun",40.9128,38.3895,20.8285714285714,12.0571428571429,4.99928571428571,72.9571428571429,43.6942857142857,NA,717,192,161,141,310,920,525,759
2017,17,39,"Giresun",40.9128,38.3895,11.0285714285714,11.7142857142857,1.02842857142857,69.3857142857143,45.7442857142857,NA,731,369,740,97,111,1478,362,738
2017,18,39,"Giresun",40.9128,38.3895,9.01428571428571,15.1285714285714,2.04285714285714,76.8,47.685,NA,506,44,55,318,615,923,462,868
2017,19,39,"Giresun",40.9128,38.3895,17.7,16.9571428571429,3.52814285714286,71.4571428571429,42.805,NA,471,124,305,135,282,966,347,661
2017,20,39,"Giresun",40.9128,38.3895,12.4,14.1571428571429,7.64228571428571,81.9,31.6528571428571,NA,472,43,105,186,391,1205,429,1100
2017,21,39,"Giresun",40.9128,38.3895,10.6857142857143,15.1285714285714,2.585,80.7428571428571,31.11,NA,448,42,22,100,267,849,406,827
2017,22,39,"Giresun",40.9128,38.3895,8.81428571428571,18.6714285714286,0.957,75.3428571428571,35.7942857142857,NA,522,65,124,113,169,1015,457,891
2017,23,39,"Giresun",40.9128,38.3895,13.3428571428571,20.4714285714286,4.28514285714286,78.2714285714286,34.08,NA,578,100,155,219,548,1388,478,1233
2017,24,39,"Giresun",40.9128,38.3895,12.3714285714286,19.7428571428571,1.72814285714286,74.4,31.3885714285714,NA,552,73,119,250,552,1139,479,1020
2017,25,39,"Giresun",40.9128,38.3895,13.0857142857143,21.3,4.01442857142857,72.5142857142857,28.9314285714286,NA,584,98,213,389,673,1041,486,828
2017,26,39,"Giresun",40.9128,38.3895,7.95714285714286,24.1,0.0571428571428571,71.9857142857143,27.9442857142857,NA,564,176,237,0,0,971,388,734
2017,27,39,"Giresun",40.9128,38.3895,14.5285714285714,22.6142857142857,1.77128571428571,73.9142857142857,30.24,NA,511,0,0,356,398,642,511,642
2017,28,39,"Giresun",40.9128,38.3895,8.11428571428571,23.6571428571429,0.0857142857142857,70.3285714285714,28.73,NA,481,105,137,0,0,864,376,727
2017,29,39,"Giresun",40.9128,38.3895,24.7428571428571,24.1714285714286,1.37128571428571,75.3,38.3314285714286,NA,532,0,0,433,1043,1272,532,1272
2017,30,39,"Giresun",40.9128,38.3895,12.5285714285714,25.3142857142857,0.499857142857143,69.7571428571429,39.9228571428571,NA,531,153,269,369,634,928,378,659
2017,31,39,"Giresun",40.9128,38.3895,7.27142857142857,24.7714285714286,1.57114285714286,75.7571428571429,38.0142857142857,NA,559,0,0,248,490,1047,559,1047
2017,32,39,"Giresun",40.9128,38.3895,9.4,26.4714285714286,0.371428571428571,74.9857142857143,52.7557142857143,NA,567,0,0,194,353,1092,567,1092
2017,33,39,"Giresun",40.9128,38.3895,12.3714285714286,25.6428571428571,9.02714285714286,77.3428571428571,39.3985714285714,NA,596,0,0,309,755,1199,596,1199
2017,34,39,"Giresun",40.9128,38.3895,13.8857142857143,23.1428571428571,5.55685714285714,75.2571428571429,31.7485714285714,NA,601,0,0,477,826,1280,601,1280
2017,35,39,"Giresun",40.9128,38.3895,13.3857142857143,22.2142857142857,1.78542857142857,73.0571428571429,32.3814285714286,NA,493,59,98,374,701,1014,434,916
2017,36,39,"Giresun",40.9128,38.3895,13.7,22.3714285714286,0.486,71.7,34.0342857142857,NA,507,206,380,200,519,1321,301,941
2017,37,39,"Giresun",40.9128,38.3895,9.05714285714286,24.3285714285714,0.1,71.5142857142857,65.6714285714286,NA,589,219,390,148,380,1138,370,748
2017,38,39,"Giresun",40.9128,38.3895,11.0857142857143,22.8,8.32857142857143,78.5857142857143,50.7257142857143,NA,671,205,203,284,695,1312,466,1109
2017,39,39,"Giresun",40.9128,38.3895,13.6857142857143,19.9428571428571,1.79985714285714,73.8285714285714,45.6171428571429,NA,782,0,0,672,1532,1630,782,1630
2017,40,39,"Giresun",40.9128,38.3895,16,17.7428571428571,6.64185714285714,63.1428571428571,39.2114285714286,NA,543,105,279,244,473,1137,438,858
2017,41,39,"Giresun",40.9128,38.3895,14.6714285714286,15.4857142857143,8.32857142857143,77.3571428571429,33.4285714285714,NA,487,41,67,375,715,843,446,776
2017,42,39,"Giresun",40.9128,38.3895,10.3571428571429,16.0714285714286,1.12857142857143,75.0142857142857,50.5171428571429,NA,530,244,411,226,306,815,286,404
2017,43,39,"Giresun",40.9128,38.3895,14.1571428571429,17.3285714285714,1.7,74.9714285714286,72.7485714285714,NA,506,10,86,121,173,919,496,833
2017,44,39,"Giresun",40.9128,38.3895,13.6857142857143,12.9714285714286,3.64242857142857,72.1714285714286,45.5685714285714,NA,561,262,504,210,463,1102,299,598
2017,45,39,"Giresun",40.9128,38.3895,9.1,14.3,8.16942857142857,80.2714285714286,59.6242857142857,NA,577,283,420,77,66,829,294,409
2017,46,39,"Giresun",40.9128,38.3895,11.3428571428571,15.9142857142857,0.0714285714285714,68.7857142857143,77.7314285714286,NA,587,162,269,96,158,1085,425,816
2017,47,39,"Giresun",40.9128,38.3895,24.0714285714286,10.6142857142857,4.51428571428571,63.2571428571429,53.8628571428571,NA,418,0,0,253,419,804,418,804
2017,48,39,"Giresun",40.9128,38.3895,16.1142857142857,12.9714285714286,2.42828571428571,62.8714285714286,48.3842857142857,NA,386,13,25,0,0,619,373,594
2017,49,39,"Giresun",40.9128,38.3895,19.7428571428571,10.8142857142857,6.41442857142857,62.0285714285714,38.3757142857143,NA,407,0,0,243,351,645,407,645
2017,50,39,"Giresun",40.9128,38.3895,13.3142857142857,11.5571428571429,2.74214285714286,64.5428571428571,50.2514285714286,NA,346,0,0,42,81,442,346,442
2017,51,39,"Giresun",40.9128,38.3895,16.5714285714286,10.0571428571429,12.3575714285714,79.5857142857143,39.4142857142857,NA,386,0,0,258,261,349,386,349
2017,52,39,"Giresun",40.9128,38.3895,15.4,11.275,0.2375,58.9625,63.2725,NA,528,0,0,136,56,507,528,507
2018,1,39,"Giresun",40.9128,38.3895,15,9.9,5.724125,70.6625,46.21125,NA,618,84,137,284,387,914,534,777
2018,2,39,"Giresun",40.9128,38.3895,15.4285714285714,9.25714285714286,5.857,75.6142857142857,45.25,NA,624,8,29,242,778,1309,616,1280
2018,3,39,"Giresun",40.9128,38.3895,19.5857142857143,9.07142857142857,6.79885714285714,64.4714285714286,38.5414285714286,NA,639,19,175,194,117,655,620,480
2018,4,39,"Giresun",40.9128,38.3895,15.9857142857143,6.65714285714286,8.61528571428572,75.3857142857143,34.8757142857143,NA,604,0,0,516,595,764,604,764
2018,5,39,"Giresun",40.9128,38.3895,16.8142857142857,10.2571428571429,0.214285714285714,60.4714285714286,45.7771428571429,NA,670,0,0,310,209,819,670,819
2018,6,39,"Giresun",40.9128,38.3895,14.2,10.3571428571429,1.8,75.4,64.8383333333333,NA,704,198,260,183,306,1022,506,762
2018,7,39,"Giresun",40.9128,38.3895,15.0714285714286,9.47142857142857,6.285,76.8,55.535,NA,478,71,104,132,165,557,407,453
2018,8,39,"Giresun",40.9128,38.3895,11.6857142857143,8.72857142857143,0.657571428571428,81.9285714285714,56.1685714285714,NA,711,317,500,100,95,1321,394,821
2018,9,39,"Giresun",40.9128,38.3895,18.4571428571429,9.25714285714286,4.94342857142857,71.4428571428571,65.0985714285714,NA,621,103,169,179,277,956,518,787
2018,10,39,"Giresun",40.9128,38.3895,16.1571428571429,11.1142857142857,4.614,74.5285714285714,72.5057142857143,NA,556,165,346,69,133,1330,391,984
2018,11,39,"Giresun",40.9128,38.3895,12.6285714285714,12.2857142857143,2.34257142857143,72.0285714285714,61.4742857142857,NA,551,118,289,152,539,1426,433,1137
2018,12,39,"Giresun",40.9128,38.3895,18.3714285714286,12.9,3.75671428571429,74.2,84.8971428571429,NA,425,74,228,183,379,1187,351,959
2018,13,39,"Giresun",40.9128,38.3895,15.7,11.9571428571429,1.31442857142857,77.1857142857143,79.9285714285714,NA,356,114,112,75,112,428,242,316
2018,14,39,"Giresun",40.9128,38.3895,11.2285714285714,11.9571428571429,2.743,71.3714285714286,47.1042857142857,NA,407,238,202,50,19,486,169,284
2018,15,39,"Giresun",40.9128,38.3895,10.3142857142857,12.6142857142857,0.171428571428571,80.3285714285714,68.27,NA,374,0,0,109,113,450,374,450
2018,16,39,"Giresun",40.9128,38.3895,13.4857142857143,12.5285714285714,3.97085714285714,71.7142857142857,54.7085714285714,NA,411,123,152,151,282,648,288,496
2018,17,39,"Giresun",40.9128,38.3895,9.95714285714286,15.4428571428571,0,73.2285714285714,52.9371428571429,NA,419,171,332,105,131,652,248,320
2018,18,39,"Giresun",40.9128,38.3895,8.31428571428571,16.3428571428571,0.542714285714286,84.6,50.8066666666667,NA,303,78,95,0,0,474,225,379
2018,19,39,"Giresun",40.9128,38.3895,11.0714285714286,17.0285714285714,3.30042857142857,79.5571428571428,41.4714285714286,NA,275,0,0,132,137,467,275,467
2018,20,39,"Giresun",40.9128,38.3895,10.6285714285714,18.9571428571429,0.214285714285714,75.4428571428572,40.6328571428571,NA,204,109,139,15,5,306,95,167
2018,21,39,"Giresun",40.9128,38.3895,9.54285714285714,20.9285714285714,0.257285714285714,76.6428571428571,41.4414285714286,NA,252,78,39,8,12,281,174,242
2018,22,39,"Giresun",40.9128,38.3895,14.0285714285714,20.0571428571429,14.0984285714286,74.5,42.74,NA,249,0,0,224,404,427,249,427
2018,23,39,"Giresun",40.9128,38.3895,8.11428571428571,21.8285714285714,0.514285714285714,71.8,35.9542857142857,NA,267,98,159,0,0,812,169,653
2018,24,39,"Giresun",40.9128,38.3895,11.2428571428571,23.4428571428571,2.17171428571429,71.9,35.3328571428571,NA,267,35,11,129,350,448,232,437
2018,25,39,"Giresun",40.9128,38.3895,10.7857142857143,23.5857142857143,2.41428571428571,74.0428571428571,29.1471428571429,NA,358,0,0,213,319,518,358,518
2018,26,39,"Giresun",40.9128,38.3895,11.1285714285714,24.2142857142857,2.41357142857143,78.9714285714286,36.2728571428571,NA,355,106,204,178,223,587,249,383
2018,27,39,"Giresun",40.9128,38.3895,11.1285714285714,23.3,3.757,72.3857142857143,35.2085714285714,NA,342,23,21,286,303,418,319,397
2018,28,39,"Giresun",40.9128,38.3895,13.6428571428571,24.9571428571429,2.888,75.6571428571429,46.6271428571429,NA,286,13,28,194,413,585,273,557
2018,29,39,"Giresun",40.9128,38.3895,10.7142857142857,24.8714285714286,1.08557142857143,68.2714285714286,31.8966666666667,NA,260,24,13,89,254,756,236,743
2018,30,39,"Giresun",40.9128,38.3895,11.3,25.8714285714286,0.571428571428571,73.9428571428572,38.9,NA,265,33,139,133,537,822,232,683
2018,31,39,"Giresun",40.9128,38.3895,13.0714285714286,25.7428571428571,9.07,72.8428571428571,40.2283333333333,NA,267,0,0,267,499,499,267,499
2018,32,39,"Giresun",40.9128,38.3895,18.8142857142857,24.7857142857143,0.8,66.5571428571429,36.6285714285714,NA,297,0,0,266,375,403,297,403
2018,33,39,"Giresun",40.9128,38.3895,12,24.4571428571429,0.143,68.9571428571429,37.1357142857143,NA,216,0,0,87,110,332,216,332
2018,34,39,"Giresun",40.9128,38.3895,11.3,24.9714285714286,0.571428571428572,68.1428571428571,46.9528571428571,NA,144,39,42,67,102,227,105,185
2018,35,39,"Giresun",40.9128,38.3895,11.7571428571429,25.5285714285714,0.142857142857143,71.9571428571429,42.0885714285714,NA,201,2,0,96,208,314,199,314
2018,36,39,"Giresun",40.9128,38.3895,12.0571428571429,24.4571428571429,6.38471428571429,71.6,45.4228571428571,NA,341,95,63,183,210,370,246,307
2018,37,39,"Giresun",40.9128,38.3895,11.7428571428571,21.9142857142857,10.7985714285714,76.4571428571429,36.1,NA,241,49,68,118,185,419,192,351
2018,38,39,"Giresun",40.9128,38.3895,10.1,20.8285714285714,3.67142857142857,72.1714285714286,36.7885714285714,NA,189,0,0,91,207,344,189,344
2018,39,39,"Giresun",40.9128,38.3895,13.1714285714286,19.1571428571429,12.384,75.5428571428571,34.4028571428571,NA,180,63,128,63,152,353,117,225
2018,40,39,"Giresun",40.9128,38.3895,12.0428571428571,19.1,8.25571428571429,74.0428571428571,36.3028571428571,NA,191,97,155,66,146,341,94,186
2018,41,39,"Giresun",40.9128,38.3895,10.7714285714286,19.2142857142857,3.12857142857143,80.7714285714286,43.892,NA,187,0,0,111,368,422,187,422
2018,42,39,"Giresun",40.9128,38.3895,6.94285714285714,19.9571428571429,2.014,79.9,67.3366666666667,NA,168,82,111,29,31,381,86,270
2018,43,39,"Giresun",40.9128,38.3895,13.6428571428571,16.4142857142857,11.8142857142857,67.5857142857143,NA,NA,187,71,136,73,92,402,116,266
2018,44,39,"Giresun",40.9128,38.3895,5.51428571428571,16.7571428571429,0,66.2285714285714,22.1414285714286,NA,196,77,88,17,43,264,119,176
2018,45,39,"Giresun",40.9128,38.3895,7.04285714285714,15.6285714285714,0.0857142857142857,70.1857142857143,44.9016666666667,NA,231,107,261,43,58,473,124,212
2018,46,39,"Giresun",40.9128,38.3895,16.9428571428571,11.1142857142857,13.6131428571429,71.8571428571429,40.9342857142857,NA,230,0,0,112,247,465,230,465
2018,47,39,"Giresun",40.9128,38.3895,14.1857142857143,12.6,5.51442857142857,75.0571428571429,49.9828571428571,NA,270,40,10,86,313,499,230,489
2018,48,39,"Giresun",40.9128,38.3895,13.6857142857143,13.7428571428571,9.08485714285714,68.6571428571429,49.82,NA,245,70,33,65,72,201,175,168
2018,49,39,"Giresun",40.9128,38.3895,14.3,10.8285714285714,3.771,74.4714285714286,47.5185714285714,NA,257,25,66,134,259,420,232,354
2018,50,39,"Giresun",40.9128,38.3895,13.8428571428571,11.1,5.24357142857143,58.2571428571429,46.0785714285714,NA,256,78,82,68,56,305,178,223
2018,51,39,"Giresun",40.9128,38.3895,9.58571428571429,11.3857142857143,2.59985714285714,69.0285714285714,69.7571428571429,NA,250,28,30,120,99,248,222,218
2018,52,39,"Giresun",40.9128,38.3895,12.9857142857143,7.01428571428571,8.65657142857143,63.9571428571429,39.6328571428571,NA,244,0,0,171,153,273,244,273
2019,1,39,"Giresun",40.9128,38.3895,14.6375,9.2375,4.912125,68.525,54.1925,NA,343,41,108,227,616,784,302,676
2019,2,39,"Giresun",40.9128,38.3895,15.2,7.3,5.51528571428571,61.4571428571429,49.8571428571429,NA,255,0,0,161,140,208,255,208
2019,3,39,"Giresun",40.9128,38.3895,17.2285714285714,7.81428571428571,4.67157142857143,62.2571428571429,49.7414285714286,NA,192,1,0,38,32,198,191,198
2019,4,39,"Giresun",40.9128,38.3895,16.3285714285714,11.3142857142857,4.02757142857143,56.6857142857143,74.1742857142857,NA,308,0,0,51,44,314,308,314
2019,5,39,"Giresun",40.9128,38.3895,13.0142857142857,10.2428571428571,1.02857142857143,64.9428571428571,76.52,NA,253,50,63,33,30,143,203,80
2019,6,39,"Giresun",40.9128,38.3895,10.9571428571429,9.2,3.99928571428571,74.4142857142857,52.0385714285714,NA,276,6,11,86,45,127,270,116
2019,7,39,"Giresun",40.9128,38.3895,11.4428571428571,8.21428571428571,2.38585714285714,67.2285714285714,47.19,NA,325,85,47,139,75,234,240,187
2019,8,39,"Giresun",40.9128,38.3895,15.1428571428571,8.04285714285714,1.10028571428571,69.4857142857143,64.0385714285714,NA,305,43,8,189,153,219,262,211
2019,9,39,"Giresun",40.9128,38.3895,15.6571428571429,6.67142857142857,4.74328571428571,68.6,48.3157142857143,NA,331,0,0,282,214,310,331,310
2019,10,39,"Giresun",40.9128,38.3895,12.2142857142857,9.84285714285714,0.914571428571429,59.9285714285714,54.768,NA,359,128,64,100,80,252,231,188
2019,11,39,"Giresun",40.9128,38.3895,14.4,10.3285714285714,2.48557142857143,73.4428571428571,41.72,NA,373,0,0,42,196,400,373,400
2019,12,39,"Giresun",40.9128,38.3895,13,7.98571428571429,0.814285714285714,68.6857142857143,54.0985714285714,NA,343,45,22,255,115,416,298,394
2019,13,39,"Giresun",40.9128,38.3895,11.5,6.82857142857143,0.714142857142857,67.5714285714286,46.2785714285714,NA,256,47,5,83,37,194,209,189
2019,14,39,"Giresun",40.9128,38.3895,12.0142857142857,9.37142857142857,0.514428571428571,78.2571428571429,68.3942857142857,NA,365,141,64,72,48,208,224,144
2019,15,39,"Giresun",40.9128,38.3895,12.7428571428571,15,0.600428571428571,61.7571428571429,62.8971428571429,NA,359,195,67,94,62,183,164,116
2019,16,39,"Giresun",40.9128,38.3895,14.1142857142857,9.7,10.0144285714286,74.8428571428571,36.0642857142857,NA,318,0,0,263,156,208,318,208
2019,17,39,"Giresun",40.9128,38.3895,10.7285714285714,11.7714285714286,0.500428571428571,72.0285714285714,45.4528571428571,NA,412,198,126,35,9,313,214,187
2019,18,39,"Giresun",40.9128,38.3895,12.1142857142857,16.8857142857143,1.54314285714286,64.4714285714286,53.5671428571429,NA,523,110,49,214,209,353,413,304
2019,19,39,"Giresun",40.9128,38.3895,16.9428571428571,16.2571428571429,2.144,71.7142857142857,50.255,NA,452,81,54,223,178,386,371,332
2019,20,39,"Giresun",40.9128,38.3895,12.8285714285714,16.9,0.314857142857143,78.4285714285714,NA,NA,454,71,56,146,155,389,383,333
2019,21,39,"Giresun",40.9128,38.3895,13.0285714285714,19.2857142857143,1,76.9,NA,NA,457,229,176,69,22,413,228,237
2019,22,39,"Giresun",40.9128,38.3895,9.4,20.2571428571429,0,68.5428571428571,NA,NA,453,107,62,60,17,323,346,261
2019,23,39,"Giresun",40.9128,38.3895,9.12857142857143,22.1571428571429,0.871428571428571,76.6285714285714,NA,NA,378,4,22,282,396,532,374,510
2019,24,39,"Giresun",40.9128,38.3895,10.4714285714286,23.3571428571429,0.942714285714286,77.9857142857143,NA,NA,378,0,0,210,124,244,378,244
2019,25,39,"Giresun",40.9128,38.3895,12.7428571428571,24.3142857142857,12.184,73.8142857142857,NA,NA,306,0,0,105,43,325,306,325
2019,26,39,"Giresun",40.9128,38.3895,16.6285714285714,24.0428571428571,2.40028571428571,68.8714285714286,40.92,NA,377,0,0,274,279,342,377,342
2019,27,39,"Giresun",40.9128,38.3895,10.1142857142857,23.0571428571429,0.685571428571429,65.3,33.2457142857143,NA,456,49,75,213,82,222,407,147
2019,28,39,"Giresun",40.9128,38.3895,14.9857142857143,23.3,5.65728571428571,69.6142857142857,29.81,NA,398,58,81,193,147,421,340,340
2019,29,39,"Giresun",40.9128,38.3895,14.7857142857143,23,4.12928571428571,69.6571428571429,NA,NA,453,52,16,271,138,203,401,187
2019,30,39,"Giresun",40.9128,38.3895,16.2142857142857,23.7571428571429,3.74271428571429,68.5142857142857,NA,NA,456,0,0,322,235,335,456,335
2019,31,39,"Giresun",40.9128,38.3895,12.5714285714286,25.0428571428571,3.82857142857143,70.5428571428571,37.1425,NA,334,46,47,134,127,375,288,328
2019,32,39,"Giresun",40.9128,38.3895,10.7857142857143,22.7857142857143,4.15828571428571,67.1571428571429,19.9157142857143,NA,346,0,0,197,264,395,346,395
2019,33,39,"Giresun",40.9128,38.3895,14.1571428571429,24.1714285714286,0.385857142857143,69.3428571428571,25.8928571428571,NA,337,30,52,249,405,531,307,479
2019,34,39,"Giresun",40.9128,38.3895,13.1142857142857,23.7285714285714,2.64328571428571,75.1571428571429,27.225,NA,299,0,0,298,345,345,299,345
2019,35,39,"Giresun",40.9128,38.3895,12.2,23.6,0.357142857142857,74.2571428571429,26.1557142857143,NA,307,0,0,272,407,415,307,415
2019,36,39,"Giresun",40.9128,38.3895,13.0714285714286,23.1,0.1,66.5142857142857,23.3657142857143,NA,171,0,0,171,67,67,171,67
2019,37,39,"Giresun",40.9128,38.3895,10.0571428571429,22.2285714285714,1.5,67.5428571428571,17.9314285714286,NA,218,0,0,122,35,55,218,55
2019,38,39,"Giresun",40.9128,38.3895,12.5142857142857,19.6285714285714,7.686,71.1142857142857,20.4371428571429,NA,266,35,4,128,54,91,231,87
2019,39,39,"Giresun",40.9128,38.3895,10.8285714285714,19.9285714285714,2.35742857142857,72.7,34.168,NA,237,62,29,60,20,79,175,50
2019,40,39,"Giresun",40.9128,38.3895,13.7428571428571,20.7142857142857,2.94242857142857,72.4857142857143,52.8485714285714,NA,241,92,59,126,41,111,149,52
2019,41,39,"Giresun",40.9128,38.3895,12.6571428571429,18.2285714285714,2.44314285714286,73.5428571428571,39.4871428571429,NA,416,127,187,214,219,448,289,261
2019,42,39,"Giresun",40.9128,38.3895,6.5,19.0285714285714,1.15928571428571,78.3285714285714,60.065,NA,356,149,176,0,0,408,207,232
2019,43,39,"Giresun",40.9128,38.3895,8.34285714285714,17.5,4.54342857142857,79.5285714285714,63.2485714285714,NA,306,31,32,207,198,300,275,268
2019,44,39,"Giresun",40.9128,38.3895,14.2142857142857,14.5857142857143,15.7712857142857,75.1142857142857,48.2716666666667,NA,350,78,46,131,108,250,272,204
2019,45,39,"Giresun",40.9128,38.3895,12.6571428571429,17.1571428571429,0,60.1571428571429,50.0071428571429,NA,417,56,60,0,0,328,361,268
2019,46,39,"Giresun",40.9128,38.3895,9.11428571428571,16.2714285714286,0,67.5428571428571,86.9666666666667,NA,401,74,80,96,73,337,327,257
2019,47,39,"Giresun",40.9128,38.3895,6.44285714285714,13.4428571428571,0.6,74.4,80.37,NA,391,199,158,187,174,339,192,181
2019,48,39,"Giresun",40.9128,38.3895,12.5142857142857,15.1285714285714,6.64271428571429,59.0285714285714,79.3128571428571,NA,320,0,0,114,105,251,320,251
2019,49,39,"Giresun",40.9128,38.3895,9.52857142857143,8.41428571428571,11.4284285714286,66.3571428571429,42.8057142857143,NA,393,175,119,120,103,274,218,155
2019,50,39,"Giresun",40.9128,38.3895,8.54285714285714,12.5142857142857,0.114285714285714,51.6714285714286,61.25,NA,218,90,35,0,0,119,128,84
2019,51,39,"Giresun",40.9128,38.3895,8.08571428571429,12.1285714285714,2.17185714285714,55.1571428571429,64.78,NA,361,29,111,59,14,488,332,377
2019,52,39,"Giresun",40.9128,38.3895,14.0142857142857,13.8142857142857,3.82942857142857,50.6,58.79,NA,279,0,0,182,125,281,279,281
2020,1,39,"Giresun",40.9128,38.3895,7.28,7.82,8.1194,71.44,45.412,NA,160,0,0,75,64,126,160,126
2020,2,39,"Giresun",40.9128,38.3895,14.4142857142857,8.67142857142857,5.64357142857143,66.5857142857143,61.3283333333333,NA,240,54,34,152,101,173,186,139
2020,3,39,"Giresun",40.9128,38.3895,13.2142857142857,7.3,2.84328571428571,69.6142857142857,48.2314285714286,NA,270,46,122,130,177,382,224,260
2020,4,39,"Giresun",40.9128,38.3895,19.4857142857143,6.44285714285714,5.52842857142857,63.6,44.0785714285714,NA,358,116,159,240,136,295,242,136
2020,5,39,"Giresun",40.9128,38.3895,12.4714285714286,9.71428571428572,6.21514285714286,54.6571428571429,60.5242857142857,NA,331,117,90,105,67,272,214,182
2020,6,39,"Giresun",40.9128,38.3895,21.1857142857143,9.01428571428571,11.1588571428571,60.6,44.0766666666667,NA,343,0,0,197,135,267,343,267
2020,7,39,"Giresun",40.9128,38.3895,21.3142857142857,5.44285714285714,3.28757142857143,60.9285714285714,46.6916666666667,NA,341,6,0,137,180,338,335,338
2020,8,39,"Giresun",40.9128,38.3895,8.75714285714286,8.08571428571429,0.571285714285714,73.5142857142857,69.8028571428571,NA,283,83,21,118,45,187,200,166
2020,9,39,"Giresun",40.9128,38.3895,18.3285714285714,10,5.21414285714286,64.3,54.3,NA,393,44,36,170,253,528,349,492
2020,10,39,"Giresun",40.9128,38.3895,8.7,13.3285714285714,0,51.3142857142857,69.9442857142857,NA,205,51,81,34,30,210,154,129
2020,11,39,"Giresun",40.9128,38.3895,11.6,13.0428571428571,2.1,68.6857142857143,83.5685714285714,NA,115,12,7,41,26,94,103,87
2020,12,39,"Giresun",40.9128,38.3895,9.78571428571429,6.5,7.41414285714286,74.5714285714286,40.0228571428571,NA,117,11,10,94,105,118,106,108
2020,13,39,"Giresun",40.9128,38.3895,8.05714285714286,9.45714285714286,1.55714285714286,78.2857142857143,58.1128571428571,NA,136,37,11,66,36,92,99,81
2020,14,39,"Giresun",40.9128,38.3895,11.2,10.5142857142857,3.186,73.7714285714286,71.29,NA,155,43,23,76,50,121,112,98
2020,15,39,"Giresun",40.9128,38.3895,13.3428571428571,10.1571428571429,0.128571428571429,70.3428571428571,70.634,NA,133,0,0,93,100,118,133,118
2020,16,39,"Giresun",40.9128,38.3895,13.8,11.5285714285714,2.08557142857143,72.1857142857143,NA,NA,141,56,19,17,20,106,85,87
2020,17,39,"Giresun",40.9128,38.3895,13.0857142857143,10.7142857142857,3.05685714285714,69.5142857142857,46.8033333333333,NA,137,19,9,83,89,123,118,114
2020,18,39,"Giresun",40.9128,38.3895,10.3714285714286,13.8428571428571,2.47085714285714,74.0428571428571,55.0757142857143,NA,146,51,32,22,14,164,95,132
2020,19,39,"Giresun",40.9128,38.3895,13.0857142857143,14.2,6.114,71.9857142857143,31.5485714285714,NA,137,3,0,58,72,157,134,157
2020,20,39,"Giresun",40.9128,38.3895,11.9571428571429,18.9142857142857,0.0285714285714286,65.5285714285714,63.5614285714286,NA,164,85,82,41,45,164,79,82
2020,21,39,"Giresun",40.9128,38.3895,14.8857142857143,17.7285714285714,4.97128571428571,65.3285714285714,55.8714285714286,NA,146,7,1,70,51,96,139,95
2020,22,39,"Giresun",40.9128,38.3895,10.9857142857143,15.8857142857143,1.08585714285714,69.1857142857143,28.7071428571429,NA,118,16,6,45,48,100,102,94
2020,23,39,"Giresun",40.9128,38.3895,9.44285714285714,18.8857142857143,1.31442857142857,75.5857142857143,37.4957142857143,NA,112,23,10,36,29,70,89,60
2020,24,39,"Giresun",40.9128,38.3895,9.85714285714286,21.5714285714286,2.40057142857143,74,56.3885714285714,NA,140,5,2,51,25,150,135,148
2020,25,39,"Giresun",40.9128,38.3895,10.5142857142857,22.3142857142857,10.7837142857143,74.0714285714286,47.1071428571429,NA,137,74,52,54,51,108,63,56
2020,26,39,"Giresun",40.9128,38.3895,13.5,23.4,0.214285714285714,72.3571428571429,45.12,NA,173,16,0,119,90,133,157,133
2020,27,39,"Giresun",40.9128,38.3895,9.7,24.5142857142857,0.271428571428571,67.7428571428571,41.27,NA,113,0,0,59,30,113,113,113
2020,28,39,"Giresun",40.9128,38.3895,13.6428571428571,24.7857142857143,10.3692857142857,72.4714285714286,42.2071428571429,NA,164,0,0,138,84,122,164,122
2020,29,39,"Giresun",40.9128,38.3895,11.4571428571429,23.5857142857143,4.12771428571429,74.7571428571429,44.7485714285714,NA,186,17,5,86,38,111,169,106
2020,30,39,"Giresun",40.9128,38.3895,11.6571428571429,24.3714285714286,4.59871428571429,67.1571428571429,49.0128571428571,NA,190,1,0,126,105,142,189,142
2020,31,39,"Giresun",40.9128,38.3895,12.2714285714286,24.9428571428571,0.928571428571428,66.1,46.8671428571429,NA,150,0,0,88,86,127,150,127
2020,32,39,"Giresun",40.9128,38.3895,8.35714285714286,24.6,0.0857142857142857,65.1,36.2571428571429,NA,146,0,0,26,8,107,146,107
2020,33,39,"Giresun",40.9128,38.3895,14.9285714285714,23.7857142857143,2.87285714285714,67.2,46.3614285714286,NA,183,0,0,182,82,83,183,83
2020,34,39,"Giresun",40.9128,38.3895,13.5857142857143,23.3857142857143,7.101,63.5142857142857,39.1457142857143,NA,197,0,0,133,68,97,197,97
2020,35,39,"Giresun",40.9128,38.3895,9.91428571428571,23.1714285714286,0.114285714285714,69.4,39.9385714285714,NA,164,31,6,38,54,157,133,151
2020,36,39,"Giresun",40.9128,38.3895,11.2714285714286,24.6142857142857,0.557142857142857,74.2,46.9557142857143,NA,179,3,0,51,40,112,176,112
2020,37,39,"Giresun",40.9128,38.3895,8.1,23.8,5.75942857142857,74.7857142857143,40.8514285714286,NA,193,17,3,99,48,91,176,88
2020,38,39,"Giresun",40.9128,38.3895,11.8428571428571,22.9142857142857,0.371571428571429,73.6285714285714,54.5685714285714,NA,235,2,0,150,93,157,233,157
2020,39,39,"Giresun",40.9128,38.3895,9.32857142857143,22.2428571428571,2.457,74.6714285714286,43.9514285714286,NA,220,17,4,60,72,129,203,125
2020,40,39,"Giresun",40.9128,38.3895,11.1714285714286,21.8571428571429,4.55628571428571,75.3285714285714,50.4342857142857,NA,187,34,42,150,112,154,153,112
2020,41,39,"Giresun",40.9128,38.3895,8.67142857142857,20.8714285714286,0.185714285714286,70.2142857142857,53.4328571428571,NA,182,51,31,28,24,127,131,96
2020,42,39,"Giresun",40.9128,38.3895,9.67142857142857,21.1285714285714,0.371428571428571,75.0428571428571,100.548571428571,NA,177,88,26,69,68,111,89,85
2020,43,39,"Giresun",40.9128,38.3895,11.4857142857143,18.5142857142857,4.39928571428571,75.0857142857143,49.8585714285714,NA,194,97,90,25,20,161,97,71
2020,44,39,"Giresun",40.9128,38.3895,9.8,19.4142857142857,3.94257142857143,76.1571428571429,93.6842857142857,NA,255,22,30,94,29,233,233,203
2020,45,39,"Giresun",40.9128,38.3895,15.3285714285714,15.6,12.0282857142857,74.4428571428572,43.34,NA,156,43,29,83,53,103,113,74
2020,46,39,"Giresun",40.9128,38.3895,7.67142857142857,14.0285714285714,4.25728571428571,71.4714285714286,44.0871428571429,NA,208,109,66,35,30,109,99,43
2020,47,39,"Giresun",40.9128,38.3895,15.8,11.5428571428571,15.0428571428571,73.7285714285714,40.7828571428571,NA,173,11,1,98,45,83,162,82
2020,48,39,"Giresun",40.9128,38.3895,11.6285714285714,10.3,4.27128571428571,69.2571428571429,44.31,NA,199,0,0,52,37,262,199,262
2020,49,39,"Giresun",40.9128,38.3895,10.9714285714286,12.3142857142857,2.48514285714286,74.5714285714286,78.5785714285714,NA,207,11,25,31,28,116,196,91
2020,50,39,"Giresun",40.9128,38.3895,13.2571428571429,13.4285714285714,0.971428571428571,59.5285714285714,73.0542857142857,NA,181,0,0,15,2,98,181,98
2020,51,39,"Giresun",40.9128,38.3895,15.1857142857143,12.0857142857143,0.799857142857143,67.2857142857143,71.4428571428572,NA,171,19,20,106,39,90,152,70
2020,52,39,"Giresun",40.9128,38.3895,15.1285714285714,9.64285714285714,8.71328571428571,60.5142857142857,48.3442857142857,NA,203,59,7,74,58,113,144,106
2020,53,39,"Giresun",40.9128,38.3895,6.5,13.375,0,37.025,62.5575,NA,122,73,69,18,23,111,49,42
2017,1,40,"Gumushane",40.46,39.4811,27.2714285714286,3.31428571428571,0.285714285714286,47.4142857142857,49.14,40.53,563,16,48,0,0,847,547,799
2017,2,40,"Gumushane",40.46,39.4811,22.9857142857143,1.82857142857143,0.257714285714286,56.2,44.8283333333333,33.5285714285714,757,78,66,105,125,1214,679,1148
2017,3,40,"Gumushane",40.46,39.4811,19.8571428571429,3.32857142857143,0.0428571428571429,58.6142857142857,43.2714285714286,33.2785714285714,762,5,10,445,961,1449,757,1439
2017,4,40,"Gumushane",40.46,39.4811,21.7571428571429,-0.2,11.1365714285714,67.5428571428571,35.6628571428571,28.8842857142857,639,97,139,297,386,889,542,750
2017,5,40,"Gumushane",40.46,39.4811,23.2857142857143,-0.757142857142857,5.28785714285714,59.9428571428571,45.5342857142857,37.15,588,12,11,304,815,1163,576,1152
2017,6,40,"Gumushane",40.46,39.4811,24.3142857142857,4.9,0.0142857142857143,58.3142857142857,45.81,37.8214285714286,736,8,151,354,661,1519,728,1368
2017,7,40,"Gumushane",40.46,39.4811,21.1857142857143,-0.685714285714286,3.24442857142857,58.3714285714286,33.3742857142857,27.06,492,0,0,353,602,717,492,717
2017,8,40,"Gumushane",40.46,39.4811,28.6142857142857,7.2,0.571714285714286,49.6714285714286,48.3785714285714,36.1571428571429,739,43,97,116,222,1747,696,1650
2017,9,40,"Gumushane",40.46,39.4811,18.4571428571429,8.62857142857143,0.985714285714286,61.7428571428571,56.9285714285714,32.4014285714286,574,322,540,92,95,866,252,326
2017,10,40,"Gumushane",40.46,39.4811,23.0428571428571,11.6142857142857,0.114142857142857,46.9857142857143,45.8285714285714,29.2585714285714,712,319,439,0,0,1043,393,604
2017,11,40,"Gumushane",40.46,39.4811,21.4285714285714,6.88571428571429,2.82814285714286,65.1142857142857,35.6171428571429,26.5885714285714,525,245,295,173,223,725,280,430
2017,12,40,"Gumushane",40.46,39.4811,23.2428571428571,6.21428571428571,0.143,58.4,43.8571428571429,29.7457142857143,589,0,0,391,726,1077,589,1077
2017,13,40,"Gumushane",40.46,39.4811,16.6857142857143,8.47142857142857,1.37128571428571,57.6571428571429,43.1142857142857,27.0771428571429,574,0,0,542,847,887,574,887
2017,14,40,"Gumushane",40.46,39.4811,23.0285714285714,9.32857142857143,1.9,58.2428571428571,40.7742857142857,27.1857142857143,639,231,442,176,348,1336,408,894
2017,15,40,"Gumushane",40.46,39.4811,19.5571428571429,9,3.92671428571429,64.3285714285714,39.2842857142857,28.1471428571429,587,146,322,288,554,1187,441,865
2017,16,40,"Gumushane",40.46,39.4811,32.5428571428571,13.4428571428571,0.372714285714286,54.5714285714286,62.6328571428571,26.2742857142857,717,100,110,219,290,920,617,810
2017,17,40,"Gumushane",40.46,39.4811,15.8428571428571,12.3285714285714,1.14271428571429,46.6142857142857,43.7114285714286,26.22,731,388,820,202,245,1478,343,658
2017,18,40,"Gumushane",40.46,39.4811,18.5571428571429,14.7428571428571,0.401285714285714,61.3285714285714,49.7385714285714,23.6214285714286,506,114,246,277,515,923,392,677
2017,19,40,"Gumushane",40.46,39.4811,27.2571428571429,16.2571428571429,1.90157142857143,57.4857142857143,40.2842857142857,19.8628571428571,471,126,260,206,418,966,345,706
2017,20,40,"Gumushane",40.46,39.4811,21.1285714285714,13.4857142857143,5.459,70.8571428571429,27.0171428571429,16.68,472,74,119,211,535,1205,398,1086
2017,21,40,"Gumushane",40.46,39.4811,16.3428571428571,14.3,3.958,68.2571428571429,30.2442857142857,23.0071428571429,448,90,199,197,266,849,358,650
2017,22,40,"Gumushane",40.46,39.4811,21.9428571428571,17.9714285714286,0.114285714285714,56.3571428571429,37.9385714285714,19.3185714285714,522,80,88,346,690,1015,442,927
2017,23,40,"Gumushane",40.46,39.4811,24.1142857142857,20.5428571428571,3.47028571428571,60.0142857142857,40.7571428571429,18.7971428571429,578,210,468,286,708,1388,368,920
2017,24,40,"Gumushane",40.46,39.4811,20.6285714285714,18.1285714285714,1.215,61.9714285714286,31.0471428571429,15.3957142857143,552,22,44,475,1024,1139,530,1095
2017,25,40,"Gumushane",40.46,39.4811,20.3,18.9142857142857,1.90271428571429,61.8142857142857,29.0057142857143,15.4814285714286,584,0,0,574,1034,1041,584,1041
2017,26,40,"Gumushane",40.46,39.4811,20.4142857142857,24.6428571428571,0,50.6714285714286,35.0642857142857,12.6728571428571,564,102,201,381,542,971,462,770
2017,27,40,"Gumushane",40.46,39.4811,23.0142857142857,22.6,0.000285714285714286,53.5571428571429,37.0257142857143,12.4442857142857,511,90,165,391,399,642,421,477
2017,28,40,"Gumushane",40.46,39.4811,25.0857142857143,23.0857142857143,0,50.9,31.9716666666667,11.4842857142857,481,0,0,443,752,864,481,864
2017,29,40,"Gumushane",40.46,39.4811,23.5428571428571,25.8857142857143,0,54.6714285714286,38.3285714285714,12.6628571428571,532,0,0,491,1146,1272,532,1272
2017,30,40,"Gumushane",40.46,39.4811,25.6571428571429,25.8,0.000142857142857143,50.3714285714286,42.8671428571429,14.6742857142857,531,1,1,362,655,928,530,927
2017,31,40,"Gumushane",40.46,39.4811,19.2428571428571,27.1428571428571,0.0411428571428571,53.3142857142857,44.5942857142857,13.0871428571429,559,56,77,286,538,1047,503,970
2017,32,40,"Gumushane",40.46,39.4811,23.0285714285714,27.8285714285714,0,49.4857142857143,48.1214285714286,15.1985714285714,567,0,0,466,787,1092,567,1092
2017,33,40,"Gumushane",40.46,39.4811,22.2142857142857,25.2428571428571,1.75657142857143,56.9714285714286,39.85,13.6942857142857,596,0,0,558,1089,1199,596,1199
2017,34,40,"Gumushane",40.46,39.4811,26.4142857142857,23.2142857142857,0.000714285714285714,58.9857142857143,30.4757142857143,11.4842857142857,601,86,343,483,900,1280,515,937
2017,35,40,"Gumushane",40.46,39.4811,22.5142857142857,22.6428571428571,0.714428571428571,59,27.5928571428571,9.67142857142857,493,0,0,406,750,1014,493,1014
2017,36,40,"Gumushane",40.46,39.4811,19.0857142857143,23,0.100142857142857,46.6571428571429,34.0014285714286,18.0528571428571,507,0,0,368,845,1321,507,1321
2017,37,40,"Gumushane",40.46,39.4811,16.6,25.2,0,38.9857142857143,68.9971428571429,31.7357142857143,589,0,0,325,428,1138,589,1138
2017,38,40,"Gumushane",40.46,39.4811,20.6142857142857,23.9142857142857,1.85714285714286,52.9428571428571,79.1271428571429,28.1385714285714,671,0,0,406,840,1312,671,1312
2017,39,40,"Gumushane",40.46,39.4811,22.2428571428571,19.7714285714286,0.442571428571429,59.2,34.2771428571429,15.0928571428571,782,0,0,718,1371,1630,782,1630
2017,40,40,"Gumushane",40.46,39.4811,18.9714285714286,15.4428571428571,2.685,51.9285714285714,35.3885714285714,24.1028571428571,543,24,55,215,374,1137,519,1082
2017,41,40,"Gumushane",40.46,39.4811,23.0428571428571,13.0285714285714,1.28871428571429,65.3285714285714,32.13,19.9942857142857,487,0,0,375,603,843,487,843
2017,42,40,"Gumushane",40.46,39.4811,17.2142857142857,12.3142857142857,0.671714285714286,59.1714285714286,57.56,28.7242857142857,530,0,0,287,388,815,530,815
2017,43,40,"Gumushane",40.46,39.4811,20.1142857142857,15.6428571428571,0.300857142857143,50.6428571428571,100.841428571429,38.8885714285714,506,23,100,125,201,919,483,819
2017,44,40,"Gumushane",40.46,39.4811,22.2714285714286,10.5428571428571,2.71457142857143,58.2285714285714,54.1,34.3528571428571,561,0,0,257,440,1102,561,1102
2017,45,40,"Gumushane",40.46,39.4811,12.7428571428571,11.1571428571429,0.285714285714286,63.8714285714286,86.5857142857143,34.96,577,20,61,310,324,829,557,768
2017,46,40,"Gumushane",40.46,39.4811,18.2714285714286,11.6428571428571,0.142714285714286,55.2285714285714,107.035714285714,43.9128571428571,587,0,0,133,196,1085,587,1085
2017,47,40,"Gumushane",40.46,39.4811,23.9285714285714,4.92857142857143,1.55971428571429,60.3857142857143,42.3066666666667,30.4142857142857,418,13,22,200,367,804,405,782
2017,48,40,"Gumushane",40.46,39.4811,17.2428571428571,7.02857142857143,0.985714285714286,60.2142857142857,67.4714285714286,41.51,386,0,0,52,109,619,386,619
2017,49,40,"Gumushane",40.46,39.4811,27,5.91428571428571,2.729,61.1571428571429,44.8071428571429,33.2971428571429,407,0,0,243,351,645,407,645
2017,50,40,"Gumushane",40.46,39.4811,14.8857142857143,5.8,0.0572857142857143,59,88.4457142857143,51.8242857142857,346,0,0,33,71,442,346,442
2017,51,40,"Gumushane",40.46,39.4811,20.0714285714286,7.5,4.61328571428571,72.8857142857143,78.63,36.6614285714286,386,47,50,204,175,349,339,299
2017,52,40,"Gumushane",40.46,39.4811,21.55,6.0625,1.199875,58.4,61.8475,40.1575,528,10,71,177,103,507,518,436
2018,1,40,"Gumushane",40.46,39.4811,16.9,5.9375,0.8265,66.6875,43.5371428571429,30.8285714285714,618,20,83,233,230,914,598,831
2018,2,40,"Gumushane",40.46,39.4811,21.9285714285714,6.87142857142857,1.07142857142857,61.5285714285714,52.4885714285714,35.8057142857143,624,7,28,368,845,1309,617,1281
2018,3,40,"Gumushane",40.46,39.4811,24.3428571428571,4.52857142857143,1.40028571428571,64.6285714285714,30.2542857142857,27.01,639,21,21,179,106,655,618,634
2018,4,40,"Gumushane",40.46,39.4811,19.7714285714286,4.45714285714286,1.57471428571429,67.4,38.3866666666667,24.7514285714286,604,11,15,468,556,764,593,749
2018,5,40,"Gumushane",40.46,39.4811,15.9142857142857,6.12857142857143,1.57028571428571,57.7,37.9342857142857,31.6671428571429,670,2,0,288,184,819,668,819
2018,6,40,"Gumushane",40.46,39.4811,21.9,8.87142857142857,0.000285714285714286,58.0714285714286,64.8385714285714,32.4228571428571,704,227,328,123,207,1022,477,694
2018,7,40,"Gumushane",40.46,39.4811,18.2285714285714,7.1,0.716428571428571,62.0571428571429,37.3028571428571,27.0271428571429,478,52,125,234,271,557,426,432
2018,8,40,"Gumushane",40.46,39.4811,15.6428571428571,7.4,0.143,62.7857142857143,41.7428571428571,31.9842857142857,711,301,632,24,11,1321,410,689
2018,9,40,"Gumushane",40.46,39.4811,34.2,7.45714285714286,2.98514285714286,64.0571428571428,35.6571428571429,31.7642857142857,621,18,50,143,230,956,603,906
2018,10,40,"Gumushane",40.46,39.4811,25.1714285714286,9.14285714285714,1.91628571428571,64.7857142857143,45.7528571428571,29.2842857142857,556,5,15,256,475,1330,551,1315
2018,11,40,"Gumushane",40.46,39.4811,16.3857142857143,10.0142857142857,3.286,62.2857142857143,38.0314285714286,27.28,551,137,393,265,826,1426,414,1033
2018,12,40,"Gumushane",40.46,39.4811,24.3142857142857,14.5571428571429,1.571,50.7428571428571,73.8771428571429,25.7142857142857,425,121,475,129,330,1187,304,712
2018,13,40,"Gumushane",40.46,39.4811,19.5571428571429,12.7857142857143,2.09942857142857,59.9142857142857,58.6316666666667,23.9685714285714,356,105,135,93,88,428,251,293
2018,14,40,"Gumushane",40.46,39.4811,20.9,13.2285714285714,1.39971428571429,45.8,37.1816666666667,25.2314285714286,407,4,1,303,370,486,403,485
2018,15,40,"Gumushane",40.46,39.4811,22.9857142857143,13.9714285714286,0.0142857142857143,60.4285714285714,42.9742857142857,20.9571428571429,374,154,246,173,155,450,220,204
2018,16,40,"Gumushane",40.46,39.4811,23.8571428571429,12.4142857142857,0.585857142857143,50.7857142857143,30.4914285714286,20.6628571428571,411,0,0,388,560,648,411,648
2018,17,40,"Gumushane",40.46,39.4811,21.1285714285714,16.5285714285714,0.134571428571429,52.4714285714286,35.5742857142857,20.66,419,188,293,169,244,652,231,359
2018,18,40,"Gumushane",40.46,39.4811,20.4,17.7571428571429,0.643,66.3,38.0357142857143,28.1214285714286,303,133,184,88,90,474,170,290
2018,19,40,"Gumushane",40.46,39.4811,20.0714285714286,15.6285714285714,3.7,69.6428571428571,31.2471428571429,21.9471428571429,275,26,138,246,329,467,249,329
2018,20,40,"Gumushane",40.46,39.4811,19.7857142857143,18.5285714285714,2.92928571428571,61.0285714285714,30.1171428571429,25.8528571428571,204,0,0,96,90,306,204,306
2018,21,40,"Gumushane",40.46,39.4811,18.7714285714286,20.1285714285714,7.03842857142857,67.6571428571429,34.1242857142857,24.43,252,45,76,60,46,281,207,205
2018,22,40,"Gumushane",40.46,39.4811,19.2142857142857,19.5285714285714,8.18128571428571,66.5,33.19,23.4185714285714,249,0,0,175,206,427,249,427
2018,23,40,"Gumushane",40.46,39.4811,18.5,20.7857142857143,0.614428571428571,60.5857142857143,32.5657142857143,26.2642857142857,267,21,92,185,397,812,246,720
2018,24,40,"Gumushane",40.46,39.4811,20.4142857142857,22.3,3.12671428571429,58.9571428571429,37.8714285714286,20.4128571428571,267,1,2,167,166,448,266,446
2018,25,40,"Gumushane",40.46,39.4811,20.3714285714286,22.0714285714286,3.19942857142857,62.9857142857143,31.4542857142857,17.8428571428571,358,0,0,280,341,518,358,518
2018,26,40,"Gumushane",40.46,39.4811,17.7,26.3714285714286,0.457142857142857,62.3571428571429,36.1971428571429,16.4328571428571,355,143,301,137,189,587,212,286
2018,27,40,"Gumushane",40.46,39.4811,25.9428571428571,23.5714285714286,0.116285714285714,60.7571428571429,27.56,10.4071428571429,342,0,0,316,322,418,342,418
2018,28,40,"Gumushane",40.46,39.4811,22.7285714285714,25.8428571428571,0.743714285714286,61.5428571428571,36.8671428571429,12.7628571428571,286,0,0,189,433,585,286,585
2018,29,40,"Gumushane",40.46,39.4811,25.9,23.4571428571429,1.74228571428571,53.3571428571429,29.796,15.135,260,0,0,227,663,756,260,756
2018,30,40,"Gumushane",40.46,39.4811,20.1,26.9571428571429,0.00114285714285714,53.8285714285714,38.8042857142857,9.565,265,74,290,175,444,822,191,532
2018,31,40,"Gumushane",40.46,39.4811,26.4142857142857,25.9142857142857,0.557142857142857,58.5571428571429,30.8828571428571,12.0633333333333,267,0,0,251,490,499,267,499
2018,32,40,"Gumushane",40.46,39.4811,26.6714285714286,23.4,0.0432857142857143,57.1857142857143,29.6685714285714,10.9114285714286,297,0,0,271,341,403,297,403
2018,33,40,"Gumushane",40.46,39.4811,25.4285714285714,24.4857142857143,0,50.1142857142857,30.725,13.34,216,0,0,186,272,332,216,332
2018,34,40,"Gumushane",40.46,39.4811,23.0714285714286,25.1428571428571,0.371857142857143,55.8142857142857,29.6514285714286,11.1857142857143,144,0,0,127,218,227,144,227
2018,35,40,"Gumushane",40.46,39.4811,22.7,26.4857142857143,0.000142857142857143,55.5,40.8771428571429,16.4742857142857,201,0,0,157,211,314,201,314
2018,36,40,"Gumushane",40.46,39.4811,25.4,23.4428571428571,1.17285714285714,53.5142857142857,38.9671428571429,18.9342857142857,341,0,0,298,262,370,341,370
2018,37,40,"Gumushane",40.46,39.4811,19.0285714285714,21.7142857142857,7.64228571428571,62.7285714285714,37.0471428571429,18.0657142857143,241,17,81,137,115,419,224,338
2018,38,40,"Gumushane",40.46,39.4811,18.0571428571429,20.2571428571429,1.47042857142857,63.7571428571429,31.9542857142857,12.3942857142857,189,0,0,153,300,344,189,344
2018,39,40,"Gumushane",40.46,39.4811,23.4857142857143,19.2571428571429,1.987,60.0571428571429,36.3928571428571,16.7785714285714,180,0,0,157,250,353,180,353
2018,40,40,"Gumushane",40.46,39.4811,22.7285714285714,18.8142857142857,2.79185714285714,57.8571428571429,39.4866666666667,15.7566666666667,191,1,0,118,211,341,190,341
2018,41,40,"Gumushane",40.46,39.4811,15.5571428571429,19.7428571428571,3.59471428571429,64.9428571428572,NA,NA,187,16,57,86,200,422,171,365
2018,42,40,"Gumushane",40.46,39.4811,14.2428571428571,19.4142857142857,0.299857142857143,58.4571428571429,96.84,33.07,168,6,1,42,35,381,162,380
2018,43,40,"Gumushane",40.46,39.4811,22.2714285714286,13.6,7.68728571428571,68.1571428571429,37.38,23.19,187,9,65,73,160,402,178,337
2018,44,40,"Gumushane",40.46,39.4811,13.5428571428571,14.0714285714286,0,55.6571428571429,57.6328571428571,35.4171428571429,196,0,0,64,46,264,196,264
2018,45,40,"Gumushane",40.46,39.4811,15.6142857142857,12.6857142857143,0.327,59.8,53.7671428571429,31.2528571428571,231,0,0,149,170,473,231,473
2018,46,40,"Gumushane",40.46,39.4811,23.6428571428571,7.65714285714286,8.30128571428572,70.1142857142857,41.7585714285714,25.3971428571429,230,0,0,194,349,465,230,465
2018,47,40,"Gumushane",40.46,39.4811,18.6,9.11428571428571,0.472,71.8142857142857,52.6314285714286,29.7771428571429,270,0,0,131,149,499,270,499
2018,48,40,"Gumushane",40.46,39.4811,23.5714285714286,11.0714285714286,3.401,65.9857142857143,37.2928571428571,29.4785714285714,245,28,35,71,69,201,217,166
2018,49,40,"Gumushane",40.46,39.4811,19.5285714285714,7.61428571428571,0.399857142857143,70.7142857142857,37.295,28.9685714285714,257,61,151,83,153,420,196,269
2018,50,40,"Gumushane",40.46,39.4811,18.5285714285714,6.74285714285714,5.95585714285714,66.3714285714286,44.32,40.3771428571429,256,18,53,45,28,305,238,252
2018,51,40,"Gumushane",40.46,39.4811,18.8285714285714,8.2,0.285571428571429,67.6285714285714,50.0971428571429,36.5614285714286,250,8,3,114,93,248,242,245
2018,52,40,"Gumushane",40.46,39.4811,25.1428571428571,2.65714285714286,5.41728571428571,68.6,37.3325,36.64,244,0,0,132,74,273,244,273
2019,1,40,"Gumushane",40.46,39.4811,16.775,5.95,2.288,67,62.175,53.185,343,12,51,64,46,784,331,733
2019,2,40,"Gumushane",40.46,39.4811,28.5714285714286,1.62857142857143,1.38571428571429,57.0428571428571,45.1483333333333,41.8966666666667,255,28,33,107,97,208,227,175
2019,3,40,"Gumushane",40.46,39.4811,20.7428571428571,1.58571428571429,0.771857142857143,59.1142857142857,42.91,39.1916666666667,192,9,10,40,35,198,183,188
2019,4,40,"Gumushane",40.46,39.4811,22.1285714285714,7.2,0.285571428571429,48.0714285714286,70.84,37.15,308,3,2,0,0,314,305,312
2019,5,40,"Gumushane",40.46,39.4811,20.1857142857143,7.18571428571429,1.342,60.6142857142857,60.5757142857143,35.0885714285714,253,8,19,90,45,143,245,124
2019,6,40,"Gumushane",40.46,39.4811,14.3571428571429,5.75714285714286,1.10014285714286,64.0428571428571,44.8842857142857,32.19,276,45,28,51,45,127,231,99
2019,7,40,"Gumushane",40.46,39.4811,19.3285714285714,4.55714285714286,0.114285714285714,60.1857142857143,36.055,28.28,325,77,33,162,78,234,248,201
2019,8,40,"Gumushane",40.46,39.4811,22,5.02857142857143,0.185714285714286,60.0571428571429,42.5914285714286,28.1285714285714,305,37,26,175,127,219,268,193
2019,9,40,"Gumushane",40.46,39.4811,19.5857142857143,4.01428571428571,2.79928571428571,64.5142857142857,35.09,27.92,331,5,2,232,208,310,326,308
2019,10,40,"Gumushane",40.46,39.4811,22.5428571428571,7.71428571428571,0.600142857142857,52.9285714285714,41.0342857142857,32.3242857142857,359,105,81,97,77,252,254,171
2019,11,40,"Gumushane",40.46,39.4811,25.1714285714286,9.17142857142857,1.27171428571429,64.2142857142857,43.0016666666667,31.4342857142857,373,40,42,150,251,400,333,358
2019,12,40,"Gumushane",40.46,39.4811,18.5285714285714,5.47142857142857,0.229,55.4,34.5085714285714,28.5328571428571,343,0,0,279,124,416,343,416
2019,13,40,"Gumushane",40.46,39.4811,18.5714285714286,5.02857142857143,0.129285714285714,60.9857142857143,NA,NA,256,9,6,152,92,194,247,188
2019,14,40,"Gumushane",40.46,39.4811,14.9428571428571,8.48571428571429,1.92842857142857,65.7714285714286,NA,NA,365,153,86,122,95,208,212,122
2019,15,40,"Gumushane",40.46,39.4811,22.1571428571429,13.2,0.957285714285714,54.0571428571429,38.0116666666667,26.9416666666667,359,211,124,89,39,183,148,59
2019,16,40,"Gumushane",40.46,39.4811,21.3714285714286,7.05714285714286,5.55714285714286,74.5,25.8385714285714,22.6414285714286,318,53,51,260,153,208,265,157
2019,17,40,"Gumushane",40.46,39.4811,18.2714285714286,10.7285714285714,0.285714285714286,54.2714285714286,31.0771428571429,23.8914285714286,412,110,106,213,146,313,302,207
2019,18,40,"Gumushane",40.46,39.4811,18.9571428571429,14.8857142857143,2.10142857142857,59.1,38.5171428571429,24.3842857142857,523,83,40,211,115,353,440,313
2019,19,40,"Gumushane",40.46,39.4811,21.2428571428571,16.8285714285714,0.514285714285714,57.3142857142857,65.1433333333333,25.32,452,85,77,101,49,386,367,309
2019,20,40,"Gumushane",40.46,39.4811,18.2285714285714,20.6428571428571,0.000142857142857143,51.0428571428571,47.426,24.7075,454,85,61,122,113,389,369,328
2019,21,40,"Gumushane",40.46,39.4811,19.7,18.7428571428571,1.45671428571429,64.0428571428571,41.2642857142857,20.37,457,0,0,345,319,413,457,413
2019,22,40,"Gumushane",40.46,39.4811,20.6,22.0857142857143,0.714142857142857,49.6428571428571,41.7328571428571,24.73,453,63,113,322,172,323,390,210
2019,23,40,"Gumushane",40.46,39.4811,19.5428571428571,23.9,0.2,59.1285714285714,46.9728571428571,15.64,378,0,0,320,411,532,378,532
2019,24,40,"Gumushane",40.46,39.4811,20.6,22.7857142857143,1.95657142857143,60.8571428571429,39.1214285714286,16.3242857142857,378,51,52,270,117,244,327,192
2019,25,40,"Gumushane",40.46,39.4811,20.2428571428571,22.0428571428571,5.91885714285714,66.0142857142857,37.2357142857143,18.2414285714286,306,0,0,249,274,325,306,325
2019,26,40,"Gumushane",40.46,39.4811,25.9,22.7428571428571,0.286714285714286,60.8857142857143,32.7285714285714,14.4928571428571,377,0,0,369,325,342,377,342
2019,27,40,"Gumushane",40.46,39.4811,22.8428571428571,22.8571428571429,2.42871428571429,55.1571428571429,32.7657142857143,14.6614285714286,456,0,0,444,217,222,456,222
2019,28,40,"Gumushane",40.46,39.4811,26.8571428571429,23.7571428571429,0.986714285714286,56.9,30.9871428571429,15.01,398,0,0,331,394,421,398,421
2019,29,40,"Gumushane",40.46,39.4811,26.2571428571429,23.3571428571429,1.45757142857143,58.2857142857143,32.1728571428571,14.7971428571429,453,0,0,376,152,203,453,203
2019,30,40,"Gumushane",40.46,39.4811,25.3857142857143,21.6571428571429,0.129285714285714,59.4857142857143,29.155,12.1642857142857,456,0,0,442,318,335,456,335
2019,31,40,"Gumushane",40.46,39.4811,22.0857142857143,24.8285714285714,0.0598571428571429,52.4857142857143,42.4057142857143,16.4842857142857,334,0,0,264,265,375,334,375
2019,32,40,"Gumushane",40.46,39.4811,25.6571428571429,21.8714285714286,0.0867142857142857,53.6714285714286,33.5857142857143,13.6771428571429,346,0,0,322,369,395,346,395
2019,33,40,"Gumushane",40.46,39.4811,20.6714285714286,26.0285714285714,0.0142857142857143,52.0571428571429,43.73,18.5542857142857,337,0,0,330,518,531,337,531
2019,34,40,"Gumushane",40.46,39.4811,19.6,23.1,2,61.3428571428571,38.7542857142857,14.4014285714286,299,0,0,285,336,345,299,345
2019,35,40,"Gumushane",40.46,39.4811,18.4,22.9428571428571,0.245857142857143,61.6428571428571,38.4042857142857,16.5514285714286,307,0,0,264,340,415,307,415
2019,36,40,"Gumushane",40.46,39.4811,25.3857142857143,21.7142857142857,0,54.9714285714286,33.97,15.27,171,0,0,153,34,67,171,67
2019,37,40,"Gumushane",40.46,39.4811,21.4285714285714,20.6857142857143,0.856714285714286,59.5714285714286,35.0085714285714,NA,218,0,0,204,48,55,218,55
2019,38,40,"Gumushane",40.46,39.4811,22.4571428571429,18.1428571428571,1.10114285714286,58.5428571428571,36.6214285714286,13.08,266,5,0,226,87,91,261,91
2019,39,40,"Gumushane",40.46,39.4811,17.0428571428571,18.7857142857143,0.0154285714285714,51.7857142857143,38.7614285714286,24.0185714285714,237,0,0,214,64,79,237,79
2019,40,40,"Gumushane",40.46,39.4811,15.3428571428571,19.4285714285714,0.800571428571428,48.7714285714286,49.7171428571429,33.7214285714286,241,2,0,127,41,111,239,111
2019,41,40,"Gumushane",40.46,39.4811,20.8,17.4142857142857,0.0577142857142857,56.0428571428571,39.2557142857143,29.9685714285714,416,0,0,273,253,448,416,448
2019,42,40,"Gumushane",40.46,39.4811,11.5571428571429,17.7285714285714,1.49928571428571,54.0142857142857,58.7671428571429,41.9671428571429,356,0,0,121,51,408,356,408
2019,43,40,"Gumushane",40.46,39.4811,15.4714285714286,15.6285714285714,0.919285714285714,69.8285714285714,33.96,26.498,306,0,0,269,245,300,306,300
2019,44,40,"Gumushane",40.46,39.4811,18.6857142857143,11.5142857142857,5.46028571428571,64.6285714285714,38.7128571428571,38.242,350,0,0,214,179,250,350,250
2019,45,40,"Gumushane",40.46,39.4811,9.65714285714286,13.4142857142857,0,45.7,64.92,66.9866666666667,417,0,0,0,0,328,417,328
2019,46,40,"Gumushane",40.46,39.4811,10.5714285714286,11.8428571428571,0,46.0714285714286,83.5585714285714,33.326,401,1,0,106,72,337,400,337
2019,47,40,"Gumushane",40.46,39.4811,15.0857142857143,8.85714285714286,0,48.1714285714286,81.6914285714286,38.89,391,0,0,282,204,339,391,339
2019,48,40,"Gumushane",40.46,39.4811,18.4,9.97142857142857,3.94185714285714,60.0142857142857,64.2642857142857,52.395,320,53,55,101,109,251,267,196
2019,49,40,"Gumushane",40.46,39.4811,16.7857142857143,4.42857142857143,0.945857142857143,67.9,44.81,38.7866666666667,393,0,0,302,192,274,393,274
2019,50,40,"Gumushane",40.46,39.4811,16.5,6.82857142857143,0.0142857142857143,58.9428571428571,52.9457142857143,55.975,218,12,5,47,19,119,206,114
2019,51,40,"Gumushane",40.46,39.4811,12.0857142857143,6.31428571428571,0.485571428571429,59.4571428571429,72.42,46.3316666666667,361,21,40,59,14,488,340,448
2019,52,40,"Gumushane",40.46,39.4811,20.1285714285714,9.52857142857143,0.114285714285714,48.2571428571429,39.3028571428571,30.4666666666667,279,19,42,73,35,281,260,239
2020,1,40,"Gumushane",40.46,39.4811,16.3,3.32,3.8226,79.98,38.69,39.2275,160,0,0,102,88,126,160,126
2020,2,40,"Gumushane",40.46,39.4811,21.7571428571429,4.17142857142857,0.115,61.8857142857143,37.6528571428571,39.0114285714286,240,7,17,124,106,173,233,156
2020,3,40,"Gumushane",40.46,39.4811,16.6714285714286,1.85714285714286,0.0435714285714286,60.8,42.46,21.7057142857143,270,0,0,166,153,382,270,382
2020,4,40,"Gumushane",40.46,39.4811,20.8857142857143,0.8,0.100857142857143,57.7142857142857,35.4285714285714,28.835,358,0,0,288,218,295,358,295
2020,5,40,"Gumushane",40.46,39.4811,21.1428571428571,5.05714285714286,4.141,57.2285714285714,39.61,31.6828571428571,331,3,1,82,47,272,328,271
2020,6,40,"Gumushane",40.46,39.4811,33.3285714285714,4.82857142857143,4.68828571428571,63.3857142857143,33.7942857142857,31.0828571428571,343,11,12,177,100,267,332,255
2020,7,40,"Gumushane",40.46,39.4811,22.2285714285714,-0.814285714285714,1.74242857142857,58.7714285714286,43.8528571428571,39.22,341,10,1,195,237,338,331,337
2020,8,40,"Gumushane",40.46,39.4811,14.0571428571429,5.01428571428571,0.228714285714286,65.5,66.0028571428571,44.0142857142857,283,5,17,91,53,187,278,170
2020,9,40,"Gumushane",40.46,39.4811,26.8714285714286,7.05714285714286,1.25742857142857,54.0714285714286,62.79,37.87,393,6,5,229,333,528,387,523
2020,10,40,"Gumushane",40.46,39.4811,15.6,10.2714285714286,0,45.4285714285714,NA,35.19,205,107,115,0,0,210,98,95
2020,11,40,"Gumushane",40.46,39.4811,23.2428571428571,13.1571428571429,0.785714285714286,56.2857142857143,56.11,27.7975,115,64,42,1,0,94,51,52
2020,12,40,"Gumushane",40.46,39.4811,15.0714285714286,4.27142857142857,4.643,71.1571428571429,31.8542857142857,23.3271428571429,117,0,0,102,110,118,117,118
2020,13,40,"Gumushane",40.46,39.4811,19.0571428571429,10.1571428571429,2.12814285714286,69.3142857142857,52.6314285714286,28.2614285714286,136,57,59,20,19,92,79,33
2020,14,40,"Gumushane",40.46,39.4811,16.3857142857143,9.57142857142857,2.97257142857143,69.8142857142857,41.0257142857143,25.17,155,58,45,67,66,121,97,76
2020,15,40,"Gumushane",40.46,39.4811,21.7428571428571,9.35714285714286,0.485428571428571,62.8714285714286,42.8528571428571,17.9857142857143,133,19,6,93,103,118,114,112
2020,16,40,"Gumushane",40.46,39.4811,19.6,12.5857142857143,0.714857142857143,52.7428571428571,45.6885714285714,21.2271428571429,141,5,4,104,87,106,136,102
2020,17,40,"Gumushane",40.46,39.4811,20.3428571428571,9.81428571428571,3.80128571428571,65.9857142857143,35.0214285714286,18.9471428571429,137,0,0,86,49,123,137,123
2020,18,40,"Gumushane",40.46,39.4811,21.6428571428571,13.5714285714286,2.12857142857143,66.5428571428571,40.4942857142857,21.5566666666667,146,45,41,36,79,164,101,123
2020,19,40,"Gumushane",40.46,39.4811,21.4428571428571,12.8142857142857,6.81571428571428,68.4285714285714,30.7142857142857,NA,137,56,43,74,101,157,81,114
2020,20,40,"Gumushane",40.46,39.4811,20.6857142857143,19.1,0,48.4714285714286,74.7042857142857,NA,164,0,0,135,126,164,164,164
2020,21,40,"Gumushane",40.46,39.4811,27.2714285714286,17.5857142857143,1.815,55.5714285714286,67.2771428571429,NA,146,21,10,95,79,96,125,86
2020,22,40,"Gumushane",40.46,39.4811,21.2285714285714,17.3142857142857,1.201,56.7,44.9757142857143,NA,118,44,52,63,37,100,74,48
2020,23,40,"Gumushane",40.46,39.4811,20.6142857142857,19.8285714285714,0.744285714285714,52.0428571428571,46.0828571428571,NA,112,35,22,29,16,70,77,48
2020,24,40,"Gumushane",40.46,39.4811,20.9142857142857,22.3142857142857,0.985857142857143,51.0428571428571,62.4757142857143,NA,140,44,96,61,44,150,96,54
2020,25,40,"Gumushane",40.46,39.4811,23.3285714285714,22.0714285714286,2.81428571428571,58.3714285714286,45.6385714285714,8.44666666666667,137,0,0,113,101,108,137,108
2020,26,40,"Gumushane",40.46,39.4811,19.8428571428571,23.1714285714286,0.899857142857143,57.4,50.1414285714286,12.88,173,34,40,119,90,133,139,93
2020,27,40,"Gumushane",40.46,39.4811,19.8285714285714,24.7,0.843285714285714,55.7,48.94,13.5385714285714,113,2,0,90,41,113,111,113
2020,28,40,"Gumushane",40.46,39.4811,29.0857142857143,25.1,1.2,60.6285714285714,43.3914285714286,11.602,164,0,0,140,85,122,164,122
2020,29,40,"Gumushane",40.46,39.4811,21.4857142857143,25.6571428571429,0.431142857142857,56.4428571428571,44.6557142857143,24.43,186,0,0,167,95,111,186,111
2020,30,40,"Gumushane",40.46,39.4811,23.2857142857143,25.2428571428571,0.1,55.2,44.3257142857143,14.8566666666667,190,0,0,147,111,142,190,142
2020,31,40,"Gumushane",40.46,39.4811,25.6428571428571,24.6857142857143,1.09985714285714,57.7285714285714,39.5771428571429,11.4557142857143,150,0,0,145,127,127,150,127
2020,32,40,"Gumushane",40.46,39.4811,24.3571428571429,25.0714285714286,0.0571428571428571,50.1428571428571,37.61,10.5157142857143,146,0,0,120,89,107,146,107
2020,33,40,"Gumushane",40.46,39.4811,25.9571428571429,22.7857142857143,0.200428571428571,54.2285714285714,38.0285714285714,10.24,183,0,0,175,78,83,183,83
2020,34,40,"Gumushane",40.46,39.4811,26.5285714285714,22.5,1.35871428571429,54.6428571428571,32.9771428571429,9.81714285714286,197,0,0,190,94,97,197,97
2020,35,40,"Gumushane",40.46,39.4811,22.2571428571429,24.5142857142857,0,47.2857142857143,41.9257142857143,16.3757142857143,164,0,0,132,101,157,164,157
2020,36,40,"Gumushane",40.46,39.4811,19.3428571428571,26.0714285714286,0.086,50.6857142857143,63.4228571428571,28.47,179,1,0,147,93,112,178,112
2020,37,40,"Gumushane",40.46,39.4811,20.1,24.3571428571429,0.143142857142857,52.7,50.3714285714286,NA,193,0,0,160,54,91,193,91
2020,38,40,"Gumushane",40.46,39.4811,21.4142857142857,23.7142857142857,0.572857142857143,54.5857142857143,54.2266666666667,NA,235,0,0,231,153,157,235,157
2020,39,40,"Gumushane",40.46,39.4811,19.8428571428571,22.4,0.642714285714286,54.9571428571429,49.5085714285714,NA,220,0,0,161,103,129,220,129
2020,40,40,"Gumushane",40.46,39.4811,19.5428571428571,21.2857142857143,4.27142857142857,58.8428571428571,57.0628571428571,NA,187,0,0,152,104,154,187,154
2020,41,40,"Gumushane",40.46,39.4811,18.2571428571429,20.0714285714286,0,46.0857142857143,58.4857142857143,NA,182,40,22,76,59,127,142,105
2020,42,40,"Gumushane",40.46,39.4811,16.0714285714286,20.7,0,46.7714285714286,88.3485714285714,NA,177,10,7,41,16,111,167,104
2020,43,40,"Gumushane",40.46,39.4811,15.2857142857143,16.9,2.58657142857143,58.6142857142857,52.3966666666667,4.59833333333333,194,0,0,97,116,161,194,161
2020,44,40,"Gumushane",40.46,39.4811,19.3,18.6857142857143,0.0571428571428571,46.5714285714286,77.4228571428571,4.60142857142857,255,9,4,79,22,233,246,229
2020,45,40,"Gumushane",40.46,39.4811,18.7857142857143,12.5428571428571,11.3701428571429,76.9714285714286,31.7157142857143,NA,156,0,0,97,60,103,156,103
2020,46,40,"Gumushane",40.46,39.4811,19.6,10.8,0.143857142857143,58.5285714285714,48.7885714285714,NA,208,0,0,142,49,109,208,109
2020,47,40,"Gumushane",40.46,39.4811,19.0857142857143,8.52857142857143,2.018,69.3571428571429,33.6114285714286,NA,173,0,0,125,42,83,173,83
2020,48,40,"Gumushane",40.46,39.4811,17.2,7.24285714285714,0.714571428571429,57.3857142857143,57.8171428571429,NA,199,0,0,82,64,262,199,262
2020,49,40,"Gumushane",40.46,39.4811,15.9,9.25714285714286,0.000714285714285714,65.5571428571429,62.5957142857143,NA,207,0,0,32,5,116,207,116
2020,50,40,"Gumushane",40.46,39.4811,23.5142857142857,9.91428571428571,0.956714285714286,55.9142857142857,42.5557142857143,NA,181,0,0,23,9,98,181,98
2020,51,40,"Gumushane",40.46,39.4811,24.1285714285714,9.77142857142857,0.471571428571429,64.2,40.5357142857143,NA,171,1,0,74,34,90,170,90
2020,52,40,"Gumushane",40.46,39.4811,19.4428571428571,5.1,4.35642857142857,61.8571428571429,42.5214285714286,NA,203,0,0,69,45,113,203,113
2020,53,40,"Gumushane",40.46,39.4811,12.275,7.9,0,44.3,72.865,NA,122,0,0,0,0,111,122,111
2017,1,41,"Hakkari",37.5833,43.7333,6.01428571428571,-9.71428571428571,0.528571428571429,72.2142857142857,190.642857142857,NA,563,561,847,0,0,847,2,0
2017,2,41,"Hakkari",37.5833,43.7333,7.72857142857143,-7.77142857142857,0.1,65.7428571428571,125.641428571429,NA,757,682,1153,0,0,1214,75,61
2017,3,41,"Hakkari",37.5833,43.7333,5.3,-6.17142857142857,0.0571428571428571,67.6142857142857,128.518571428571,NA,762,760,1449,0,0,1449,2,0
2017,4,41,"Hakkari",37.5833,43.7333,11.9571428571429,-6.51428571428571,2.8,72.1857142857143,77.4483333333333,NA,639,223,333,220,266,889,416,556
2017,5,41,"Hakkari",37.5833,43.7333,7.92857142857143,-9.68571428571429,0.285714285714286,69.7142857142857,67.45,NA,588,321,416,135,483,1163,267,747
2017,6,41,"Hakkari",37.5833,43.7333,6.32857142857143,-5.04285714285714,0.2,71.9857142857143,NA,NA,736,734,1519,0,0,1519,2,0
2017,7,41,"Hakkari",37.5833,43.7333,11.4428571428571,-7.64285714285714,3.62857142857143,70.2285714285714,NA,NA,492,255,297,163,241,717,237,420
2017,8,41,"Hakkari",37.5833,43.7333,6.8,-5.62857142857143,0,57.8714285714286,NA,NA,739,648,1528,0,0,1747,91,219
2017,9,41,"Hakkari",37.5833,43.7333,7.15714285714286,0.785714285714286,0.771428571428571,71.4,34.09,NA,574,468,743,0,0,866,106,123
2017,10,41,"Hakkari",37.5833,43.7333,9.65714285714286,2.42857142857143,1.65714285714286,57.9571428571429,46.6325,NA,712,489,624,37,90,1043,223,419
2017,11,41,"Hakkari",37.5833,43.7333,9.48571428571429,1.35714285714286,7.78571428571429,83.3571428571429,59.6516666666667,NA,525,60,61,238,338,725,465,664
2017,12,41,"Hakkari",37.5833,43.7333,12.1142857142857,0.671428571428571,3.7,68.7714285714286,50.0828571428571,NA,589,241,371,64,119,1077,348,706
2017,13,41,"Hakkari",37.5833,43.7333,12.2285714285714,4.52857142857143,3.78571428571429,67.5714285714286,53.3485714285714,NA,574,0,0,420,591,887,574,887
2017,14,41,"Hakkari",37.5833,43.7333,12.9428571428571,4.41428571428571,3.07142857142857,59.2142857142857,46.2157142857143,NA,639,276,609,265,503,1336,363,727
2017,15,41,"Hakkari",37.5833,43.7333,11.7571428571429,6.1,13.5571428571429,68.3857142857143,55.5285714285714,NA,587,66,62,232,334,1187,521,1125
2017,16,41,"Hakkari",37.5833,43.7333,11.9714285714286,8.17142857142857,1.97142857142857,57.1428571428571,49.9342857142857,NA,717,0,0,357,545,920,717,920
2017,17,41,"Hakkari",37.5833,43.7333,14.0285714285714,8.67142857142857,3,46.6428571428571,56.9628571428571,NA,731,344,687,249,568,1478,387,791
2017,18,41,"Hakkari",37.5833,43.7333,11.4571428571429,9.27142857142857,7.17142857142857,68.5857142857143,48.8485714285714,NA,506,149,276,259,473,923,357,647
2017,19,41,"Hakkari",37.5833,43.7333,14.5428571428571,14.1,0.557142857142857,49.2,72.8214285714286,NA,471,64,173,404,793,966,407,793
2017,20,41,"Hakkari",37.5833,43.7333,13.2571428571429,13.5571428571429,6.11428571428571,54.0285714285714,72.2471428571429,NA,472,0,0,383,1075,1205,472,1205
2017,21,41,"Hakkari",37.5833,43.7333,13.7,12.8857142857143,1.12857142857143,51.8571428571429,75.35,NA,448,0,0,443,772,849,448,849
2017,22,41,"Hakkari",37.5833,43.7333,12.4857142857143,15.0571428571429,0.0571428571428571,42.5571428571429,82.7785714285714,NA,522,64,127,178,220,1015,458,888
2017,23,41,"Hakkari",37.5833,43.7333,11.0857142857143,20,0,32.5571428571429,83.3071428571429,NA,578,88,185,233,642,1388,490,1203
2017,24,41,"Hakkari",37.5833,43.7333,13.2571428571429,18.6571428571429,0,34.4142857142857,91.04,NA,552,0,0,552,1139,1139,552,1139
2017,25,41,"Hakkari",37.5833,43.7333,11.2,18.6571428571429,0,36.8857142857143,64.9714285714286,NA,584,130,313,347,539,1041,454,728
2017,26,41,"Hakkari",37.5833,43.7333,13.9142857142857,22.4142857142857,0,31.1714285714286,69.4214285714286,NA,564,380,620,91,182,971,184,351
2017,27,41,"Hakkari",37.5833,43.7333,12.4857142857143,24.2,0,24.6571428571429,104.597142857143,NA,511,90,165,337,359,642,421,477
2017,28,41,"Hakkari",37.5833,43.7333,12.3571428571429,22.1571428571429,0.971428571428571,31.3714285714286,91.8766666666667,NA,481,188,408,156,203,864,293,456
2017,29,41,"Hakkari",37.5833,43.7333,12.3285714285714,24.6428571428571,0,22.2142857142857,146.887142857143,NA,532,70,214,304,684,1272,462,1058
2017,30,41,"Hakkari",37.5833,43.7333,11.7571428571429,24.1142857142857,0,23.0285714285714,153.487142857143,NA,531,11,7,337,625,928,520,921
2017,31,41,"Hakkari",37.5833,43.7333,13.3428571428571,25.0714285714286,0,22.5571428571429,127.798571428571,NA,559,323,586,208,322,1047,236,461
2017,32,41,"Hakkari",37.5833,43.7333,13.5571428571429,25.3285714285714,0,20.0857142857143,131.217142857143,NA,567,227,546,141,275,1092,340,546
2017,33,41,"Hakkari",37.5833,43.7333,12.1142857142857,23.1571428571429,0.171428571428571,29.8571428571429,139.588571428571,NA,596,0,0,447,856,1199,596,1199
2017,34,41,"Hakkari",37.5833,43.7333,13.5142857142857,23.4285714285714,0,20.5,122.035714285714,NA,601,17,18,431,963,1280,584,1262
2017,35,41,"Hakkari",37.5833,43.7333,13.7714285714286,23,0,20.8,53.02,NA,493,0,0,384,859,1014,493,1014
2017,36,41,"Hakkari",37.5833,43.7333,11.5857142857143,21.1285714285714,0,20.9714285714286,58.5814285714286,NA,507,232,436,124,307,1321,275,885
2017,37,41,"Hakkari",37.5833,43.7333,11.3428571428571,20.9714285714286,0.0857142857142857,21.4285714285714,58.5342857142857,NA,589,294,645,130,236,1138,295,493
2017,38,41,"Hakkari",37.5833,43.7333,12.7428571428571,19.6285714285714,0.0857142857142857,25.0714285714286,66.7857142857143,NA,671,295,460,267,536,1312,376,852
2017,39,41,"Hakkari",37.5833,43.7333,11.9714285714286,16.1714285714286,0,32.9571428571429,64.99,NA,782,0,0,606,1212,1630,782,1630
2017,40,41,"Hakkari",37.5833,43.7333,13.8571428571429,9.78571428571429,3.08571428571429,48.5428571428571,35.4385714285714,NA,543,234,565,301,568,1137,309,572
2017,41,41,"Hakkari",37.5833,43.7333,12.4857142857143,10.9857142857143,0.0571428571428571,44.6,38.35,NA,487,1,0,302,564,843,486,843
2017,42,41,"Hakkari",37.5833,43.7333,10.5714285714286,8.81428571428571,0,33.3,41.2157142857143,NA,530,254,389,117,162,815,276,426
2017,43,41,"Hakkari",37.5833,43.7333,12.7428571428571,11.4714285714286,0.742857142857143,41.1,50.0528571428571,NA,506,41,115,404,735,919,465,804
2017,44,41,"Hakkari",37.5833,43.7333,13.9142857142857,7.22857142857143,2.75714285714286,66.6714285714286,91.6433333333333,NA,561,179,365,310,524,1102,382,737
2017,45,41,"Hakkari",37.5833,43.7333,8.61428571428571,7.12857142857143,3.71428571428571,74.1142857142857,30.3485714285714,NA,577,138,164,210,389,829,439,665
2017,46,41,"Hakkari",37.5833,43.7333,7.11428571428571,5.12857142857143,0.4,49.1571428571429,49.6657142857143,NA,587,470,846,81,171,1085,117,239
2017,47,41,"Hakkari",37.5833,43.7333,9.75714285714286,-1.78571428571429,7.48571428571429,75.4857142857143,24.9814285714286,NA,418,0,0,187,308,804,418,804
2017,48,41,"Hakkari",37.5833,43.7333,10.4714285714286,-2.48571428571429,1.45714285714286,62.0285714285714,43.4642857142857,NA,386,203,292,0,0,619,183,327
2017,49,41,"Hakkari",37.5833,43.7333,9.67142857142857,-4.07142857142857,1.34285714285714,65.7142857142857,43.6314285714286,NA,407,254,363,54,74,645,153,282
2017,50,41,"Hakkari",37.5833,43.7333,8.01428571428571,-4.24285714285714,0,59.6571428571429,60.2785714285714,NA,346,309,337,0,0,442,37,105
2017,51,41,"Hakkari",37.5833,43.7333,12.3571428571429,2.92857142857143,2.71428571428571,77.3714285714286,23.3314285714286,NA,386,196,193,83,115,349,190,156
2017,52,41,"Hakkari",37.5833,43.7333,6.3,0.3,2.5625,65.625,50.175,NA,528,425,411,0,0,507,103,96
2018,1,41,"Hakkari",37.5833,43.7333,6.575,-2.45,5.3,78.0375,20.3325,NA,618,483,666,0,0,914,135,248
2018,2,41,"Hakkari",37.5833,43.7333,10.5142857142857,-3.41428571428571,0.0857142857142857,56.8714285714286,43.81,NA,624,443,1054,2,2,1309,181,255
2018,3,41,"Hakkari",37.5833,43.7333,8,-3.02857142857143,3.92857142857143,81.2428571428571,20.6042857142857,NA,639,307,390,83,33,655,332,265
2018,4,41,"Hakkari",37.5833,43.7333,9.07142857142857,-1.9,2.02857142857143,74.3142857142857,19.23,NA,604,355,505,17,24,764,249,259
2018,5,41,"Hakkari",37.5833,43.7333,8.85714285714286,-6.15714285714286,0,54.6428571428571,32.2614285714286,NA,670,515,602,0,0,819,155,217
2018,6,41,"Hakkari",37.5833,43.7333,10.3714285714286,0.442857142857143,0.228571428571429,52.0285714285714,37.4214285714286,NA,704,353,626,0,0,1022,351,396
2018,7,41,"Hakkari",37.5833,43.7333,7.57142857142857,1.34285714285714,9.5,81.1857142857143,23.36,NA,478,253,298,153,148,557,225,259
2018,8,41,"Hakkari",37.5833,43.7333,7.42857142857143,1.18571428571429,1.47142857142857,77.3714285714286,NA,NA,711,515,771,77,258,1321,196,550
2018,9,41,"Hakkari",37.5833,43.7333,11.6571428571429,2.64285714285714,3.9,75.6857142857143,NA,NA,621,45,25,368,572,956,576,931
2018,10,41,"Hakkari",37.5833,43.7333,12.4857142857143,5.68571428571429,1.88571428571429,68.8428571428571,30.6575,NA,556,0,0,270,606,1330,556,1330
2018,11,41,"Hakkari",37.5833,43.7333,13.5,4.62857142857143,1.94285714285714,63.7571428571429,22.4971428571429,NA,551,135,393,183,572,1426,416,1033
2018,12,41,"Hakkari",37.5833,43.7333,14.8428571428571,8.64285714285714,2.78571428571429,47.5571428571429,39.7728571428571,NA,425,0,0,158,680,1187,425,1187
2018,13,41,"Hakkari",37.5833,43.7333,11.9714285714286,6.81428571428571,7.05714285714286,63.4428571428571,36.16,NA,356,60,65,127,133,428,296,363
2018,14,41,"Hakkari",37.5833,43.7333,11.9714285714286,7.84285714285714,0.257142857142857,54.1285714285714,19.76,NA,407,231,357,112,88,486,176,129
2018,15,41,"Hakkari",37.5833,43.7333,13.5,7.91428571428571,2.02857142857143,68.9142857142857,14.41,NA,374,349,429,0,0,450,25,21
2018,16,41,"Hakkari",37.5833,43.7333,13.2,7.05714285714286,6.64285714285714,61.3285714285714,19.8914285714286,NA,411,122,133,199,325,648,289,515
2018,17,41,"Hakkari",37.5833,43.7333,10.9428571428571,8.18571428571429,2.12857142857143,65.9857142857143,18.7285714285714,NA,419,346,544,0,0,652,73,108
2018,18,41,"Hakkari",37.5833,43.7333,12.7857142857143,10.4142857142857,5.02857142857143,71.2,14.19,NA,303,156,218,46,81,474,147,256
2018,19,41,"Hakkari",37.5833,43.7333,10.2714285714286,8,11.3,84.2857142857143,15.3142857142857,NA,275,87,101,100,171,467,188,366
2018,20,41,"Hakkari",37.5833,43.7333,11.0428571428571,12,0.457142857142857,60.2142857142857,18.5085714285714,NA,204,152,263,0,0,306,52,43
2018,21,41,"Hakkari",37.5833,43.7333,9.75714285714286,14.4428571428571,2.32857142857143,62.6428571428571,23.21,NA,252,144,185,1,0,281,108,96
2018,22,41,"Hakkari",37.5833,43.7333,10.9428571428571,16.1571428571429,1.32857142857143,53.3,25.87,NA,249,25,91,149,186,427,224,336
2018,23,41,"Hakkari",37.5833,43.7333,10.6857142857143,17.1857142857143,0.0285714285714286,46.4857142857143,20.2857142857143,NA,267,91,236,54,227,812,176,576
2018,24,41,"Hakkari",37.5833,43.7333,13.8142857142857,17.4285714285714,1.5,50.8285714285714,20.166,NA,267,140,163,118,275,448,127,285
2018,25,41,"Hakkari",37.5833,43.7333,9.65714285714286,19.4,0,40.6857142857143,16.2914285714286,NA,358,55,136,194,260,518,303,382
2018,26,41,"Hakkari",37.5833,43.7333,10.4714285714286,22.8714285714286,0,35.6571428571429,53.8657142857143,NA,355,118,187,177,275,587,237,400
2018,27,41,"Hakkari",37.5833,43.7333,12.2285714285714,24.4714285714286,0,28.6857142857143,66.1871428571429,NA,342,159,184,130,131,418,183,234
2018,28,41,"Hakkari",37.5833,43.7333,11.9714285714286,25.1714285714286,0,32.3142857142857,13.2685714285714,NA,286,56,114,138,289,585,230,471
2018,29,41,"Hakkari",37.5833,43.7333,12.7428571428571,22.2142857142857,0,32.7428571428571,6.95857142857143,NA,260,0,0,201,644,756,260,756
2018,30,41,"Hakkari",37.5833,43.7333,12.2285714285714,24.9,0,29.7857142857143,7.59571428571429,NA,265,0,0,210,638,822,265,822
2018,31,41,"Hakkari",37.5833,43.7333,13.7714285714286,24.0142857142857,0.114285714285714,33.2714285714286,6.26142857142857,NA,267,0,0,250,484,499,267,499
2018,32,41,"Hakkari",37.5833,43.7333,12.2285714285714,23.7,0,29.8285714285714,9.57714285714286,NA,297,0,0,260,379,403,297,403
2018,33,41,"Hakkari",37.5833,43.7333,11.2,22.8571428571429,0,33.3,8.16,NA,216,67,110,81,136,332,149,222
2018,34,41,"Hakkari",37.5833,43.7333,10.4285714285714,22.7714285714286,0,33.6,8.47714285714286,NA,144,14,47,52,74,227,130,180
2018,35,41,"Hakkari",37.5833,43.7333,11.1428571428571,22.4857142857143,0,29.0571428571429,12.4328571428571,NA,201,24,107,46,65,314,177,207
2018,36,41,"Hakkari",37.5833,43.7333,11.9714285714286,20.3142857142857,0,34.6,15.2685714285714,NA,341,11,29,260,257,370,330,341
2018,37,41,"Hakkari",37.5833,43.7333,12.2142857142857,19.7428571428571,0,31.3428571428571,37.5633333333333,NA,241,23,45,145,143,419,218,374
2018,38,41,"Hakkari",37.5833,43.7333,11.8571428571429,17.4428571428571,0.0714285714285714,40.9714285714286,26.1142857142857,NA,189,79,194,75,91,344,110,150
2018,39,41,"Hakkari",37.5833,43.7333,9.91428571428571,17.5285714285714,0,30.3714285714286,21.1057142857143,NA,180,33,58,88,186,353,147,295
2018,40,41,"Hakkari",37.5833,43.7333,13.5142857142857,15.7285714285714,0.0142857142857143,41.3285714285714,19.1657142857143,NA,191,47,69,70,165,341,144,272
2018,41,41,"Hakkari",37.5833,43.7333,11.5428571428571,12.4571428571429,1.11428571428571,62.3142857142857,18.2742857142857,NA,187,165,304,0,0,422,22,118
2018,42,41,"Hakkari",37.5833,43.7333,9.7,11.1142857142857,1.68571428571429,62.9428571428571,17.5314285714286,NA,168,134,208,0,0,381,34,173
2018,43,41,"Hakkari",37.5833,43.7333,13.7142857142857,7.71428571428571,20.1714285714286,76.4285714285714,15.81,NA,187,54,85,114,294,402,133,317
2018,44,41,"Hakkari",37.5833,43.7333,13.1428571428571,6.2,0.171428571428571,52.0714285714286,11.7314285714286,NA,196,196,264,0,0,264,0,0
2018,45,41,"Hakkari",37.5833,43.7333,8.41428571428571,4.14285714285714,1.98571428571429,82.2142857142857,13.1214285714286,NA,231,231,473,0,0,473,0,0
2018,46,41,"Hakkari",37.5833,43.7333,7.7,3.7,4.74285714285714,78.8142857142857,13.9114285714286,NA,230,91,252,12,52,465,139,213
2018,47,41,"Hakkari",37.5833,43.7333,8.75714285714286,2.62857142857143,1.9,76.0714285714286,12.17,NA,270,178,163,38,83,499,92,336
2018,48,41,"Hakkari",37.5833,43.7333,7.44285714285714,1.4,11,84.2142857142857,12.1757142857143,NA,245,161,136,0,0,201,84,65
2018,49,41,"Hakkari",37.5833,43.7333,5.3,-0.657142857142857,11.4,89.2285714285714,14.8285714285714,NA,257,179,333,0,0,420,78,87
2018,50,41,"Hakkari",37.5833,43.7333,10.1571428571429,-1.01428571428571,4.2,81.4,11.555,NA,256,107,95,92,135,305,149,210
2018,51,41,"Hakkari",37.5833,43.7333,6.07142857142857,-2.02857142857143,3.82857142857143,85.7,23.6416666666667,NA,250,238,187,0,0,248,12,61
2018,52,41,"Hakkari",37.5833,43.7333,8.5,-3.38571428571429,10.6571428571429,86.6857142857143,17.3571428571429,NA,244,84,47,74,88,273,160,226
2019,1,41,"Hakkari",37.5833,43.7333,6,-5.1875,6.375,84.6875,35.38625,NA,343,307,658,0,0,784,36,126
2019,2,41,"Hakkari",37.5833,43.7333,8.02857142857143,-7.27142857142857,5.22857142857143,72.8714285714286,21.79,NA,255,114,50,89,93,208,141,158
2019,3,41,"Hakkari",37.5833,43.7333,9.8,-4.91428571428571,2.72857142857143,81.7142857142857,NA,NA,192,75,104,52,43,198,117,94
2019,4,41,"Hakkari",37.5833,43.7333,7.27142857142857,-5.62857142857143,0.328571428571429,79.6857142857143,NA,NA,308,299,252,0,0,314,9,62
2019,5,41,"Hakkari",37.5833,43.7333,7.05714285714286,-2.01428571428571,8.22857142857143,86.4,NA,NA,253,173,70,28,15,143,80,73
2019,6,41,"Hakkari",37.5833,43.7333,5.85714285714286,-3.5,3.82857142857143,72.2142857142857,NA,NA,276,191,73,20,12,127,85,54
2019,7,41,"Hakkari",37.5833,43.7333,8.28571428571428,-3.22857142857143,3.17142857142857,76.1142857142857,NA,NA,325,166,178,61,10,234,159,56
2019,8,41,"Hakkari",37.5833,43.7333,6.8,-4.11428571428571,0.0571428571428571,68.2,28.8716666666667,NA,305,266,200,0,0,219,39,19
2019,9,41,"Hakkari",37.5833,43.7333,9.85714285714286,-1.72857142857143,7.08571428571429,80.2428571428571,20.7485714285714,NA,331,63,20,82,82,310,268,290
2019,10,41,"Hakkari",37.5833,43.7333,8.7,-0.857142857142857,2.51428571428571,73.7428571428571,20.1,NA,359,314,194,0,0,252,45,58
2019,11,41,"Hakkari",37.5833,43.7333,8.35714285714286,1.15714285714286,16.5428571428571,80.9285714285714,23.4016666666667,NA,373,59,47,44,25,400,314,353
2019,12,41,"Hakkari",37.5833,43.7333,8.97142857142857,-0.0142857142857143,2.32857142857143,74.9714285714286,21.6525,NA,343,148,47,5,4,416,195,369
2019,13,41,"Hakkari",37.5833,43.7333,8.4,1.54285714285714,20.9714285714286,91.2857142857143,18.2214285714286,NA,256,67,66,56,38,194,189,128
2019,14,41,"Hakkari",37.5833,43.7333,8.82857142857143,2.9,10.3,83.1857142857143,13.295,NA,365,208,129,116,60,208,157,79
2019,15,41,"Hakkari",37.5833,43.7333,12.4857142857143,5.05714285714286,4.62857142857143,67.3857142857143,NA,NA,359,62,30,0,0,183,297,153
2019,16,41,"Hakkari",37.5833,43.7333,12.2285714285714,4.15714285714286,8.87142857142857,77.2714285714286,NA,NA,318,0,0,241,175,208,318,208
2019,17,41,"Hakkari",37.5833,43.7333,14.0285714285714,3.52857142857143,3.3,61.2142857142857,NA,NA,412,267,182,0,0,313,145,131
2019,18,41,"Hakkari",37.5833,43.7333,14.3285714285714,8.12857142857143,9.47142857142857,67.6142857142857,6.33166666666667,NA,523,7,12,5,3,353,516,341
2019,19,41,"Hakkari",37.5833,43.7333,12.7428571428571,9.7,0.471428571428571,62.7714285714286,7.05142857142857,NA,452,0,0,9,13,386,452,386
2019,20,41,"Hakkari",37.5833,43.7333,14.8,14.5142857142857,0.6,45.8857142857143,6.65428571428571,NA,454,35,33,45,41,389,419,356
2019,21,41,"Hakkari",37.5833,43.7333,14.0285714285714,15.8857142857143,0.171428571428571,50.6571428571429,9.68666666666667,NA,457,144,154,207,216,413,313,259
2019,22,41,"Hakkari",37.5833,43.7333,12.4857142857143,16.6571428571429,0.271428571428571,44.2428571428571,7.35714285714286,NA,453,292,215,73,54,323,161,108
2019,23,41,"Hakkari",37.5833,43.7333,10.4285714285714,20.3857142857143,0,41.6,11.4685714285714,NA,378,88,202,124,159,532,290,330
2019,24,41,"Hakkari",37.5833,43.7333,13.0428571428571,19.6428571428571,0.0428571428571429,40.2142857142857,10.2285714285714,NA,378,112,107,106,32,244,266,137
2019,25,41,"Hakkari",37.5833,43.7333,11.4571428571429,20.1428571428571,0,40.9,11.0871428571429,NA,306,0,0,170,239,325,306,325
2019,26,41,"Hakkari",37.5833,43.7333,10.7285714285714,22.9285714285714,0,33.3,12.4985714285714,NA,377,48,16,202,210,342,329,326
2019,27,41,"Hakkari",37.5833,43.7333,11.2,20.9714285714286,0,30.6571428571429,11.274,NA,456,117,90,139,49,222,339,132
2019,28,41,"Hakkari",37.5833,43.7333,13.2571428571429,21.7,0.0714285714285714,36.0142857142857,11.8342857142857,NA,398,70,59,217,214,421,328,362
2019,29,41,"Hakkari",37.5833,43.7333,11.7142857142857,22.7571428571429,0,32.6,13.6766666666667,NA,453,67,15,314,132,203,386,188
2019,30,41,"Hakkari",37.5833,43.7333,13,24.0714285714286,0,28.8571428571429,11.7185714285714,NA,456,81,38,313,273,335,375,297
2019,31,41,"Hakkari",37.5833,43.7333,11.2,23.7714285714286,0,28.8142857142857,11.4357142857143,NA,334,0,0,202,223,375,334,375
2019,32,41,"Hakkari",37.5833,43.7333,12.4857142857143,23.1428571428571,0,35.6714285714286,11.1585714285714,NA,346,130,140,47,34,395,216,255
2019,33,41,"Hakkari",37.5833,43.7333,16.3857142857143,24.5428571428571,0,35.5428571428571,11.2371428571429,NA,337,129,146,153,299,531,208,385
2019,34,41,"Hakkari",37.5833,43.7333,14.2857142857143,23.6142857142857,0,27.0857142857143,10.6157142857143,NA,299,0,0,203,229,345,299,345
2019,35,41,"Hakkari",37.5833,43.7333,14.3285714285714,21.3714285714286,0.0857142857142857,33.4,8.74571428571429,NA,307,55,76,134,175,415,252,339
2019,36,41,"Hakkari",37.5833,43.7333,11.7142857142857,20.1,0,35.0714285714286,10.4916666666667,NA,171,0,0,132,36,67,171,67
2019,37,41,"Hakkari",37.5833,43.7333,13.5142857142857,16.7,0.0428571428571429,48.1142857142857,7.82571428571429,NA,218,46,16,0,0,55,172,39
2019,38,41,"Hakkari",37.5833,43.7333,15.1,18.6,0.0285714285714286,31.9,11.6314285714286,NA,266,0,0,230,87,91,266,91
2019,39,41,"Hakkari",37.5833,43.7333,13,16.8,0,31.7,12.15,NA,237,0,0,227,74,79,237,79
2019,40,41,"Hakkari",37.5833,43.7333,11.7142857142857,15.9428571428571,0,36.1142857142857,12.8271428571429,NA,241,0,0,204,81,111,241,111
2019,41,41,"Hakkari",37.5833,43.7333,12.2285714285714,15.1714285714286,0.428571428571429,42.2571428571429,12.9,NA,416,66,100,140,137,448,350,348
2019,42,41,"Hakkari",37.5833,43.7333,9.87142857142857,11.6714285714286,1.71428571428571,45.0428571428571,11.1971428571429,NA,356,309,348,0,0,408,47,60
2019,43,41,"Hakkari",37.5833,43.7333,12.5285714285714,8.45714285714286,1.58571428571429,70.7285714285714,9.58142857142857,NA,306,278,281,0,0,300,28,19
2019,44,41,"Hakkari",37.5833,43.7333,9.34285714285714,6.47142857142857,0.685714285714286,75.8285714285714,11.1828571428571,NA,350,67,24,87,65,250,283,226
2019,45,41,"Hakkari",37.5833,43.7333,7.91428571428571,5.04285714285714,0,41.7285714285714,20.0357142857143,NA,417,417,328,0,0,328,0,0
2019,46,41,"Hakkari",37.5833,43.7333,10.3,3.85714285714286,0,35.3428571428571,22.1166666666667,NA,401,401,337,0,0,337,0,0
2019,47,41,"Hakkari",37.5833,43.7333,10.3714285714286,1.6,0,38.9,18.0371428571429,NA,391,278,283,113,56,339,113,56
2019,48,41,"Hakkari",37.5833,43.7333,11.9714285714286,2.77142857142857,2.44285714285714,73.1285714285714,16.8342857142857,NA,320,67,32,88,100,251,253,219
2019,49,41,"Hakkari",37.5833,43.7333,10.2571428571429,0.485714285714286,2.15714285714286,81.7857142857143,13.6628571428571,NA,393,187,122,95,76,274,206,152
2019,50,41,"Hakkari",37.5833,43.7333,6.42857142857143,-1.87142857142857,2.77142857142857,89.6142857142857,21.1014285714286,NA,218,155,112,4,2,119,63,7
2019,51,41,"Hakkari",37.5833,43.7333,10.5,-2.12857142857143,0,61.6,34.0171428571429,NA,361,304,376,0,0,488,57,112
2019,52,41,"Hakkari",37.5833,43.7333,8.45714285714286,-0.471428571428571,11.1,75.0285714285714,16.5357142857143,NA,279,49,66,127,62,281,230,215
2020,1,41,"Hakkari",37.5833,43.7333,6,-6.82,0.78,85.3,32.658,NA,160,127,105,0,0,126,33,21
2020,2,41,"Hakkari",37.5833,43.7333,8.02857142857143,-7.22857142857143,0.6,79.0857142857143,33.8057142857143,NA,240,239,173,0,0,173,1,0
2020,3,41,"Hakkari",37.5833,43.7333,7.18571428571429,-7.04285714285714,4.08571428571429,77.7571428571429,39.3114285714286,NA,270,246,308,0,0,382,24,74
2020,4,41,"Hakkari",37.5833,43.7333,9.57142857142857,-6.21428571428571,2.7,77.2857142857143,25.5085714285714,NA,358,262,239,0,0,295,96,56
2020,5,41,"Hakkari",37.5833,43.7333,7.77142857142857,-5.38571428571429,4.3,75.1142857142857,39.7285714285714,NA,331,209,201,40,28,272,122,71
2020,6,41,"Hakkari",37.5833,43.7333,11.3428571428571,-4.11428571428571,6.92857142857143,82.2142857142857,16.3614285714286,NA,343,135,79,152,142,267,208,188
2020,7,41,"Hakkari",37.5833,43.7333,10.0571428571429,-8.84285714285714,2.37142857142857,74.3857142857143,18.7328571428571,NA,341,218,199,34,23,338,123,139
2020,8,41,"Hakkari",37.5833,43.7333,5.95714285714286,0.228571428571429,10,89.7428571428571,29.2142857142857,NA,283,221,173,0,0,187,62,14
2020,9,41,"Hakkari",37.5833,43.7333,7,0.628571428571429,3.21428571428571,73.6285714285714,28.8871428571429,NA,393,242,337,38,34,528,151,191
2020,10,41,"Hakkari",37.5833,43.7333,7.92857142857143,2.05714285714286,3.27142857142857,65.7571428571429,24.1614285714286,NA,205,165,141,40,69,210,40,69
2020,11,41,"Hakkari",37.5833,43.7333,8.15714285714286,3.95714285714286,3.65714285714286,64.4285714285714,22.2342857142857,NA,115,81,60,16,1,94,34,34
2020,12,41,"Hakkari",37.5833,43.7333,9.52857142857143,2.07142857142857,19.1428571428571,83.2428571428571,14.44,NA,117,21,15,33,16,118,96,103
2020,13,41,"Hakkari",37.5833,43.7333,10.5714285714286,3.67142857142857,6.64285714285714,75.5571428571429,12.2985714285714,NA,136,62,44,16,10,92,74,48
2020,14,41,"Hakkari",37.5833,43.7333,9.64285714285714,2.98571428571429,10.0571428571429,80.8,11.1671428571429,NA,155,20,7,99,91,121,135,114
2020,15,41,"Hakkari",37.5833,43.7333,11.9142857142857,4.35714285714286,3.78571428571429,76.8428571428571,10.6557142857143,NA,133,79,82,14,6,118,54,36
2020,16,41,"Hakkari",37.5833,43.7333,12.7428571428571,6.15714285714286,0.0285714285714286,57.1714285714286,12.34,NA,141,6,3,0,0,106,135,103
2020,17,41,"Hakkari",37.5833,43.7333,14.5857142857143,7.57142857142857,11.1142857142857,75.5571428571428,11.0485714285714,NA,137,0,0,87,62,123,137,123
2020,18,41,"Hakkari",37.5833,43.7333,13.7714285714286,7.3,1.81428571428571,69.1571428571429,8.07,NA,146,9,4,76,116,164,137,160
2020,19,41,"Hakkari",37.5833,43.7333,13.7714285714286,9.41428571428571,6.02857142857143,73.1857142857143,8.82285714285714,NA,137,19,5,89,120,157,118,152
2020,20,41,"Hakkari",37.5833,43.7333,12.4857142857143,13.3428571428571,0.114285714285714,51.6285714285714,6.04142857142857,NA,164,107,94,0,0,164,57,70
2020,21,41,"Hakkari",37.5833,43.7333,14.5857142857143,16.2714285714286,1.22857142857143,48.4142857142857,8.46571428571429,NA,146,62,36,34,43,96,84,60
2020,22,41,"Hakkari",37.5833,43.7333,11.9142857142857,15.5,0.6,41.6,5.97,NA,118,13,4,70,44,100,105,96
2020,23,41,"Hakkari",37.5833,43.7333,11.7142857142857,17.2428571428571,0,34.3857142857143,6.11142857142857,NA,112,25,17,87,53,70,87,53
2020,24,41,"Hakkari",37.5833,43.7333,11.5,18.6142857142857,0,33.7428571428571,6.05,NA,140,58,104,53,40,150,82,46
2020,25,41,"Hakkari",37.5833,43.7333,12.2285714285714,18.1285714285714,0.771428571428572,43.8,6.89714285714286,NA,137,25,16,87,66,108,112,92
2020,26,41,"Hakkari",37.5833,43.7333,10.9428571428571,20.0714285714286,0.0571428571428571,40.3142857142857,5.38142857142857,NA,173,1,9,32,19,133,172,124
2020,27,41,"Hakkari",37.5833,43.7333,11.7571428571429,19.8285714285714,0.371428571428571,44.9142857142857,5.17666666666667,NA,113,64,78,0,0,113,49,35
2020,28,41,"Hakkari",37.5833,43.7333,12.8428571428571,21.1142857142857,0.285714285714286,44.2,6.11,NA,164,130,102,0,0,122,34,20
2020,29,41,"Hakkari",37.5833,43.7333,9.4,21.4714285714286,1.4,44.7714285714286,4.76333333333333,NA,186,121,82,0,0,111,65,29
2020,30,41,"Hakkari",37.5833,43.7333,12.2285714285714,24.8714285714286,0,29.4857142857143,5.11571428571429,NA,190,0,0,109,109,142,190,142
2020,31,41,"Hakkari",37.5833,43.7333,10.9857142857143,24.3714285714286,0,32.5571428571429,4.82428571428571,NA,150,24,20,86,50,127,126,107
2020,32,41,"Hakkari",37.5833,43.7333,12.7428571428571,21.4571428571429,0,35.7857142857143,4.12166666666667,NA,146,80,42,18,30,107,66,65
2020,33,41,"Hakkari",37.5833,43.7333,11.9714285714286,22,0,37.4,4.33,NA,183,47,20,60,34,83,136,63
2020,34,41,"Hakkari",37.5833,43.7333,11.4571428571429,20.6571428571429,0.742857142857143,37.7857142857143,4.28,NA,197,25,7,95,34,97,172,90
2020,35,41,"Hakkari",37.5833,43.7333,11.4571428571429,19.4428571428571,0.8,38.7142857142857,3.84166666666667,NA,164,119,126,0,0,157,45,31
2020,36,41,"Hakkari",37.5833,43.7333,14.3285714285714,21.3714285714286,0,32.7,4.66285714285714,NA,179,120,75,33,25,112,59,37
2020,37,41,"Hakkari",37.5833,43.7333,11.2,20.8285714285714,0,28.5428571428571,4.405,NA,193,86,57,16,7,91,107,34
2020,38,41,"Hakkari",37.5833,43.7333,10.8857142857143,19.8,0,29.4571428571429,12.0471428571429,NA,235,99,54,94,81,157,136,103
2020,39,41,"Hakkari",37.5833,43.7333,11.2,17.9428571428571,0,36.2857142857143,17.6928571428571,NA,220,39,25,137,76,129,181,104
2020,40,41,"Hakkari",37.5833,43.7333,13.5142857142857,14.9714285714286,1.11428571428571,46.5857142857143,13.8871428571429,NA,187,83,68,79,56,154,104,86
2020,41,41,"Hakkari",37.5833,43.7333,12.3714285714286,10.6571428571429,0.0142857142857143,49.0857142857143,9.36857142857143,NA,182,137,85,0,0,127,45,42
2020,42,41,"Hakkari",37.5833,43.7333,7.78571428571429,13.1857142857143,0,33.0428571428571,16.0314285714286,NA,177,144,72,0,0,111,33,39
2020,43,41,"Hakkari",37.5833,43.7333,8.67142857142857,12.0142857142857,0,31.2857142857143,15.2728571428571,NA,194,160,136,0,0,161,34,25
2020,44,41,"Hakkari",37.5833,43.7333,7.72857142857143,12.1571428571429,0,27.5,20.4414285714286,NA,255,107,84,65,61,233,148,149
2020,45,41,"Hakkari",37.5833,43.7333,10.3142857142857,6.98571428571429,9.51428571428571,79.8,14.3857142857143,NA,156,103,68,17,8,103,53,35
2020,46,41,"Hakkari",37.5833,43.7333,10.5,4.54285714285714,2.78571428571429,72.0857142857143,17.8757142857143,NA,208,188,101,4,3,109,20,8
2020,47,41,"Hakkari",37.5833,43.7333,6.9,2.74285714285714,3.22857142857143,76.6,20.0057142857143,NA,173,160,82,0,0,83,13,1
2020,48,41,"Hakkari",37.5833,43.7333,10.4571428571429,-0.2,0.457142857142857,73.1285714285714,19.8885714285714,NA,199,180,253,0,0,262,19,9
2020,49,41,"Hakkari",37.5833,43.7333,9.42857142857143,-1.08571428571429,0.0571428571428571,69.3857142857143,24.4071428571429,NA,207,175,100,0,0,116,32,16
2020,50,41,"Hakkari",37.5833,43.7333,7.15714285714286,0.285714285714286,0.271428571428571,76.1285714285714,20.0628571428571,NA,181,154,89,9,5,98,27,9
2020,51,41,"Hakkari",37.5833,43.7333,7.27142857142857,-1.72857142857143,2.71428571428571,83.8571428571429,18.1671428571429,NA,171,111,57,0,0,90,60,33
2020,52,41,"Hakkari",37.5833,43.7333,8.95714285714286,-7.25714285714286,2,76.3714285714286,27.4942857142857,NA,203,184,88,19,25,113,19,25
2020,53,41,"Hakkari",37.5833,43.7333,8.375,-5.525,0,65.3,45.8375,NA,122,118,107,0,0,111,4,4
2017,1,42,"Antakya",36.1968,36.1612,24.5142857142857,7.55714285714286,7.17142857142857,85.2714285714286,80.7142857142857,NA,563,165,181,46,138,847,398,666
2017,2,42,"Antakya",36.1968,36.1612,18.5428571428571,7.34285714285714,6.45714285714286,76.1285714285714,125.781428571429,NA,757,263,332,48,68,1214,494,882
2017,3,42,"Antakya",36.1968,36.1612,12.5285714285714,6.65714285714286,0.0285714285714286,78.6428571428571,173.368571428571,NA,762,135,132,213,377,1449,627,1317
2017,4,42,"Antakya",36.1968,36.1612,23.5,6.07142857142857,4.3,64.9571428571429,106.74,NA,639,34,31,238,420,889,605,858
2017,5,42,"Antakya",36.1968,36.1612,31.2571428571429,5.68571428571429,0.0285714285714286,55.2142857142857,124.898571428571,NA,588,36,59,225,456,1163,552,1104
2017,6,42,"Antakya",36.1968,36.1612,18.1571428571429,10.7,0.228571428571429,65.9,124.842857142857,NA,736,81,92,175,405,1519,655,1427
2017,7,42,"Antakya",36.1968,36.1612,23.9,7.04285714285714,0.0714285714285714,43.5857142857143,97.0042857142857,NA,492,0,0,243,288,717,492,717
2017,8,42,"Antakya",36.1968,36.1612,19.3,9.9,0.742857142857143,63.5428571428571,128.325714285714,NA,739,82,134,229,643,1747,657,1613
2017,9,42,"Antakya",36.1968,36.1612,22.0142857142857,13.0571428571429,2.88571428571429,67.1571428571429,106.232857142857,NA,574,64,79,171,200,866,510,787
2017,10,42,"Antakya",36.1968,36.1612,21.2571428571429,14.3285714285714,1.88571428571429,71.0857142857143,155.35,NA,712,35,83,234,340,1043,677,960
2017,11,42,"Antakya",36.1968,36.1612,28.1285714285714,11.7428571428571,3.35714285714286,73.8285714285714,51.4928571428571,NA,525,22,13,206,310,725,503,712
2017,12,42,"Antakya",36.1968,36.1612,29.7,14.6571428571429,0.957142857142857,68.8571428571429,63.2685714285714,NA,589,35,34,141,196,1077,554,1043
2017,13,42,"Antakya",36.1968,36.1612,24.7714285714286,15.5428571428571,3.77142857142857,71.8714285714286,59.4542857142857,NA,574,62,72,200,304,887,512,815
2017,14,42,"Antakya",36.1968,36.1612,32.1285714285714,17.2142857142857,1.17142857142857,61.5428571428571,57.74,NA,639,45,73,253,520,1336,594,1263
2017,15,42,"Antakya",36.1968,36.1612,30.1714285714286,16.0142857142857,1.97142857142857,65.5285714285714,54.9228571428571,NA,587,31,39,169,185,1187,556,1148
2017,16,42,"Antakya",36.1968,36.1612,29.0857142857143,18.2142857142857,0,64.6714285714286,80.23,NA,717,69,92,170,240,920,648,828
2017,17,42,"Antakya",36.1968,36.1612,22.1142857142857,19.4285714285714,0.0285714285714286,54.4142857142857,79.5571428571428,NA,731,1,0,365,767,1478,730,1478
2017,18,42,"Antakya",36.1968,36.1612,32.7857142857143,20.7571428571429,1.04285714285714,67.2714285714286,88.7142857142857,NA,506,24,63,168,218,923,482,860
2017,19,42,"Antakya",36.1968,36.1612,32.2285714285714,23.0142857142857,0,54.3142857142857,76.1342857142857,NA,471,43,127,119,211,966,428,839
2017,20,42,"Antakya",36.1968,36.1612,33.8285714285714,22.1285714285714,7.58571428571429,60.6285714285714,58.0671428571429,NA,472,12,5,172,355,1205,460,1200
2017,21,42,"Antakya",36.1968,36.1612,33.2285714285714,20.9285714285714,0.314285714285714,65.4142857142857,47.6885714285714,NA,448,21,33,109,117,849,427,816
2017,22,42,"Antakya",36.1968,36.1612,36.2571428571429,23.9857142857143,0.514285714285714,57.8714285714286,45.7242857142857,NA,522,14,5,155,293,1015,508,1010
2017,23,42,"Antakya",36.1968,36.1612,37.7428571428571,26.4428571428571,0,60.2142857142857,55.6071428571429,NA,578,17,30,152,261,1388,561,1358
2017,24,42,"Antakya",36.1968,36.1612,38.5714285714286,25.9285714285714,0.0142857142857143,64.3285714285714,52.3857142857143,NA,552,29,110,180,197,1139,523,1029
2017,25,42,"Antakya",36.1968,36.1612,37.6142857142857,26.2714285714286,2.74285714285714,61.7,46.1657142857143,NA,584,37,85,182,239,1041,547,956
2017,26,42,"Antakya",36.1968,36.1612,38.6571428571429,30.1,0,55.7285714285714,56.8671428571429,NA,564,8,11,275,360,971,556,960
2017,27,42,"Antakya",36.1968,36.1612,41.4857142857143,29.8714285714286,0,55.8428571428571,67.5528571428571,NA,511,32,22,156,143,642,479,620
2017,28,42,"Antakya",36.1968,36.1612,40.3,29.9857142857143,0,60.7142857142857,61.4557142857143,NA,481,34,23,120,176,864,447,841
2017,29,42,"Antakya",36.1968,36.1612,39.1,29.4428571428571,0,63.1142857142857,65.5628571428571,NA,532,27,68,114,197,1272,505,1204
2017,30,42,"Antakya",36.1968,36.1612,36.9857142857143,30.2571428571429,0,56.9428571428571,76.4714285714286,NA,531,25,21,144,134,928,506,907
2017,31,42,"Antakya",36.1968,36.1612,37.0142857142857,29.4285714285714,0,65.0428571428571,72.49,NA,559,54,87,79,67,1047,505,960
2017,32,42,"Antakya",36.1968,36.1612,38.2571428571429,29.7428571428571,0,65.8285714285714,71.0457142857143,NA,567,33,25,93,180,1092,534,1067
2017,33,42,"Antakya",36.1968,36.1612,37.8,29.4142857142857,0.0285714285714286,63.9714285714286,74.7142857142857,NA,596,37,73,137,165,1199,559,1126
2017,34,42,"Antakya",36.1968,36.1612,38.2,29.2714285714286,0,63.9428571428571,71.14,NA,601,26,49,106,122,1280,575,1231
2017,35,42,"Antakya",36.1968,36.1612,34.9857142857143,28.4714285714286,0.0142857142857143,66.9285714285714,63.6128571428571,NA,493,34,36,69,77,1014,459,978
2017,36,42,"Antakya",36.1968,36.1612,33.3428571428571,26.8285714285714,0,60.8,64.5142857142857,NA,507,32,44,98,168,1321,475,1277
2017,37,42,"Antakya",36.1968,36.1612,36.2285714285714,27.7,0,67.9142857142857,80.5685714285714,NA,589,20,25,80,34,1138,569,1113
2017,38,42,"Antakya",36.1968,36.1612,33.1714285714286,27.1142857142857,0.3,66.4714285714286,77.2457142857143,NA,671,25,28,120,90,1312,646,1284
2017,39,42,"Antakya",36.1968,36.1612,33.1428571428571,25.6428571428571,3.58571428571429,63.3857142857143,31.5083333333333,NA,782,24,39,155,226,1630,758,1591
2017,40,42,"Antakya",36.1968,36.1612,21.6,21.7142857142857,0.128571428571429,51.9714285714286,28.4885714285714,NA,543,12,33,184,160,1137,531,1104
2017,41,42,"Antakya",36.1968,36.1612,19.8,20.7428571428571,3.74285714285714,61.9857142857143,53.1042857142857,NA,487,8,2,179,283,843,479,841
2017,42,42,"Antakya",36.1968,36.1612,20.2571428571429,19.5142857142857,0,46.9857142857143,69.5714285714286,NA,530,7,1,298,499,815,523,814
2017,43,42,"Antakya",36.1968,36.1612,21.6857142857143,19.5714285714286,0.914285714285714,65.5857142857143,41.2185714285714,NA,506,59,246,120,173,919,447,673
2017,44,42,"Antakya",36.1968,36.1612,19.6428571428571,16.5285714285714,1.91428571428571,76.8714285714286,28.6342857142857,NA,561,134,290,152,318,1102,427,812
2017,45,42,"Antakya",36.1968,36.1612,14.4,15.8285714285714,0.142857142857143,74.5,42.26,NA,577,1,7,246,286,829,576,822
2017,46,42,"Antakya",36.1968,36.1612,17.9142857142857,16.3714285714286,0.285714285714286,61.8285714285714,68.0885714285714,NA,587,114,179,104,236,1085,473,906
2017,47,42,"Antakya",36.1968,36.1612,22.5857142857143,11.3142857142857,3.54285714285714,66.4285714285714,56.8442857142857,NA,418,53,69,122,143,804,365,735
2017,48,42,"Antakya",36.1968,36.1612,10.7428571428571,11.0285714285714,3.01428571428571,85.9,38.7414285714286,NA,386,172,216,19,46,619,214,403
2017,49,42,"Antakya",36.1968,36.1612,21.5857142857143,8.27142857142857,3.02857142857143,74.5142857142857,50.6285714285714,NA,407,48,65,170,251,645,359,580
2017,50,42,"Antakya",36.1968,36.1612,10.7142857142857,9.4,0,78.4428571428572,65.6571428571429,NA,346,15,14,102,78,442,331,428
2017,51,42,"Antakya",36.1968,36.1612,16.6428571428571,11.9285714285714,2.87142857142857,81.3,115.607142857143,NA,386,69,53,82,65,349,317,296
2017,52,42,"Antakya",36.1968,36.1612,15,10.45,4.9,76.55,58.1657142857143,NA,528,103,80,69,54,507,425,427
2018,1,42,"Antakya",36.1968,36.1612,20.8375,9.35,5.65,83.35,36.52,NA,618,29,32,157,206,914,589,882
2018,2,42,"Antakya",36.1968,36.1612,17.8857142857143,9.3,0.442857142857143,76.2571428571429,54.1542857142857,NA,624,31,8,150,742,1309,593,1301
2018,3,42,"Antakya",36.1968,36.1612,23.7428571428571,9.05714285714286,5.88571428571429,78.7142857142857,38.5128571428571,NA,639,29,13,274,403,655,610,642
2018,4,42,"Antakya",36.1968,36.1612,20.2285714285714,9.44285714285714,5.17142857142857,84.5142857142857,56.2857142857143,NA,604,65,156,242,294,764,539,608
2018,5,42,"Antakya",36.1968,36.1612,12.1571428571429,8.88571428571429,0,77.8,66.3471428571429,NA,670,17,4,273,411,819,653,815
2018,6,42,"Antakya",36.1968,36.1612,10.4571428571429,12.0285714285714,0.0142857142857143,77.1428571428571,66.7185714285714,NA,704,40,62,205,212,1022,664,960
2018,7,42,"Antakya",36.1968,36.1612,25.0714285714286,12.5428571428571,3.15714285714286,76.5857142857143,35.7628571428571,NA,478,72,129,168,155,557,406,428
2018,8,42,"Antakya",36.1968,36.1612,22.0857142857143,12.3428571428571,4.18571428571429,76.0714285714286,40.6157142857143,NA,711,28,55,189,231,1321,683,1266
2018,9,42,"Antakya",36.1968,36.1612,20.3428571428571,13.0428571428571,3.01428571428571,83.2714285714286,35.5557142857143,NA,621,47,68,136,246,956,574,888
2018,10,42,"Antakya",36.1968,36.1612,33.6714285714286,15.8,0.671428571428571,74.7,45.5657142857143,NA,556,116,154,234,822,1330,440,1176
2018,11,42,"Antakya",36.1968,36.1612,28.6428571428571,15.1714285714286,2.74285714285714,74.0857142857143,23.682,NA,551,91,354,168,648,1426,460,1072
2018,12,42,"Antakya",36.1968,36.1612,30.2142857142857,17.0428571428571,0.0428571428571429,63.5142857142857,35.0585714285714,NA,425,74,224,71,124,1187,351,963
2018,13,42,"Antakya",36.1968,36.1612,23.9428571428571,16.3714285714286,2.27142857142857,68.9285714285714,26.9671428571429,NA,356,14,29,104,115,428,342,399
2018,14,42,"Antakya",36.1968,36.1612,21.5571428571429,17.1428571428571,0,56.4142857142857,25.6485714285714,NA,407,10,11,217,317,486,397,475
2018,15,42,"Antakya",36.1968,36.1612,29.9571428571429,18.3571428571429,4.22857142857143,75.8142857142857,19.0971428571429,NA,374,17,44,163,80,450,357,406
2018,16,42,"Antakya",36.1968,36.1612,29.4714285714286,18.2142857142857,2.8,60.7428571428571,24.0257142857143,NA,411,11,7,166,272,648,400,641
2018,17,42,"Antakya",36.1968,36.1612,28.2142857142857,21.0428571428571,0.128571428571429,61.7857142857143,28.1142857142857,NA,419,24,35,136,262,652,395,617
2018,18,42,"Antakya",36.1968,36.1612,25.9857142857143,23.8285714285714,0.314285714285714,56.2714285714286,34.0242857142857,NA,303,4,9,126,193,474,299,465
2018,19,42,"Antakya",36.1968,36.1612,27.8857142857143,19.6571428571429,6.28571428571429,72.3285714285714,17.13,NA,275,29,33,89,120,467,246,434
2018,20,42,"Antakya",36.1968,36.1612,27.7285714285714,25,0.0142857142857143,53.0142857142857,21.39,NA,204,2,2,87,172,306,202,304
2018,21,42,"Antakya",36.1968,36.1612,35.2857142857143,26.1142857142857,0.0285714285714286,54.0571428571429,27.8542857142857,NA,252,33,35,62,30,281,219,246
2018,22,42,"Antakya",36.1968,36.1612,34.1714285714286,25.3,6.04285714285714,59.8,21.2471428571429,NA,249,37,112,63,63,427,212,315
2018,23,42,"Antakya",36.1968,36.1612,34.2,27.6428571428571,0.0428571428571429,57.8142857142857,19.1142857142857,NA,267,3,6,86,102,812,264,806
2018,24,42,"Antakya",36.1968,36.1612,36.8857142857143,26.3428571428571,6.58571428571429,63.7142857142857,16.0185714285714,NA,267,29,91,48,18,448,238,357
2018,25,42,"Antakya",36.1968,36.1612,41.3714285714286,26.8714285714286,3.47142857142857,59.8285714285714,14.4171428571429,NA,358,12,5,230,267,518,346,513
2018,26,42,"Antakya",36.1968,36.1612,37.4285714285714,27.5,0.128571428571429,58.6428571428571,15.2371428571429,NA,355,7,15,213,408,587,348,572
2018,27,42,"Antakya",36.1968,36.1612,41.0571428571429,28.8571428571429,0,60.4142857142857,18.0385714285714,NA,342,24,37,147,125,418,318,381
2018,28,42,"Antakya",36.1968,36.1612,36.8857142857143,29.3428571428571,0.0428571428571429,59.3857142857143,16.3025,NA,286,8,5,128,286,585,278,580
2018,29,42,"Antakya",36.1968,36.1612,35.7428571428571,29.4428571428571,0.857142857142857,59.4714285714286,20.8266666666667,NA,260,10,7,128,550,756,250,749
2018,30,42,"Antakya",36.1968,36.1612,39.1857142857143,29.3857142857143,2.64285714285714,57.9857142857143,22.3214285714286,NA,265,17,19,129,339,822,248,803
2018,31,42,"Antakya",36.1968,36.1612,40.1285714285714,29.7142857142857,3.42857142857143,61.8428571428571,20.2685714285714,NA,267,11,16,124,371,499,256,483
2018,32,42,"Antakya",36.1968,36.1612,35.4857142857143,30.0428571428571,0.828571428571429,57.1571428571429,19.4742857142857,NA,297,10,14,123,169,403,287,389
2018,33,42,"Antakya",36.1968,36.1612,38.3142857142857,29.5857142857143,0,57.2714285714286,21.7971428571429,NA,216,5,10,91,157,332,211,322
2018,34,42,"Antakya",36.1968,36.1612,37.8,29.5857142857143,0,62.9142857142857,21.7442857142857,NA,144,6,4,37,68,227,138,223
2018,35,42,"Antakya",36.1968,36.1612,34.4285714285714,28.7,1.57142857142857,67.3857142857143,16.3128571428571,NA,201,24,30,17,11,314,177,284
2018,36,42,"Antakya",36.1968,36.1612,36.5571428571429,28.1714285714286,3.77142857142857,61.1571428571429,16.5114285714286,NA,341,12,43,95,89,370,329,327
2018,37,42,"Antakya",36.1968,36.1612,28.3428571428571,27.2142857142857,1.14285714285714,56.3428571428571,18.4185714285714,NA,241,14,18,79,114,419,227,401
2018,38,42,"Antakya",36.1968,36.1612,32.7428571428571,27.9142857142857,0,62.9,17.97,NA,189,25,26,29,60,344,164,318
2018,39,42,"Antakya",36.1968,36.1612,31.7714285714286,26.3428571428571,0.0857142857142857,64.5428571428571,21.1571428571429,NA,180,10,9,29,68,353,170,344
2018,40,42,"Antakya",36.1968,36.1612,27.7285714285714,24.8,0,55.5857142857143,20.0571428571429,NA,191,10,17,41,48,341,181,324
2018,41,42,"Antakya",36.1968,36.1612,22.8428571428571,23.5285714285714,1.02857142857143,61.7571428571429,33.0614285714286,NA,187,23,18,31,54,422,164,404
2018,42,42,"Antakya",36.1968,36.1612,24.8714285714286,22.4428571428571,4.28571428571429,63.4857142857143,30.65,NA,168,13,16,55,177,381,155,365
2018,43,42,"Antakya",36.1968,36.1612,24.4,18.2,6.97142857142857,69.8428571428571,11.5428571428571,NA,187,33,31,57,156,402,154,371
2018,44,42,"Antakya",36.1968,36.1612,12.8571428571429,16.5571428571429,0.0857142857142857,61.9,20.2616666666667,NA,196,1,0,62,75,264,195,264
2018,45,42,"Antakya",36.1968,36.1612,16.2571428571429,15.7714285714286,1.68571428571429,81.7428571428571,12.3185714285714,NA,231,75,188,48,104,473,156,285
2018,46,42,"Antakya",36.1968,36.1612,12.6,12.5285714285714,1.01428571428571,75.7714285714286,17.1671428571429,NA,230,0,0,61,162,465,230,465
2018,47,42,"Antakya",36.1968,36.1612,13.2857142857143,13.4571428571429,6.77142857142857,85.4714285714286,22.2042857142857,NA,270,4,2,104,312,499,266,497
2018,48,42,"Antakya",36.1968,36.1612,17,14.2142857142857,0.528571428571429,86.7714285714286,13.7933333333333,NA,245,19,4,48,67,201,226,197
2018,49,42,"Antakya",36.1968,36.1612,16.1142857142857,12.9142857142857,4.25714285714286,88.5571428571429,13.87,NA,257,25,16,25,52,420,232,404
2018,50,42,"Antakya",36.1968,36.1612,24.4571428571429,12.3,5.97142857142857,77.0285714285714,14.1857142857143,NA,256,23,53,29,38,305,233,252
2018,51,42,"Antakya",36.1968,36.1612,17.1285714285714,10.5714285714286,1.8,92.2857142857143,16.9571428571429,NA,250,75,82,14,16,248,175,166
2018,52,42,"Antakya",36.1968,36.1612,28.1142857142857,8.68571428571429,8.68571428571429,79.9571428571429,15.45,NA,244,22,14,63,35,273,222,259
2019,1,42,"Antakya",36.1968,36.1612,20.8875,9.7375,10.5125,88.2875,20.95625,NA,343,44,25,56,176,784,299,759
2019,2,42,"Antakya",36.1968,36.1612,27.2428571428571,7.81428571428571,4.72857142857143,69.5428571428571,12.63,NA,255,39,60,54,22,208,216,148
2019,3,42,"Antakya",36.1968,36.1612,29.2,7.72857142857143,5.25714285714286,70.0142857142857,20.3142857142857,NA,192,19,12,40,64,198,173,186
2019,4,42,"Antakya",36.1968,36.1612,20.5571428571429,9.8,3.08571428571429,73.6857142857143,22.952,NA,308,84,41,27,18,314,224,273
2019,5,42,"Antakya",36.1968,36.1612,25.7285714285714,11.5,5.58571428571429,77.8,16.3071428571429,NA,253,47,21,16,10,143,206,122
2019,6,42,"Antakya",36.1968,36.1612,27.5428571428571,9.94285714285714,8.34285714285714,79.7857142857143,13.2042857142857,NA,276,30,4,31,20,127,246,123
2019,7,42,"Antakya",36.1968,36.1612,19.1714285714286,10.2285714285714,1.01428571428571,82.8,14.8614285714286,NA,325,60,25,20,11,234,265,209
2019,8,42,"Antakya",36.1968,36.1612,23.7,12.3714285714286,4.67142857142857,77.0428571428571,14.5166666666667,NA,305,11,5,73,38,219,294,214
2019,9,42,"Antakya",36.1968,36.1612,28.8714285714286,11.8142857142857,4.88571428571429,71.8428571428571,11.3828571428571,NA,331,56,124,118,41,310,275,186
2019,10,42,"Antakya",36.1968,36.1612,30.9,12.9142857142857,1.7,71.9142857142857,10.9314285714286,NA,359,10,10,121,77,252,349,242
2019,11,42,"Antakya",36.1968,36.1612,27.9,14.0142857142857,6.35714285714286,77.8,10.3771428571429,NA,373,9,11,102,40,400,364,389
2019,12,42,"Antakya",36.1968,36.1612,22.8571428571429,15.0285714285714,0.0142857142857143,66.5285714285714,14.3685714285714,NA,343,49,10,38,33,416,294,406
2019,13,42,"Antakya",36.1968,36.1612,29.9285714285714,13.9285714285714,5.4,72,8.81571428571429,NA,256,10,7,58,36,194,246,187
2019,14,42,"Antakya",36.1968,36.1612,25.2142857142857,15.5571428571429,3.17142857142857,76.3285714285714,8.26,NA,365,26,17,58,16,208,339,191
2019,15,42,"Antakya",36.1968,36.1612,28.0142857142857,18.0428571428571,2.85714285714286,68.5857142857143,11.0342857142857,NA,359,46,63,56,21,183,313,120
2019,16,42,"Antakya",36.1968,36.1612,31.2857142857143,13.7857142857143,4.27142857142857,78.0714285714286,6.34,NA,318,34,55,49,39,208,284,153
2019,17,42,"Antakya",36.1968,36.1612,27.5714285714286,18.0714285714286,0,55.5571428571429,8.9825,NA,412,9,3,117,81,313,403,310
2019,18,42,"Antakya",36.1968,36.1612,29.6285714285714,21.5428571428571,0,60.8428571428571,12.59,NA,523,83,123,137,94,353,440,230
2019,19,42,"Antakya",36.1968,36.1612,33.4,20.2,0.528571428571429,58.7857142857143,10.7785714285714,NA,452,14,5,38,89,386,438,381
2019,20,42,"Antakya",36.1968,36.1612,31.4857142857143,25.5571428571429,0,50.9571428571429,13.3157142857143,NA,454,30,23,71,41,389,424,366
2019,21,42,"Antakya",36.1968,36.1612,35.4142857142857,25.1,0,50.6285714285714,10.382,NA,457,31,18,13,4,413,426,395
2019,22,42,"Antakya",36.1968,36.1612,32.9428571428571,27.7428571428571,0,50.2714285714286,11.6014285714286,NA,453,20,33,79,62,323,433,290
2019,23,42,"Antakya",36.1968,36.1612,34.4,27.2142857142857,0,52.5,10.4071428571429,NA,378,23,21,17,44,532,355,511
2019,24,42,"Antakya",36.1968,36.1612,38.3142857142857,26.3428571428571,3.57142857142857,62.3857142857143,8.26,NA,378,21,3,69,36,244,357,241
2019,25,42,"Antakya",36.1968,36.1612,36.8428571428571,26.8285714285714,2.68571428571429,63.5,7.04571428571429,NA,306,11,3,52,37,325,295,322
2019,26,42,"Antakya",36.1968,36.1612,39.3,29.1,0,61.5,7.39285714285714,NA,377,14,11,126,163,342,363,331
2019,27,42,"Antakya",36.1968,36.1612,38.0142857142857,28.3142857142857,0,55.4428571428571,7.64333333333333,NA,456,16,4,143,106,222,440,218
2019,28,42,"Antakya",36.1968,36.1612,37.5571428571429,28.6714285714286,2.81428571428571,62.5714285714286,10.8771428571429,NA,398,20,21,64,103,421,378,400
2019,29,42,"Antakya",36.1968,36.1612,33.2142857142857,28.0142857142857,9.42857142857143,59.6714285714286,10.2128571428571,NA,453,17,1,218,77,203,436,202
2019,30,42,"Antakya",36.1968,36.1612,33.5857142857143,29.3428571428571,0,59.2285714285714,9.44285714285714,NA,456,5,8,226,96,335,451,327
2019,31,42,"Antakya",36.1968,36.1612,35.8714285714286,29.1285714285714,0.0142857142857143,64.6857142857143,9.02428571428571,NA,334,33,38,55,25,375,301,337
2019,32,42,"Antakya",36.1968,36.1612,36.7428571428571,29.3285714285714,0.1,62.9857142857143,8.68857142857143,NA,346,22,25,77,68,395,324,370
2019,33,42,"Antakya",36.1968,36.1612,35.0571428571429,29.3571428571429,0.3,64.2714285714286,8.21714285714286,NA,337,20,24,71,141,531,317,507
2019,34,42,"Antakya",36.1968,36.1612,30.4428571428571,28.8142857142857,0.657142857142857,62,8.66,NA,299,18,5,37,55,345,281,340
2019,35,42,"Antakya",36.1968,36.1612,32.4714285714286,29.4714285714286,0.285714285714286,67.6142857142857,10.2171428571429,NA,307,21,16,30,31,415,286,399
2019,36,42,"Antakya",36.1968,36.1612,34.4142857142857,28.7142857142857,0.342857142857143,62.1857142857143,10.8042857142857,NA,171,33,5,13,3,67,138,62
2019,37,42,"Antakya",36.1968,36.1612,32.9428571428571,27.7428571428571,2.27142857142857,64.1,10.0785714285714,NA,218,9,12,35,11,55,209,43
2019,38,42,"Antakya",36.1968,36.1612,25.8857142857143,26.0571428571429,1.54285714285714,55.0428571428571,9.52142857142857,NA,266,24,7,99,30,91,242,84
2019,39,42,"Antakya",36.1968,36.1612,28.6,25.0857142857143,0.0857142857142857,61.9142857142857,10.78,NA,237,27,13,25,16,79,210,66
2019,40,42,"Antakya",36.1968,36.1612,33.4857142857143,25.2714285714286,0.485714285714286,65.0714285714286,10.9657142857143,NA,241,39,8,31,12,111,202,103
2019,41,42,"Antakya",36.1968,36.1612,25.1142857142857,23.9857142857143,0,62.8571428571429,13.4085714285714,NA,416,143,188,119,116,448,273,260
2019,42,42,"Antakya",36.1968,36.1612,23,24.1,0.4,55.0285714285714,17.2257142857143,NA,356,26,54,196,292,408,330,354
2019,43,42,"Antakya",36.1968,36.1612,14.2571428571429,19.7857142857143,1.71428571428571,68.9,15.2585714285714,NA,306,31,14,143,199,300,275,286
2019,44,42,"Antakya",36.1968,36.1612,17.8,17.8285714285714,9.82857142857143,77.1714285714286,12.1171428571429,NA,350,13,25,146,111,250,337,225
2019,45,42,"Antakya",36.1968,36.1612,11.6,17.7142857142857,0,60.7285714285714,20.6742857142857,NA,417,1,0,186,232,328,416,328
2019,46,42,"Antakya",36.1968,36.1612,18.0571428571429,17.0428571428571,0.0857142857142857,48.8714285714286,22.2085714285714,NA,401,2,3,153,165,337,399,334
2019,47,42,"Antakya",36.1968,36.1612,10.7714285714286,10.8285714285714,0,52.3142857142857,27.0342857142857,NA,391,17,19,166,156,339,374,320
2019,48,42,"Antakya",36.1968,36.1612,15.9142857142857,13.5,2.01428571428571,76.7,21.8728571428571,NA,320,51,65,73,73,251,269,186
2019,49,42,"Antakya",36.1968,36.1612,17.1428571428571,11.4428571428571,9.07142857142857,79.5285714285714,14.2828571428571,NA,393,45,37,99,57,274,348,237
2019,50,42,"Antakya",36.1968,36.1612,20.5857142857143,10.9285714285714,5.65714285714286,91.0857142857143,7.68857142857143,NA,218,3,2,53,11,119,215,117
2019,51,42,"Antakya",36.1968,36.1612,6.92857142857143,8,0,90.2,44.3657142857143,NA,361,8,10,230,282,488,353,478
2019,52,42,"Antakya",36.1968,36.1612,17.4142857142857,9.12857142857143,7.27142857142857,94.3714285714286,17.3671428571429,NA,279,50,72,57,41,281,229,209
2020,1,42,"Antakya",36.1968,36.1612,19.96,9.16,7.24,91.1,47.426,NA,160,26,14,58,40,126,134,112
2020,2,42,"Antakya",36.1968,36.1612,16.0714285714286,9.42857142857143,0.214285714285714,80.5857142857143,70.3028571428571,NA,240,25,6,64,51,173,215,167
2020,3,42,"Antakya",36.1968,36.1612,19.2,8.22857142857143,0.271428571428571,76.2857142857143,88.7957142857143,NA,270,14,66,122,119,382,256,316
2020,4,42,"Antakya",36.1968,36.1612,21.9714285714286,7.94285714285714,0.271428571428571,63.0571428571429,73.7185714285714,NA,358,2,1,220,183,295,356,294
2020,5,42,"Antakya",36.1968,36.1612,25.3285714285714,10.1428571428571,3.18571428571429,70.5571428571428,86.2885714285714,NA,331,0,0,172,126,272,331,272
2020,6,42,"Antakya",36.1968,36.1612,19.9714285714286,8.5,8.37142857142857,73.3,50.7366666666667,NA,343,72,51,131,150,267,271,216
2020,7,42,"Antakya",36.1968,36.1612,20.2142857142857,3.91428571428571,0.371428571428571,70.2571428571429,43.82,NA,341,27,30,182,226,338,314,308
2020,8,42,"Antakya",36.1968,36.1612,17.9428571428571,11.8285714285714,0.542857142857143,78.7,50.3185714285714,NA,283,5,7,145,70,187,278,180
2020,9,42,"Antakya",36.1968,36.1612,19.6142857142857,12.8428571428571,4.55714285714286,74.2714285714286,53.9371428571429,NA,393,7,0,185,209,528,386,528
2020,10,42,"Antakya",36.1968,36.1612,20.8714285714286,15.2714285714286,0.257142857142857,69.1714285714286,45.5114285714286,NA,205,6,4,61,46,210,199,206
2020,11,42,"Antakya",36.1968,36.1612,21.2285714285714,16.4857142857143,3.64285714285714,70.0571428571429,53.8485714285714,NA,115,15,1,49,50,94,100,93
2020,12,42,"Antakya",36.1968,36.1612,22.8428571428571,11.7857142857143,7.21428571428571,74.1714285714286,25.3828571428571,NA,117,11,8,49,65,118,106,110
2020,13,42,"Antakya",36.1968,36.1612,24.8714285714286,15.3857142857143,9.71428571428571,77.0142857142857,31.8828571428571,NA,136,19,3,53,28,92,117,89
2020,14,42,"Antakya",36.1968,36.1612,27.1428571428571,15.0142857142857,2.17142857142857,76.1428571428571,24.1614285714286,NA,155,23,14,54,39,121,132,107
2020,15,42,"Antakya",36.1968,36.1612,27.2285714285714,16.7714285714286,1.57142857142857,69.2857142857143,24.8628571428571,NA,133,38,5,17,12,118,95,113
2020,16,42,"Antakya",36.1968,36.1612,19.5571428571429,18.6857142857143,0.114285714285714,62.7571428571429,30.12,NA,141,13,5,56,42,106,128,101
2020,17,42,"Antakya",36.1968,36.1612,24.6857142857143,17.9857142857143,7.42857142857143,70.8571428571429,24.0242857142857,NA,137,8,3,32,33,123,129,120
2020,18,42,"Antakya",36.1968,36.1612,28.4,18.7428571428571,4.22857142857143,74.4428571428572,20.8557142857143,NA,146,25,53,27,38,164,121,111
2020,19,42,"Antakya",36.1968,36.1612,31.0714285714286,19.6857142857143,2.24285714285714,64.1428571428571,22.06,NA,137,11,4,29,82,157,126,153
2020,20,42,"Antakya",36.1968,36.1612,21.6,25.2285714285714,0,50.2285714285714,28.4714285714286,NA,164,13,5,59,40,164,151,159
2020,21,42,"Antakya",36.1968,36.1612,31.2142857142857,26.5571428571429,2.68571428571429,44.7714285714286,29.3,NA,146,15,9,44,33,96,131,87
2020,22,42,"Antakya",36.1968,36.1612,30.9857142857143,22.0857142857143,0.0857142857142857,52.2285714285714,19.7585714285714,NA,118,11,5,37,26,100,107,95
2020,23,42,"Antakya",36.1968,36.1612,28.4285714285714,24.0857142857143,0.0428571428571429,51.7285714285714,29.954,NA,112,15,6,30,24,70,97,64
2020,24,42,"Antakya",36.1968,36.1612,33.6142857142857,24.6714285714286,0,59.3571428571429,31.99,NA,140,25,24,14,11,150,115,126
2020,25,42,"Antakya",36.1968,36.1612,33.6142857142857,25.2714285714286,4.32857142857143,62.1857142857143,24.92,NA,137,19,14,29,32,108,118,94
2020,26,42,"Antakya",36.1968,36.1612,33.5142857142857,26.3,0.0285714285714286,62.9,25.0916666666667,NA,173,27,22,28,12,133,146,111
2020,27,42,"Antakya",36.1968,36.1612,34.7571428571429,28.2428571428571,0,63.6571428571429,34,NA,113,20,14,24,14,113,93,99
2020,28,42,"Antakya",36.1968,36.1612,36.5428571428571,28.4571428571429,0,66.1428571428571,32.4814285714286,NA,164,21,19,38,12,122,143,103
2020,29,42,"Antakya",36.1968,36.1612,34.4857142857143,28.6,0.0285714285714286,66.5428571428571,29.1414285714286,NA,186,19,18,41,40,111,167,93
2020,30,42,"Antakya",36.1968,36.1612,33.5,29.4571428571429,0,65.4857142857143,30.6314285714286,NA,190,26,22,41,39,142,164,120
2020,31,42,"Antakya",36.1968,36.1612,32.1857142857143,29.9857142857143,0,65.1,30.72,NA,150,26,37,28,17,127,124,90
2020,32,42,"Antakya",36.1968,36.1612,33.2857142857143,29.7285714285714,2.15714285714286,63.0428571428571,29.8871428571429,NA,146,13,6,32,43,107,133,101
2020,33,42,"Antakya",36.1968,36.1612,32.0285714285714,29.5142857142857,0.457142857142857,55.5857142857143,26.1271428571429,NA,183,10,5,52,17,83,173,78
2020,34,42,"Antakya",36.1968,36.1612,30.8142857142857,29.2714285714286,0.0142857142857143,54.6285714285714,27.2,NA,197,8,6,73,31,97,189,91
2020,35,42,"Antakya",36.1968,36.1612,27.4857142857143,28.8857142857143,0.0142857142857143,62.6857142857143,33.2642857142857,NA,164,8,1,21,15,157,156,156
2020,36,42,"Antakya",36.1968,36.1612,25.6142857142857,29.6571428571429,0.0285714285714286,63.1142857142857,42.11,NA,179,20,27,23,18,112,159,85
2020,37,42,"Antakya",36.1968,36.1612,25.7142857142857,28.7571428571429,0,64.5571428571429,42.1033333333333,NA,193,18,1,33,19,91,175,90
2020,38,42,"Antakya",36.1968,36.1612,28.2714285714286,28.1714285714286,0,68.6,37.2871428571429,NA,235,41,19,16,8,157,194,138
2020,39,42,"Antakya",36.1968,36.1612,28.4142857142857,27.6428571428571,1.68571428571429,63.5571428571429,32.4285714285714,NA,220,22,6,33,17,129,198,123
2020,40,42,"Antakya",36.1968,36.1612,28.5428571428571,26.7285714285714,0.0857142857142857,61.6714285714286,31.5357142857143,NA,187,10,2,48,34,154,177,152
2020,41,42,"Antakya",36.1968,36.1612,17.7428571428571,24.6857142857143,0,47.4142857142857,51.1214285714286,NA,182,49,25,27,13,127,133,102
2020,42,42,"Antakya",36.1968,36.1612,23.9285714285714,24.0285714285714,0,67.2142857142857,39.3057142857143,NA,177,30,30,29,19,111,147,81
2020,43,42,"Antakya",36.1968,36.1612,15.8,23.0142857142857,0,58.7285714285714,58.9783333333333,NA,194,13,7,58,30,161,181,154
2020,44,42,"Antakya",36.1968,36.1612,15.3714285714286,22.1428571428571,0,50.8142857142857,61.4933333333333,NA,255,9,2,46,89,233,246,231
2020,45,42,"Antakya",36.1968,36.1612,12.6285714285714,17.1,6.84285714285714,81.6285714285714,33.1566666666667,20.15,156,10,10,71,58,103,146,93
2020,46,42,"Antakya",36.1968,36.1612,9.97142857142857,15.4,0,70.1428571428571,64.7683333333333,29.4025,208,6,1,98,59,109,202,108
2020,47,42,"Antakya",36.1968,36.1612,15.8142857142857,12.7,0.8,75.8571428571429,36.84,52.69,173,2,1,78,36,83,171,82
2020,48,42,"Antakya",36.1968,36.1612,18.1571428571429,10.6857142857143,0.471428571428571,74.7142857142857,55.43,75.398,199,8,1,83,90,262,191,261
2020,49,42,"Antakya",36.1968,36.1612,16.5,12.2285714285714,0.428571428571429,76.8285714285714,59.5742857142857,64.05,207,3,4,82,36,116,204,112
2020,50,42,"Antakya",36.1968,36.1612,14.9285714285714,11.0714285714286,1.42857142857143,77.7714285714286,55.1442857142857,64.37,181,26,9,41,33,98,155,89
2020,51,42,"Antakya",36.1968,36.1612,19.2428571428571,11.9714285714286,3.57142857142857,88.8857142857143,48.59,51.6333333333333,171,37,29,27,13,90,134,61
2020,52,42,"Antakya",36.1968,36.1612,16,8.57142857142857,1.17142857142857,71.1571428571429,53.7485714285714,63.492,203,19,9,49,29,113,184,104
2020,53,42,"Antakya",36.1968,36.1612,11.45,8.025,0,70.1,71.56,103.58,122,2,0,44,26,111,120,111
2017,1,43,"Iskenderun",36.7105,36.1965,21.3,9.47142857142857,7.13657142857143,74.3857142857143,15.8157142857143,12.26,563,267,242,7,15,847,296,605
2017,2,43,"Iskenderun",36.7105,36.1965,17.9714285714286,8.8,6.03814285714286,66.9571428571429,22.6757142857143,16.9185714285714,757,362,455,30,48,1214,395,759
2017,3,43,"Iskenderun",36.7105,36.1965,12.2428571428571,8.9,0,66.4714285714286,37.4514285714286,27.9842857142857,762,159,192,157,454,1449,603,1257
2017,4,43,"Iskenderun",36.7105,36.1965,21.6285714285714,7.74285714285714,3.91657142857143,54.8714285714286,28.0366666666667,21.0585714285714,639,187,121,82,101,889,452,768
2017,5,43,"Iskenderun",36.7105,36.1965,24.3142857142857,6.47142857142857,0.0107142857142857,50.1142857142857,31.1771428571429,9.995,588,126,99,149,351,1163,462,1064
2017,6,43,"Iskenderun",36.7105,36.1965,13.8285714285714,12.5,0.0104285714285714,58.3285714285714,44.4142857142857,NA,736,85,100,117,340,1519,651,1419
2017,7,43,"Iskenderun",36.7105,36.1965,19.1,7.92857142857143,0,40.2571428571429,33.4257142857143,NA,492,16,19,169,301,717,476,698
2017,8,43,"Iskenderun",36.7105,36.1965,12.0857142857143,11.2,0.633857142857143,60.1428571428571,36.3885714285714,31.42,739,48,70,267,625,1747,691,1677
2017,9,43,"Iskenderun",36.7105,36.1965,14.9428571428571,14.5428571428571,2.70814285714286,59.2142857142857,53.9542857142857,22.7514285714286,574,66,43,126,176,866,508,823
2017,10,43,"Iskenderun",36.7105,36.1965,18.3285714285714,15.4857142857143,2.13514285714286,64.6,80.2414285714286,20.3028571428571,712,138,246,204,353,1043,574,797
2017,11,43,"Iskenderun",36.7105,36.1965,18.2857142857143,12.5428571428571,3.08914285714286,68.7857142857143,19.74,14.7042857142857,525,36,21,219,341,725,489,704
2017,12,43,"Iskenderun",36.7105,36.1965,18.7571428571429,15.2285714285714,0.343285714285714,67.9571428571429,28.9085714285714,22.2271428571429,589,0,0,314,500,1077,589,1077
2017,13,43,"Iskenderun",36.7105,36.1965,15.9857142857143,15.9857142857143,3.43242857142857,71.3571428571429,29.3257142857143,18.6057142857143,574,0,0,328,500,887,574,887
2017,14,43,"Iskenderun",36.7105,36.1965,22.9142857142857,17.8285714285714,1.48914285714286,62.4285714285714,28.68,14.0285714285714,639,0,0,273,582,1336,639,1336
2017,15,43,"Iskenderun",36.7105,36.1965,21.2,16.7714285714286,2.66357142857143,63.8857142857143,25.3333333333333,13.5542857142857,587,0,0,247,702,1187,587,1187
2017,16,43,"Iskenderun",36.7105,36.1965,18.7857142857143,18.3571428571429,0,66.5714285714286,37.8333333333333,18.735,717,0,0,375,433,920,717,920
2017,17,43,"Iskenderun",36.7105,36.1965,15.1142857142857,19.3714285714286,0,55.2571428571429,59.1728571428571,30.4833333333333,731,0,0,416,783,1478,731,1478
2017,18,43,"Iskenderun",36.7105,36.1965,19.6571428571429,20.4285714285714,1.01214285714286,72.8857142857143,40.9557142857143,14.1785714285714,506,0,0,330,440,923,506,923
2017,19,43,"Iskenderun",36.7105,36.1965,16.3857142857143,22.2,0.001,63.3,45.8716666666667,21.5757142857143,471,0,0,269,508,966,471,966
2017,20,43,"Iskenderun",36.7105,36.1965,20.4714285714286,21.7857142857143,9.13642857142857,65.0571428571429,25.1933333333333,16.2528571428571,472,0,0,273,547,1205,472,1205
2017,21,43,"Iskenderun",36.7105,36.1965,23.1142857142857,20.9428571428571,1.45114285714286,68.8714285714286,23.1742857142857,6.206,448,0,0,237,292,849,448,849
2017,22,43,"Iskenderun",36.7105,36.1965,22.8428571428571,23,0.420571428571429,66.8714285714286,23.5585714285714,20.1175,522,0,0,292,554,1015,522,1015
2017,23,43,"Iskenderun",36.7105,36.1965,22.7142857142857,25.3714285714286,0,68.6571428571429,35.1157142857143,15.3885714285714,578,0,0,280,537,1388,578,1388
2017,24,43,"Iskenderun",36.7105,36.1965,21.7285714285714,25.3142857142857,0.228142857142857,70.8,28.6742857142857,8.25166666666667,552,0,0,317,475,1139,552,1139
2017,25,43,"Iskenderun",36.7105,36.1965,22.7285714285714,25.5428571428571,2.40842857142857,68.2714285714286,23.7885714285714,16.346,584,0,0,331,467,1041,584,1041
2017,26,43,"Iskenderun",36.7105,36.1965,24.0285714285714,28.9428571428571,0,63.2571428571429,40.65,25.3628571428571,564,0,0,390,503,971,564,971
2017,27,43,"Iskenderun",36.7105,36.1965,22.5571428571429,29.1142857142857,0,62.4428571428571,34.3557142857143,19.7028571428571,511,0,0,290,251,642,511,642
2017,28,43,"Iskenderun",36.7105,36.1965,21.7428571428571,29.0857142857143,0,68.1,34.7328571428571,17.4057142857143,481,0,0,298,396,864,481,864
2017,29,43,"Iskenderun",36.7105,36.1965,24.6,29.1428571428571,0,68.0571428571429,109.418571428571,12.6014285714286,532,0,0,265,590,1272,532,1272
2017,30,43,"Iskenderun",36.7105,36.1965,23.1428571428571,29.7428571428571,0,63.6571428571429,33.1857142857143,11.8271428571429,531,0,0,246,274,928,531,928
2017,31,43,"Iskenderun",36.7105,36.1965,25.0428571428571,29.3,0,68.9142857142857,46.1271428571429,12.3628571428571,559,0,0,200,183,1047,559,1047
2017,32,43,"Iskenderun",36.7105,36.1965,23.3,29.5714285714286,0.00157142857142857,69.3428571428571,42.2357142857143,12.42,567,0,0,279,400,1092,567,1092
2017,33,43,"Iskenderun",36.7105,36.1965,22.3428571428571,29.1571428571429,0,68.8,38.0471428571429,6.39,596,0,0,296,338,1199,596,1199
2017,34,43,"Iskenderun",36.7105,36.1965,20.2857142857143,29.0142857142857,0,67.4,39.2857142857143,10.6114285714286,601,0,0,387,475,1280,601,1280
2017,35,43,"Iskenderun",36.7105,36.1965,23.1714285714286,28.4714285714286,0,69.1714285714286,35.4914285714286,6.40142857142857,493,0,0,196,187,1014,493,1014
2017,36,43,"Iskenderun",36.7105,36.1965,20.8857142857143,27.0428571428571,0.358571428571429,61.2714285714286,45.5528571428571,17.0157142857143,507,0,0,229,409,1321,507,1321
2017,37,43,"Iskenderun",36.7105,36.1965,23.1714285714286,27.8714285714286,0,71.3,61.1928571428571,16.6128571428571,589,0,0,264,187,1138,589,1138
2017,38,43,"Iskenderun",36.7105,36.1965,20.1428571428571,27.4142857142857,0.244428571428571,68.3571428571429,42.4814285714286,8.97714285714286,671,0,0,424,646,1312,671,1312
2017,39,43,"Iskenderun",36.7105,36.1965,21.6142857142857,25.7285714285714,3.09642857142857,65.2857142857143,36.5014285714286,10.8371428571429,782,0,0,332,523,1630,782,1630
2017,40,43,"Iskenderun",36.7105,36.1965,14.8857142857143,22.6428571428571,0.158285714285714,50.3428571428571,37.2657142857143,18.7128571428571,543,0,0,357,832,1137,543,1137
2017,41,43,"Iskenderun",36.7105,36.1965,15.2857142857143,21.5428571428571,3.61471428571429,58.6,33.1014285714286,14.09,487,0,0,286,470,843,487,843
2017,42,43,"Iskenderun",36.7105,36.1965,12.8714285714286,20.9142857142857,0,47.8285714285714,47.7185714285714,15.1983333333333,530,0,0,247,383,815,530,815
2017,43,43,"Iskenderun",36.7105,36.1965,14.5714285714286,20.4,2.94485714285714,66.2142857142857,53.3885714285714,17.138,506,60,222,195,256,919,446,697
2017,44,43,"Iskenderun",36.7105,36.1965,13.9,17.5142857142857,4.80614285714286,70.9714285714286,34.9314285714286,10.875,561,84,174,167,370,1102,477,928
2017,45,43,"Iskenderun",36.7105,36.1965,9.48571428571429,16.9428571428571,0.189571428571429,69.9285714285714,47.0528571428571,14.3057142857143,577,0,0,158,330,829,577,829
2017,46,43,"Iskenderun",36.7105,36.1965,15.4714285714286,18.6142857142857,0.00571428571428571,55.8571428571429,78.5785714285714,10.4766666666667,587,87,150,92,223,1085,500,935
2017,47,43,"Iskenderun",36.7105,36.1965,18.4857142857143,12.9,3.67928571428571,59.3428571428571,57.12,9.58571428571429,418,31,76,100,95,804,387,728
2017,48,43,"Iskenderun",36.7105,36.1965,10.3714285714286,13.0142857142857,5.76542857142857,75.8714285714286,37.2314285714286,20.3625,386,141,209,4,5,619,245,410
2017,49,43,"Iskenderun",36.7105,36.1965,16.1285714285714,10.2857142857143,3.086,64.2857142857143,31.1757142857143,23.676,407,82,76,69,148,645,325,569
2017,50,43,"Iskenderun",36.7105,36.1965,10.2142857142857,12.3428571428571,0.00271428571428571,70.5,39.3685714285714,26.3342857142857,346,62,113,32,59,442,284,329
2017,51,43,"Iskenderun",36.7105,36.1965,14.7857142857143,14.4142857142857,2.96057142857143,68.2857142857143,125.333333333333,23.136,386,177,159,16,5,349,209,190
2017,52,43,"Iskenderun",36.7105,36.1965,13.025,12.325,4.722,66.8375,30.39625,16.595,528,109,105,74,96,507,419,402
2018,1,43,"Iskenderun",36.7105,36.1965,18.425,11.1125,6.019,73.5875,38.0371428571429,19.5285714285714,618,127,231,118,195,914,491,683
2018,2,43,"Iskenderun",36.7105,36.1965,14.5,11.6285714285714,0.360285714285714,65.3571428571429,40.7457142857143,39.2157142857143,624,199,238,25,47,1309,425,1071
2018,3,43,"Iskenderun",36.7105,36.1965,15.3142857142857,10.3571428571429,7.31871428571429,72.4285714285714,22.1314285714286,17.8714285714286,639,93,44,108,265,655,546,611
2018,4,43,"Iskenderun",36.7105,36.1965,15.6714285714286,10.5,5.92971428571429,77.1857142857143,36.3083333333333,2.36,604,76,106,166,269,764,528,658
2018,5,43,"Iskenderun",36.7105,36.1965,9.6,10.5142857142857,0.00214285714285714,69.5428571428571,28.8242857142857,NA,670,81,69,65,100,819,589,750
2018,6,43,"Iskenderun",36.7105,36.1965,9.91428571428571,13.8857142857143,0.00471428571428572,68.1857142857143,59.5657142857143,NA,704,65,93,54,44,1022,639,929
2018,7,43,"Iskenderun",36.7105,36.1965,20.3571428571429,14.1857142857143,2.903,68.8285714285714,21.9966666666667,NA,478,29,41,123,136,557,449,516
2018,8,43,"Iskenderun",36.7105,36.1965,16.0285714285714,13.8,4.27142857142857,68.4714285714286,21.2728571428571,19.384,711,121,403,131,168,1321,590,918
2018,9,43,"Iskenderun",36.7105,36.1965,14.0428571428571,13.9857142857143,3.294,78.0428571428571,20.31,20.6333333333333,621,77,99,131,197,956,544,857
2018,10,43,"Iskenderun",36.7105,36.1965,23.6857142857143,16.4,0.294571428571429,73.3,49.674,11.942,556,0,0,326,917,1330,556,1330
2018,11,43,"Iskenderun",36.7105,36.1965,17.9142857142857,15.8857142857143,2.60885714285714,73.4714285714286,14.62,2.915,551,2,1,293,788,1426,549,1425
2018,12,43,"Iskenderun",36.7105,36.1965,20.4,17.9714285714286,0.19,63.8857142857143,50.6314285714286,2.00857142857143,425,65,218,176,446,1187,360,969
2018,13,43,"Iskenderun",36.7105,36.1965,16.9857142857143,17.1714285714286,1.96614285714286,66.4,44.49,1.7,356,0,0,182,200,428,356,428
2018,14,43,"Iskenderun",36.7105,36.1965,14.8,18.0571428571429,0,56.0428571428571,38.5614285714286,1.77285714285714,407,0,0,246,203,486,407,486
2018,15,43,"Iskenderun",36.7105,36.1965,17.8142857142857,18.2714285714286,4.338,78.7428571428571,36.6775,22.6525,374,0,0,268,273,450,374,450
2018,16,43,"Iskenderun",36.7105,36.1965,17.8428571428571,18.6428571428571,2.42242857142857,60.2,35.504,32.254,411,0,0,334,451,648,411,648
2018,17,43,"Iskenderun",36.7105,36.1965,17.5285714285714,21.1571428571429,0.135142857142857,64.4,43.5357142857143,5.36714285714286,419,10,14,277,371,652,409,638
2018,18,43,"Iskenderun",36.7105,36.1965,18.7285714285714,24.2428571428571,0.589714285714286,57.8428571428571,51.862,2.84,303,0,0,149,232,474,303,474
2018,19,43,"Iskenderun",36.7105,36.1965,17.4285714285714,19.9857142857143,6.15428571428571,73.6857142857143,19.22,2.2375,275,0,0,178,249,467,275,467
2018,20,43,"Iskenderun",36.7105,36.1965,17.9285714285714,24.3714285714286,0.0261428571428571,60.1142857142857,16.0157142857143,2.12,204,0,0,144,207,306,204,306
2018,21,43,"Iskenderun",36.7105,36.1965,18.9,25.5142857142857,0,62.3857142857143,21.7042857142857,2.33714285714286,252,0,0,147,70,281,252,281
2018,22,43,"Iskenderun",36.7105,36.1965,21.1857142857143,24.7142857142857,5.90328571428571,67.1714285714286,12.26,2.45428571428571,249,0,0,130,107,427,249,427
2018,23,43,"Iskenderun",36.7105,36.1965,21.8285714285714,27.0571428571429,0,64.9285714285714,NA,2.46,267,0,0,189,408,812,267,812
2018,24,43,"Iskenderun",36.7105,36.1965,26.0571428571429,25.8571428571429,6.547,70.4142857142857,NA,2.41428571428571,267,0,0,114,60,448,267,448
2018,25,43,"Iskenderun",36.7105,36.1965,24.6285714285714,26.2,3.41928571428571,68.0571428571429,NA,2.08,358,0,0,254,291,518,358,518
2018,26,43,"Iskenderun",36.7105,36.1965,24.8571428571429,27.0571428571429,0.109714285714286,66.2285714285714,NA,NA,355,0,0,253,440,587,355,587
2018,27,43,"Iskenderun",36.7105,36.1965,23.5,28.3285714285714,0,68.3857142857143,NA,NA,342,0,0,220,185,418,342,418
2018,28,43,"Iskenderun",36.7105,36.1965,25.1285714285714,28.8142857142857,0,67.6571428571429,199.05,9.815,286,0,0,191,331,585,286,585
2018,29,43,"Iskenderun",36.7105,36.1965,23.7142857142857,28.7714285714286,0.740857142857143,67.7857142857143,15.7675,11.6975,260,0,0,173,578,756,260,756
2018,30,43,"Iskenderun",36.7105,36.1965,23.7571428571429,28.8571428571429,2.262,66.0428571428571,11.918,6.424,265,0,0,188,707,822,265,822
2018,31,43,"Iskenderun",36.7105,36.1965,26.7714285714286,29.0428571428571,2.90114285714286,69.9428571428571,19.175,12.3133333333333,267,0,0,138,354,499,267,499
2018,32,43,"Iskenderun",36.7105,36.1965,23.8857142857143,29.4714285714286,0.707,63.5857142857143,18.145,11.47,297,0,0,163,190,403,297,403
2018,33,43,"Iskenderun",36.7105,36.1965,24.2714285714286,29.1142857142857,0,64.3571428571429,15.354,6.58833333333333,216,0,0,140,194,332,216,332
2018,34,43,"Iskenderun",36.7105,36.1965,24.7142857142857,29.1571428571429,0,68.8142857142857,15.766,3.33,144,0,0,75,114,227,144,227
2018,35,43,"Iskenderun",36.7105,36.1965,23.4285714285714,28.5,1.34085714285714,71.0571428571428,18.3171428571429,9.914,201,0,0,86,114,314,201,314
2018,36,43,"Iskenderun",36.7105,36.1965,21.6285714285714,27.6428571428571,3.21757142857143,67.1,9.06166666666667,15.778,341,0,0,241,193,370,341,370
2018,37,43,"Iskenderun",36.7105,36.1965,19,26.9571428571429,0.975285714285714,60.1285714285714,1.07833333333333,11.19,241,0,0,158,240,419,241,419
2018,38,43,"Iskenderun",36.7105,36.1965,21.9142857142857,27.7857142857143,0,63.6285714285714,3.76833333333333,NA,189,0,0,95,121,344,189,344
2018,39,43,"Iskenderun",36.7105,36.1965,19.9142857142857,26.6,0.0788571428571429,64.8,5.62571428571429,NA,180,0,0,81,134,353,180,353
2018,40,43,"Iskenderun",36.7105,36.1965,17.2142857142857,25.2571428571429,0.0102857142857143,55.3,6.68666666666667,8.0125,191,0,0,129,219,341,191,341
2018,41,43,"Iskenderun",36.7105,36.1965,13.3285714285714,23.9571428571429,0.880142857142857,62.1714285714286,7.08857142857143,8.94857142857143,187,0,0,133,321,422,187,422
2018,42,43,"Iskenderun",36.7105,36.1965,14.2571428571429,23.7,3.761,60.9142857142857,7.736,11.5166666666667,168,1,0,80,267,381,167,381
2018,43,43,"Iskenderun",36.7105,36.1965,19.3,19.4142857142857,7.30857142857143,64.2142857142857,6.502,13.2533333333333,187,28,7,44,160,402,159,395
2018,44,43,"Iskenderun",36.7105,36.1965,11.9857142857143,18.9142857142857,0,52.7571428571429,6.90857142857143,12.6083333333333,196,14,12,48,49,264,182,252
2018,45,43,"Iskenderun",36.7105,36.1965,10.4857142857143,17.5857142857143,1.57757142857143,70.2714285714286,6.506,10.152,231,50,127,41,40,473,181,346
2018,46,43,"Iskenderun",36.7105,36.1965,12.7428571428571,14.2571428571429,0.994857142857143,65.9571428571429,6.17,18.1,230,2,1,38,76,465,228,464
2018,47,43,"Iskenderun",36.7105,36.1965,10.4142857142857,15.4,6.41228571428571,75.1857142857143,7.05,NA,270,25,1,40,224,499,245,498
2018,48,43,"Iskenderun",36.7105,36.1965,15.5571428571429,15.8428571428571,0.267571428571429,76.2857142857143,6.47333333333333,NA,245,24,2,27,49,201,221,199
2018,49,43,"Iskenderun",36.7105,36.1965,15.3857142857143,14.5428571428571,4.16771428571429,76.8428571428571,6.61,18.11,257,0,0,45,96,420,257,420
2018,50,43,"Iskenderun",36.7105,36.1965,17.7857142857143,13.5428571428571,6.69028571428571,70.0857142857143,5.92,10.98,256,60,62,26,44,305,196,243
2018,51,43,"Iskenderun",36.7105,36.1965,15.8142857142857,12.5714285714286,2.34342857142857,79.5,5.726,NA,250,44,58,5,10,248,206,190
2018,52,43,"Iskenderun",36.7105,36.1965,18.6142857142857,10.1428571428571,8.34328571428571,71.1857142857143,7.725,NA,244,92,38,45,115,273,152,235
2019,1,43,"Iskenderun",36.7105,36.1965,19.5625,11.3125,12.380375,78.375,NA,20.345,343,88,145,4,2,784,255,639
2019,2,43,"Iskenderun",36.7105,36.1965,20.5285714285714,8.71428571428571,4.47014285714286,63.1857142857143,NA,9.72666666666667,255,73,26,69,94,208,182,182
2019,3,43,"Iskenderun",36.7105,36.1965,20.2142857142857,8.95714285714286,5.793,62.8,6.34,11.63,192,61,28,15,5,198,131,170
2019,4,43,"Iskenderun",36.7105,36.1965,17.2142857142857,11.6,2.73771428571429,63.2571428571429,NA,NA,308,126,55,1,1,314,182,259
2019,5,43,"Iskenderun",36.7105,36.1965,15.5571428571429,12.2571428571429,5.29257142857143,71.9571428571429,5.48,NA,253,34,12,91,46,143,219,131
2019,6,43,"Iskenderun",36.7105,36.1965,22.9285714285714,11.9285714285714,7.72285714285714,67.8285714285714,6.1,11.04,276,0,0,45,28,127,276,127
2019,7,43,"Iskenderun",36.7105,36.1965,15.8571428571429,11.4857142857143,0.873857142857143,74.5428571428571,NA,NA,325,76,30,57,110,234,249,204
2019,8,43,"Iskenderun",36.7105,36.1965,17.0714285714286,12.9,4.616,73.9857142857143,7.91,21.73,305,1,2,121,96,219,304,217
2019,9,43,"Iskenderun",36.7105,36.1965,18.6428571428571,12.3285714285714,4.75,67.6857142857143,6.7225,22.7,331,33,31,73,50,310,298,279
2019,10,43,"Iskenderun",36.7105,36.1965,18.2285714285714,13.2142857142857,1.48985714285714,68.8285714285714,NA,26.6385714285714,359,2,0,175,193,252,357,252
2019,11,43,"Iskenderun",36.7105,36.1965,19.4857142857143,14.1571428571429,7.70328571428571,77.4857142857143,NA,20.7816666666667,373,9,21,138,85,400,364,379
2019,12,43,"Iskenderun",36.7105,36.1965,16.0142857142857,15.5142857142857,0,63.4571428571429,10.1383333333333,17.7771428571429,343,1,0,122,338,416,342,416
2019,13,43,"Iskenderun",36.7105,36.1965,19.8285714285714,14.1285714285714,5.7,71.5428571428571,7.765,7.315,256,0,0,163,66,194,256,194
2019,14,43,"Iskenderun",36.7105,36.1965,14.9428571428571,15.6857142857143,2.98785714285714,77.1714285714286,7.91571428571429,9.04142857142857,365,0,0,181,98,208,365,208
2019,15,43,"Iskenderun",36.7105,36.1965,17.7285714285714,18.2714285714286,2.51814285714286,68.6857142857143,12.29,5.93,359,33,22,149,69,183,326,161
2019,16,43,"Iskenderun",36.7105,36.1965,20.7285714285714,14.3,4.10957142857143,75.4714285714286,6.24833333333333,5.32833333333333,318,0,0,172,90,208,318,208
2019,17,43,"Iskenderun",36.7105,36.1965,19.2285714285714,18.0857142857143,0,57.4,6.54,4.85,412,0,0,376,280,313,412,313
2019,18,43,"Iskenderun",36.7105,36.1965,17.8571428571429,21.1714285714286,0.00514285714285714,63.8142857142857,13.1275,4.3075,523,55,110,320,160,353,468,243
2019,19,43,"Iskenderun",36.7105,36.1965,21.8,20.2142857142857,0.477,61.9857142857143,9.0475,12.3583333333333,452,28,32,292,255,386,424,354
2019,20,43,"Iskenderun",36.7105,36.1965,18.6571428571429,24.7285714285714,0,55.6857142857143,9.03,26.3857142857143,454,0,0,356,300,389,454,389
2019,21,43,"Iskenderun",36.7105,36.1965,19.8285714285714,24.1857142857143,0.00471428571428572,59.2857142857143,11.2433333333333,18.9466666666667,457,0,0,333,334,413,457,413
2019,22,43,"Iskenderun",36.7105,36.1965,21.1428571428571,26.5571428571429,0,59.2714285714286,13.736,NA,453,0,0,398,220,323,453,323
2019,23,43,"Iskenderun",36.7105,36.1965,25.0428571428571,26.2,0.0321428571428571,60.5714285714286,9.79666666666667,NA,378,0,0,333,480,532,378,532
2019,24,43,"Iskenderun",36.7105,36.1965,22.6857142857143,25.7428571428571,3.08371428571429,69.0285714285714,9.32666666666667,NA,378,0,0,285,187,244,378,244
2019,25,43,"Iskenderun",36.7105,36.1965,23.9714285714286,26.1285714285714,3.44385714285714,71.0571428571429,9.41333333333333,NA,306,0,0,234,232,325,306,325
2019,26,43,"Iskenderun",36.7105,36.1965,29.6857142857143,28.3857142857143,0.237428571428571,69.4571428571429,15.29,NA,377,0,0,281,157,342,377,342
2019,27,43,"Iskenderun",36.7105,36.1965,26.1857142857143,27.7428571428571,0,61.7571428571429,12.7466666666667,NA,456,0,0,382,195,222,456,222
2019,28,43,"Iskenderun",36.7105,36.1965,23.1571428571429,28.1142857142857,2.41185714285714,69.0142857142857,22.682,NA,398,0,0,310,345,421,398,421
2019,29,43,"Iskenderun",36.7105,36.1965,22.6857142857143,27.5,8.99357142857143,66.6714285714286,13.4742857142857,NA,453,0,0,352,142,203,453,203
2019,30,43,"Iskenderun",36.7105,36.1965,21.3285714285714,28.8285714285714,0,65.9,14.65,NA,456,0,0,354,243,335,456,335
2019,31,43,"Iskenderun",36.7105,36.1965,24.0428571428571,28.7428571428571,0,70.6285714285714,14.74,NA,334,0,0,202,222,375,334,375
2019,32,43,"Iskenderun",36.7105,36.1965,23.6285714285714,28.8857142857143,0.0731428571428571,67.4285714285714,14.196,NA,346,0,0,265,303,395,346,395
2019,33,43,"Iskenderun",36.7105,36.1965,24.4857142857143,29.0714285714286,0.505285714285714,70.2142857142857,17.98,NA,337,0,0,228,404,531,337,531
2019,34,43,"Iskenderun",36.7105,36.1965,20.8714285714286,28.5428571428571,0.560714285714286,64.4,13.3742857142857,27.5866666666667,299,0,0,220,273,345,299,345
2019,35,43,"Iskenderun",36.7105,36.1965,20.2,29.2285714285714,0.243857142857143,71.2857142857143,18.1925,16.515,307,0,0,229,295,415,307,415
2019,36,43,"Iskenderun",36.7105,36.1965,22.1142857142857,28.5857142857143,0.482428571428571,66.1571428571429,13.8942857142857,11.0142857142857,171,0,0,94,15,67,171,67
2019,37,43,"Iskenderun",36.7105,36.1965,19.9571428571429,27.6285714285714,2.03642857142857,65.3,13.7257142857143,14.24,218,0,0,174,32,55,218,55
2019,38,43,"Iskenderun",36.7105,36.1965,18.6714285714286,25.8428571428571,1.35385714285714,56.4142857142857,15.25,15.516,266,0,0,180,40,91,266,91
2019,39,43,"Iskenderun",36.7105,36.1965,17.7857142857143,25.1428571428571,0.0731428571428571,62.1714285714286,13.0966666666667,14.1066666666667,237,0,0,161,29,79,237,79
2019,40,43,"Iskenderun",36.7105,36.1965,22.4857142857143,25.3857142857143,0.577428571428571,66.9,13.7228571428571,12.8633333333333,241,0,0,140,47,111,241,111
2019,41,43,"Iskenderun",36.7105,36.1965,16.4714285714286,24.5,0.131857142857143,61.3285714285714,14.165,15.32,416,0,0,176,146,448,416,448
2019,42,43,"Iskenderun",36.7105,36.1965,18.3428571428571,25.0142857142857,0.407857142857143,56.9142857142857,15.1625,12.29,356,0,0,224,290,408,356,408
2019,43,43,"Iskenderun",36.7105,36.1965,12.2571428571429,21.7571428571429,1.43414285714286,60.4714285714286,12.8083333333333,14.31,306,0,0,154,202,300,306,300
2019,44,43,"Iskenderun",36.7105,36.1965,12.7571428571429,18.8571428571429,8.84642857142857,72.8571428571429,11.975,10.83,350,36,29,111,115,250,314,221
2019,45,43,"Iskenderun",36.7105,36.1965,10.5,19.2857142857143,0,56.1857142857143,15.0683333333333,12.4325,417,1,0,124,182,328,416,328
2019,46,43,"Iskenderun",36.7105,36.1965,13.8285714285714,18.8,0.0972857142857143,47,14.7942857142857,17.7,401,0,0,118,153,337,401,337
2019,47,43,"Iskenderun",36.7105,36.1965,8.27142857142857,13.0857142857143,0,49,13.506,15.905,391,0,0,154,180,339,391,339
2019,48,43,"Iskenderun",36.7105,36.1965,14.5428571428571,15.1,2.79942857142857,70.1,13.485,18.094,320,33,22,47,66,251,287,229
2019,49,43,"Iskenderun",36.7105,36.1965,13.2571428571429,12.7,9.19571428571428,72.3285714285714,NA,20.5014285714286,393,17,3,101,87,274,376,271
2019,50,43,"Iskenderun",36.7105,36.1965,18.1,12.6857142857143,5.47714285714286,77.5571428571428,NA,10.1414285714286,218,41,39,21,6,119,177,80
2019,51,43,"Iskenderun",36.7105,36.1965,5.94285714285714,10.9428571428571,0,79.5857142857143,NA,27.2266666666667,361,2,0,34,42,488,359,488
2019,52,43,"Iskenderun",36.7105,36.1965,16.0285714285714,10.9571428571429,8.92057142857143,81.3285714285714,NA,12.8785714285714,279,81,135,9,2,281,198,146
2020,1,43,"Iskenderun",36.7105,36.1965,17,10.34,6.5364,81.14,NA,19.075,160,27,2,28,24,126,133,124
2020,2,43,"Iskenderun",36.7105,36.1965,14,10.5714285714286,0.727857142857143,70.8857142857143,NA,20.6033333333333,240,3,5,65,35,173,237,168
2020,3,43,"Iskenderun",36.7105,36.1965,14.7857142857143,9.98571428571429,0.179142857142857,65.8571428571429,NA,23.34,270,13,30,62,56,382,257,352
2020,4,43,"Iskenderun",36.7105,36.1965,19.1571428571429,8.62857142857143,0.0731428571428571,57.3142857142857,NA,24.212,358,0,0,235,229,295,358,295
2020,5,43,"Iskenderun",36.7105,36.1965,20.9,10.7285714285714,8.00185714285714,68.2,NA,20.594,331,9,0,118,81,272,322,272
2020,6,43,"Iskenderun",36.7105,36.1965,17.3,9.91428571428571,7.67214285714286,67.1571428571429,NA,18.0566666666667,343,71,72,65,29,267,272,195
2020,7,43,"Iskenderun",36.7105,36.1965,19.7,5.71428571428571,0.0531428571428571,56.6142857142857,NA,24.4285714285714,341,54,43,99,122,338,287,295
2020,8,43,"Iskenderun",36.7105,36.1965,14.7142857142857,12.6142857142857,1.82014285714286,73.4571428571429,NA,19.5814285714286,283,27,1,125,64,187,256,186
2020,9,43,"Iskenderun",36.7105,36.1965,13.9,13.4857142857143,4.491,72.6285714285714,10.1775,24.7228571428571,393,0,0,310,435,528,393,528
2020,10,43,"Iskenderun",36.7105,36.1965,15.9714285714286,15.8285714285714,0.219428571428571,68.0857142857143,10.04,21.988,205,0,0,126,151,210,205,210
2020,11,43,"Iskenderun",36.7105,36.1965,19.3285714285714,17.4285714285714,3.21,66.9714285714286,16.12,21.444,115,3,1,55,61,94,112,93
2020,12,43,"Iskenderun",36.7105,36.1965,16.6571428571429,11.8,6.741,75,8.06,14.73,117,0,0,59,79,118,117,118
2020,13,43,"Iskenderun",36.7105,36.1965,19.7571428571429,15.6714285714286,11.6597142857143,74.6571428571429,NA,16.1014285714286,136,9,19,61,19,92,127,73
2020,14,43,"Iskenderun",36.7105,36.1965,21.5142857142857,15.7428571428571,2.40814285714286,72.2714285714286,NA,15.6757142857143,155,0,0,68,50,121,155,121
2020,15,43,"Iskenderun",36.7105,36.1965,17.8142857142857,16.3714285714286,1.67642857142857,75.8714285714286,NA,10.7342857142857,133,0,0,38,72,118,133,118
2020,16,43,"Iskenderun",36.7105,36.1965,15.5285714285714,18.1857142857143,0.129857142857143,67.0428571428571,NA,24.452,141,0,0,90,51,106,141,106
2020,17,43,"Iskenderun",36.7105,36.1965,18.7571428571429,17.8571428571429,6.67785714285714,73.9142857142857,NA,NA,137,0,0,84,56,123,137,123
2020,18,43,"Iskenderun",36.7105,36.1965,20.1857142857143,18.4857142857143,5.36642857142857,79.5714285714286,NA,NA,146,0,0,73,47,164,146,164
2020,19,43,"Iskenderun",36.7105,36.1965,18.8142857142857,19.5142857142857,2.24171428571429,70.1428571428571,11.0975,NA,137,0,0,82,122,157,137,157
2020,20,43,"Iskenderun",36.7105,36.1965,15.7714285714286,24.3571428571429,0,57.1857142857143,29.3925,NA,164,0,0,109,112,164,164,164
2020,21,43,"Iskenderun",36.7105,36.1965,21.6142857142857,25.9,3.43342857142857,48.2571428571429,52.99,NA,146,0,0,88,51,96,146,96
2020,22,43,"Iskenderun",36.7105,36.1965,23.6714285714286,21.4714285714286,0.0487142857142857,57.9714285714286,NA,NA,118,0,0,66,47,100,118,100
2020,23,43,"Iskenderun",36.7105,36.1965,20.6428571428571,23.5285714285714,0.0244285714285714,58.2714285714286,16.4633333333333,27.6666666666667,112,0,0,65,34,70,112,70
2020,24,43,"Iskenderun",36.7105,36.1965,23.2714285714286,24.2428571428571,0.0154285714285714,66.7857142857143,10.4042857142857,18.7742857142857,140,0,0,81,73,150,140,150
2020,25,43,"Iskenderun",36.7105,36.1965,20.3571428571429,24.7714285714286,3.77014285714286,70.0285714285714,9.59285714285714,16.0614285714286,137,0,0,72,46,108,137,108
2020,26,43,"Iskenderun",36.7105,36.1965,23.7571428571429,25.8142857142857,0,70.7714285714286,11.1771428571429,18.8385714285714,173,0,0,83,24,133,173,133
2020,27,43,"Iskenderun",36.7105,36.1965,25.6714285714286,27.7,0,71.7857142857143,12.1514285714286,21.0814285714286,113,0,0,63,39,113,113,113
2020,28,43,"Iskenderun",36.7105,36.1965,23.4571428571429,27.9714285714286,0,73.2571428571429,8.3,15.1857142857143,164,0,0,89,24,122,164,122
2020,29,43,"Iskenderun",36.7105,36.1965,23.0285714285714,28.4285714285714,0.0244285714285714,72.7285714285714,8.98166666666667,15.3028571428571,186,0,0,92,48,111,186,111
2020,30,43,"Iskenderun",36.7105,36.1965,24.2142857142857,29.1857142857143,0,70.8285714285714,8.26857142857143,16.2314285714286,190,0,0,112,57,142,190,142
2020,31,43,"Iskenderun",36.7105,36.1965,22.9571428571429,29.6,0,72.4142857142857,NA,22.3771428571429,150,0,0,79,26,127,150,127
2020,32,43,"Iskenderun",36.7105,36.1965,22.8714285714286,29.4714285714286,1.76742857142857,69.6571428571429,9.235,13.75,146,0,0,65,46,107,146,107
2020,33,43,"Iskenderun",36.7105,36.1965,24.4285714285714,29.1857142857143,0.504571428571429,60.5,9.67,15.2975,183,0,0,89,23,83,183,83
2020,34,43,"Iskenderun",36.7105,36.1965,22.2142857142857,28.9571428571429,0.0791428571428571,58.6,NA,NA,197,0,0,121,42,97,197,97
2020,35,43,"Iskenderun",36.7105,36.1965,19.4571428571429,28.4857142857143,0,66.5285714285714,16.5325,31.735,164,0,0,100,58,157,164,157
2020,36,43,"Iskenderun",36.7105,36.1965,17.0571428571429,29.3857142857143,0.0244285714285714,67.5571428571428,15.945,30.444,179,0,0,93,36,112,179,112
2020,37,43,"Iskenderun",36.7105,36.1965,17.1,28.8142857142857,0,65.5,14.7883333333333,35.3566666666667,193,0,0,127,51,91,193,91
2020,38,43,"Iskenderun",36.7105,36.1965,17.1571428571429,28.2571428571429,0,72.1714285714286,11.5,19.76,235,0,0,105,45,157,235,157
2020,39,43,"Iskenderun",36.7105,36.1965,16.6714285714286,27.4,1.39485714285714,66.9428571428571,9.42,20.63,220,0,0,123,55,129,220,129
2020,40,43,"Iskenderun",36.7105,36.1965,17.9428571428571,26.6428571428571,0.038,64.7428571428571,11.5457142857143,23.5357142857143,187,0,0,95,71,154,187,154
2020,41,43,"Iskenderun",36.7105,36.1965,13.5571428571429,25.9857142857143,0,47.1285714285714,13.4914285714286,18.3,182,30,13,75,52,127,152,114
2020,42,43,"Iskenderun",36.7105,36.1965,16.2142857142857,24.5571428571429,0,68.4857142857143,11.7171428571429,23.4542857142857,177,0,0,97,64,111,177,111
2020,43,43,"Iskenderun",36.7105,36.1965,11.9428571428571,24.1142857142857,0.205714285714286,57.1857142857143,12.9442857142857,33.2342857142857,194,0,0,130,123,161,194,161
2020,44,43,"Iskenderun",36.7105,36.1965,12.6428571428571,23.1,0,53.6,14.33,38.988,255,50,29,147,92,233,205,204
2020,45,43,"Iskenderun",36.7105,36.1965,11.9285714285714,18.5285714285714,6.37642857142857,71.8428571428571,8.29428571428571,20.494,156,14,6,50,38,103,142,97
2020,46,43,"Iskenderun",36.7105,36.1965,9.41428571428571,16.9,0,61.9857142857143,11.132,14.7533333333333,208,5,6,81,70,109,203,103
2020,47,43,"Iskenderun",36.7105,36.1965,13.1571428571429,14.5428571428571,0.673857142857143,65.6857142857143,9.27142857142857,10.9357142857143,173,10,13,53,23,83,163,70
2020,48,43,"Iskenderun",36.7105,36.1965,15.7428571428571,12.6142857142857,0.703,62.2428571428571,11.5266666666667,11.3171428571429,199,9,5,53,130,262,190,257
2020,49,43,"Iskenderun",36.7105,36.1965,14.1857142857143,14.2428571428571,0.484,65.1571428571429,9.6,10.8857142857143,207,15,3,79,74,116,192,113
2020,50,43,"Iskenderun",36.7105,36.1965,13.7285714285714,13.1857142857143,1.24328571428571,67.4428571428572,9.39428571428572,12.3842857142857,181,69,29,10,6,98,112,69
2020,51,43,"Iskenderun",36.7105,36.1965,18.0142857142857,13.5142857142857,4.74742857142857,75.7714285714286,12.15,12.2128571428571,171,13,4,52,33,90,158,86
2020,52,43,"Iskenderun",36.7105,36.1965,15.7571428571429,10.3857142857143,0.926428571428571,58.4857142857143,9.315,9.77,203,45,17,20,2,113,158,96
2020,53,43,"Iskenderun",36.7105,36.1965,9.15,10.45,0,57.75,12.1275,15.8975,122,5,0,39,30,111,117,111
2017,1,44,"Samandag",36.0871,35.9685,22.3428571428571,8.57142857142857,9.88485714285714,81.3142857142857,9.00142857142857,16.3442857142857,563,237,289,24,103,847,326,558
2017,2,44,"Samandag",36.0871,35.9685,16.7285714285714,8.25714285714286,6.47614285714286,72.3571428571429,90.765,32.186,757,246,328,74,89,1214,511,886
2017,3,44,"Samandag",36.0871,35.9685,12,7.8,0.202857142857143,74.9285714285714,98.1542857142857,35.9585714285714,762,116,212,264,784,1449,646,1237
2017,4,44,"Samandag",36.0871,35.9685,21.2142857142857,7.04285714285714,4.192,62.4,102.142857142857,33.5185714285714,639,12,8,251,435,889,627,881
2017,5,44,"Samandag",36.0871,35.9685,28.6285714285714,6.38571428571429,0,54.1142857142857,85.0071428571429,37.5257142857143,588,0,0,261,523,1163,588,1163
2017,6,44,"Samandag",36.0871,35.9685,16.9428571428571,11.6285714285714,0.0811428571428571,62.8,39.9133333333333,28.8214285714286,736,67,86,173,366,1519,669,1433
2017,7,44,"Samandag",36.0871,35.9685,20.6857142857143,7.48571428571429,5.47385714285714,44.9714285714286,75.0483333333333,28.09,492,0,0,255,299,717,492,717
2017,8,44,"Samandag",36.0871,35.9685,16.6571428571429,10.4857142857143,0.479285714285714,62.0714285714286,NA,25.7842857142857,739,101,215,238,621,1747,638,1532
2017,9,44,"Samandag",36.0871,35.9685,20.0571428571429,13.7285714285714,2.33314285714286,64.1142857142857,NA,19.265,574,64,52,182,190,866,510,814
2017,10,44,"Samandag",36.0871,35.9685,18.9714285714286,14.8428571428571,2.34185714285714,69.1,NA,NA,712,95,183,222,282,1043,617,860
2017,11,44,"Samandag",36.0871,35.9685,24.4857142857143,12.2714285714286,3.45242857142857,72.0428571428571,133.775,34.53,525,54,77,210,326,725,471,648
2017,12,44,"Samandag",36.0871,35.9685,26.2,14.8142857142857,0.258,68.4285714285714,58.0757142857143,37.2,589,63,90,170,294,1077,526,987
2017,13,44,"Samandag",36.0871,35.9685,20.6285714285714,15.6,3.26985714285714,71.6714285714286,35.9985714285714,31.9757142857143,574,73,121,147,202,887,501,766
2017,14,44,"Samandag",36.0871,35.9685,28.9571428571429,17.5,1.04471428571429,61.6,40.02,32.1842857142857,639,36,74,215,455,1336,603,1262
2017,15,44,"Samandag",36.0871,35.9685,26.1857142857143,16.5,1.26871428571429,64.5285714285714,31.4914285714286,35.0142857142857,587,64,94,148,286,1187,523,1093
2017,16,44,"Samandag",36.0871,35.9685,24.9857142857143,18.2428571428571,0,65.3857142857143,33.6542857142857,27.8371428571429,717,110,193,129,207,920,607,727
2017,17,44,"Samandag",36.0871,35.9685,19.7,19.3571428571429,0,56.2,35.77,36.9457142857143,731,6,1,362,710,1478,725,1477
2017,18,44,"Samandag",36.0871,35.9685,27.4714285714286,20.4714285714286,0.663714285714286,69.5428571428571,NA,NA,506,38,146,109,141,923,468,777
2017,19,44,"Samandag",36.0871,35.9685,27.0285714285714,22.6857142857143,0,55.9428571428571,164.98,17.9766666666667,471,53,131,101,179,966,418,835
2017,20,44,"Samandag",36.0871,35.9685,30.1571428571429,21.8571428571429,7.58571428571429,62.7714285714286,NA,12.6628571428571,472,15,17,129,316,1205,457,1188
2017,21,44,"Samandag",36.0871,35.9685,29.1142857142857,20.8857142857143,0.517,66.4714285714286,NA,16.5085714285714,448,30,46,111,124,849,418,803
2017,22,44,"Samandag",36.0871,35.9685,31.0285714285714,23.5285714285714,0.489857142857143,61.0285714285714,101.57,16.9928571428571,522,22,4,137,276,1015,500,1011
2017,23,44,"Samandag",36.0871,35.9685,32.7428571428571,25.8857142857143,0,63.0285714285714,66.24,17.7257142857143,578,28,33,88,160,1388,550,1355
2017,24,44,"Samandag",36.0871,35.9685,32.7,25.5714285714286,0,66.6428571428571,63.0414285714286,17.1985714285714,552,47,168,98,123,1139,505,971
2017,25,44,"Samandag",36.0871,35.9685,32.9428571428571,25.8857142857143,2.00614285714286,63.5714285714286,60.2828571428571,15.0828571428571,584,67,148,117,178,1041,517,893
2017,26,44,"Samandag",36.0871,35.9685,32.6714285714286,29.2428571428571,0,59.1,98.79,22.0328571428571,564,19,41,177,232,971,545,930
2017,27,44,"Samandag",36.0871,35.9685,35.1857142857143,29.3,0,58.7857142857143,NA,15.2014285714286,511,59,81,85,102,642,452,561
2017,28,44,"Samandag",36.0871,35.9685,35.2571428571429,29.4571428571429,0,61.9571428571429,NA,20.2157142857143,481,70,215,46,45,864,411,649
2017,29,44,"Samandag",36.0871,35.9685,33.4285714285714,29.0142857142857,0,64.3857142857143,92.665,15.5285714285714,532,58,152,46,65,1272,474,1120
2017,30,44,"Samandag",36.0871,35.9685,30.8428571428571,29.7857142857143,0.0428571428571429,59.2142857142857,100.804285714286,23.25,531,35,32,74,71,928,496,896
2017,31,44,"Samandag",36.0871,35.9685,31.3571428571429,29.0857142857143,0,66.3,72.4985714285714,15.7042857142857,559,122,279,1,0,1047,437,768
2017,32,44,"Samandag",36.0871,35.9685,33.6857142857143,29.4285714285714,0,66.7857142857143,NA,18.7071428571429,567,61,109,32,23,1092,506,983
2017,33,44,"Samandag",36.0871,35.9685,32,29.0428571428571,0.0142857142857143,65.2,NA,21.4414285714286,596,100,260,24,42,1199,496,939
2017,34,44,"Samandag",36.0871,35.9685,31.8285714285714,28.9714285714286,0,65.2142857142857,123.94,20.4285714285714,601,60,125,44,51,1280,541,1155
2017,35,44,"Samandag",36.0871,35.9685,29.7714285714286,28.2,0,67.1428571428571,100.566666666667,16.945,493,90,356,26,59,1014,403,658
2017,36,44,"Samandag",36.0871,35.9685,27.9714285714286,26.8857142857143,0.0285714285714286,61.2142857142857,89.5842857142857,18.2028571428571,507,35,61,113,185,1321,472,1260
2017,37,44,"Samandag",36.0871,35.9685,29.5857142857143,27.4571428571429,0,68.0142857142857,116.31,25.8585714285714,589,31,48,64,39,1138,558,1090
2017,38,44,"Samandag",36.0871,35.9685,27.9571428571429,26.9857142857143,0.212857142857143,66.7142857142857,122.571428571429,23.3914285714286,671,50,75,43,20,1312,621,1237
2017,39,44,"Samandag",36.0871,35.9685,28.4285714285714,25.5285714285714,2.45628571428571,63.8571428571429,69.12,16.73,782,94,220,48,38,1630,688,1410
2017,40,44,"Samandag",36.0871,35.9685,18.7571428571429,22.1142857142857,0,52.7857142857143,69.2142857142857,19.2271428571429,543,32,73,165,160,1137,511,1064
2017,41,44,"Samandag",36.0871,35.9685,17.4285714285714,21.1285714285714,4.74657142857143,62.4142857142857,72.3185714285714,21.6571428571429,487,41,32,168,216,843,446,811
2017,42,44,"Samandag",36.0871,35.9685,16.7285714285714,20.1428571428571,0,47.7285714285714,108.505714285714,22.06,530,5,1,276,458,815,525,814
2017,43,44,"Samandag",36.0871,35.9685,18.7571428571429,19.9571428571429,3.08885714285714,66.0428571428571,85.4485714285714,20.6228571428571,506,119,396,122,176,919,387,523
2017,44,44,"Samandag",36.0871,35.9685,17.7,17.3857142857143,4.58571428571429,73.7428571428571,80.4871428571429,22.3214285714286,561,159,428,142,278,1102,402,674
2017,45,44,"Samandag",36.0871,35.9685,12.5,16.5285714285714,1.09057142857143,72.3,87.3528571428571,21.9785714285714,577,18,86,181,176,829,559,743
2017,46,44,"Samandag",36.0871,35.9685,15.6571428571429,17.3428571428571,0,59.5857142857143,108.054,48.624,587,81,144,140,295,1085,506,941
2017,47,44,"Samandag",36.0871,35.9685,20.6714285714286,12.3,6.04671428571429,64.6,33.9414285714286,29.45,418,48,70,91,90,804,370,734
2017,48,44,"Samandag",36.0871,35.9685,10.4714285714286,12.1857142857143,4.20571428571429,80.6,32.0114285714286,42.6142857142857,386,82,102,16,15,619,304,517
2017,49,44,"Samandag",36.0871,35.9685,19.1857142857143,9.51428571428571,2.99071428571429,69.7285714285714,71.97,39.3914285714286,407,40,40,150,233,645,367,605
2017,50,44,"Samandag",36.0871,35.9685,10.5142857142857,10.8571428571429,0.0902857142857143,75.0571428571429,127.535714285714,12.8385714285714,346,24,27,52,35,442,322,415
2017,51,44,"Samandag",36.0871,35.9685,15.8285714285714,13.1,2.02042857142857,75.3,77.49,0.172857142857143,386,37,36,92,84,349,349,313
2017,52,44,"Samandag",36.0871,35.9685,14.125,11.2375,4.19025,73.325,86.93875,3.47,528,76,70,63,67,507,452,437
2018,1,44,"Samandag",36.0871,35.9685,18.7125,10.3125,11.4445,80.875,49.61125,41.70875,618,64,193,173,252,914,554,721
2018,2,44,"Samandag",36.0871,35.9685,16.9428571428571,10.0714285714286,1.67714285714286,73.9857142857143,307.925,26.7225,624,82,60,156,380,1309,542,1249
2018,3,44,"Samandag",36.0871,35.9685,21.1571428571429,9.91428571428571,10.6372857142857,76.9,163.992857142857,19.3042857142857,639,43,25,252,385,655,596,630
2018,4,44,"Samandag",36.0871,35.9685,18.7142857142857,10.1285714285714,9.99342857142857,82.6,213.944285714286,18.6242857142857,604,59,149,202,203,764,545,615
2018,5,44,"Samandag",36.0871,35.9685,11.4428571428571,9.87142857142857,0,74.5857142857143,143.065,18.14,670,0,0,305,508,819,670,819
2018,6,44,"Samandag",36.0871,35.9685,10.2571428571429,13.0714285714286,0,71.1714285714286,85.5814285714286,21.0128571428571,704,28,35,206,199,1022,676,987
2018,7,44,"Samandag",36.0871,35.9685,22.6285714285714,13.3285714285714,3.27328571428571,72.8285714285714,107.211428571429,14.7042857142857,478,118,172,108,106,557,360,385
2018,8,44,"Samandag",36.0871,35.9685,19.0428571428571,12.9571428571429,2.69142857142857,73.7714285714286,158.571428571429,15.9457142857143,711,84,294,196,245,1321,627,1027
2018,9,44,"Samandag",36.0871,35.9685,18.7857142857143,13.5857142857143,2.33185714285714,80.2142857142857,96.2114285714286,16.8942857142857,621,75,100,154,279,956,546,856
2018,10,44,"Samandag",36.0871,35.9685,29.4,16.1571428571429,0.212857142857143,73.2714285714286,65.4171428571429,10.0571428571429,556,91,125,184,553,1330,465,1205
2018,11,44,"Samandag",36.0871,35.9685,24.3857142857143,15.4714285714286,2.32728571428571,72.8857142857143,82.31,12.18,551,102,367,65,391,1426,449,1059
2018,12,44,"Samandag",36.0871,35.9685,25.5,17.5571428571429,7.174,62.0428571428571,NA,NA,425,60,120,43,118,1187,365,1067
2018,13,44,"Samandag",36.0871,35.9685,20.5428571428571,16.7571428571429,1.91885714285714,67.4142857142857,NA,NA,356,14,53,124,166,428,342,375
2018,14,44,"Samandag",36.0871,35.9685,18.2428571428571,17.4285714285714,0,56.8,150.76,13.1233333333333,407,13,17,192,188,486,394,469
2018,15,44,"Samandag",36.0871,35.9685,25.1,18.0857142857143,4.33,76.5,133.134285714286,11.5185714285714,374,23,56,164,113,450,351,394
2018,16,44,"Samandag",36.0871,35.9685,25.1428571428571,18.4,3.12442857142857,61.1571428571429,78.018,17.058,411,15,12,191,229,648,396,636
2018,17,44,"Samandag",36.0871,35.9685,23.9571428571429,20.9714285714286,0.427714285714286,62.6428571428571,123.701428571429,24.0671428571429,419,35,65,120,251,652,384,587
2018,18,44,"Samandag",36.0871,35.9685,23.5428571428571,24.2428571428571,0.202714285714286,54.7714285714286,96.4885714285714,15.0128571428571,303,1,1,115,213,474,302,473
2018,19,44,"Samandag",36.0871,35.9685,24.4,19.7428571428571,9.58042857142857,73.4857142857143,113.67,10,275,50,146,58,89,467,225,321
2018,20,44,"Samandag",36.0871,35.9685,23.0571428571429,24.7142857142857,0,55.0571428571429,77.6071428571429,11.2216666666667,204,11,4,90,157,306,193,302
2018,21,44,"Samandag",36.0871,35.9685,29.3571428571429,25.6142857142857,0,57.0571428571429,109.525714285714,6.13857142857143,252,48,48,27,18,281,204,233
2018,22,44,"Samandag",36.0871,35.9685,28.1857142857143,24.8857142857143,3.96871428571429,63.1428571428571,124.252857142857,5.62428571428571,249,49,74,33,29,427,200,353
2018,23,44,"Samandag",36.0871,35.9685,28.4285714285714,27.0857142857143,0,60.3285714285714,71.2428571428571,7.96714285714286,267,26,88,75,113,812,241,724
2018,24,44,"Samandag",36.0871,35.9685,31.8428571428571,26.0142857142857,4.47585714285714,66.1571428571429,66.2485714285714,5.19,267,58,144,18,10,448,209,304
2018,25,44,"Samandag",36.0871,35.9685,34.9,26.5142857142857,2.30085714285714,62.9285714285714,67.2714285714286,3.80571428571429,358,25,9,158,173,518,333,509
2018,26,44,"Samandag",36.0871,35.9685,31.9142857142857,27.0857142857143,0.083,61.1,80.3566666666667,7.93333333333333,355,16,17,169,358,587,339,570
2018,27,44,"Samandag",36.0871,35.9685,35.0857142857143,28.2714285714286,0,63.2,74.2614285714286,10.5757142857143,342,37,47,83,99,418,305,371
2018,28,44,"Samandag",36.0871,35.9685,31.6428571428571,28.7571428571429,0.0142857142857143,62.5142857142857,81.7028571428571,10.1485714285714,286,21,28,70,236,585,265,557
2018,29,44,"Samandag",36.0871,35.9685,31.0142857142857,28.9285714285714,0.567285714285714,62.6,131.077142857143,11.9157142857143,260,22,33,76,475,756,238,723
2018,30,44,"Samandag",36.0871,35.9685,33.2428571428571,29.0428571428571,1.696,60.7142857142857,129.058571428571,11.3542857142857,265,23,26,67,306,822,242,796
2018,31,44,"Samandag",36.0871,35.9685,34.1142857142857,29.2142857142857,2.214,64.6857142857143,69.924,16.754,267,29,24,41,257,499,238,475
2018,32,44,"Samandag",36.0871,35.9685,30.6857142857143,29.5285714285714,0.534571428571428,60.5,59.97,17.5385714285714,297,30,72,64,97,403,267,331
2018,33,44,"Samandag",36.0871,35.9685,32.3714285714286,29.1285714285714,0,60.1285714285714,64.1728571428571,26.4228571428571,216,13,13,45,92,332,203,319
2018,34,44,"Samandag",36.0871,35.9685,31.7714285714286,29.1142857142857,0,65.3571428571429,60.3242857142857,26.5057142857143,144,14,13,10,17,227,130,214
2018,35,44,"Samandag",36.0871,35.9685,28.9857142857143,28.3714285714286,1.01385714285714,68.0857142857143,73.4842857142857,25.1314285714286,201,28,24,7,23,314,173,290
2018,36,44,"Samandag",36.0871,35.9685,30.9285714285714,27.9142857142857,2.47071428571429,62.9285714285714,42.404,23.83,341,25,54,17,36,370,316,316
2018,37,44,"Samandag",36.0871,35.9685,23.8285714285714,26.9428571428571,1.005,58.6285714285714,44.54,1.3,241,18,20,54,88,419,223,399
2018,38,44,"Samandag",36.0871,35.9685,28.2285714285714,27.5,0,64.6,20.2771428571429,0.904285714285714,189,41,53,8,29,344,148,291
2018,39,44,"Samandag",36.0871,35.9685,27.1,26.1428571428571,0.0552857142857143,64.7142857142857,24.734,1.28714285714286,180,15,15,26,61,353,165,338
2018,40,44,"Samandag",36.0871,35.9685,23.3,24.8285714285714,0,56.3571428571429,30.424,1.47,191,4,1,51,73,341,187,340
2018,41,44,"Samandag",36.0871,35.9685,19.6857142857143,23.6571428571429,1.02857142857143,62.8,70.5471428571429,3.18428571428571,187,20,28,44,134,422,167,394
2018,42,44,"Samandag",36.0871,35.9685,20.0285714285714,22.9714285714286,2.70985714285714,63.3285714285714,218.233333333333,4.13285714285714,168,8,5,86,307,381,160,376
2018,43,44,"Samandag",36.0871,35.9685,21.4714285714286,18.9428571428571,6.284,66.1714285714286,39.3033333333333,4.58142857142857,187,28,26,60,193,402,159,376
2018,44,44,"Samandag",36.0871,35.9685,12.6,17.4857142857143,0.101428571428571,55.6571428571429,27.5714285714286,7.28714285714286,196,1,0,84,126,264,195,264
2018,45,44,"Samandag",36.0871,35.9685,16.6285714285714,16.3857142857143,6.25757142857143,77.1428571428571,22.8275,5.75,231,68,166,47,101,473,163,307
2018,46,44,"Samandag",36.0871,35.9685,12.1571428571429,13.4857142857143,0.944714285714286,72.9285714285714,39.81,16.6116666666667,230,0,0,99,266,465,230,465
2018,47,44,"Samandag",36.0871,35.9685,12.6,14.4,5.51128571428571,81.8,58.1657142857143,13.6757142857143,270,4,0,107,288,499,266,499
2018,48,44,"Samandag",36.0871,35.9685,15.4571428571429,15.0857142857143,1.50614285714286,82.1571428571429,28.3785714285714,11.9071428571429,245,5,4,48,69,201,240,197
2018,49,44,"Samandag",36.0871,35.9685,15.4571428571429,13.6,5.01942857142857,84.0571428571429,31.105,6.32333333333333,257,6,11,33,67,420,251,409
2018,50,44,"Samandag",36.0871,35.9685,24.2285714285714,13.1285714285714,8.26242857142857,73.4857142857143,29.1014285714286,6.78,256,47,62,29,47,305,209,243
2018,51,44,"Samandag",36.0871,35.9685,23.6285714285714,11.4571428571429,5.50342857142857,88.1714285714286,32.73,7.90714285714286,250,9,2,18,19,248,241,246
2018,52,44,"Samandag",36.0871,35.9685,24.0857142857143,9.68571428571429,7.65171428571429,78.0857142857143,26.4785714285714,5.61285714285714,244,18,14,60,35,273,226,259
2019,1,44,"Samandag",36.0871,35.9685,21,10.6375,11.077375,83.325,27.68,6.756,343,55,44,34,87,784,288,740
2019,2,44,"Samandag",36.0871,35.9685,25.3571428571429,8.45714285714286,5.90628571428571,67.8714285714286,NA,NA,255,34,61,42,20,208,221,147
2019,3,44,"Samandag",36.0871,35.9685,26.9,8.5,6.991,67.8142857142857,NA,NA,192,26,13,39,65,198,166,185
2019,4,44,"Samandag",36.0871,35.9685,19.1285714285714,10.6285714285714,1.87114285714286,69.6714285714286,NA,NA,308,20,8,31,25,314,288,306
2019,5,44,"Samandag",36.0871,35.9685,22.8571428571429,12.1,5.06828571428571,74.5,NA,NA,253,28,20,19,12,143,225,123
2019,6,44,"Samandag",36.0871,35.9685,26.5714285714286,10.8285714285714,10.6691428571429,74.5571428571428,NA,NA,276,3,4,27,16,127,273,123
2019,7,44,"Samandag",36.0871,35.9685,18.6142857142857,10.7857142857143,5.84671428571429,80,NA,NA,325,50,16,17,8,234,275,218
2019,8,44,"Samandag",36.0871,35.9685,20.1285714285714,12.6142857142857,3.66928571428571,75.5285714285714,NA,NA,305,16,6,61,34,219,289,213
2019,9,44,"Samandag",36.0871,35.9685,24.8285714285714,12.2285714285714,7.76971428571429,70.0142857142857,NA,NA,331,52,122,120,30,310,279,188
2019,10,44,"Samandag",36.0871,35.9685,27.1,13.0428571428571,2.64042857142857,70.9,NA,NA,359,18,23,103,69,252,341,229
2019,11,44,"Samandag",36.0871,35.9685,25.5714285714286,14.2,7.70614285714286,76.9,NA,NA,373,11,12,59,42,400,362,388
2019,12,44,"Samandag",36.0871,35.9685,19.7285714285714,15.2285714285714,0.0142857142857143,67.1714285714286,NA,NA,343,27,38,62,35,416,316,378
2019,13,44,"Samandag",36.0871,35.9685,26.7142857142857,14.0285714285714,5.89042857142857,71.6285714285714,NA,NA,256,19,40,40,35,194,237,154
2019,14,44,"Samandag",36.0871,35.9685,21.7571428571429,15.4714285714286,4.63571428571429,76.8,NA,16.975,365,15,21,132,64,208,350,187
2019,15,44,"Samandag",36.0871,35.9685,24.1571428571429,18.0857142857143,1.81671428571429,68.2142857142857,NA,11.3228571428571,359,79,80,43,23,183,280,103
2019,16,44,"Samandag",36.0871,35.9685,27.6857142857143,14.0571428571429,7.43928571428571,77.0428571428571,NA,11.11,318,45,63,25,11,208,273,145
2019,17,44,"Samandag",36.0871,35.9685,22.5571428571429,17.8142857142857,0,57.4285714285714,NA,0.08,412,8,4,185,184,313,404,309
2019,18,44,"Samandag",36.0871,35.9685,24.6428571428571,21.2,0,62.5142857142857,NA,0.0414285714285714,523,31,110,150,94,353,492,243
2019,19,44,"Samandag",36.0871,35.9685,27.8857142857143,20,0.346,60.4714285714286,NA,0.026,452,21,5,16,16,386,431,381
2019,20,44,"Samandag",36.0871,35.9685,26.3714285714286,24.7428571428571,0,54.4714285714286,NA,0.0371428571428571,454,38,39,99,76,389,416,350
2019,21,44,"Samandag",36.0871,35.9685,29.0857142857143,24.7285714285714,0,52.3714285714286,NA,8.61,457,34,21,9,5,413,423,392
2019,22,44,"Samandag",36.0871,35.9685,27.5857142857143,26.9142857142857,0,53.4857142857143,46.975,0.705,453,18,31,50,42,323,435,292
2019,23,44,"Samandag",36.0871,35.9685,28.7,26.6142857142857,0,54.9571428571429,44.8766666666667,0.72,378,18,21,8,6,532,360,511
2019,24,44,"Samandag",36.0871,35.9685,31.3857142857143,25.8714285714286,2.30428571428571,64.6571428571429,27.2685714285714,0.748571428571429,378,33,18,16,9,244,345,226
2019,25,44,"Samandag",36.0871,35.9685,30.8142857142857,26.5,2.14442857142857,65.9857142857143,27.3785714285714,0.707142857142857,306,18,16,9,12,325,288,309
2019,26,44,"Samandag",36.0871,35.9685,33.5428571428571,28.5285714285714,0,63.5714285714286,33.25,4.34,377,16,11,62,42,342,361,331
2019,27,44,"Samandag",36.0871,35.9685,32.5285714285714,27.8285714285714,0,58.2285714285714,23.36,5.82142857142857,456,28,13,57,46,222,428,209
2019,28,44,"Samandag",36.0871,35.9685,32.0857142857143,28.2571428571429,1.80657142857143,64.6285714285714,23.7066666666667,5.88,398,33,40,38,84,421,365,381
2019,29,44,"Samandag",36.0871,35.9685,28.4571428571429,27.7428571428571,6.06957142857143,61.4857142857143,22.0828571428571,5.74142857142857,453,24,3,35,35,203,429,200
2019,30,44,"Samandag",36.0871,35.9685,28.8714285714286,28.7714285714286,0,62.0857142857143,20.98,5.75,456,20,13,75,57,335,436,322
2019,31,44,"Samandag",36.0871,35.9685,30.2,28.6714285714286,0.0142857142857143,65.8571428571429,NA,NA,334,62,67,14,16,375,272,308
2019,32,44,"Samandag",36.0871,35.9685,30.7142857142857,28.9,0.0552857142857143,64.6571428571429,NA,16.17,346,37,38,43,49,395,309,357
2019,33,44,"Samandag",36.0871,35.9685,29.2428571428571,28.9714285714286,0.184285714285714,65.7,NA,11.0328571428571,337,27,25,7,7,531,310,506
2019,34,44,"Samandag",36.0871,35.9685,25.3714285714286,28.5,0.424,63.3571428571429,NA,13.9242857142857,299,29,7,21,19,345,270,338
2019,35,44,"Samandag",36.0871,35.9685,27.0428571428571,29.1142857142857,0.184285714285714,68.6428571428571,33.9566666666667,13.026,307,29,17,11,3,415,278,398
2019,36,44,"Samandag",36.0871,35.9685,28.6142857142857,28.3857142857143,1.13342857142857,63.3857142857143,23.4814285714286,9.13571428571429,171,41,8,3,2,67,130,59
2019,37,44,"Samandag",36.0871,35.9685,27.3285714285714,27.4428571428571,1.60828571428571,65.7571428571429,29.8185714285714,9.282,218,20,12,6,6,55,198,43
2019,38,44,"Samandag",36.0871,35.9685,21.3428571428571,25.9428571428571,1.13828571428571,56.6142857142857,25.5185714285714,5.93333333333333,266,25,7,111,23,91,241,84
2019,39,44,"Samandag",36.0871,35.9685,23.3714285714286,24.9714285714286,0.0552857142857143,62.7428571428571,25.2,NA,237,33,17,16,13,79,204,62
2019,40,44,"Samandag",36.0871,35.9685,28.3571428571429,25.1714285714286,0.333714285714286,65.7857142857143,33.2166666666667,7.12333333333333,241,38,8,19,10,111,203,103
2019,41,44,"Samandag",36.0871,35.9685,20.8571428571429,24.1,0.0507142857142857,62.9428571428571,26.945,4.195,416,104,86,122,125,448,312,362
2019,42,44,"Samandag",36.0871,35.9685,19.4142857142857,24.7142857142857,0.323857142857143,55.3857142857143,32.7766666666667,5.56166666666667,356,33,61,184,280,408,323,347
2019,43,44,"Samandag",36.0871,35.9685,13.4428571428571,20.7428571428571,1.47,63.7142857142857,28.0728571428571,3.62857142857143,306,14,0,137,201,300,292,300
2019,44,44,"Samandag",36.0871,35.9685,15.8857142857143,18.2857142857143,7.47042857142857,75.9857142857143,29.6628571428571,4.31285714285714,350,37,48,164,102,250,313,202
2019,45,44,"Samandag",36.0871,35.9685,12,19.2,0.106428571428571,54.7428571428571,26.6071428571429,4.81142857142857,417,1,0,177,229,328,416,328
2019,46,44,"Samandag",36.0871,35.9685,16.9857142857143,18.4428571428571,0.797142857142857,44.7857142857143,30.215,6.115,401,2,3,132,158,337,399,334
2019,47,44,"Samandag",36.0871,35.9685,9.62857142857143,12.1285714285714,0,50.0428571428571,NA,NA,391,4,1,186,169,339,387,338
2019,48,44,"Samandag",36.0871,35.9685,14.7142857142857,14.4571428571429,13.7088571428571,73.9857142857143,NA,6.065,320,38,29,80,84,251,282,222
2019,49,44,"Samandag",36.0871,35.9685,15.1571428571429,12.1714285714286,9.02028571428571,77.4571428571429,NA,5.398,393,10,10,107,77,274,383,264
2019,50,44,"Samandag",36.0871,35.9685,19.1857142857143,11.7142857142857,10.6442857142857,85.7714285714286,NA,4.60666666666667,218,6,2,49,8,119,212,117
2019,51,44,"Samandag",36.0871,35.9685,7.2,9.47142857142857,0,85.4285714285714,NA,5.66,361,1,0,107,105,488,360,488
2019,52,44,"Samandag",36.0871,35.9685,17.3857142857143,10.1,12.3612857142857,89.1,NA,17.6,279,62,71,35,32,281,217,210
2020,1,44,"Samandag",36.0871,35.9685,18.06,9.72,12.6894,88.02,NA,NA,160,28,2,48,39,126,132,124
2020,2,44,"Samandag",36.0871,35.9685,14.7857142857143,9.97142857142857,3.32628571428571,77.2571428571429,NA,NA,240,24,7,114,78,173,216,166
2020,3,44,"Samandag",36.0871,35.9685,17.6428571428571,9.22857142857143,2.185,72.5285714285714,NA,NA,270,3,4,120,112,382,267,378
2020,4,44,"Samandag",36.0871,35.9685,18.4571428571429,8.41428571428571,0.864857142857143,63.2428571428571,78.9716666666667,NA,358,21,3,211,152,295,337,292
2020,5,44,"Samandag",36.0871,35.9685,22.1285714285714,10.8285714285714,6.72814285714286,69.6142857142857,46.7914285714286,NA,331,0,0,155,116,272,331,272
2020,6,44,"Samandag",36.0871,35.9685,19.8857142857143,9.47142857142857,6.673,69.9142857142857,55.6928571428571,NA,343,107,68,141,143,267,236,199
2020,7,44,"Samandag",36.0871,35.9685,19.6714285714286,5.05714285714286,0.966142857142857,66.2285714285714,67.5014285714286,NA,341,2,1,222,265,338,339,337
2020,8,44,"Samandag",36.0871,35.9685,17.3714285714286,12.3857142857143,1.43528571428571,75.7428571428571,35.108,36.056,283,53,27,115,48,187,230,160
2020,9,44,"Samandag",36.0871,35.9685,18.1285714285714,13.1571428571429,3.80471428571429,73.1857142857143,36.1828571428571,39.73,393,21,26,155,186,528,372,502
2020,10,44,"Samandag",36.0871,35.9685,18.9714285714286,15.5571428571429,0.779142857142857,68.4714285714286,30.6528571428571,38.6,205,9,9,41,61,210,196,201
2020,11,44,"Samandag",36.0871,35.9685,19.9571428571429,16.7428571428571,3.46628571428571,69.1428571428571,32.0225,34.3325,115,14,1,50,47,94,101,93
2020,12,44,"Samandag",36.0871,35.9685,19.8428571428571,11.9,6.251,74.1142857142857,25.7428571428571,15.0971428571429,117,20,9,45,60,118,97,109
2020,13,44,"Samandag",36.0871,35.9685,21.3285714285714,15.5428571428571,7.88814285714286,75.8,25.52,15.72,136,23,6,50,25,92,113,86
2020,14,44,"Samandag",36.0871,35.9685,25.8142857142857,15.5857142857143,1.935,73.2142857142857,NA,NA,155,24,15,53,39,121,131,106
2020,15,44,"Samandag",36.0871,35.9685,24.2714285714286,16.6,2.18657142857143,71.4428571428572,26.975,10.7983333333333,133,48,7,8,6,118,85,111
2020,16,44,"Samandag",36.0871,35.9685,17.8142857142857,18.4857142857143,0.102285714285714,64.3571428571429,24.38,12.11,141,14,6,45,37,106,127,100
2020,17,44,"Samandag",36.0871,35.9685,22.2571428571429,18,10.4928571428571,71.6,NA,NA,137,10,13,31,33,123,127,110
2020,18,44,"Samandag",36.0871,35.9685,24.9857142857143,18.5857142857143,2.71157142857143,75.2714285714286,NA,NA,146,39,73,13,17,164,107,91
2020,19,44,"Samandag",36.0871,35.9685,27.4714285714286,19.6428571428571,1.578,65.7142857142857,27.8533333333333,8.89,137,22,6,25,32,157,115,151
2020,20,44,"Samandag",36.0871,35.9685,18.6142857142857,24.8714285714286,0,51.7714285714286,30.1533333333333,9.03,164,8,3,64,42,164,156,161
2020,21,44,"Samandag",36.0871,35.9685,27.4142857142857,26.3142857142857,2.34885714285714,46.3571428571429,27.3333333333333,6.75857142857143,146,11,9,45,31,96,135,87
2020,22,44,"Samandag",36.0871,35.9685,26.5857142857143,21.7428571428571,0.0368571428571429,54.9714285714286,NA,7.59714285714286,118,12,7,31,26,100,106,93
2020,23,44,"Samandag",36.0871,35.9685,25.0857142857143,23.5857142857143,0.0184285714285714,55,NA,10.9171428571429,112,15,6,26,15,70,97,64
2020,24,44,"Samandag",36.0871,35.9685,29.2714285714286,24.3,0,61.9714285714286,NA,12.5957142857143,140,32,27,8,6,150,108,123
2020,25,44,"Samandag",36.0871,35.9685,29.4857142857143,24.8428571428571,2.80885714285714,64.9428571428571,NA,11.2185714285714,137,23,15,16,28,108,114,93
2020,26,44,"Samandag",36.0871,35.9685,29.2714285714286,25.8,0,65.2,NA,7.66428571428571,173,42,23,17,9,133,131,110
2020,27,44,"Samandag",36.0871,35.9685,30.2142857142857,27.6857142857143,0,66.7285714285714,27.68,9.8,113,22,10,16,14,113,91,103
2020,28,44,"Samandag",36.0871,35.9685,31.2571428571429,28.0142857142857,0.0142857142857143,68.2285714285714,55.74,6.2925,164,29,30,9,5,122,135,92
2020,29,44,"Samandag",36.0871,35.9685,29.2571428571429,28.2285714285714,0.0184285714285714,67.8714285714286,29.7471428571429,6.30857142857143,186,30,23,18,36,111,156,88
2020,30,44,"Samandag",36.0871,35.9685,28.7,29,0,66.9285714285714,28.3914285714286,7.91857142857143,190,36,30,13,20,142,154,112
2020,31,44,"Samandag",36.0871,35.9685,28.5857142857143,29.5428571428571,0,66.2142857142857,27.3214285714286,6.76714285714286,150,33,41,16,16,127,117,86
2020,32,44,"Samandag",36.0871,35.9685,29.8857142857143,29.3714285714286,1.33657142857143,64.8285714285714,31.6042857142857,9.05714285714286,146,28,20,8,4,107,118,87
2020,33,44,"Samandag",36.0871,35.9685,28.6285714285714,29.0571428571429,0.3,58.2428571428571,27.6414285714286,8.51,183,20,16,19,15,83,163,67
2020,34,44,"Samandag",36.0871,35.9685,27.2285714285714,28.8285714285714,0.0285714285714286,56.8428571428571,25.9742857142857,9.82571428571429,197,26,20,38,15,97,171,77
2020,35,44,"Samandag",36.0871,35.9685,22.9285714285714,28.5142857142857,15.2197142857143,63.8857142857143,29.4871428571429,13.6357142857143,164,16,17,16,11,157,148,140
2020,36,44,"Samandag",36.0871,35.9685,21.7714285714286,29.4,0.0184285714285714,63.9142857142857,27.93,13.5871428571429,179,11,24,19,18,112,168,88
2020,37,44,"Samandag",36.0871,35.9685,21.7,28.6285714285714,0,64.8428571428571,15.3071428571429,10.1342857142857,193,20,7,29,15,91,173,84
2020,38,44,"Samandag",36.0871,35.9685,24.6714285714286,27.9571428571429,0,68.6571428571429,27.1666666666667,12.68,235,47,21,11,6,157,188,136
2020,39,44,"Samandag",36.0871,35.9685,24.2571428571429,27.3571428571429,1.05071428571429,64.2571428571429,25.7171428571429,12.5985714285714,220,46,41,18,10,129,174,88
2020,40,44,"Samandag",36.0871,35.9685,24.7571428571429,26.5285714285714,0,62.8857142857143,27.2614285714286,20.03,187,8,2,27,33,154,179,152
2020,41,44,"Samandag",36.0871,35.9685,16.6,25.0857142857143,0,47.3714285714286,24.8885714285714,23.3528571428571,182,29,10,22,11,127,153,117
2020,42,44,"Samandag",36.0871,35.9685,21.1,24.0857142857143,0,67.5,29.22,27.5971428571429,177,24,21,17,13,111,153,90
2020,43,44,"Samandag",36.0871,35.9685,15.4571428571429,23.3857142857143,0,56.9714285714286,26.565,27.68,194,6,4,61,30,161,188,157
2020,44,44,"Samandag",36.0871,35.9685,14.0285714285714,22.4714285714286,0,52.2714285714286,29.2557142857143,28.9228571428571,255,3,3,57,91,233,252,230
2020,45,44,"Samandag",36.0871,35.9685,12.8571428571429,17.7,7.11785714285714,78.0428571428571,26.9683333333333,29.08,156,9,6,56,40,103,147,97
2020,46,44,"Samandag",36.0871,35.9685,9.74285714285714,16.2857142857143,0.152,66.8714285714286,30.295,38.9457142857143,208,1,0,118,75,109,207,109
2020,47,44,"Samandag",36.0871,35.9685,14.8857142857143,13.7,0.857142857142857,71.4142857142857,38.5771428571429,42.7885714285714,173,2,1,75,35,83,171,82
2020,48,44,"Samandag",36.0871,35.9685,17.1428571428571,11.9142857142857,0.419428571428571,70.4285714285714,55.91,40.7028571428571,199,2,1,86,86,262,197,261
2020,49,44,"Samandag",36.0871,35.9685,15.0428571428571,13.1571428571429,1.44228571428571,72.5714285714286,39.3542857142857,25.5557142857143,207,2,4,84,36,116,205,112
2020,50,44,"Samandag",36.0871,35.9685,15.2857142857143,12.1142857142857,1.20142857142857,74.4,26.626,22.276,181,12,9,44,33,98,169,89
2020,51,44,"Samandag",36.0871,35.9685,18.0714285714286,12.7142857142857,9.973,83.9,396.99,25.0628571428571,171,19,9,31,13,90,152,81
2020,52,44,"Samandag",36.0871,35.9685,14.8714285714286,9.6,0.852571428571429,66.2142857142857,638.615,33.89,203,11,7,56,41,113,192,106
2020,53,44,"Samandag",36.0871,35.9685,11.5,9.45,0,64.825,NA,38.68,122,3,5,30,8,111,119,106
2017,1,45,"Igdir",39.9237,44.045,5.58571428571429,-8.82857142857143,0.0285714285714286,80.5,90.5642857142857,33.8057142857143,563,77,127,226,357,847,486,720
2017,2,45,"Igdir",39.9237,44.045,5.91428571428571,-8.95714285714286,0.0571428571428571,83.6,134.081428571429,45.2685714285714,757,0,0,670,1099,1214,757,1214
2017,3,45,"Igdir",39.9237,44.045,4.11428571428571,-9.27142857142857,0.114285714285714,85.7142857142857,218.971428571429,56.4157142857143,762,109,196,334,464,1449,653,1253
2017,4,45,"Igdir",39.9237,44.045,6.48571428571429,-7.85714285714286,1.95714285714286,82.5571428571428,135.634285714286,49.2471428571429,639,108,170,233,276,889,531,719
2017,5,45,"Igdir",39.9237,44.045,6.75714285714286,-9.52857142857143,0.128714285714286,71.8142857142857,176.785714285714,55.05,588,423,875,53,124,1163,165,288
2017,6,45,"Igdir",39.9237,44.045,4.62857142857143,-5.92857142857143,0.1,77.3714285714286,253.76,75.4385714285714,736,628,1285,0,0,1519,108,234
2017,7,45,"Igdir",39.9237,44.045,6.4,-7.71428571428571,0.7,71.3142857142857,107.931428571429,48.4914285714286,492,146,147,199,391,717,346,570
2017,8,45,"Igdir",39.9237,44.045,5.94285714285714,-7.98571428571429,0.0428571428571429,77.7714285714286,179.048571428571,60.174,739,730,1705,0,0,1747,9,42
2017,9,45,"Igdir",39.9237,44.045,3.94285714285714,-0.771428571428571,0.0714285714285714,84.2857142857143,144.1375,57.382,574,373,564,0,0,866,201,302
2017,10,45,"Igdir",39.9237,44.045,8.45714285714286,6.48571428571429,0.0287142857142857,65.8857142857143,135.4,43.0314285714286,712,185,300,0,0,1043,527,743
2017,11,45,"Igdir",39.9237,44.045,11.7571428571429,7.38571428571429,0.915142857142857,63.4142857142857,83.6342857142857,30.22,525,185,215,58,60,725,340,510
2017,12,45,"Igdir",39.9237,44.045,18.9,7.47142857142857,0.185714285714286,46.0142857142857,97.6128571428571,26.5542857142857,589,331,529,82,166,1077,258,548
2017,13,45,"Igdir",39.9237,44.045,17.2571428571429,10.0571428571429,1.31385714285714,53.4428571428571,82.224,28.1985714285714,574,69,88,159,266,887,505,799
2017,14,45,"Igdir",39.9237,44.045,15.4428571428571,11.7285714285714,0.171714285714286,45.5571428571429,87.9142857142857,25.9771428571429,639,370,858,214,397,1336,269,478
2017,15,45,"Igdir",39.9237,44.045,19.6,11.5571428571429,0.371714285714286,50.4571428571429,62.3571428571429,21.875,587,93,243,182,254,1187,494,944
2017,16,45,"Igdir",39.9237,44.045,16.8142857142857,16.5142857142857,0.0714285714285714,42.9714285714286,78.4714285714286,25.8771428571429,717,289,446,94,152,920,428,474
2017,17,45,"Igdir",39.9237,44.045,20.2571428571429,14.0857142857143,12.4632857142857,42.3714285714286,68.7242857142857,16.4985714285714,731,427,986,0,0,1478,304,492
2017,18,45,"Igdir",39.9237,44.045,15.2857142857143,16.7714285714286,0.656857142857143,60.3428571428571,49.9,15.6157142857143,506,143,268,87,184,923,363,655
2017,19,45,"Igdir",39.9237,44.045,21.3,19.4857142857143,0.857142857142857,46.2142857142857,67.426,13.546,471,81,163,110,165,966,390,803
2017,20,45,"Igdir",39.9237,44.045,20.2857142857143,18.2428571428571,2.39957142857143,55.0571428571429,53.6366666666667,16.7333333333333,472,68,193,55,43,1205,404,1012
2017,21,45,"Igdir",39.9237,44.045,16.0142857142857,17.7,2.76942857142857,56.0142857142857,52.4575,14.2125,448,227,444,0,0,849,221,405
2017,22,45,"Igdir",39.9237,44.045,17.8142857142857,21.1571428571429,0.114285714285714,41.1714285714286,64.37,14.3375,522,229,502,0,0,1015,293,513
2017,23,45,"Igdir",39.9237,44.045,21.0428571428571,25.2714285714286,0.357,41.2428571428571,73.3228571428571,13.5571428571429,578,238,516,45,178,1388,340,872
2017,24,45,"Igdir",39.9237,44.045,20.0142857142857,22.4857142857143,0.143,44.5285714285714,55.69,19.1114285714286,552,142,272,2,1,1139,410,867
2017,25,45,"Igdir",39.9237,44.045,21.7857142857143,23.5714285714286,0.471428571428571,42.0857142857143,46.6066666666667,19.9,584,93,145,23,49,1041,491,896
2017,26,45,"Igdir",39.9237,44.045,27.3142857142857,27.6142857142857,0.2,38.9714285714286,81.0442857142857,17.69,564,337,567,0,0,971,227,404
2017,27,45,"Igdir",39.9237,44.045,22.1714285714286,27.6,0.328428571428571,41.8285714285714,140.146666666667,17.6514285714286,511,177,284,0,0,642,334,358
2017,28,45,"Igdir",39.9237,44.045,27.0142857142857,26.3,0.328571428571429,42.5,77.2616666666667,13.0985714285714,481,314,519,0,0,864,167,345
2017,29,45,"Igdir",39.9237,44.045,24.6857142857143,29.8857142857143,0,33.3428571428571,121.538333333333,15.1366666666667,532,357,806,0,0,1272,175,466
2017,30,45,"Igdir",39.9237,44.045,20.1,29.0571428571429,0,37.8714285714286,120.857142857143,13.7114285714286,531,186,259,0,0,928,345,669
2017,31,45,"Igdir",39.9237,44.045,24.1571428571429,30.1428571428571,0,37.0142857142857,127.121428571429,18.8057142857143,559,402,638,0,0,1047,157,409
2017,32,45,"Igdir",39.9237,44.045,23.4571428571429,30.7571428571429,0,32,157.548571428571,16.5842857142857,567,543,1007,0,0,1092,24,85
2017,33,45,"Igdir",39.9237,44.045,23.0857142857143,26,1.38542857142857,51.3285714285714,97.0742857142857,13.7842857142857,596,490,950,0,0,1199,106,249
2017,34,45,"Igdir",39.9237,44.045,23.6285714285714,27.7428571428571,0,37.5857142857143,130.55,14.0171428571429,601,377,854,0,0,1280,224,426
2017,35,45,"Igdir",39.9237,44.045,18.1857142857143,27.2285714285714,0,34.2571428571429,161.181666666667,18.03,493,253,307,0,0,1014,240,707
2017,36,45,"Igdir",39.9237,44.045,18.1428571428571,24.5857142857143,0.0142857142857143,35.1857142857143,170.404,20.9485714285714,507,47,65,62,148,1321,460,1256
2017,37,45,"Igdir",39.9237,44.045,19.7571428571429,25.7,0.0142857142857143,36.2142857142857,174.657142857143,20.97,589,217,276,0,0,1138,372,862
2017,38,45,"Igdir",39.9237,44.045,17.3,24.8142857142857,0.0857142857142857,35.0285714285714,180.312857142857,18.9228571428571,671,643,1202,0,0,1312,28,110
2017,39,45,"Igdir",39.9237,44.045,16.9571428571429,18.8714285714286,0.228428571428571,51.0142857142857,82.42,16.6233333333333,782,378,817,1,0,1630,404,813
2017,40,45,"Igdir",39.9237,44.045,11.0857142857143,12.6285714285714,1.45657142857143,64.4571428571429,96.135,17.5,543,204,383,104,205,1137,339,754
2017,41,45,"Igdir",39.9237,44.045,13.0428571428571,14.8428571428571,1.18614285714286,59.0428571428571,81.02,20.005,487,73,49,147,448,843,414,794
2017,42,45,"Igdir",39.9237,44.045,16.2857142857143,11.4,0.142857142857143,54.2285714285714,223.87,24.115,530,0,0,107,153,815,530,815
2017,43,45,"Igdir",39.9237,44.045,11.1142857142857,12.2285714285714,1.94285714285714,59.5428571428571,212.2,33.1625,506,83,187,76,175,919,423,732
2017,44,45,"Igdir",39.9237,44.045,12.6142857142857,9.67142857142857,0.500142857142857,65.6428571428571,102.768333333333,25.9625,561,421,915,128,164,1102,140,187
2017,45,45,"Igdir",39.9237,44.045,5.58571428571429,10.0857142857143,4.11585714285714,86.3571428571429,178.787142857143,26.9583333333333,577,253,304,0,0,829,324,525
2017,46,45,"Igdir",39.9237,44.045,6.18571428571429,7.5,0,75.4428571428572,253.788333333333,29.9071428571429,587,511,844,0,0,1085,76,241
2017,47,45,"Igdir",39.9237,44.045,11.5571428571429,4.12857142857143,1.15742857142857,69.8,137.487142857143,30.3033333333333,418,248,562,57,108,804,170,242
2017,48,45,"Igdir",39.9237,44.045,6.82857142857143,2.91428571428571,0.175714285714286,72.0714285714286,241.9875,34.1985714285714,386,175,277,44,59,619,211,342
2017,49,45,"Igdir",39.9237,44.045,8.41428571428571,0.871428571428571,0.143,74.7142857142857,200.487142857143,37.12,407,276,431,68,89,645,131,214
2017,50,45,"Igdir",39.9237,44.045,4.2,-0.685714285714286,0,74.4285714285714,NA,39.8542857142857,346,28,19,0,0,442,318,423
2017,51,45,"Igdir",39.9237,44.045,8,2.82857142857143,0.629428571428571,86.4,176.0725,49.4085714285714,386,230,196,0,0,349,156,153
2017,52,45,"Igdir",39.9237,44.045,6.5,2.2625,0.1125,70.325,176.658571428571,50.18125,528,200,179,76,47,507,328,328
2018,1,45,"Igdir",39.9237,44.045,7.025,2.8375,1.15675,77.2875,156.39,52.3825,618,190,304,44,89,914,428,610
2018,2,45,"Igdir",39.9237,44.045,7.71428571428571,1.24285714285714,11.2822857142857,74.3857142857143,256.554285714286,41.4171428571429,624,260,312,99,199,1309,364,997
2018,3,45,"Igdir",39.9237,44.045,8.5,2.5,0.328571428571429,75.8,154.628571428571,44.6057142857143,639,381,334,0,0,655,258,321
2018,4,45,"Igdir",39.9237,44.045,5.6,2.54285714285714,0.942714285714286,79.5285714285714,200.305714285714,46.3257142857143,604,157,214,82,111,764,447,550
2018,5,45,"Igdir",39.9237,44.045,9.14285714285714,1.21428571428571,0.0857142857142857,54.8142857142857,154.481428571429,44.6628571428571,670,98,100,190,209,819,572,719
2018,6,45,"Igdir",39.9237,44.045,6.1,4.91428571428571,0,58.3571428571429,239.981428571429,55.19,704,393,609,165,226,1022,311,413
2018,7,45,"Igdir",39.9237,44.045,10.7571428571429,6.91428571428571,3.40028571428571,62.4714285714286,144.235714285714,47.3971428571429,478,188,229,90,119,557,290,328
2018,8,45,"Igdir",39.9237,44.045,8.4,6.35714285714286,1.38557142857143,68.7428571428571,129.367142857143,40.7471428571429,711,626,1219,0,0,1321,85,102
2018,9,45,"Igdir",39.9237,44.045,11.8571428571429,7.62857142857143,0.228714285714286,60.7714285714286,140.611428571429,46.1728571428571,621,373,557,135,222,956,248,399
2018,10,45,"Igdir",39.9237,44.045,10.1714285714286,9.8,1.25771428571429,63.7285714285714,82.8271428571429,44.6285714285714,556,301,741,55,174,1330,255,589
2018,11,45,"Igdir",39.9237,44.045,10.4142857142857,10.1285714285714,0.0572857142857143,58.7857142857143,96.202,41.4242857142857,551,365,871,2,14,1426,186,555
2018,12,45,"Igdir",39.9237,44.045,22.2571428571429,14.2571428571429,0.0717142857142857,45.5428571428571,192.094285714286,52.1,425,112,323,147,484,1187,313,864
2018,13,45,"Igdir",39.9237,44.045,21.2428571428571,14.3142857142857,0.614857142857143,48.9285714285714,94.0828571428572,41.9742857142857,356,99,101,67,111,428,257,327
2018,14,45,"Igdir",39.9237,44.045,15.9571428571429,12.4571428571429,0.271428571428571,44.6142857142857,89.6757142857143,39.9,407,270,238,2,16,486,137,248
2018,15,45,"Igdir",39.9237,44.045,16.5857142857143,15.0428571428571,0.100142857142857,46.8571428571429,81.1742857142857,45.7642857142857,374,206,303,22,39,450,168,147
2018,16,45,"Igdir",39.9237,44.045,18.8,12.3428571428571,1.91414285714286,50.4714285714286,77.3785714285714,38.3185714285714,411,171,261,0,0,648,240,387
2018,17,45,"Igdir",39.9237,44.045,15.5714285714286,16.4,0.371857142857143,50.1857142857143,64.6942857142857,43.3071428571429,419,230,427,128,126,652,189,225
2018,18,45,"Igdir",39.9237,44.045,13.4857142857143,18.6,0.742857142857143,54.1714285714286,69.7285714285714,29.7571428571429,303,303,474,0,0,474,0,0
2018,19,45,"Igdir",39.9237,44.045,10.2,15.7428571428571,3.91657142857143,74.2571428571429,48.1557142857143,26.8742857142857,275,137,231,2,0,467,138,236
2018,20,45,"Igdir",39.9237,44.045,13.7,18.7714285714286,0.214285714285714,57.4857142857143,55.4414285714286,27.6828571428571,204,122,226,24,35,306,82,80
2018,21,45,"Igdir",39.9237,44.045,14.3857142857143,19.7571428571429,1.81485714285714,63.9428571428571,58.4557142857143,22.2685714285714,252,45,60,40,30,281,207,221
2018,22,45,"Igdir",39.9237,44.045,14.4571428571429,19.2857142857143,3.88557142857143,67.5571428571429,51.2328571428571,31.54,249,50,101,11,37,427,199,326
2018,23,45,"Igdir",39.9237,44.045,18.1,21.2142857142857,27.4447142857143,56.5571428571429,46.77,41.6014285714286,267,85,271,28,78,812,182,541
2018,24,45,"Igdir",39.9237,44.045,18.0285714285714,22.1857142857143,0.971714285714286,56.1285714285714,65.1028571428571,18.7185714285714,267,209,411,29,21,448,58,37
2018,25,45,"Igdir",39.9237,44.045,18.7428571428571,23.7714285714286,0.299857142857143,48.2857142857143,61.5542857142857,18.9785714285714,358,4,5,0,0,518,354,513
2018,26,45,"Igdir",39.9237,44.045,25.7,29.5,0.114285714285714,38.1571428571429,96.5871428571429,14.766,355,215,314,0,0,587,140,273
2018,27,45,"Igdir",39.9237,44.045,25.7142857142857,30.3571428571429,0,35.8571428571429,119.165714285714,NA,342,179,216,0,0,418,163,202
2018,28,45,"Igdir",39.9237,44.045,25.8571428571429,30.5714285714286,0.0285714285714286,41.4285714285714,105.481428571429,13.172,286,158,279,0,0,585,128,306
2018,29,45,"Igdir",39.9237,44.045,26.1714285714286,26.4285714285714,0.671142857142857,44.3571428571429,63.7657142857143,11.53,260,98,152,0,0,756,162,604
2018,30,45,"Igdir",39.9237,44.045,26,29.5,0.000142857142857143,41.3571428571429,119.334285714286,13.8171428571429,265,108,229,0,0,822,157,593
2018,31,45,"Igdir",39.9237,44.045,26.0571428571429,27.9,0.214428571428571,45.6285714285714,96.0442857142857,12.6242857142857,267,105,269,0,0,499,162,230
2018,32,45,"Igdir",39.9237,44.045,27.1285714285714,27.1571428571429,0.029,46.2142857142857,62.9442857142857,10.396,297,36,47,0,0,403,261,356
2018,33,45,"Igdir",39.9237,44.045,27.7857142857143,25.9714285714286,0.543428571428571,44.8142857142857,81.9242857142857,13.04,216,132,236,0,0,332,84,96
2018,34,45,"Igdir",39.9237,44.045,20.8857142857143,25.5,0.0571428571428571,48.5142857142857,80.2828571428571,14.9257142857143,144,120,179,0,0,227,24,48
2018,35,45,"Igdir",39.9237,44.045,28.6,26.7857142857143,0,41.6142857142857,126.365714285714,14.6342857142857,201,160,222,0,0,314,41,92
2018,36,45,"Igdir",39.9237,44.045,20.1285714285714,24.1714285714286,0.1,43.3571428571429,128.22,22.1083333333333,341,223,231,0,0,370,118,139
2018,37,45,"Igdir",39.9237,44.045,14.7714285714286,23.6285714285714,0,43.4428571428571,99.3028571428571,21.6142857142857,241,64,89,3,10,419,177,330
2018,38,45,"Igdir",39.9237,44.045,21.1714285714286,20.7,0.942714285714286,48.1142857142857,67.9728571428571,17.6857142857143,189,113,132,0,0,344,76,212
2018,39,45,"Igdir",39.9237,44.045,19.4,21.1571428571429,0,47.7142857142857,90.9885714285714,20.6671428571429,180,98,125,0,0,353,82,228
2018,40,45,"Igdir",39.9237,44.045,14.6571428571429,18.6142857142857,0.0857142857142857,45.6571428571429,89.7228571428571,18.3814285714286,191,44,43,0,0,341,147,298
2018,41,45,"Igdir",39.9237,44.045,11.7857142857143,16.9428571428571,0.128571428571429,59.1714285714286,135.021428571429,25.4657142857143,187,150,305,14,88,422,37,117
2018,42,45,"Igdir",39.9237,44.045,10.0714285714286,15.6428571428571,0.0714285714285714,51.8,187.501428571429,46.7766666666667,168,103,155,6,1,381,65,226
2018,43,45,"Igdir",39.9237,44.045,12.1571428571429,12.1,2.68685714285714,75.9571428571429,78.8042857142857,20.0183333333333,187,15,91,66,193,402,172,311
2018,44,45,"Igdir",39.9237,44.045,7.95714285714286,9.61428571428571,0,67.3142857142857,215.357142857143,34.9557142857143,196,114,192,27,32,264,82,72
2018,45,45,"Igdir",39.9237,44.045,4.91428571428571,7.1,2.742,84.7857142857143,203.464285714286,28.814,231,152,244,0,0,473,79,229
2018,46,45,"Igdir",39.9237,44.045,8.9,7.2,0.757142857142857,77.1571428571429,222.552857142857,33.9433333333333,230,112,267,0,0,465,118,198
2018,47,45,"Igdir",39.9237,44.045,5.91428571428571,6.01428571428571,0.471428571428571,77.2571428571429,226.727142857143,43.068,270,185,255,27,58,499,85,244
2018,48,45,"Igdir",39.9237,44.045,6.14285714285714,6.21428571428571,2.44285714285714,84.5,213.321428571429,37.2333333333333,245,62,24,22,8,201,183,177
2018,49,45,"Igdir",39.9237,44.045,4.64285714285714,5.34285714285714,0.157857142857143,87.3571428571429,182.254285714286,29.426,257,194,279,36,39,420,63,141
2018,50,45,"Igdir",39.9237,44.045,8.07142857142857,3.22857142857143,0.757571428571428,80.0285714285714,102.582,46.5825,256,105,115,33,52,305,151,190
2018,51,45,"Igdir",39.9237,44.045,4.25714285714286,3.27142857142857,0,83.6714285714286,194.273333333333,48.4814285714286,250,116,94,28,3,248,134,154
2018,52,45,"Igdir",39.9237,44.045,7.14285714285714,1.91428571428571,1.47171428571429,76.9714285714286,119.393333333333,42.295,244,88,126,57,63,273,156,147
2019,1,45,"Igdir",39.9237,44.045,6.7375,0.65,0.0625,79.85,212.988,51.9325,343,141,429,1,1,784,202,355
2019,2,45,"Igdir",39.9237,44.045,14.0857142857143,0.142857142857143,0.942571428571429,59.4571428571429,105.383333333333,38.18,255,42,27,74,75,208,213,181
2019,3,45,"Igdir",39.9237,44.045,9.27142857142857,-0.214285714285714,0.259428571428571,69.6571428571429,163.47,52.012,192,64,42,29,23,198,128,156
2019,4,45,"Igdir",39.9237,44.045,4.41428571428571,-0.114285714285714,0.0571428571428571,68.9142857142857,324.254285714286,61.7471428571429,308,46,86,88,79,314,262,228
2019,5,45,"Igdir",39.9237,44.045,7.97142857142857,3.3,2.84314285714286,73.2714285714286,188.618571428571,55.604,253,64,29,44,44,143,189,114
2019,6,45,"Igdir",39.9237,44.045,7.41428571428571,2.14285714285714,0.471428571428571,71.6428571428571,164.507142857143,47.1828571428571,276,181,84,0,0,127,95,43
2019,7,45,"Igdir",39.9237,44.045,9.5,3.04285714285714,0.457142857142857,66.1285714285714,103.47,NA,325,68,27,73,62,234,257,207
2019,8,45,"Igdir",39.9237,44.045,14.1,3.4,0,47.9285714285714,99.1685714285714,32.52,305,81,42,43,58,219,224,177
2019,9,45,"Igdir",39.9237,44.045,13.6571428571429,3.61428571428571,1.62942857142857,63.6571428571429,59.34,NA,331,56,29,143,195,310,275,281
2019,10,45,"Igdir",39.9237,44.045,11.4571428571429,5.34285714285714,0.314142857142857,64.3142857142857,87.7771428571428,27.9825,359,250,191,48,36,252,109,61
2019,11,45,"Igdir",39.9237,44.045,12.4857142857143,8.35714285714286,1.02885714285714,62.1,94.5285714285714,12.31,373,113,175,126,115,400,260,225
2019,12,45,"Igdir",39.9237,44.045,12.8428571428571,6.41428571428571,0.0287142857142857,54.4714285714286,67.7866666666667,12.2214285714286,343,47,14,90,302,416,296,402
2019,13,45,"Igdir",39.9237,44.045,10.5571428571429,6.24285714285714,1.70014285714286,74.6714285714286,62.275,15.8571428571429,256,26,22,79,95,194,230,172
2019,14,45,"Igdir",39.9237,44.045,12.1428571428571,9.51428571428571,1.25742857142857,68.8428571428571,62.87,17.11,365,166,105,67,36,208,199,103
2019,15,45,"Igdir",39.9237,44.045,13.6142857142857,13.6714285714286,0.385714285714286,50.2571428571429,65.2428571428571,15.0225,359,139,48,75,52,183,220,135
2019,16,45,"Igdir",39.9237,44.045,19.1142857142857,11.9571428571429,1.18714285714286,59.8,53.6628571428571,11.7985714285714,318,254,166,10,11,208,64,42
2019,17,45,"Igdir",39.9237,44.045,15.5428571428571,11.4142857142857,0.385714285714286,47.7571428571429,51.5414285714286,16.174,412,236,177,1,1,313,176,136
2019,18,45,"Igdir",39.9237,44.045,16.7571428571429,15.8857142857143,2.47228571428571,60.2428571428571,51.7071428571429,12.0233333333333,523,297,252,1,0,353,226,101
2019,19,45,"Igdir",39.9237,44.045,13.3285714285714,17.9,0.3,55.8,58.0257142857143,10.66,452,310,264,45,24,386,142,122
2019,20,45,"Igdir",39.9237,44.045,19.1285714285714,21.9714285714286,0.0714285714285714,37.7142857142857,85.72,15.3657142857143,454,223,190,0,0,389,231,199
2019,21,45,"Igdir",39.9237,44.045,17.8571428571429,19.5571428571429,15.4142857142857,58.1285714285714,55.7557142857143,10.9033333333333,457,149,105,2,2,413,308,308
2019,22,45,"Igdir",39.9237,44.045,19.4285714285714,23,0,36.7428571428571,65.0057142857143,NA,453,368,260,0,0,323,85,63
2019,23,45,"Igdir",39.9237,44.045,17.6428571428571,26.3,0.0285714285714286,39.0285714285714,89.0985714285714,NA,378,317,398,0,0,532,61,134
2019,24,45,"Igdir",39.9237,44.045,17.2,24.2714285714286,0.385714285714286,45.9571428571429,68.7328571428571,11.77,378,366,234,0,0,244,12,10
2019,25,45,"Igdir",39.9237,44.045,22.2571428571429,25.6285714285714,1.34214285714286,42.7,64.9642857142857,11.07,306,219,168,0,0,325,87,157
2019,26,45,"Igdir",39.9237,44.045,19.5,26.6428571428571,0.800714285714286,45.0714285714286,62.2028571428571,11.3216666666667,377,84,69,2,1,342,293,273
2019,27,45,"Igdir",39.9237,44.045,22.4714285714286,24.1857142857143,0.0142857142857143,39.2,54.0216666666667,8.904,456,190,50,0,0,222,266,172
2019,28,45,"Igdir",39.9237,44.045,21.3285714285714,26.4142857142857,0.0142857142857143,39.9428571428571,71.5771428571429,9.82166666666667,398,216,237,0,0,421,182,184
2019,29,45,"Igdir",39.9237,44.045,24.4857142857143,28.5714285714286,0,38.2428571428571,98.7471428571429,11.3114285714286,453,359,120,0,0,203,94,83
2019,30,45,"Igdir",39.9237,44.045,26.8571428571429,28.9428571428571,0,37.6142857142857,90.4366666666667,7.69666666666667,456,359,267,0,0,335,97,68
2019,31,45,"Igdir",39.9237,44.045,23.8571428571429,28.9857142857143,0,36.1,99.67,9.99142857142857,334,283,325,0,0,375,51,50
2019,32,45,"Igdir",39.9237,44.045,24.6571428571429,25.7,0,37.9857142857143,82.5514285714286,7.28,346,207,228,0,0,395,139,167
2019,33,45,"Igdir",39.9237,44.045,23.6142857142857,28.1285714285714,0.0428571428571429,39.7857142857143,105.091428571429,15.5385714285714,337,292,506,0,0,531,45,25
2019,34,45,"Igdir",39.9237,44.045,20.7857142857143,28.3428571428571,0,30.7428571428571,139.022857142857,20.7733333333333,299,255,299,0,0,345,44,46
2019,35,45,"Igdir",39.9237,44.045,19.7285714285714,24.8714285714286,0.100285714285714,42.8,65.9342857142857,10.7385714285714,307,131,150,0,0,415,176,265
2019,36,45,"Igdir",39.9237,44.045,20.4,21.8428571428571,1.10042857142857,55.7857142857143,53.9166666666667,13.7966666666667,171,95,25,0,0,67,76,42
2019,37,45,"Igdir",39.9237,44.045,17.6571428571429,18.3571428571429,0.279142857142857,56.4571428571429,50.15,16.2171428571429,218,183,41,0,0,55,35,14
2019,38,45,"Igdir",39.9237,44.045,21.3285714285714,20.9285714285714,0,42.2428571428571,86.8757142857143,22.0914285714286,266,82,28,27,5,91,184,63
2019,39,45,"Igdir",39.9237,44.045,15.3,19.1285714285714,0.428428571428571,44.8714285714286,96.2842857142857,22.3471428571429,237,44,10,33,9,79,193,69
2019,40,45,"Igdir",39.9237,44.045,19.4714285714286,19.9571428571429,0,46.1428571428571,106.674285714286,26.4314285714286,241,0,0,22,13,111,241,111
2019,41,45,"Igdir",39.9237,44.045,17.0571428571429,18.0714285714286,0,47.4714285714286,118.207142857143,25.8842857142857,416,133,142,2,1,448,283,306
2019,42,45,"Igdir",39.9237,44.045,12.2,15.0428571428571,0.0857142857142857,44.1142857142857,199.404285714286,37.8371428571429,356,61,43,136,184,408,295,365
2019,43,45,"Igdir",39.9237,44.045,13.1428571428571,13.2571428571429,0.642714285714286,67.2,131.591428571429,29.6416666666667,306,4,5,158,195,300,302,295
2019,44,45,"Igdir",39.9237,44.045,12.6142857142857,11.0142857142857,1.69342857142857,58.8428571428571,124.907142857143,29.1014285714286,350,161,119,83,78,250,189,131
2019,45,45,"Igdir",39.9237,44.045,5.7,6.62857142857143,0,66.0571428571428,209.925714285714,46.9528571428571,417,304,212,0,0,328,113,116
2019,46,45,"Igdir",39.9237,44.045,7.48571428571429,4.51428571428571,0,60.4142857142857,284.14,54.71,401,370,311,0,0,337,31,26
2019,47,45,"Igdir",39.9237,44.045,9.45714285714286,0.971428571428571,0,63.5142857142857,269.075714285714,51.3542857142857,391,217,196,52,54,339,174,143
2019,48,45,"Igdir",39.9237,44.045,5.8,3.11428571428571,1.447,82.5714285714286,267.088571428571,46.1985714285714,320,169,102,38,52,251,151,149
2019,49,45,"Igdir",39.9237,44.045,7.82857142857143,4.11428571428571,0.700428571428571,78.6857142857143,91.8328571428571,26.4828571428571,393,99,70,195,166,274,294,204
2019,50,45,"Igdir",39.9237,44.045,4.28571428571429,2.77142857142857,0.0285714285714286,86.5142857142857,144.344285714286,33.0371428571429,218,114,34,16,17,119,104,85
2019,51,45,"Igdir",39.9237,44.045,7.92857142857143,2.3,0,73.4857142857143,272.967142857143,49.25,361,135,299,188,166,488,226,189
2019,52,45,"Igdir",39.9237,44.045,8.12857142857143,3.21428571428571,0.171571428571429,76.2142857142857,256.448571428571,45.5457142857143,279,105,78,9,25,281,174,203
2020,1,45,"Igdir",39.9237,44.045,7.6,0.58,0.54,80.62,152.438,38.7675,160,0,0,10,6,126,160,126
2020,2,45,"Igdir",39.9237,44.045,7.61428571428571,0.414285714285714,0.0285714285714286,68.7714285714286,123.577142857143,39.195,240,62,34,13,19,173,178,139
2020,3,45,"Igdir",39.9237,44.045,8.45714285714286,-1.95714285714286,0.628714285714286,70.3,133.651428571429,44.9342857142857,270,74,165,89,98,382,196,217
2020,4,45,"Igdir",39.9237,44.045,10.0714285714286,-0.971428571428571,0.185714285714286,59.6285714285714,102.558571428571,37.1057142857143,358,97,97,159,157,295,261,198
2020,5,45,"Igdir",39.9237,44.045,10.0285714285714,0.271428571428572,1.89942857142857,61.7857142857143,188.173333333333,47.62,331,235,208,49,21,272,96,64
2020,6,45,"Igdir",39.9237,44.045,13.5857142857143,2.42857142857143,0.138857142857143,65.4285714285714,95.9228571428571,31.6285714285714,343,166,119,11,10,267,177,148
2020,7,45,"Igdir",39.9237,44.045,12.2428571428571,-2.64285714285714,0.000142857142857143,52.6714285714286,68.3471428571429,31.9566666666667,341,196,138,2,0,338,145,200
2020,8,45,"Igdir",39.9237,44.045,4.3,3.71428571428571,0.171571428571429,78.5857142857143,120.298571428571,35.8728571428571,283,105,91,47,23,187,178,96
2020,9,45,"Igdir",39.9237,44.045,11.3714285714286,4.42857142857143,0.885571428571428,61.3428571428571,103.381428571429,38.2157142857143,393,102,95,54,44,528,291,433
2020,10,45,"Igdir",39.9237,44.045,12.9,9.11428571428571,0.0857142857142857,48.4714285714286,110.325714285714,38.3657142857143,205,114,122,39,27,210,91,88
2020,11,45,"Igdir",39.9237,44.045,13.5571428571429,12.7428571428571,0.314571428571429,49.7428571428571,89.0314285714286,28.6671428571429,115,63,46,18,33,94,52,48
2020,12,45,"Igdir",39.9237,44.045,12.8857142857143,8.38571428571429,2.157,70.0571428571428,43.9771428571429,19.5957142857143,117,48,32,42,62,118,69,86
2020,13,45,"Igdir",39.9237,44.045,19.4714285714286,12.4285714285714,2.75685714285714,49.3571428571429,63.78,20.5328571428571,136,131,91,0,0,92,5,1
2020,14,45,"Igdir",39.9237,44.045,15.7714285714286,10.3571428571429,3.086,66.4,33.1242857142857,14.5428571428571,155,86,58,18,29,121,69,63
2020,15,45,"Igdir",39.9237,44.045,19.0571428571429,8.98571428571429,2.37014285714286,64.5857142857143,41.99,15.59,133,75,41,0,0,118,58,77
2020,16,45,"Igdir",39.9237,44.045,21.0571428571429,12.9428571428571,0.457428571428571,48.2428571428571,50.5057142857143,17.3128571428571,141,141,106,0,0,106,0,0
2020,17,45,"Igdir",39.9237,44.045,20.7428571428571,10.6428571428571,5.98657142857143,79.1571428571429,33.3371428571429,14.94,137,99,85,0,0,123,38,38
2020,18,45,"Igdir",39.9237,44.045,19.1428571428571,13.7,1.871,62.4,42.4128571428571,NA,146,76,112,24,16,164,70,52
2020,19,45,"Igdir",39.9237,44.045,22.8428571428571,13.9428571428571,5.77157142857143,74.0285714285714,36.3757142857143,NA,137,29,13,0,0,157,108,144
2020,20,45,"Igdir",39.9237,44.045,19.5,17.4285714285714,0.0287142857142857,50.5142857142857,60.0685714285714,NA,164,130,122,0,0,164,34,42
2020,21,45,"Igdir",39.9237,44.045,23.5428571428571,20.7,0.957,39.8428571428571,66.1185714285714,NA,146,61,18,20,34,96,85,78
2020,22,45,"Igdir",39.9237,44.045,23.5571428571429,20.8142857142857,3.62771428571429,48.3571428571429,57.42,NA,118,63,60,0,0,100,55,40
2020,23,45,"Igdir",39.9237,44.045,16.5857142857143,22.6857142857143,0.571,37.5285714285714,84.52,NA,112,62,35,0,0,70,50,35
2020,24,45,"Igdir",39.9237,44.045,20.5,24.6142857142857,0.142857142857143,36.5285714285714,66.968,NA,140,78,113,0,0,150,62,37
2020,25,45,"Igdir",39.9237,44.045,17.4571428571429,22.5428571428571,0.814,49.4142857142857,52.6571428571429,NA,137,0,0,0,0,108,137,108
2020,26,45,"Igdir",39.9237,44.045,27.1428571428571,25.4571428571429,0.871428571428571,43.1428571428571,47.8857142857143,NA,173,119,103,0,0,133,54,30
2020,27,45,"Igdir",39.9237,44.045,22.7857142857143,24.9,0.115714285714286,42.4571428571429,43.985,14.458,113,86,64,0,0,113,27,49
2020,28,45,"Igdir",39.9237,44.045,19.7428571428571,25.8714285714286,2.22771428571429,46.6571428571429,39.04,13.12,164,57,43,0,0,122,107,79
2020,29,45,"Igdir",39.9237,44.045,21.5571428571429,26.5428571428571,0.157714285714286,48.3714285714286,35.6114285714286,12.595,186,65,48,0,0,111,121,63
2020,30,45,"Igdir",39.9237,44.045,22.8857142857143,28.0285714285714,1.77042857142857,48.2285714285714,43.6014285714286,11.6483333333333,190,55,39,0,0,142,135,103
2020,31,45,"Igdir",39.9237,44.045,22.2857142857143,26.9571428571429,1.05685714285714,44.8142857142857,39.7928571428571,16.28,150,66,56,4,4,127,84,71
2020,32,45,"Igdir",39.9237,44.045,23.9285714285714,25.1571428571429,0.114285714285714,39.1714285714286,31.2585714285714,NA,146,75,37,0,0,107,71,70
2020,33,45,"Igdir",39.9237,44.045,25.4142857142857,25.2142857142857,0.143,42.2571428571429,38.4557142857143,NA,183,49,13,0,0,83,134,70
2020,34,45,"Igdir",39.9237,44.045,20.8857142857143,23.8285714285714,0.657,49.9142857142857,48.0342857142857,NA,197,121,66,0,0,97,76,31
2020,35,45,"Igdir",39.9237,44.045,21.9571428571429,23.2571428571429,0,39.8857142857143,50.6485714285714,NA,164,135,112,0,0,157,29,45
2020,36,45,"Igdir",39.9237,44.045,16.3142857142857,26.0571428571429,0.000428571428571429,38.0571428571429,77.6942857142857,NA,179,150,100,0,0,112,29,12
2020,37,45,"Igdir",39.9237,44.045,22.8428571428571,25.4571428571429,0.128571428571429,37.2142857142857,70.7585714285714,13.4125,193,113,49,0,0,91,80,42
2020,38,45,"Igdir",39.9237,44.045,25.6,24,0,40.4,75.8442857142857,NA,235,128,83,0,0,157,107,74
2020,39,45,"Igdir",39.9237,44.045,20.0428571428571,21.1428571428571,0.214285714285714,49.7142857142857,64.5271428571429,NA,220,174,93,0,0,129,46,36
2020,40,45,"Igdir",39.9237,44.045,19.4142857142857,19.1714285714286,0.456857142857143,48.4142857142857,76.0142857142857,NA,187,143,116,0,0,154,44,38
2020,41,45,"Igdir",39.9237,44.045,10.9142857142857,13.6857142857143,0.572714285714286,64.5285714285714,60.6614285714286,NA,182,125,91,0,0,127,57,36
2020,42,45,"Igdir",39.9237,44.045,9.2,15.3,0,53.0714285714286,168.321428571429,NA,177,27,29,9,6,111,150,82
2020,43,45,"Igdir",39.9237,44.045,10.8,14.9,0,50.5,151.947142857143,NA,194,13,10,35,26,161,181,151
2020,44,45,"Igdir",39.9237,44.045,5.8,13.0714285714286,0,53.8428571428571,216.445714285714,NA,255,137,98,0,0,233,118,135
2020,45,45,"Igdir",39.9237,44.045,8.75714285714286,12.1428571428571,0.614428571428571,70.8285714285714,74.045,NA,156,36,28,10,11,103,120,75
2020,46,45,"Igdir",39.9237,44.045,12.5714285714286,6.97142857142857,0,62.7571428571429,136.675714285714,NA,208,67,51,0,0,109,141,58
2020,47,45,"Igdir",39.9237,44.045,9.58571428571429,6.18571428571429,0.585857142857143,68.2571428571429,177.674285714286,36.516,173,31,31,18,6,83,142,52
2020,48,45,"Igdir",39.9237,44.045,7.24285714285714,1.7,0.285571428571429,60.2142857142857,141.831428571429,30.7183333333333,199,89,86,15,36,262,110,176
2020,49,45,"Igdir",39.9237,44.045,5.17142857142857,3.94285714285714,0.000142857142857143,79.1571428571429,139.406666666667,30.01,207,113,55,9,4,116,94,61
2020,50,45,"Igdir",39.9237,44.045,5.8,3.25714285714286,0.486428571428571,84.5285714285714,103.106666666667,27.8128571428571,181,102,64,3,2,98,79,34
2020,51,45,"Igdir",39.9237,44.045,7.4,3.54285714285714,1.11457142857143,84.9142857142857,193.72,31.91,171,73,37,15,12,90,98,53
2020,52,45,"Igdir",39.9237,44.045,7.92857142857143,-1.27142857142857,1.21485714285714,76.9142857142857,142.215,27.1028571428571,203,73,52,69,42,113,130,61
2020,53,45,"Igdir",39.9237,44.045,7.225,-5.275,0,75.075,388.8625,52.365,122,2,0,0,0,111,120,111
2017,1,46,"Isparta",37.7648,30.5566,16.2,-0.457142857142857,4.71171428571429,81.4714285714286,53.4757142857143,NA,563,176,272,298,458,847,387,575
2017,2,46,"Isparta",37.7648,30.5566,11.7,-1.32857142857143,14.8198571428571,81.8142857142857,74.5714285714286,NA,757,388,614,178,186,1214,369,600
2017,3,46,"Isparta",37.7648,30.5566,11.0714285714286,2.94285714285714,0.283142857142857,78.7714285714286,77.6628571428571,NA,762,185,232,480,1098,1449,577,1217
2017,4,46,"Isparta",37.7648,30.5566,12.4714285714286,-1.92857142857143,1.76628571428571,71.1428571428571,62.95,NA,639,26,30,388,550,889,613,859
2017,5,46,"Isparta",37.7648,30.5566,8.6,-1.45714285714286,0.143,67.6428571428571,134.545714285714,NA,588,141,146,359,826,1163,447,1017
2017,6,46,"Isparta",37.7648,30.5566,12.6,5.35714285714286,0.000714285714285714,75.7142857142857,95.0371428571429,NA,736,331,465,83,289,1519,405,1054
2017,7,46,"Isparta",37.7648,30.5566,16.6571428571429,-0.671428571428571,0,56.7285714285714,77.6742857142857,NA,492,131,103,154,264,717,361,614
2017,8,46,"Isparta",37.7648,30.5566,13.5285714285714,5.92857142857143,0.0605714285714286,72.3,94.4457142857143,NA,739,402,912,122,374,1747,337,835
2017,9,46,"Isparta",37.7648,30.5566,10.3714285714286,6.38571428571429,3.41771428571429,69.7571428571429,107.511428571429,NA,574,176,261,188,273,866,398,605
2017,10,46,"Isparta",37.7648,30.5566,17.9857142857143,7.14285714285714,5.80357142857143,67.7428571428571,61.4257142857143,NA,712,700,1011,0,0,1043,12,32
2017,11,46,"Isparta",37.7648,30.5566,11.5714285714286,3.77142857142857,0.561,68.8857142857143,42.0471428571429,NA,525,68,137,452,578,725,457,588
2017,12,46,"Isparta",37.7648,30.5566,13.6571428571429,10.3571428571429,0,48.6571428571429,71.1671428571429,NA,589,83,78,325,671,1077,506,999
2017,13,46,"Isparta",37.7648,30.5566,13.6428571428571,10.3,0.860857142857143,63.9857142857143,53.2114285714286,NA,574,242,428,64,114,887,332,459
2017,14,46,"Isparta",37.7648,30.5566,14.8142857142857,9.51428571428571,0.767857142857143,58.8142857142857,49.87,NA,639,173,446,166,277,1336,466,890
2017,15,46,"Isparta",37.7648,30.5566,12.2142857142857,10.6142857142857,0.0204285714285714,56.3142857142857,48.4342857142857,NA,587,99,259,306,526,1187,488,928
2017,16,46,"Isparta",37.7648,30.5566,19.5142857142857,9.92857142857143,1.729,72.3857142857143,39.1228571428571,NA,717,656,851,61,69,920,61,69
2017,17,46,"Isparta",37.7648,30.5566,11.3571428571429,13.1,0,48.3571428571429,63.9442857142857,NA,731,132,397,509,888,1478,599,1081
2017,18,46,"Isparta",37.7648,30.5566,16.0285714285714,15.1571428571429,6.62514285714286,62.7714285714286,55.1128571428571,NA,506,130,210,244,485,923,376,713
2017,19,46,"Isparta",37.7648,30.5566,17.1571428571429,17.9285714285714,1.24357142857143,52.7285714285714,61.9485714285714,NA,471,123,198,308,663,966,348,768
2017,20,46,"Isparta",37.7648,30.5566,14.9714285714286,14.0714285714286,5.23257142857143,63.9857142857143,29.38,NA,472,208,525,131,408,1205,264,680
2017,21,46,"Isparta",37.7648,30.5566,13.3571428571429,13.4285714285714,6.23642857142857,69.8142857142857,37.0671428571429,NA,448,219,497,150,229,849,229,352
2017,22,46,"Isparta",37.7648,30.5566,14.6428571428571,16.0571428571429,2.64814285714286,71.3285714285714,34.1375,NA,522,166,309,269,509,1015,356,706
2017,23,46,"Isparta",37.7648,30.5566,11.6714285714286,18.9142857142857,0.190857142857143,64.7571428571429,37.8085714285714,NA,578,0,0,368,984,1388,578,1388
2017,24,46,"Isparta",37.7648,30.5566,15.6571428571429,19.9857142857143,0.290714285714286,58.8428571428571,36.9914285714286,NA,552,238,507,236,484,1139,314,632
2017,25,46,"Isparta",37.7648,30.5566,12.8857142857143,19.7714285714286,1.781,53.1,32.19,NA,584,0,0,368,740,1041,584,1041
2017,26,46,"Isparta",37.7648,30.5566,13.8142857142857,26.3857142857143,0.0554285714285714,41.3285714285714,49.5257142857143,NA,564,113,234,202,347,971,451,737
2017,27,46,"Isparta",37.7648,30.5566,15.9285714285714,24.8,0.817142857142857,41.5857142857143,49.12,NA,511,90,165,133,225,642,421,477
2017,28,46,"Isparta",37.7648,30.5566,13.2714285714286,26.1428571428571,0.0345714285714286,37.3142857142857,48.3471428571429,NA,481,167,263,248,475,864,314,601
2017,29,46,"Isparta",37.7648,30.5566,14.0571428571429,24.8571428571429,1.029,48.7,46.7157142857143,NA,532,70,214,371,768,1272,462,1058
2017,30,46,"Isparta",37.7648,30.5566,15.5428571428571,24.4,0,40.5428571428571,45.4685714285714,NA,531,221,436,184,329,928,310,492
2017,31,46,"Isparta",37.7648,30.5566,14.4857142857143,23.6857142857143,0.749142857142857,52.0142857142857,35.0871428571429,NA,559,0,0,270,550,1047,559,1047
2017,32,46,"Isparta",37.7648,30.5566,12.1714285714286,26.7428571428571,0.0192857142857143,47.1142857142857,52.6971428571429,NA,567,167,311,167,238,1092,400,781
2017,33,46,"Isparta",37.7648,30.5566,15.7428571428571,24.2,0.832285714285714,54.7714285714286,47.0528571428571,NA,596,336,633,235,488,1199,260,566
2017,34,46,"Isparta",37.7648,30.5566,13.9571428571429,22.5714285714286,0.0742857142857143,48.4571428571429,33.6828571428571,NA,601,38,47,288,593,1280,563,1233
2017,35,46,"Isparta",37.7648,30.5566,10.5857142857143,21.8428571428571,1.27085714285714,50.1,35.7842857142857,NA,493,214,602,268,409,1014,279,412
2017,36,46,"Isparta",37.7648,30.5566,12.5428571428571,21.3714285714286,0,39.4285714285714,48.1085714285714,NA,507,131,211,258,763,1321,376,1110
2017,37,46,"Isparta",37.7648,30.5566,11.1714285714286,23.2428571428571,0,38.9571428571429,79.62,NA,589,308,677,126,219,1138,281,461
2017,38,46,"Isparta",37.7648,30.5566,13.6,20.7142857142857,0.0152857142857143,44.7142857142857,102.03,NA,671,183,233,396,922,1312,488,1079
2017,39,46,"Isparta",37.7648,30.5566,14.4428571428571,17.6142857142857,1.34271428571429,59.5714285714286,NA,NA,782,516,1107,245,454,1630,266,523
2017,40,46,"Isparta",37.7648,30.5566,13.2857142857143,14.2571428571429,1.83185714285714,60.8857142857143,NA,NA,543,228,493,267,601,1137,315,644
2017,41,46,"Isparta",37.7648,30.5566,11,12.7571428571429,0.0414285714285714,57.1285714285714,NA,NA,487,0,0,391,687,843,487,843
2017,42,46,"Isparta",37.7648,30.5566,11.0714285714286,14.1142857142857,0,47.6,NA,NA,530,79,121,109,140,815,451,694
2017,43,46,"Isparta",37.7648,30.5566,14.5857142857143,11.8285714285714,3.30228571428571,74.6,NA,NA,506,414,732,59,109,919,92,187
2017,44,46,"Isparta",37.7648,30.5566,12.0285714285714,7.28571428571429,1.41628571428571,66.9142857142857,NA,NA,561,157,354,268,442,1102,404,748
2017,45,46,"Isparta",37.7648,30.5566,7.15714285714286,7.67142857142857,0,70.9857142857143,NA,NA,577,91,235,357,395,829,486,594
2017,46,46,"Isparta",37.7648,30.5566,11.2,8.7,2.39257142857143,78.4142857142857,NA,NA,587,267,326,96,158,1085,320,759
2017,47,46,"Isparta",37.7648,30.5566,11.3714285714286,4.08571428571429,0.881428571428571,75.2142857142857,109.203333333333,NA,418,86,223,286,520,804,332,581
2017,48,46,"Isparta",37.7648,30.5566,12.6428571428571,6.57142857142857,0.492571428571429,77.7714285714286,51.0614285714286,NA,386,202,299,67,120,619,184,320
2017,49,46,"Isparta",37.7648,30.5566,14.7857142857143,3.35714285714286,0.0734285714285714,69.0428571428571,7.38428571428571,NA,407,164,294,243,351,645,243,351
2017,50,46,"Isparta",37.7648,30.5566,9.42857142857143,5.65714285714286,0.31,81.2857142857143,10.0433333333333,NA,346,190,226,156,216,442,156,216
2017,51,46,"Isparta",37.7648,30.5566,16.3285714285714,6.84285714285714,2.33328571428571,74.9285714285714,28.202,NA,386,166,113,54,81,349,220,236
2017,52,46,"Isparta",37.7648,30.5566,9.625,1.95,0.94875,81.6375,92.7,NA,528,207,267,321,240,507,321,240
2018,1,46,"Isparta",37.7648,30.5566,9.9875,3.6,1.0065,78.225,79.61625,NA,618,199,351,392,559,914,419,563
2018,2,46,"Isparta",37.7648,30.5566,11.3428571428571,4.25714285714286,1.606,81.5714285714286,129.064285714286,NA,624,170,302,348,880,1309,454,1007
2018,3,46,"Isparta",37.7648,30.5566,16.6,2.64285714285714,2.25128571428571,75.2,59.0728571428571,NA,639,258,422,197,118,655,381,233
2018,4,46,"Isparta",37.7648,30.5566,17.7285714285714,1.45714285714286,6.83342857142857,69.5857142857143,35.5657142857143,NA,604,79,162,174,191,764,525,602
2018,5,46,"Isparta",37.7648,30.5566,11.5,4.78571428571429,0.047,74.3857142857143,112.711428571429,NA,670,351,592,319,227,819,319,227
2018,6,46,"Isparta",37.7648,30.5566,15.9,8.48571428571429,0.912857142857143,71.6714285714286,129.592857142857,NA,704,457,759,66,107,1022,247,263
2018,7,46,"Isparta",37.7648,30.5566,12.5714285714286,5.44285714285714,0.539142857142857,70.2142857142857,57.9657142857143,NA,478,167,203,284,309,557,311,354
2018,8,46,"Isparta",37.7648,30.5566,12.8,5.68571428571429,1.51485714285714,80.3714285714286,57.1285714285714,NA,711,607,1021,52,229,1321,104,300
2018,9,46,"Isparta",37.7648,30.5566,18.5142857142857,6.2,1.77885714285714,74.8285714285714,55.2414285714286,NA,621,525,787,93,162,956,96,169
2018,10,46,"Isparta",37.7648,30.5566,14.6142857142857,9.45714285714286,1.39728571428571,72.0142857142857,131.745714285714,NA,556,349,1035,149,284,1330,207,295
2018,11,46,"Isparta",37.7648,30.5566,16.5714285714286,8.91428571428571,0.782285714285714,71.0142857142857,59.4514285714286,NA,551,349,646,66,412,1426,202,780
2018,12,46,"Isparta",37.7648,30.5566,21.6142857142857,11.0571428571429,0.0452857142857143,55.3285714285714,80.0957142857143,NA,425,367,1054,0,0,1187,58,133
2018,13,46,"Isparta",37.7648,30.5566,16.7428571428571,9.5,6.14657142857143,60.7285714285714,77.4485714285714,NA,356,239,292,71,99,428,117,136
2018,14,46,"Isparta",37.7648,30.5566,15.5857142857143,11.4285714285714,0.222428571428571,48.9285714285714,42.8775,NA,407,179,316,123,88,486,228,170
2018,15,46,"Isparta",37.7648,30.5566,11.9,14.3857142857143,0.617571428571429,62.7285714285714,89.755,NA,374,41,33,177,177,450,333,417
2018,16,46,"Isparta",37.7648,30.5566,15.1571428571429,14.2857142857143,0.0698571428571429,45.2142857142857,71.1057142857143,NA,411,133,229,115,167,648,278,419
2018,17,46,"Isparta",37.7648,30.5566,14.5571428571429,16.6857142857143,0.00657142857142857,46.0142857142857,54.5871428571429,NA,419,61,96,150,173,652,358,556
2018,18,46,"Isparta",37.7648,30.5566,14.6428571428571,17.0285714285714,0.521857142857143,56.3571428571429,85.2085714285714,NA,303,205,374,0,0,474,98,100
2018,19,46,"Isparta",37.7648,30.5566,12.7,13.2571428571429,3.80328571428571,72.1571428571429,41.4728571428571,NA,275,45,70,214,362,467,230,397
2018,20,46,"Isparta",37.7648,30.5566,11.1142857142857,18.8285714285714,0.586857142857143,52.1571428571429,58.3457142857143,NA,204,48,98,103,148,306,156,208
2018,21,46,"Isparta",37.7648,30.5566,14.3571428571429,18.9428571428571,1.12714285714286,58.3428571428571,79.7628571428571,NA,252,135,151,69,55,281,117,130
2018,22,46,"Isparta",37.7648,30.5566,12.4,17.5142857142857,3.69457142857143,67.5571428571428,34.1514285714286,NA,249,0,0,177,364,427,249,427
2018,23,46,"Isparta",37.7648,30.5566,13.5428571428571,21.5,1.05257142857143,54.0571428571429,61.2857142857143,NA,267,88,262,122,375,812,179,550
2018,24,46,"Isparta",37.7648,30.5566,14.4,19.5571428571429,6.13114285714286,64.9142857142857,40.5428571428571,NA,267,161,218,62,146,448,106,230
2018,25,46,"Isparta",37.7648,30.5566,12.2714285714286,19.1571428571429,0.857428571428571,70.5285714285714,28.6985714285714,NA,358,108,143,100,129,518,250,375
2018,26,46,"Isparta",37.7648,30.5566,13.3285714285714,20.8571428571429,0.757428571428571,58.3857142857143,37.1514285714286,NA,355,257,468,48,83,587,98,119
2018,27,46,"Isparta",37.7648,30.5566,13.4571428571429,24.9285714285714,0,39.3571428571429,49.0914285714286,NA,342,46,80,194,217,418,296,338
2018,28,46,"Isparta",37.7648,30.5566,12.5142857142857,25.2857142857143,0,44.1571428571429,52.4457142857143,NA,286,69,146,130,283,585,217,439
2018,29,46,"Isparta",37.7648,30.5566,14.1428571428571,24.6142857142857,0,41.2714285714286,45.2114285714286,NA,260,29,17,231,739,756,231,739
2018,30,46,"Isparta",37.7648,30.5566,14.4571428571429,23.0714285714286,0.606571428571429,55.9142857142857,51.5685714285714,NA,265,142,530,85,233,822,123,292
2018,31,46,"Isparta",37.7648,30.5566,13.4142857142857,24.8142857142857,1.07371428571429,55.2428571428571,41.3871428571429,NA,267,81,247,76,183,499,186,252
2018,32,46,"Isparta",37.7648,30.5566,13.4142857142857,23.4857142857143,0.626571428571429,47,39.3914285714286,NA,297,0,0,111,159,403,297,403
2018,33,46,"Isparta",37.7648,30.5566,12.9428571428571,24.8857142857143,0,35.7285714285714,51.5285714285714,NA,216,49,95,97,141,332,167,237
2018,34,46,"Isparta",37.7648,30.5566,10.8142857142857,24.8285714285714,0.0817142857142857,47.4714285714286,44.3657142857143,NA,144,53,97,38,39,227,91,130
2018,35,46,"Isparta",37.7648,30.5566,12.4857142857143,24.5,0.00885714285714286,49.5428571428571,52.2757142857143,NA,201,67,49,126,226,314,134,265
2018,36,46,"Isparta",37.7648,30.5566,12.7142857142857,22.7571428571429,0.0148571428571429,45.4285714285714,52.0385714285714,NA,341,105,87,167,196,370,236,283
2018,37,46,"Isparta",37.7648,30.5566,14.7714285714286,19.4142857142857,0.000428571428571429,49.5,39.1757142857143,NA,241,22,45,152,238,419,219,374
2018,38,46,"Isparta",37.7648,30.5566,16.6714285714286,20.9571428571429,0.0142857142857143,39.3571428571429,52.8185714285714,NA,189,23,53,110,205,344,166,291
2018,39,46,"Isparta",37.7648,30.5566,21.9285714285714,18.4428571428571,0.300714285714286,53.5142857142857,54.8685714285714,NA,180,88,181,69,112,353,92,172
2018,40,46,"Isparta",37.7648,30.5566,12.3571428571429,16.3285714285714,0.414714285714286,56.4571428571429,48.1528571428571,NA,191,109,160,34,88,341,82,181
2018,41,46,"Isparta",37.7648,30.5566,9.85714285714286,14.6428571428571,1.68557142857143,65.2285714285714,53.4928571428571,NA,187,21,40,88,114,422,166,382
2018,42,46,"Isparta",37.7648,30.5566,10.3571428571429,15.7571428571429,0.583714285714286,65.5285714285714,178.511428571429,NA,168,151,374,17,7,381,17,7
2018,43,46,"Isparta",37.7648,30.5566,15.1857142857143,10.1285714285714,1.25114285714286,67.1857142857143,53.934,NA,187,84,152,62,169,402,103,250
2018,44,46,"Isparta",37.7648,30.5566,8.14285714285714,12.0142857142857,0,47.6571428571429,132.18,NA,196,0,0,84,120,264,196,264
2018,45,46,"Isparta",37.7648,30.5566,8.48571428571429,10.6428571428571,0,56.5285714285714,99.8,NA,231,33,97,127,238,473,198,376
2018,46,46,"Isparta",37.7648,30.5566,10.7428571428571,6.31428571428571,2.28957142857143,66.3428571428571,66.976,NA,230,31,39,184,353,465,199,426
2018,47,46,"Isparta",37.7648,30.5566,9,8.32857142857143,2.36471428571429,81.2,98.84,NA,270,90,60,116,326,499,180,439
2018,48,46,"Isparta",37.7648,30.5566,10.1,7.71428571428571,3.44971428571429,86.7142857142857,57.2342857142857,NA,245,171,97,53,67,201,74,104
2018,49,46,"Isparta",37.7648,30.5566,9.58571428571429,5.6,1.71514285714286,83.1,56.2485714285714,NA,257,83,92,95,93,420,174,328
2018,50,46,"Isparta",37.7648,30.5566,12.5142857142857,4.84285714285714,4.92371428571429,80.6,36.9971428571429,NA,256,158,164,61,86,305,98,141
2018,51,46,"Isparta",37.7648,30.5566,9.11428571428571,3.14285714285714,4.36757142857143,90.8714285714286,72.9042857142857,NA,250,43,47,202,201,248,207,201
2018,52,46,"Isparta",37.7648,30.5566,14.4142857142857,0.828571428571429,2.34685714285714,74.1142857142857,63.2128571428571,NA,244,60,59,84,93,273,184,214
2019,1,46,"Isparta",37.7648,30.5566,14.425,2.875,4.58225,82.8,32.42375,NA,343,51,284,35,27,784,292,500
2019,2,46,"Isparta",37.7648,30.5566,10.9714285714286,0.114285714285714,0.218571428571429,79.5857142857143,48.7985714285714,NA,255,99,57,154,150,208,156,151
2019,3,46,"Isparta",37.7648,30.5566,14.9,2.12857142857143,1.90771428571429,75.4142857142857,68.1914285714286,NA,192,83,69,72,97,198,109,129
2019,4,46,"Isparta",37.7648,30.5566,17.3428571428571,4.58571428571429,5.92185714285714,84.8285714285714,56.106,NA,308,255,264,0,0,314,53,50
2019,5,46,"Isparta",37.7648,30.5566,12.4,3.7,2.012,79.8714285714286,78.7814285714286,NA,253,106,59,61,33,143,147,84
2019,6,46,"Isparta",37.7648,30.5566,11.0428571428571,4.78571428571429,6.13071428571429,77.9857142857143,63.8071428571429,NA,276,118,35,120,85,127,158,92
2019,7,46,"Isparta",37.7648,30.5566,15.4857142857143,4.45714285714286,0.199428571428571,72.2428571428571,39.22,NA,325,127,145,65,16,234,198,89
2019,8,46,"Isparta",37.7648,30.5566,11.7714285714286,4.95714285714286,0.0284285714285714,68.7285714285714,86.8442857142857,NA,305,156,89,146,129,219,149,130
2019,9,46,"Isparta",37.7648,30.5566,13.1857142857143,4.44285714285714,0.444,66.4,57.2857142857143,NA,331,34,91,179,103,310,297,219
2019,10,46,"Isparta",37.7648,30.5566,11.3857142857143,7.08571428571429,0.564571428571429,64.8428571428571,65.6642857142857,NA,359,112,77,159,120,252,247,175
2019,11,46,"Isparta",37.7648,30.5566,18.0857142857143,7.62857142857143,2.30885714285714,72.6285714285714,34.5242857142857,NA,373,300,303,67,85,400,73,97
2019,12,46,"Isparta",37.7648,30.5566,15.0571428571429,9.65714285714286,0.0295714285714286,53.7285714285714,49.6628571428571,NA,343,85,300,102,44,416,258,116
2019,13,46,"Isparta",37.7648,30.5566,18.1857142857143,6.45714285714286,1.83542857142857,56.7857142857143,37.8971428571429,NA,256,54,38,26,22,194,202,156
2019,14,46,"Isparta",37.7648,30.5566,12.9142857142857,8.85714285714286,0.0412857142857143,65.8428571428571,44.3057142857143,NA,365,255,134,29,13,208,110,74
2019,15,46,"Isparta",37.7648,30.5566,16.0714285714286,10.1714285714286,3.47857142857143,71.2142857142857,43.5242857142857,NA,359,304,156,53,25,183,55,27
2019,16,46,"Isparta",37.7648,30.5566,14.7142857142857,6.7,2.944,64.2285714285714,26.02,NA,318,6,6,263,156,208,312,202
2019,17,46,"Isparta",37.7648,30.5566,12.0571428571429,12.6142857142857,0.614571428571429,57.4142857142857,76.0728571428571,NA,412,52,18,295,223,313,360,295
2019,18,46,"Isparta",37.7648,30.5566,16.9428571428571,13.9142857142857,0.940714285714286,54.7571428571429,45.0514285714286,NA,523,374,276,72,44,353,149,77
2019,19,46,"Isparta",37.7648,30.5566,15.0142857142857,12.0571428571429,2.955,62.9,33.2842857142857,NA,452,206,154,111,106,386,246,232
2019,20,46,"Isparta",37.7648,30.5566,14.5,18.1,0.274571428571429,49.7,44.1483333333333,NA,454,286,260,97,90,389,168,129
2019,21,46,"Isparta",37.7648,30.5566,15.1857142857143,18.9428571428571,0.094,52.2,43.76,NA,457,246,193,209,219,413,211,220
2019,22,46,"Isparta",37.7648,30.5566,11.7857142857143,22.4571428571429,1.09014285714286,46.0142857142857,50.3542857142857,NA,453,56,59,175,134,323,397,264
2019,23,46,"Isparta",37.7648,30.5566,13.6285714285714,19.9714285714286,0.549142857142857,50.0285714285714,36.52,NA,378,167,117,207,413,532,211,415
2019,24,46,"Isparta",37.7648,30.5566,12.7142857142857,18.5857142857143,4.14642857142857,70.2142857142857,28.6385714285714,NA,378,56,65,179,68,244,322,179
2019,25,46,"Isparta",37.7648,30.5566,11.9285714285714,19.9571428571429,0.926428571428571,69.6142857142857,27.1828571428571,32.905,306,7,26,221,191,325,299,299
2019,26,46,"Isparta",37.7648,30.5566,13,23.9142857142857,1.09914285714286,49.5857142857143,32.0842857142857,31.5714285714286,377,0,0,73,152,342,377,342
2019,27,46,"Isparta",37.7648,30.5566,12.6428571428571,23.6428571428571,0,37.4142857142857,32.6185714285714,32.9657142857143,456,0,0,245,111,222,456,222
2019,28,46,"Isparta",37.7648,30.5566,15.1714285714286,23.7571428571429,0.0291428571428571,41.8714285714286,39.9,31.56,398,56,25,303,295,421,342,396
2019,29,46,"Isparta",37.7648,30.5566,12.9285714285714,21.2285714285714,1.45271428571429,56.8714285714286,26.6514285714286,25.4785714285714,453,135,78,163,48,203,318,125
2019,30,46,"Isparta",37.7648,30.5566,13.9571428571429,24.3142857142857,0,41,38.9614285714286,30.8771428571429,456,0,0,262,184,335,456,335
2019,31,46,"Isparta",37.7648,30.5566,13.7142857142857,25.6714285714286,0.0272857142857143,47.7857142857143,47.7257142857143,40.3242857142857,334,113,154,81,74,375,221,221
2019,32,46,"Isparta",37.7648,30.5566,16.1,24.6,0,33.8428571428571,33.3828571428571,23.4585714285714,346,0,0,48,39,395,346,395
2019,33,46,"Isparta",37.7648,30.5566,13.2571428571429,24.5571428571429,0.588714285714286,46.7142857142857,37.8485714285714,30.1071428571429,337,135,210,103,216,531,202,321
2019,34,46,"Isparta",37.7648,30.5566,15.2428571428571,23.1,0,47.3857142857143,34.9271428571429,25.9742857142857,299,0,0,69,70,345,299,345
2019,35,46,"Isparta",37.7648,30.5566,10.9,24.5857142857143,0,38.3857142857143,41.6971428571429,38.75,307,71,77,140,252,415,236,338
2019,36,46,"Isparta",37.7648,30.5566,10.7,21.9571428571429,3.10114285714286,55.9142857142857,43.4085714285714,45.7085714285714,171,71,18,63,31,67,100,49
2019,37,46,"Isparta",37.7648,30.5566,13.8285714285714,21.2428571428571,0.00128571428571429,46.0714285714286,44.8042857142857,38.1142857142857,218,35,14,96,19,55,183,41
2019,38,46,"Isparta",37.7648,30.5566,12.6571428571429,18.6,0,44.0571428571429,39.7385714285714,36.5371428571429,266,72,19,119,51,91,194,72
2019,39,46,"Isparta",37.7648,30.5566,10.2714285714286,18.2571428571429,0.575285714285714,54.5428571428571,38.2114285714286,42.93,237,94,45,132,27,79,143,34
2019,40,46,"Isparta",37.7648,30.5566,14.7714285714286,17.3,0.354714285714286,59.2428571428571,41.36,46.5057142857143,241,165,96,12,2,111,76,15
2019,41,46,"Isparta",37.7648,30.5566,11.0428571428571,17.1428571428571,0,58.7428571428571,38.1485714285714,42.4816666666667,416,71,21,292,365,448,345,427
2019,42,46,"Isparta",37.7648,30.5566,11.2142857142857,16.3857142857143,1.05242857142857,59.0428571428571,46.1242857142857,45.6233333333333,356,163,205,103,97,408,193,203
2019,43,46,"Isparta",37.7648,30.5566,13.0142857142857,14.7428571428571,0,53.8,39.07,43.5157142857143,306,0,0,225,268,300,306,300
2019,44,46,"Isparta",37.7648,30.5566,7.81428571428571,11.0571428571429,0.425857142857143,66.8428571428571,57.3514285714286,62.346,350,167,99,167,143,250,183,151
2019,45,46,"Isparta",37.7648,30.5566,9.02857142857143,11.6857142857143,0.000142857142857143,65.8,68.0285714285714,49.0166666666667,417,227,136,136,161,328,190,192
2019,46,46,"Isparta",37.7648,30.5566,9.22857142857143,11.3142857142857,1.91671428571429,65.4571428571429,60.85,56.675,401,280,233,104,96,337,121,104
2019,47,46,"Isparta",37.7648,30.5566,6.2,7.17142857142857,0.0517142857142857,70.0428571428571,87.0228571428571,75.216,391,82,80,242,200,339,309,259
2019,48,46,"Isparta",37.7648,30.5566,10.3,8.74285714285714,1.691,83.0142857142857,33.59,NA,320,131,102,114,102,251,189,149
2019,49,46,"Isparta",37.7648,30.5566,9.78571428571428,3.35714285714286,0.848714285714286,68.5857142857143,57.6171428571429,NA,393,0,0,336,244,274,393,274
2019,50,46,"Isparta",37.7648,30.5566,10.8142857142857,6.11428571428571,1.14442857142857,83.1,33.5985714285714,NA,218,138,80,41,7,119,80,39
2019,51,46,"Isparta",37.7648,30.5566,5.92857142857143,4.68571428571429,0,76.7714285714286,110.041428571429,NA,361,99,194,158,142,488,262,294
2019,52,46,"Isparta",37.7648,30.5566,12.8571428571429,4.22857142857143,1.92728571428571,77.5571428571429,28.28,NA,279,49,66,228,214,281,230,215
2020,1,46,"Isparta",37.7648,30.5566,12.6,1.92,8e-04,70.62,26.644,NA,160,1,0,65,44,126,159,126
2020,2,46,"Isparta",37.7648,30.5566,11.2428571428571,1.34285714285714,7.71485714285714,77.1428571428571,50.8385714285714,NA,240,0,0,160,81,173,240,173
2020,3,46,"Isparta",37.7648,30.5566,10.8,1.47142857142857,0,69.9714285714286,57.1371428571429,NA,270,0,0,157,234,382,270,382
2020,4,46,"Isparta",37.7648,30.5566,12.5714285714286,-0.385714285714286,0,56.7714285714286,61.5885714285714,NA,358,0,0,312,255,295,358,295
2020,5,46,"Isparta",37.7648,30.5566,12.0428571428571,3.7,2.33214285714286,78.8,62.7271428571429,NA,331,175,136,79,45,272,156,136
2020,6,46,"Isparta",37.7648,30.5566,20.4714285714286,2.88571428571429,16.1612857142857,75.3571428571429,19.5871428571429,NA,343,211,157,85,63,267,132,110
2020,7,46,"Isparta",37.7648,30.5566,12.2,2.62857142857143,1.38714285714286,80.8142857142857,56.035,NA,341,88,75,77,109,338,253,263
2020,8,46,"Isparta",37.7648,30.5566,12.1571428571429,4.38571428571429,3.43285714285714,71.3571428571429,56.7485714285714,NA,283,31,59,117,53,187,252,128
2020,9,46,"Isparta",37.7648,30.5566,14.6285714285714,5.7,1.45157142857143,72.0142857142857,48.8071428571429,NA,393,176,239,205,286,528,217,289
2020,10,46,"Isparta",37.7648,30.5566,14.6571428571429,8.04285714285714,0.908571428571429,66.3285714285714,61.1242857142857,NA,205,142,126,21,23,210,63,84
2020,11,46,"Isparta",37.7648,30.5566,16.3714285714286,10.6,2.20485714285714,62.5285714285714,45.2528571428571,NA,115,66,49,9,10,94,49,45
2020,12,46,"Isparta",37.7648,30.5566,17.8571428571429,3.65714285714286,0.152714285714286,58.1285714285714,21.6757142857143,NA,117,11,10,67,48,118,106,108
2020,13,46,"Isparta",37.7648,30.5566,12.5857142857143,9.15714285714286,0.713571428571429,68.9428571428572,40.6528571428571,NA,136,37,27,6,4,92,99,65
2020,14,46,"Isparta",37.7648,30.5566,16.3571428571429,9.48571428571429,1.955,69.0285714285714,32.5657142857143,NA,155,55,41,54,44,121,100,80
2020,15,46,"Isparta",37.7648,30.5566,22.3571428571429,11,0.294857142857143,59.4142857142857,32.7471428571429,NA,133,17,12,85,92,118,116,106
2020,16,46,"Isparta",37.7648,30.5566,19.6142857142857,12.9857142857143,0.0142857142857143,53.2428571428571,39.0528571428571,NA,141,26,17,73,61,106,115,89
2020,17,46,"Isparta",37.7648,30.5566,22.0285714285714,12.6285714285714,1.169,59.2428571428571,26.374,NA,137,0,0,103,89,123,137,123
2020,18,46,"Isparta",37.7648,30.5566,19.7142857142857,12.9142857142857,3.93457142857143,67.3571428571429,29.9557142857143,NA,146,42,43,59,93,164,104,121
2020,19,46,"Isparta",37.7648,30.5566,23.5428571428571,12.6285714285714,7.34442857142857,69.9,22.8528571428571,NA,137,0,0,127,151,157,137,157
2020,20,46,"Isparta",37.7648,30.5566,17.0571428571429,21.0571428571429,0,49.0285714285714,47.9757142857143,NA,164,7,15,120,100,164,157,149
2020,21,46,"Isparta",37.7648,30.5566,34.4857142857143,18.9714285714286,0.285428571428571,44.8142857142857,52.3757142857143,NA,146,44,13,98,79,96,102,83
2020,22,46,"Isparta",37.7648,30.5566,20.2,14.4428571428571,1.62285714285714,59.0285714285714,17.5042857142857,NA,118,45,24,21,8,100,73,76
2020,23,46,"Isparta",37.7648,30.5566,22.1142857142857,16.0857142857143,2.874,57.5428571428571,22.4214285714286,NA,112,57,44,34,18,70,55,26
2020,24,46,"Isparta",37.7648,30.5566,13.1142857142857,19.9,0.382714285714286,52.0142857142857,35.5014285714286,NA,140,94,114,20,10,150,46,36
2020,25,46,"Isparta",37.7648,30.5566,14.6142857142857,20.9,0.331142857142857,54.6142857142857,32.4,NA,137,60,40,55,52,108,77,68
2020,26,46,"Isparta",37.7648,30.5566,9.45714285714286,22.9571428571429,2.37471428571429,49.5857142857143,26.1242857142857,NA,173,54,43,79,62,133,119,90
2020,27,46,"Isparta",37.7648,30.5566,9.94285714285714,26.7857142857143,0,34.1714285714286,34.1857142857143,NA,113,0,0,49,51,113,113,113
2020,28,46,"Isparta",37.7648,30.5566,12.0571428571429,26.5428571428571,0.285,38.3142857142857,32.8428571428571,NA,164,57,43,44,31,122,107,79
2020,29,46,"Isparta",37.7648,30.5566,12.9,26.3714285714286,0.0182857142857143,42.8,39.1157142857143,NA,186,133,85,23,13,111,53,26
2020,30,46,"Isparta",37.7648,30.5566,11.7857142857143,27.0428571428571,0,34,36.1057142857143,NA,190,50,30,41,41,142,140,112
2020,31,46,"Isparta",37.7648,30.5566,12.8428571428571,28.5142857142857,0.686428571428571,32.2142857142857,36.35,NA,150,30,30,96,83,127,120,97
2020,32,46,"Isparta",37.7648,30.5566,10.8714285714286,26.6571428571429,2.258,41.8142857142857,38.44,NA,146,57,61,37,23,107,89,46
2020,33,46,"Isparta",37.7648,30.5566,10.4571428571429,24.6,0.602285714285714,44.8142857142857,32.77,NA,183,0,0,137,59,83,183,83
2020,34,46,"Isparta",37.7648,30.5566,11.7142857142857,25.0571428571429,0.000571428571428571,36.7428571428571,34.1342857142857,30.285,197,29,7,132,71,97,168,90
2020,35,46,"Isparta",37.7648,30.5566,6.77142857142857,25.5571428571429,0.0394285714285714,35.0285714285714,38.4642857142857,49.1785714285714,164,19,23,96,92,157,145,134
2020,36,46,"Isparta",37.7648,30.5566,10.2857142857143,26.1142857142857,0,34.0714285714286,46.7157142857143,45.31,179,59,19,66,47,112,120,93
2020,37,46,"Isparta",37.7648,30.5566,9.68571428571429,25.2,0.000428571428571429,37.5714285714286,41.6042857142857,36.5885714285714,193,57,34,65,26,91,136,57
2020,38,46,"Isparta",37.7648,30.5566,8.8,24.4714285714286,0.0107142857142857,41.6142857142857,43.0814285714286,42.8457142857143,235,28,23,93,57,157,207,134
2020,39,46,"Isparta",37.7648,30.5566,10.0428571428571,21.9714285714286,0.104714285714286,54.0714285714286,35.96,30.7985714285714,220,63,33,124,91,129,157,96
2020,40,46,"Isparta",37.7648,30.5566,8.64285714285714,19.6571428571429,0,43.2142857142857,41.1357142857143,38.9828571428571,187,14,10,111,91,154,173,144
2020,41,46,"Isparta",37.7648,30.5566,11.2142857142857,20.2714285714286,2.24185714285714,51.3,61.4157142857143,37.4157142857143,182,96,63,82,61,127,86,64
2020,42,46,"Isparta",37.7648,30.5566,10.2714285714286,17.4857142857143,0.178571428571429,55.9285714285714,41.5557142857143,42.6628571428571,177,109,74,18,12,111,68,37
2020,43,46,"Isparta",37.7648,30.5566,7.77142857142857,15.3857142857143,2.28857142857143,69.6857142857143,44.5471428571429,43.3742857142857,194,67,86,9,6,161,127,75
2020,44,46,"Isparta",37.7648,30.5566,11.1,14.9,2.227,66.4857142857143,44.2185714285714,36.1342857142857,255,194,175,61,58,233,61,58
2020,45,46,"Isparta",37.7648,30.5566,11.5857142857143,11.7142857142857,0.0135714285714286,57.9142857142857,29.3614285714286,28.5614285714286,156,0,0,80,54,103,156,103
2020,46,46,"Isparta",37.7648,30.5566,6.47142857142857,11.1571428571429,2.38514285714286,63.5,45.1757142857143,45.5571428571429,208,37,31,117,64,109,171,78
2020,47,46,"Isparta",37.7648,30.5566,7.15714285714286,8.22857142857143,1.02442857142857,71.4,53.3142857142857,46.5242857142857,173,0,0,137,64,83,173,83
2020,48,46,"Isparta",37.7648,30.5566,6.9,6.41428571428571,0,56.1571428571429,62.5957142857143,47.6871428571429,199,0,0,103,174,262,199,262
2020,49,46,"Isparta",37.7648,30.5566,5.07142857142857,7.58571428571429,0.0142857142857143,78.0428571428571,83.3171428571429,54.0057142857143,207,60,53,115,55,116,147,63
2020,50,46,"Isparta",37.7648,30.5566,10.5142857142857,8.64285714285714,0.600857142857143,78.1714285714286,37.6942857142857,27.8371428571429,181,155,90,0,0,98,26,8
2020,51,46,"Isparta",37.7648,30.5566,6.21428571428571,6.65714285714286,3.68457142857143,81.5857142857143,50.6885714285714,36.7785714285714,171,17,11,111,56,90,154,79
2020,52,46,"Isparta",37.7648,30.5566,7.3,4.6,0,81.9714285714286,82.29,45.3228571428571,203,87,48,101,65,113,116,65
2020,53,46,"Isparta",37.7648,30.5566,9.875,6.025,2.76875,86.8,71.935,44.2975,122,95,62,26,48,111,27,49
2017,1,47,"Mecidiyekoy",41.0716,28.9961,25.0428571428571,3.95714285714286,8.67714285714286,81.1428571428571,36.7671428571429,63.1628571428571,563,127,179,201,364,847,436,668
2017,2,47,"Mecidiyekoy",41.0716,28.9961,21.6285714285714,3.82857142857143,5.484,80.4142857142857,31.44,69.2771428571429,757,86,205,50,158,1214,671,1009
2017,3,47,"Mecidiyekoy",41.0716,28.9961,21.1285714285714,4.44285714285714,3.87214285714286,90.2714285714286,32.2871428571429,70.8128571428571,762,0,0,3,10,1449,762,1449
2017,4,47,"Mecidiyekoy",41.0716,28.9961,21.6,2.51428571428571,0.701,80.2142857142857,42.5257142857143,65.7714285714286,639,0,0,188,228,889,639,889
2017,5,47,"Mecidiyekoy",41.0716,28.9961,16.7857142857143,6.07142857142857,0.468571428571429,70.2714285714286,52.5728571428571,76.53,588,0,0,0,0,1163,588,1163
2017,6,47,"Mecidiyekoy",41.0716,28.9961,18.8428571428571,7.37142857142857,0.900571428571429,77.7714285714286,41.9014285714286,68.3728571428571,736,131,203,184,475,1519,605,1316
2017,7,47,"Mecidiyekoy",41.0716,28.9961,17.8714285714286,4.04285714285714,0.553428571428571,74.2714285714286,58.0457142857143,83.0614285714286,492,53,33,92,172,717,439,684
2017,8,47,"Mecidiyekoy",41.0716,28.9961,17.7142857142857,9.84285714285714,3.54128571428571,76.4285714285714,59.1066666666667,71.9485714285714,739,0,0,0,0,1747,739,1747
2017,9,47,"Mecidiyekoy",41.0716,28.9961,13.0428571428571,8.62857142857143,0.00957142857142857,81.5857142857143,89.2585714285714,85.4628571428571,574,0,0,283,488,866,574,866
2017,10,47,"Mecidiyekoy",41.0716,28.9961,19.7428571428571,10.1,1.55685714285714,80.3428571428571,64.3442857142857,72.3757142857143,712,0,0,103,159,1043,712,1043
2017,11,47,"Mecidiyekoy",41.0716,28.9961,13.1428571428571,6.68571428571429,5.74028571428571,85.3,50.5285714285714,64.23,525,0,0,356,490,725,525,725
2017,12,47,"Mecidiyekoy",41.0716,28.9961,18.8714285714286,9.44285714285714,0.349,77.9857142857143,59.0642857142857,78.48,589,0,0,88,173,1077,589,1077
2017,13,47,"Mecidiyekoy",41.0716,28.9961,23.7285714285714,8.57142857142857,0.346571428571429,75.0428571428571,50.2042857142857,73.3385714285714,574,0,0,0,0,887,574,887
2017,14,47,"Mecidiyekoy",41.0716,28.9961,13.7857142857143,9.71428571428571,0.396857142857143,81.5857142857143,64.2614285714286,85.1414285714286,639,0,0,289,548,1336,639,1336
2017,15,47,"Mecidiyekoy",41.0716,28.9961,16.7571428571429,12.4142857142857,0.0148571428571429,65.8285714285714,71.3914285714286,90.4157142857143,587,2,10,43,264,1187,585,1177
2017,16,47,"Mecidiyekoy",41.0716,28.9961,17.3,11.1142857142857,3.307,72.8428571428571,43.1042857142857,74.7385714285714,717,0,0,280,496,920,717,920
2017,17,47,"Mecidiyekoy",41.0716,28.9961,17.6428571428571,14.2857142857143,0.321142857142857,60.6,70.7857142857143,105.278571428571,731,0,0,153,310,1478,731,1478
2017,18,47,"Mecidiyekoy",41.0716,28.9961,17.5714285714286,14.5285714285714,1.13257142857143,82.0714285714286,55.1114285714286,71.7285714285714,506,1,1,98,314,923,505,922
2017,19,47,"Mecidiyekoy",41.0716,28.9961,14.6,18.1571428571429,1.618,72.4,51.9857142857143,83.3628571428571,471,53,131,4,13,966,418,835
2017,20,47,"Mecidiyekoy",41.0716,28.9961,21.5285714285714,15.8857142857143,1.18442857142857,78.0857142857143,36.6014285714286,66.2971428571429,472,0,0,123,289,1205,472,1205
2017,21,47,"Mecidiyekoy",41.0716,28.9961,19.2714285714286,16.9,0.0622857142857143,76.7285714285714,35.1428571428571,71.22,448,0,0,68,84,849,448,849
2017,22,47,"Mecidiyekoy",41.0716,28.9961,16.9857142857143,20.4714285714286,0.583714285714286,78.3285714285714,44.7757142857143,76.8985714285714,522,0,0,25,65,1015,522,1015
2017,23,47,"Mecidiyekoy",41.0716,28.9961,17.6571428571429,20.3714285714286,2.63471428571429,81.3142857142857,46.5085714285714,72.7885714285714,578,0,0,138,437,1388,578,1388
2017,24,47,"Mecidiyekoy",41.0716,28.9961,19.2428571428571,21.3571428571429,0.599142857142857,74.6714285714286,30.2028571428571,67.1828571428571,552,0,0,9,32,1139,552,1139
2017,25,47,"Mecidiyekoy",41.0716,28.9961,13.4714285714286,23.1857142857143,3.48514285714286,71.3571428571429,35.1485714285714,76.55,584,0,0,256,381,1041,584,1041
2017,26,47,"Mecidiyekoy",41.0716,28.9961,15.6142857142857,27.1,0,61.8428571428571,36.5314285714286,75.6128571428571,564,0,0,63,84,971,564,971
2017,27,47,"Mecidiyekoy",41.0716,28.9961,21.0142857142857,23.9142857142857,0.261142857142857,65.2428571428571,31.3114285714286,59.1228571428571,511,0,0,83,116,642,511,642
2017,28,47,"Mecidiyekoy",41.0716,28.9961,18.2,24.3142857142857,0.597571428571429,73.1285714285714,42.5242857142857,61.6457142857143,481,0,0,18,117,864,481,864
2017,29,47,"Mecidiyekoy",41.0716,28.9961,18.4428571428571,23.6857142857143,9.98971428571428,77.8428571428571,46.926,64.7866666666667,532,0,0,41,155,1272,532,1272
2017,30,47,"Mecidiyekoy",41.0716,28.9961,13.1142857142857,25.1857142857143,2.73985714285714,73.9428571428571,78.65,80.8271428571429,531,40,71,87,157,928,491,857
2017,31,47,"Mecidiyekoy",41.0716,28.9961,17.4285714285714,26.0142857142857,0.0835714285714286,75.6428571428571,58.21,64.7071428571429,559,0,0,37,44,1047,559,1047
2017,32,47,"Mecidiyekoy",41.0716,28.9961,17.1285714285714,26.5142857142857,0,78.9142857142857,51.18,58.2457142857143,567,0,0,25,69,1092,567,1092
2017,33,47,"Mecidiyekoy",41.0716,28.9961,15.7285714285714,25.1857142857143,2.51142857142857,77.9285714285714,58.3371428571429,63.05,596,0,0,253,640,1199,596,1199
2017,34,47,"Mecidiyekoy",41.0716,28.9961,18.9428571428571,23.0142857142857,2.56157142857143,70.8285714285714,38.3942857142857,65.26,601,0,0,75,111,1280,601,1280
2017,35,47,"Mecidiyekoy",41.0716,28.9961,18.7,22.9,0.216428571428571,65.6428571428571,20.9128571428571,58.5285714285714,493,0,0,0,0,1014,493,1014
2017,36,47,"Mecidiyekoy",41.0716,28.9961,13.4571428571429,23.3142857142857,0.0768571428571429,62.8,35.4985714285714,81.4757142857143,507,69,170,62,148,1321,438,1151
2017,37,47,"Mecidiyekoy",41.0716,28.9961,13.9571428571429,25.1285714285714,0,69.6142857142857,52.5728571428571,82.1028571428571,589,0,0,118,221,1138,589,1138
2017,38,47,"Mecidiyekoy",41.0716,28.9961,16.0142857142857,22.1571428571429,2.22685714285714,72.4285714285714,51.3133333333333,79.3183333333333,671,0,0,204,451,1312,671,1312
2017,39,47,"Mecidiyekoy",41.0716,28.9961,22.4571428571429,18.8857142857143,16.1004285714286,79.1857142857143,37.7628571428571,62.4685714285714,782,0,0,26,72,1630,782,1630
2017,40,47,"Mecidiyekoy",41.0716,28.9961,11.4142857142857,16.8428571428571,1.66071428571429,72.1142857142857,50.9957142857143,75.1014285714286,543,114,334,42,70,1137,429,803
2017,41,47,"Mecidiyekoy",41.0716,28.9961,11.6142857142857,15.1428571428571,0.734714285714286,73.8857142857143,55.2228571428571,81.6442857142857,487,0,0,88,70,843,487,843
2017,42,47,"Mecidiyekoy",41.0716,28.9961,11.4142857142857,17.0285714285714,0.016,80.7,71.0485714285714,80.2728571428571,530,93,103,23,37,815,437,712
2017,43,47,"Mecidiyekoy",41.0716,28.9961,14.3142857142857,14.6714285714286,6.46542857142857,85.1714285714286,47.2185714285714,63.4971428571429,506,0,0,69,237,919,506,919
2017,44,47,"Mecidiyekoy",41.0716,28.9961,12.6857142857143,11.0571428571429,3.15414285714286,69.9571428571429,47.5883333333333,70.91,561,4,0,183,305,1102,557,1102
2017,45,47,"Mecidiyekoy",41.0716,28.9961,12.9571428571429,13.6,0.165714285714286,80,53.1483333333333,72.13,577,91,235,79,108,829,486,594
2017,46,47,"Mecidiyekoy",41.0716,28.9961,13.1142857142857,14.6857142857143,0.194571428571429,82.1714285714286,56.5283333333333,68.64,587,0,0,0,0,1085,587,1085
2017,47,47,"Mecidiyekoy",41.0716,28.9961,16.0714285714286,10.3857142857143,7.139,80.7285714285714,52.6342857142857,64.4228571428571,418,45,170,176,242,804,373,634
2017,48,47,"Mecidiyekoy",41.0716,28.9961,11.6571428571429,14.4714285714286,1.18971428571429,68.3714285714286,33.0714285714286,55.82,386,147,235,68,118,619,239,384
2017,49,47,"Mecidiyekoy",41.0716,28.9961,16.0714285714286,9.84285714285714,3.84214285714286,71.2428571428571,35.5742857142857,53.5085714285714,407,0,0,185,368,645,407,645
2017,50,47,"Mecidiyekoy",41.0716,28.9961,13.5857142857143,14.1857142857143,1.16642857142857,71.9142857142857,42.3242857142857,54.67,346,0,0,0,0,442,346,442
2017,51,47,"Mecidiyekoy",41.0716,28.9961,18.9714285714286,5.77142857142857,10.7801428571429,85.6857142857143,23.59,53.1942857142857,386,0,0,78,87,349,386,349
2017,52,47,"Mecidiyekoy",41.0716,28.9961,15.4375,9.3875,3.850625,75.05,37.6371428571429,61.4,528,186,219,96,140,507,342,288
2018,1,47,"Mecidiyekoy",41.0716,28.9961,14.575,8.7625,0.5485,80.65,44.88,61.6985714285714,618,189,267,123,151,914,429,647
2018,2,47,"Mecidiyekoy",41.0716,28.9961,17.7428571428571,8.7,1.26185714285714,86.9,50.6057142857143,57.76,624,0,0,0,0,1309,624,1309
2018,3,47,"Mecidiyekoy",41.0716,28.9961,15.6285714285714,7.84285714285714,3.80842857142857,73.9714285714286,31.5228571428571,57.2085714285714,639,69,197,16,4,655,570,458
2018,4,47,"Mecidiyekoy",41.0716,28.9961,23.4428571428571,4.64285714285714,1.80957142857143,72.1,32.3814285714286,62.19,604,0,0,145,234,764,604,764
2018,5,47,"Mecidiyekoy",41.0716,28.9961,14.1857142857143,10.6285714285714,1.79942857142857,71.2857142857143,87.4733333333333,61.68,670,0,0,85,54,819,670,819
2018,6,47,"Mecidiyekoy",41.0716,28.9961,14.9428571428571,8.32857142857143,3.69457142857143,87.1142857142857,70.9514285714286,63.0857142857143,704,0,0,188,261,1022,704,1022
2018,7,47,"Mecidiyekoy",41.0716,28.9961,14.7714285714286,6.85714285714286,0.667714285714286,83.7714285714286,47.5928571428571,59.96,478,71,104,80,74,557,407,453
2018,8,47,"Mecidiyekoy",41.0716,28.9961,19.2428571428571,7.05714285714286,1.37242857142857,87.4,47.3685714285714,57.2642857142857,711,0,0,0,0,1321,711,1321
2018,9,47,"Mecidiyekoy",41.0716,28.9961,16.4428571428571,5.98571428571429,7.83585714285714,84.2428571428571,40.966,62.4571428571429,621,65,92,242,333,956,556,864
2018,10,47,"Mecidiyekoy",41.0716,28.9961,11.6571428571429,10.7,3.07314285714286,82.6571428571429,55.86,73.6214285714286,556,0,0,63,126,1330,556,1330
2018,11,47,"Mecidiyekoy",41.0716,28.9961,10.9571428571429,14.4714285714286,0.195571428571429,65.1571428571429,44.5416666666667,68.4571428571429,551,65,185,0,0,1426,486,1241
2018,12,47,"Mecidiyekoy",41.0716,28.9961,18.3857142857143,8.78571428571429,2.13685714285714,86.4571428571429,36.7957142857143,58.6942857142857,425,0,0,0,0,1187,425,1187
2018,13,47,"Mecidiyekoy",41.0716,28.9961,13.3714285714286,11.4571428571429,2.42485714285714,74.0428571428571,97.2771428571429,72.2114285714286,356,108,116,83,130,428,248,312
2018,14,47,"Mecidiyekoy",41.0716,28.9961,15.0714285714286,12.3142857142857,2.42157142857143,70.3,77.4528571428571,83.7657142857143,407,0,0,36,41,486,407,486
2018,15,47,"Mecidiyekoy",41.0716,28.9961,14.3857142857143,11.5,0.0651428571428572,85.4142857142857,87.8728571428571,74.5114285714286,374,0,0,133,257,450,374,450
2018,16,47,"Mecidiyekoy",41.0716,28.9961,14.5571428571429,12.7428571428571,0.286857142857143,75.7,61.0785714285714,69.0971428571429,411,55,71,20,85,648,356,577
2018,17,47,"Mecidiyekoy",41.0716,28.9961,15.2857142857143,18.1571428571429,0,64.5285714285714,78.7957142857143,87.6328571428571,419,0,0,47,15,652,419,652
2018,18,47,"Mecidiyekoy",41.0716,28.9961,16.7,14.8571428571429,0.394571428571429,84.8714285714286,49.3242857142857,58.6142857142857,303,0,0,1,33,474,303,474
2018,19,47,"Mecidiyekoy",41.0716,28.9961,13.3428571428571,16.9285714285714,4.00914285714286,82.7,53.814,64.448,275,0,0,70,60,467,275,467
2018,20,47,"Mecidiyekoy",41.0716,28.9961,12.9714285714286,21.9,0.188285714285714,63.0285714285714,71.2185714285714,87.2342857142857,204,23,33,0,0,306,181,273
2018,21,47,"Mecidiyekoy",41.0716,28.9961,18.4857142857143,20.2714285714286,1.30157142857143,81.4857142857143,45.0514285714286,61.2671428571429,252,0,0,0,0,281,252,281
2018,22,47,"Mecidiyekoy",41.0716,28.9961,17.3571428571429,20.5142857142857,0.178142857142857,73.4428571428571,52.58,60.9257142857143,249,0,0,4,0,427,249,427
2018,23,47,"Mecidiyekoy",41.0716,28.9961,15.9,23.6571428571429,0.163571428571429,71.2,71.1116666666667,86.4185714285714,267,0,0,36,201,812,267,812
2018,24,47,"Mecidiyekoy",41.0716,28.9961,17.0857142857143,23.2714285714286,1.57971428571429,72.5285714285714,35.3533333333333,64.4733333333333,267,0,0,10,1,448,267,448
2018,25,47,"Mecidiyekoy",41.0716,28.9961,17.0714285714286,23.6428571428571,2.92285714285714,75.3571428571429,38.588,65.1333333333333,358,0,0,90,95,518,358,518
2018,26,47,"Mecidiyekoy",41.0716,28.9961,17.3714285714286,23.5857142857143,4.03128571428571,72.8142857142857,40.53,59.39,355,0,0,38,65,587,355,587
2018,27,47,"Mecidiyekoy",41.0716,28.9961,16.2285714285714,25.8,0,60.7714285714286,41.7571428571429,77.0642857142857,342,0,0,0,0,418,342,418
2018,28,47,"Mecidiyekoy",41.0716,28.9961,15.0714285714286,26.3857142857143,0.141428571428571,69.9285714285714,40.5842857142857,66.1071428571429,286,0,0,8,2,585,286,585
2018,29,47,"Mecidiyekoy",41.0716,28.9961,12.0857142857143,26.4714285714286,0.474428571428571,64.7571428571429,64.1828571428571,80.7471428571429,260,65,261,81,181,756,195,495
2018,30,47,"Mecidiyekoy",41.0716,28.9961,14.8571428571429,25.2142857142857,6.97757142857143,76.6142857142857,52.43,78.5314285714286,265,0,0,109,451,822,265,822
2018,31,47,"Mecidiyekoy",41.0716,28.9961,18.9142857142857,27.1428571428571,0.207142857142857,74.6714285714286,53.2571428571429,61.95,267,0,0,0,0,499,267,499
2018,32,47,"Mecidiyekoy",41.0716,28.9961,20.5857142857143,26.6857142857143,0,64.8857142857143,53.4085714285714,66.2114285714286,297,0,0,0,0,403,297,403
2018,33,47,"Mecidiyekoy",41.0716,28.9961,18.4714285714286,26.1285714285714,0.0468571428571429,70.4285714285714,45.8814285714286,68.5028571428571,216,0,0,0,0,332,216,332
2018,34,47,"Mecidiyekoy",41.0716,28.9961,18.7714285714286,26.0857142857143,0,68.3857142857143,43.5285714285714,54.4185714285714,144,0,0,0,0,227,144,227
2018,35,47,"Mecidiyekoy",41.0716,28.9961,18.7428571428571,26.4857142857143,0.33,76.6428571428571,53.59,59.0285714285714,201,0,0,12,42,314,201,314
2018,36,47,"Mecidiyekoy",41.0716,28.9961,14.5,24.4857142857143,10.8867142857143,75.0571428571428,72.2325,73.2875,341,0,0,90,94,370,341,370
2018,37,47,"Mecidiyekoy",41.0716,28.9961,16.5142857142857,21.9,11.562,75.8428571428571,56.6583333333333,79.5283333333333,241,0,0,71,134,419,241,419
2018,38,47,"Mecidiyekoy",41.0716,28.9961,22.9142857142857,22.2714285714286,0.0142857142857143,70.7714285714286,43.5514285714286,69.6371428571429,189,0,0,1,0,344,189,344
2018,39,47,"Mecidiyekoy",41.0716,28.9961,24.0857142857143,18.2857142857143,7.081,76.9,40.1814285714286,62.5485714285714,180,0,0,13,28,353,180,353
2018,40,47,"Mecidiyekoy",41.0716,28.9961,19.1428571428571,18.8142857142857,1.03685714285714,75.2,48.7242857142857,66.3185714285714,191,0,0,2,3,341,191,341
2018,41,47,"Mecidiyekoy",41.0716,28.9961,20.1428571428571,18.0571428571429,1.12414285714286,81.3857142857143,NA,50.73,187,0,0,0,0,422,187,422
2018,42,47,"Mecidiyekoy",41.0716,28.9961,15.2285714285714,18.4142857142857,0.610714285714286,84.3714285714286,81.905,64.9914285714286,168,0,0,20,64,381,168,381
2018,43,47,"Mecidiyekoy",41.0716,28.9961,20.8571428571429,15.9714285714286,1.09328571428571,66.3714285714286,74.6142857142857,65.09,187,32,75,40,45,402,155,327
2018,44,47,"Mecidiyekoy",41.0716,28.9961,14.3142857142857,16.9714285714286,0,74.4714285714286,95.052,85.278,196,27,32,37,35,264,169,232
2018,45,47,"Mecidiyekoy",41.0716,28.9961,16.9857142857143,15.3714285714286,0.643,78.3142857142857,43.66,62.8471428571429,231,0,0,0,0,473,231,473
2018,46,47,"Mecidiyekoy",41.0716,28.9961,18.7142857142857,11.0428571428571,9.41357142857143,80.0857142857143,41.1671428571429,54.1957142857143,230,0,0,59,106,465,230,465
2018,47,47,"Mecidiyekoy",41.0716,28.9961,18.1714285714286,11.7571428571429,4.45371428571429,80.2428571428571,62.7157142857143,58.2771428571429,270,90,214,0,0,499,180,285
2018,48,47,"Mecidiyekoy",41.0716,28.9961,26.2285714285714,9.82857142857143,8.90171428571429,81.3285714285714,45.7071428571429,49.6685714285714,245,0,0,47,81,201,245,201
2018,49,47,"Mecidiyekoy",41.0716,28.9961,20.6142857142857,8.51428571428571,4.78871428571429,75,57.0057142857143,59.1371428571429,257,43,47,43,106,420,214,373
2018,50,47,"Mecidiyekoy",41.0716,28.9961,19.2285714285714,8.7,7.96771428571429,75.7571428571429,73.9671428571429,66.2242857142857,256,29,3,101,126,305,227,302
2018,51,47,"Mecidiyekoy",41.0716,28.9961,22.2428571428571,7.45714285714286,9.21842857142857,83.6142857142857,62.5328571428571,45.8285714285714,250,0,0,116,174,248,250,248
2018,52,47,"Mecidiyekoy",41.0716,28.9961,19.0285714285714,5.78571428571429,7.17757142857143,76.6714285714286,66.9414285714286,59.79,244,0,0,150,177,273,244,273
2019,1,47,"Mecidiyekoy",41.0716,28.9961,29.4625,5.0625,9.9235,79.925,39.795,53.75375,343,0,0,66,204,784,343,784
2019,2,47,"Mecidiyekoy",41.0716,28.9961,26.1428571428571,4.65714285714286,4.99528571428571,74.2285714285714,51.3171428571429,55.7442857142857,255,68,61,67,85,208,187,147
2019,3,47,"Mecidiyekoy",41.0716,28.9961,18.6,6.94285714285714,1.40685714285714,70.9,69.1971428571429,66.7457142857143,192,14,48,50,24,198,178,150
2019,4,47,"Mecidiyekoy",41.0716,28.9961,18.2571428571429,9.42857142857143,0.766285714285714,73.1857142857143,82.5285714285714,66.5657142857143,308,106,102,1,6,314,202,212
2019,5,47,"Mecidiyekoy",41.0716,28.9961,17.1,11.5428571428571,1.222,64.9428571428572,71.9442857142857,68.2885714285714,253,160,92,0,0,143,93,51
2019,6,47,"Mecidiyekoy",41.0716,28.9961,20.7857142857143,7.45714285714286,2.30585714285714,78.5857142857143,63.9214285714286,61.4885714285714,276,0,0,22,17,127,276,127
2019,7,47,"Mecidiyekoy",41.0716,28.9961,21.3857142857143,6.9,4.61471428571429,72.8857142857143,53.3757142857143,59.7228571428571,325,0,0,0,0,234,325,234
2019,8,47,"Mecidiyekoy",41.0716,28.9961,17.9,5.22857142857143,4.92842857142857,82.8857142857143,112.52,73.8414285714286,305,0,0,119,93,219,305,219
2019,9,47,"Mecidiyekoy",41.0716,28.9961,22.7714285714286,6.65714285714286,1.87928571428571,73.0428571428571,61.27,66.58,331,0,0,67,86,310,331,310
2019,10,47,"Mecidiyekoy",41.0716,28.9961,13,11.2285714285714,0.266,63.4285714285714,92.8585714285714,89.1071428571429,359,0,0,52,44,252,359,252
2019,11,47,"Mecidiyekoy",41.0716,28.9961,19.0857142857143,9.95714285714286,4.29985714285714,70.4571428571429,63.8142857142857,68.5042857142857,373,0,0,71,40,400,373,400
2019,12,47,"Mecidiyekoy",41.0716,28.9961,16.1571428571429,10.2714285714286,0,67.2714285714286,82.4957142857143,79.58,343,0,0,13,258,416,343,416
2019,13,47,"Mecidiyekoy",41.0716,28.9961,23.8285714285714,8.3,0.000714285714285714,65.5428571428571,70.1342857142857,67.1814285714286,256,0,0,3,4,194,256,194
2019,14,47,"Mecidiyekoy",41.0716,28.9961,18.0571428571429,9.5,0.026,74.5285714285714,71.3971428571429,68.45,365,0,0,5,2,208,365,208
2019,15,47,"Mecidiyekoy",41.0716,28.9961,14.7285714285714,13.4285714285714,3.08828571428571,78.8857142857143,63.8271428571429,74.4128571428571,359,0,0,119,90,183,359,183
2019,16,47,"Mecidiyekoy",41.0716,28.9961,17.9857142857143,9.28571428571428,0.971285714285714,70.7857142857143,54.1628571428571,66.0757142857143,318,0,0,64,100,208,318,208
2019,17,47,"Mecidiyekoy",41.0716,28.9961,15.3285714285714,13.0571428571429,0.0387142857142857,65.5857142857143,79.1771428571429,81.4771428571429,412,0,0,63,33,313,412,313
2019,18,47,"Mecidiyekoy",41.0716,28.9961,13.4,18.2285714285714,1.78985714285714,62.7285714285714,97.4742857142857,75.9942857142857,523,107,42,47,28,353,416,311
2019,19,47,"Mecidiyekoy",41.0716,28.9961,13.6571428571429,15.7571428571429,4.43,70.2142857142857,75.1485714285714,69.6514285714286,452,64,73,130,93,386,388,313
2019,20,47,"Mecidiyekoy",41.0716,28.9961,19.7714285714286,18.0285714285714,0.152857142857143,72.2142857142857,69.5157142857143,65.7785714285714,454,0,0,57,51,389,454,389
2019,21,47,"Mecidiyekoy",41.0716,28.9961,13.8,21.0285714285714,3.56185714285714,65.4571428571429,85.842,79.558,457,34,53,142,202,413,423,360
2019,22,47,"Mecidiyekoy",41.0716,28.9961,14.7,22.6714285714286,0.139857142857143,69.0714285714286,72.2666666666667,75.0566666666667,453,0,0,1,0,323,453,323
2019,23,47,"Mecidiyekoy",41.0716,28.9961,14.6,23.1428571428571,0.198142857142857,65.3857142857143,56.5214285714286,62.1828571428571,378,0,0,106,49,532,378,532
2019,24,47,"Mecidiyekoy",41.0716,28.9961,15.3714285714286,24.1142857142857,0.566,77.0857142857143,65.94,54.2966666666667,378,0,0,167,43,244,378,244
2019,25,47,"Mecidiyekoy",41.0716,28.9961,14,24.9142857142857,1.76185714285714,76.8285714285714,67.9242857142857,65.526,306,0,0,69,125,325,306,325
2019,26,47,"Mecidiyekoy",41.0716,28.9961,21.2,25.4285714285714,0.104714285714286,65.5428571428571,59.3228571428571,65.85,377,0,0,0,0,342,377,342
2019,27,47,"Mecidiyekoy",41.0716,28.9961,18.4571428571429,24.9285714285714,0,66.8571428571429,50.4957142857143,65.0828571428571,456,0,0,0,0,222,456,222
2019,28,47,"Mecidiyekoy",41.0716,28.9961,16.2857142857143,23.1857142857143,5.49957142857143,66.8285714285714,53.9183333333333,72.4033333333333,398,0,0,11,26,421,398,421
2019,29,47,"Mecidiyekoy",41.0716,28.9961,18.2142857142857,23.1285714285714,4.44528571428571,71.0714285714286,46.8314285714286,62.6285714285714,453,0,0,57,5,203,453,203
2019,30,47,"Mecidiyekoy",41.0716,28.9961,17.7571428571429,24.2285714285714,3.18642857142857,72.5,49.524,63.7214285714286,456,0,0,0,0,335,456,335
2019,31,47,"Mecidiyekoy",41.0716,28.9961,15.5142857142857,26.0285714285714,0.0525714285714286,69.3,48.9114285714286,62.8957142857143,334,0,0,23,20,375,334,375
2019,32,47,"Mecidiyekoy",41.0716,28.9961,19.0571428571429,24.6571428571429,0.0165714285714286,66.3142857142857,39.1314285714286,59.8514285714286,346,0,0,0,0,395,346,395
2019,33,47,"Mecidiyekoy",41.0716,28.9961,19.6428571428571,23.9857142857143,5.07114285714286,74.9142857142857,40.9971428571429,47.7171428571429,337,0,0,2,2,531,337,531
2019,34,47,"Mecidiyekoy",41.0716,28.9961,19.6428571428571,24.5857142857143,0.628142857142857,77.6857142857143,58.4328571428571,57.4457142857143,299,0,0,89,102,345,299,345
2019,35,47,"Mecidiyekoy",41.0716,28.9961,21.6428571428571,24.9,0,71.3428571428571,53.2857142857143,58.6571428571429,307,0,0,0,0,415,307,415
2019,36,47,"Mecidiyekoy",41.0716,28.9961,21.7714285714286,23.9,0.256142857142857,69.0428571428571,50.6485714285714,63.9157142857143,171,0,0,0,0,67,171,67
2019,37,47,"Mecidiyekoy",41.0716,28.9961,22.6142857142857,23,0.108142857142857,68.0428571428571,53.395,61.14,218,0,0,0,0,55,218,55
2019,38,47,"Mecidiyekoy",41.0716,28.9961,15.6428571428571,20.1428571428571,2.39942857142857,66.1714285714286,57.3057142857143,70.0971428571429,266,0,0,6,0,91,266,91
2019,39,47,"Mecidiyekoy",41.0716,28.9961,11.6428571428571,19.5714285714286,0.319857142857143,74.7142857142857,64.0971428571429,74.4328571428571,237,0,0,88,36,79,237,79
2019,40,47,"Mecidiyekoy",41.0716,28.9961,16.3714285714286,20.6714285714286,4.70942857142857,71.6857142857143,52.066,62.266,241,0,0,33,25,111,241,111
2019,41,47,"Mecidiyekoy",41.0716,28.9961,16.0714285714286,17.5,2.93914285714286,78.9714285714286,44.9,60.8728571428571,416,0,0,0,0,448,416,448
2019,42,47,"Mecidiyekoy",41.0716,28.9961,16.1714285714286,18.4,0.00414285714285714,82.9,68.7957142857143,70.9485714285714,356,0,0,0,0,408,356,408
2019,43,47,"Mecidiyekoy",41.0716,28.9961,21.6,17.5714285714286,0,78.2285714285714,54.3333333333333,64.7766666666667,306,0,0,0,0,300,306,300
2019,44,47,"Mecidiyekoy",41.0716,28.9961,17,14.5428571428571,7.332,81.0428571428571,59.6157142857143,63.1557142857143,350,0,0,5,26,250,350,250
2019,45,47,"Mecidiyekoy",41.0716,28.9961,12.2285714285714,19.4571428571429,0.000285714285714286,66.7,82.1771428571429,67.0771428571429,417,61,27,0,0,328,356,301
2019,46,47,"Mecidiyekoy",41.0716,28.9961,13.7714285714286,16.6,0.115428571428571,78.9857142857143,102.338571428571,75.5214285714286,401,61,55,55,36,337,340,282
2019,47,47,"Mecidiyekoy",41.0716,28.9961,16.9571428571429,14.6428571428571,0.181142857142857,81.5285714285714,93.0414285714286,71.0657142857143,391,0,0,0,0,339,391,339
2019,48,47,"Mecidiyekoy",41.0716,28.9961,24.1,14,5.99057142857143,79.1285714285714,53.4985714285714,53.4185714285714,320,0,0,45,33,251,320,251
2019,49,47,"Mecidiyekoy",41.0716,28.9961,19.6428571428571,8.77142857142857,2.02514285714286,74.6571428571429,36.698,58.552,393,0,0,73,67,274,393,274
2019,50,47,"Mecidiyekoy",41.0716,28.9961,13.9285714285714,10.9,0.370857142857143,78.1428571428571,72.148,67.428,218,34,5,1,1,119,184,114
2019,51,47,"Mecidiyekoy",41.0716,28.9961,17.2,12.9285714285714,0.0418571428571429,73.0571428571428,84.0228571428571,61.6228571428571,361,105,130,2,2,488,256,358
2019,52,47,"Mecidiyekoy",41.0716,28.9961,21.5285714285714,8.68571428571429,6.84328571428571,79.0714285714286,33.0483333333333,44.1116666666667,279,0,0,128,147,281,279,281
2020,1,47,"Mecidiyekoy",41.0716,28.9961,19.18,6.26,4.9684,76.94,55.888,54.696,160,0,0,34,19,126,160,126
2020,2,47,"Mecidiyekoy",41.0716,28.9961,26.9857142857143,6.04285714285714,13.2688571428571,82.4571428571429,49.9828571428571,46.49,240,0,0,32,16,173,240,173
2020,3,47,"Mecidiyekoy",41.0716,28.9961,22.1285714285714,7.11428571428571,0.228714285714286,78.4571428571429,46.6942857142857,52.3442857142857,270,0,0,0,0,382,270,382
2020,4,47,"Mecidiyekoy",41.0716,28.9961,20.4714285714286,6.01428571428571,1.93771428571429,72.3,65.86,48.0933333333333,358,0,0,174,94,295,358,295
2020,5,47,"Mecidiyekoy",41.0716,28.9961,17.2285714285714,9.81428571428571,4.03528571428571,76.9428571428571,59.2683333333333,57.8528571428571,331,64,57,11,14,272,267,215
2020,6,47,"Mecidiyekoy",41.0716,28.9961,23.7428571428571,6.98571428571429,4.90071428571429,76.4571428571429,38.8733333333333,46.2071428571429,343,0,0,138,108,267,343,267
2020,7,47,"Mecidiyekoy",41.0716,28.9961,22.1571428571429,8.15714285714286,1.59957142857143,72.7714285714286,49.9025,55.1625,341,43,48,34,22,338,298,290
2020,8,47,"Mecidiyekoy",41.0716,28.9961,18.5285714285714,6.68571428571429,1.85985714285714,81.0714285714286,49.08,52.9025,283,0,0,16,17,187,283,187
2020,9,47,"Mecidiyekoy",41.0716,28.9961,23.0428571428571,10.2428571428571,2.65528571428571,68.4142857142857,52.1228571428571,52.5685714285714,393,2,3,0,0,528,391,525
2020,10,47,"Mecidiyekoy",41.0716,28.9961,13.8142857142857,13.7571428571429,0.218142857142857,66.7,70.3528571428571,37.32,205,0,0,35,28,210,205,210
2020,11,47,"Mecidiyekoy",41.0716,28.9961,22.1142857142857,10.6142857142857,1.77842857142857,81.1571428571429,73.032,37.6685714285714,115,0,0,23,11,94,115,94
2020,12,47,"Mecidiyekoy",41.0716,28.9961,24.6714285714286,7.32857142857143,0.515714285714286,68.7,52.1857142857143,33.8642857142857,117,0,0,3,0,118,117,118
2020,13,47,"Mecidiyekoy",41.0716,28.9961,25.2714285714286,8.5,3.648,86.2,84.4942857142857,32.33,136,0,0,19,23,92,136,92
2020,14,47,"Mecidiyekoy",41.0716,28.9961,26.0857142857143,8.65714285714286,3.33428571428571,84.8571428571429,55.5566666666667,40.4,155,0,0,22,19,121,155,121
2020,15,47,"Mecidiyekoy",41.0716,28.9961,28.8428571428571,9.84285714285714,0.141857142857143,68.7142857142857,51.0357142857143,36.9783333333333,133,0,0,1,0,118,133,118
2020,16,47,"Mecidiyekoy",41.0716,28.9961,15.7,12.9428571428571,0.893714285714286,63.3142857142857,47.0742857142857,52.4014285714286,141,0,0,11,3,106,141,106
2020,17,47,"Mecidiyekoy",41.0716,28.9961,26.8428571428571,11.4714285714286,0.104571428571429,67.2142857142857,36.6,32.705,137,0,0,35,17,123,137,123
2020,18,47,"Mecidiyekoy",41.0716,28.9961,17.0142857142857,17.0714285714286,1.38785714285714,63.4428571428571,37.9757142857143,44.0971428571429,146,26,21,0,0,164,120,143
2020,19,47,"Mecidiyekoy",41.0716,28.9961,21.0428571428571,14.7428571428571,3.64042857142857,71.8285714285714,35.93,40.9642857142857,137,0,0,70,60,157,137,157
2020,20,47,"Mecidiyekoy",41.0716,28.9961,19.7,21.1285714285714,0,62.6142857142857,74.35,47.49,164,0,0,31,20,164,164,164
2020,21,47,"Mecidiyekoy",41.0716,28.9961,26.5857142857143,17.4571428571429,2.81785714285714,72.1428571428571,40.3185714285714,34.8414285714286,146,0,0,50,43,96,146,96
2020,22,47,"Mecidiyekoy",41.0716,28.9961,19.1,16.2571428571429,1.73557142857143,73.5,27.47,32.61,118,0,0,13,30,100,118,100
2020,23,47,"Mecidiyekoy",41.0716,28.9961,15.3714285714286,19.9,2.02114285714286,66.2,47.5971428571429,55.8857142857143,112,12,2,17,1,70,100,68
2020,24,47,"Mecidiyekoy",41.0716,28.9961,18.0428571428571,22.8428571428571,0.536571428571429,67.3428571428571,49.1085714285714,49.4842857142857,140,0,0,5,5,150,140,150
2020,25,47,"Mecidiyekoy",41.0716,28.9961,18.1142857142857,23.2,2.78828571428571,75.4571428571429,58.6575,55.72,137,0,0,63,48,108,137,108
2020,26,47,"Mecidiyekoy",41.0716,28.9961,21.1428571428571,23.3571428571429,0.484857142857143,75.8285714285714,39.13,44.72,173,0,0,37,41,133,173,133
2020,27,47,"Mecidiyekoy",41.0716,28.9961,20.8,25.8285714285714,0.00342857142857143,73.6571428571429,52.84,50.1071428571429,113,0,0,0,0,113,113,113
2020,28,47,"Mecidiyekoy",41.0716,28.9961,28.7857142857143,24.8142857142857,0.0121428571428571,71.8142857142857,40.3957142857143,41.6742857142857,164,0,0,1,0,122,164,122
2020,29,47,"Mecidiyekoy",41.0716,28.9961,23.1285714285714,22.9142857142857,0.00957142857142857,68.6714285714286,43.1642857142857,43.3485714285714,186,0,0,0,0,111,186,111
2020,30,47,"Mecidiyekoy",41.0716,28.9961,24.9285714285714,25.0285714285714,0,71.4714285714286,48.4842857142857,48.03,190,0,0,0,0,142,190,142
2020,31,47,"Mecidiyekoy",41.0716,28.9961,22.7714285714286,26.1142857142857,0,70.5571428571428,39.4028571428571,48.7414285714286,150,0,0,0,0,127,150,127
2020,32,47,"Mecidiyekoy",41.0716,28.9961,27.8714285714286,25.5285714285714,0,71.5571428571428,34.1528571428571,41.8757142857143,146,0,0,0,0,107,146,107
2020,33,47,"Mecidiyekoy",41.0716,28.9961,25.8571428571429,25.5571428571429,0,65.4142857142857,36.33,48.45,183,0,0,0,0,83,183,83
2020,34,47,"Mecidiyekoy",41.0716,28.9961,21.3428571428571,24.1,1.449,70.6857142857143,45.7366666666667,54.986,197,0,0,8,5,97,197,97
2020,35,47,"Mecidiyekoy",41.0716,28.9961,22.3428571428571,25.0428571428571,0,68.7857142857143,38.6657142857143,53.4271428571429,164,0,0,0,0,157,164,157
2020,36,47,"Mecidiyekoy",41.0716,28.9961,20.4285714285714,24.1857142857143,0.486714285714286,73.1142857142857,39.0428571428571,50.9714285714286,179,0,0,29,17,112,179,112
2020,37,47,"Mecidiyekoy",41.0716,28.9961,27.4285714285714,24.1285714285714,0.0831428571428571,74.7571428571429,46.315,52.2383333333333,193,0,0,3,2,91,193,91
2020,38,47,"Mecidiyekoy",41.0716,28.9961,27.0571428571429,23.3,0.112857142857143,71.4857142857143,44.52,46.7257142857143,235,0,0,3,2,157,235,157
2020,39,47,"Mecidiyekoy",41.0716,28.9961,19.9428571428571,23.1428571428571,0.491428571428571,66.6714285714286,51.6766666666667,64.4128571428571,220,20,6,52,18,129,200,123
2020,40,47,"Mecidiyekoy",41.0716,28.9961,12.0142857142857,21.2857142857143,1.60642857142857,62.3714285714286,53.1671428571429,68.7014285714286,187,0,0,93,75,154,187,154
2020,41,47,"Mecidiyekoy",41.0716,28.9961,12.7285714285714,21.5428571428571,5.26371428571429,73.1571428571429,72.2257142857143,70.4542857142857,182,14,7,78,50,127,168,120
2020,42,47,"Mecidiyekoy",41.0716,28.9961,14.8142857142857,20.6,2.49485714285714,72.1571428571429,63.305,59.8757142857143,177,33,8,12,7,111,144,103
2020,43,47,"Mecidiyekoy",41.0716,28.9961,18.2142857142857,17.8142857142857,2.49071428571429,80.4571428571429,72.3971428571429,53.6485714285714,194,0,0,28,8,161,194,161
2020,44,47,"Mecidiyekoy",41.0716,28.9961,17.8857142857143,16.3857142857143,8.48628571428571,81.8428571428571,66.3185714285714,49.57,255,0,0,139,126,233,255,233
2020,45,47,"Mecidiyekoy",41.0716,28.9961,19.5428571428571,13.5142857142857,4.07928571428571,82.4,50.942,48.1333333333333,156,0,0,35,27,103,156,103
2020,46,47,"Mecidiyekoy",41.0716,28.9961,21.1142857142857,14.1571428571429,1.21571428571429,79.5857142857143,43.3457142857143,42.6957142857143,208,0,0,2,2,109,208,109
2020,47,47,"Mecidiyekoy",41.0716,28.9961,23.9142857142857,11.4285714285714,2.592,78.7142857142857,48.5657142857143,45.7142857142857,173,0,0,3,2,83,173,83
2020,48,47,"Mecidiyekoy",41.0716,28.9961,17.0285714285714,10.3428571428571,0.186571428571429,72.5,63.6671428571429,54.5571428571429,199,38,20,1,1,262,161,242
2020,49,47,"Mecidiyekoy",41.0716,28.9961,21.6714285714286,9.7,0.538428571428571,84.5428571428571,69.996,41.8733333333333,207,0,0,38,8,116,207,116
2020,50,47,"Mecidiyekoy",41.0716,28.9961,16.1285714285714,12.7857142857143,1.25571428571429,76.2571428571429,51.8642857142857,46.9557142857143,181,48,56,0,0,98,133,42
2020,51,47,"Mecidiyekoy",41.0716,28.9961,20.7857142857143,9.67142857142857,2.98042857142857,87.7285714285714,41.0566666666667,34.8342857142857,171,0,0,0,0,90,171,90
2020,52,47,"Mecidiyekoy",41.0716,28.9961,18.0714285714286,10.6142857142857,0.597285714285714,75.2,62.6514285714286,40.3457142857143,203,14,22,0,0,113,189,91
2020,53,47,"Mecidiyekoy",41.0716,28.9961,16.1,13.9,0.3815,65.725,46.2825,47.5275,122,38,30,0,0,111,84,81
2017,1,48,"Silivri",41.0749,28.2488,24.8571428571429,1.2,7.07471428571429,86.6285714285714,35.3533333333333,27.5628571428571,563,148,204,200,326,847,415,643
2017,2,48,"Silivri",41.0749,28.2488,27.0285714285714,1.3,5.043,83.6,39.2328571428571,31.45,757,186,277,235,352,1214,571,937
2017,3,48,"Silivri",41.0749,28.2488,29.0285714285714,3.34285714285714,2.79871428571429,89.2,29.8842857142857,23.67,762,0,0,338,512,1449,762,1449
2017,4,48,"Silivri",41.0749,28.2488,27.5428571428571,1.2,0.201857142857143,77.8142857142857,33.3457142857143,27.2085714285714,639,0,0,306,367,889,639,889
2017,5,48,"Silivri",41.0749,28.2488,20.7285714285714,4.95714285714286,0.381285714285714,78.0428571428571,47.2957142857143,39.8042857142857,588,67,99,0,0,1163,521,1064
2017,6,48,"Silivri",41.0749,28.2488,28.0714285714286,6.04285714285714,0.348142857142857,79.7,28.9585714285714,24.3528571428571,736,131,203,269,798,1519,605,1316
2017,7,48,"Silivri",41.0749,28.2488,23,2.74285714285714,0.275857142857143,75.0285714285714,45.8428571428571,40.2128571428571,492,61,47,280,477,717,431,670
2017,8,48,"Silivri",41.0749,28.2488,25,8.87142857142857,3.62785714285714,79.3142857142857,37.365,33.0928571428571,739,0,0,0,0,1747,739,1747
2017,9,48,"Silivri",41.0749,28.2488,14.4,8.45714285714286,0.255428571428571,82.7,50.0414285714286,42.2742857142857,574,4,10,158,272,866,570,856
2017,10,48,"Silivri",41.0749,28.2488,28.3571428571429,9.74285714285714,1.357,79.3428571428571,51.3257142857143,29.5085714285714,712,0,0,166,304,1043,712,1043
2017,11,48,"Silivri",41.0749,28.2488,22.8,6.47142857142857,3.44171428571429,83.3285714285714,49.7228571428571,36.4971428571429,525,0,0,362,498,725,525,725
2017,12,48,"Silivri",41.0749,28.2488,28.4571428571429,9.91428571428571,0.625428571428571,74.7142857142857,43.8842857142857,35.1528571428571,589,22,83,27,28,1077,567,994
2017,13,48,"Silivri",41.0749,28.2488,28.0285714285714,9.32857142857143,0.342142857142857,66.4714285714286,33.1257142857143,24.2614285714286,574,0,0,28,61,887,574,887
2017,14,48,"Silivri",41.0749,28.2488,17.8857142857143,10.0571428571429,0.503,77.6428571428571,42.1342857142857,32.68,639,0,0,243,514,1336,639,1336
2017,15,48,"Silivri",41.0749,28.2488,18.7142857142857,12.5714285714286,0.0278571428571429,61.8428571428571,55.6183333333333,45.05,587,99,259,86,118,1187,488,928
2017,16,48,"Silivri",41.0749,28.2488,25.0571428571429,10.0285714285714,4.30485714285714,75.5285714285714,31.9057142857143,27.0942857142857,717,105,101,218,331,920,612,819
2017,17,48,"Silivri",41.0749,28.2488,17.0285714285714,14.9571428571429,0.803285714285714,56.2571428571429,65.32,49.5971428571429,731,0,0,98,111,1478,731,1478
2017,18,48,"Silivri",41.0749,28.2488,21.9428571428571,15.9,0.630142857142857,72.2,44.0314285714286,20.5585714285714,506,41,91,140,292,923,465,832
2017,19,48,"Silivri",41.0749,28.2488,21.0857142857143,17.5857142857143,1.24257142857143,73.3857142857143,39.5114285714286,28.6942857142857,471,14,48,129,269,966,457,918
2017,20,48,"Silivri",41.0749,28.2488,26.9285714285714,15.6142857142857,1.01157142857143,71.4857142857143,26.9514285714286,17.0128571428571,472,0,0,36,80,1205,472,1205
2017,21,48,"Silivri",41.0749,28.2488,21.6,16.7428571428571,0.180285714285714,74.2428571428571,28.0342857142857,22.7485714285714,448,0,0,114,196,849,448,849
2017,22,48,"Silivri",41.0749,28.2488,21.2142857142857,20.6571428571429,0.757714285714286,73.4571428571429,32.1028571428571,22.5228571428571,522,0,0,147,286,1015,522,1015
2017,23,48,"Silivri",41.0749,28.2488,17.8285714285714,20.0857142857143,2.534,77.7714285714286,33.5514285714286,24.0842857142857,578,3,15,278,568,1388,575,1373
2017,24,48,"Silivri",41.0749,28.2488,21.6,20.7714285714286,0.870428571428571,70.7285714285714,30.6514285714286,23.04,552,0,0,168,315,1139,552,1139
2017,25,48,"Silivri",41.0749,28.2488,18.4428571428571,22.4428571428571,2.26857142857143,70.3428571428571,31.9133333333333,28.87,584,50,71,193,294,1041,534,970
2017,26,48,"Silivri",41.0749,28.2488,17.8571428571429,26.6,0,61.1142857142857,50.23,33.2228571428571,564,61,70,64,85,971,503,901
2017,27,48,"Silivri",41.0749,28.2488,24.9857142857143,22.9714285714286,0.0788571428571429,65.6714285714286,41.0714285714286,21.1628571428571,511,0,0,106,136,642,511,642
2017,28,48,"Silivri",41.0749,28.2488,26.8428571428571,24.2857142857143,0.340714285714286,67.9285714285714,26.9871428571429,19.1042857142857,481,0,0,28,30,864,481,864
2017,29,48,"Silivri",41.0749,28.2488,28.7,23.3285714285714,4.12157142857143,68.5285714285714,31.3114285714286,16.7571428571429,532,0,0,211,487,1272,532,1272
2017,30,48,"Silivri",41.0749,28.2488,21.5714285714286,24.7428571428571,2.37471428571429,67.6142857142857,43.33,28.4328571428571,531,0,0,89,145,928,531,928
2017,31,48,"Silivri",41.0749,28.2488,31.4285714285714,26.2857142857143,0.142,63.7571428571429,33.8714285714286,14.9185714285714,559,0,0,310,633,1047,559,1047
2017,32,48,"Silivri",41.0749,28.2488,28.8142857142857,26.1142857142857,0,71.8142857142857,32.7714285714286,13.3585714285714,567,0,0,190,476,1092,567,1092
2017,33,48,"Silivri",41.0749,28.2488,26.8428571428571,24.7142857142857,1.15485714285714,70.1857142857143,26.7771428571429,17.8385714285714,596,0,0,492,1088,1199,596,1199
2017,34,48,"Silivri",41.0749,28.2488,24.9142857142857,21.8571428571429,2.17285714285714,68.7142857142857,21.8357142857143,26.61,601,0,0,209,622,1280,601,1280
2017,35,48,"Silivri",41.0749,28.2488,24.3857142857143,21.9285714285714,0.0562857142857143,65.0571428571428,17.7614285714286,19.8814285714286,493,0,0,4,17,1014,493,1014
2017,36,48,"Silivri",41.0749,28.2488,19.2714285714286,22.5428571428571,0,57.6428571428571,28.7714285714286,37.8542857142857,507,58,241,87,226,1321,449,1080
2017,37,48,"Silivri",41.0749,28.2488,22.4,24.4428571428571,0,64.4142857142857,32.3471428571429,30.2185714285714,589,94,164,125,218,1138,495,974
2017,38,48,"Silivri",41.0749,28.2488,19.2857142857143,21.4285714285714,1.90014285714286,66.5428571428571,34.3316666666667,28.5966666666667,671,112,227,183,330,1312,559,1085
2017,39,48,"Silivri",41.0749,28.2488,29.9285714285714,17.6714285714286,7.76871428571429,79.9285714285714,28.1,15.4783333333333,782,0,0,208,357,1630,782,1630
2017,40,48,"Silivri",41.0749,28.2488,21.6857142857143,15.6857142857143,1.16757142857143,73.6285714285714,34.2016666666667,36.2771428571429,543,57,163,69,196,1137,486,974
2017,41,48,"Silivri",41.0749,28.2488,16.6142857142857,14.8142857142857,0.0668571428571429,70.3857142857143,41.3114285714286,46.6385714285714,487,0,0,316,403,843,487,843
2017,42,48,"Silivri",41.0749,28.2488,18.5857142857143,16.7571428571429,0.0387142857142857,71.2285714285714,60.55,40.96,530,0,0,180,247,815,530,815
2017,43,48,"Silivri",41.0749,28.2488,24.6,13.2,6.78457142857143,83.5,35.91,33.475,506,63,34,252,588,919,443,885
2017,44,48,"Silivri",41.0749,28.2488,22.1714285714286,9.45714285714286,1.973,67.5428571428571,31.09,40.1114285714286,561,0,0,423,820,1102,561,1102
2017,45,48,"Silivri",41.0749,28.2488,18.2428571428571,12.4285714285714,0.309,83.9428571428572,38.8442857142857,38.2542857142857,577,69,200,144,167,829,508,629
2017,46,48,"Silivri",41.0749,28.2488,20.2142857142857,13.6142857142857,1.18842857142857,84.1,47.275,35.2816666666667,587,0,0,75,131,1085,587,1085
2017,47,48,"Silivri",41.0749,28.2488,18.1857142857143,8.94285714285714,5.11614285714286,83.7,46.4066666666667,41.4485714285714,418,45,170,225,355,804,373,634
2017,48,48,"Silivri",41.0749,28.2488,24.6857142857143,12.7428571428571,1.41542857142857,76.8142857142857,25.9614285714286,20.7471428571429,386,228,325,64,111,619,158,294
2017,49,48,"Silivri",41.0749,28.2488,25.1428571428571,8.25714285714286,3.13228571428571,75.5142857142857,31.49,26.93,407,56,42,130,209,645,351,603
2017,50,48,"Silivri",41.0749,28.2488,20.9571428571429,11.9285714285714,1.48014285714286,82.1857142857143,29.2,21.5785714285714,346,9,16,0,0,442,337,426
2017,51,48,"Silivri",41.0749,28.2488,23.5857142857143,3.71428571428571,8.66671428571429,81.1285714285714,17.0814285714286,17.6414285714286,386,0,0,309,302,349,386,349
2017,52,48,"Silivri",41.0749,28.2488,21.475,7.45,3.116875,84.4375,31.815,33.9683333333333,528,228,235,115,149,507,300,272
2018,1,48,"Silivri",41.0749,28.2488,18.3875,6.875,1.157125,86.9875,46.6275,38.4575,618,191,267,143,169,914,427,647
2018,2,48,"Silivri",41.0749,28.2488,25.2,7.75714285714286,0.958571428571429,88.9,51.7666666666667,33.495,624,0,0,25,19,1309,624,1309
2018,3,48,"Silivri",41.0749,28.2488,25.3571428571429,6.45714285714286,3.12271428571429,79.8571428571429,38.3814285714286,27.1785714285714,639,249,346,54,26,655,390,309
2018,4,48,"Silivri",41.0749,28.2488,26.7857142857143,3.08571428571429,1.61557142857143,74.5142857142857,30.68,21.4214285714286,604,0,0,332,464,764,604,764
2018,5,48,"Silivri",41.0749,28.2488,22.8571428571429,8.87142857142857,1.43085714285714,80.4142857142857,50.4585714285714,33.1571428571429,670,52,138,108,69,819,618,681
2018,6,48,"Silivri",41.0749,28.2488,24.5857142857143,7.34285714285714,4.303,86.6285714285714,34.4071428571429,28.9528571428571,704,0,0,194,324,1022,704,1022
2018,7,48,"Silivri",41.0749,28.2488,23.6,5.87142857142857,0.655571428571429,83.3857142857143,23.3628571428571,22.41,478,88,114,22,12,557,390,443
2018,8,48,"Silivri",41.0749,28.2488,29.2571428571429,6.2,1.71271428571429,87.1428571428571,21.3257142857143,13.4471428571429,711,0,0,26,69,1321,711,1321
2018,9,48,"Silivri",41.0749,28.2488,31.4571428571429,5.02857142857143,6.12571428571429,83.4,30.1114285714286,20.2671428571429,621,97,158,218,247,956,524,798
2018,10,48,"Silivri",41.0749,28.2488,22.2,9.77142857142857,3.16857142857143,85.0428571428571,44.7985714285714,31.53,556,0,0,96,207,1330,556,1330
2018,11,48,"Silivri",41.0749,28.2488,21.8571428571429,12.8142857142857,0.355714285714286,74.5285714285714,41.9457142857143,31.2871428571429,551,234,956,0,0,1426,317,470
2018,12,48,"Silivri",41.0749,28.2488,32.3571428571429,7.78571428571429,1.99514285714286,86.4857142857143,20.1728571428571,18.1057142857143,425,5,2,0,0,1187,420,1185
2018,13,48,"Silivri",41.0749,28.2488,23.6714285714286,10.4571428571429,2.79228571428571,77.9857142857143,52.9585714285714,31.0642857142857,356,156,147,37,67,428,200,281
2018,14,48,"Silivri",41.0749,28.2488,24.3,12.5,1.33771428571429,63.9285714285714,58.0585714285714,33.9828571428571,407,114,82,39,33,486,293,404
2018,15,48,"Silivri",41.0749,28.2488,18.6142857142857,13.5571428571429,0.072,77.2714285714286,49.2842857142857,31.2842857142857,374,49,50,55,170,450,325,400
2018,16,48,"Silivri",41.0749,28.2488,23.3428571428571,13.1142857142857,0.420285714285714,67.1428571428571,37.7371428571429,28.0285714285714,411,0,0,96,194,648,411,648
2018,17,48,"Silivri",41.0749,28.2488,19.4571428571429,18.4571428571429,0,61.7285714285714,61.0371428571429,38.1171428571429,419,49,81,80,96,652,370,571
2018,18,48,"Silivri",41.0749,28.2488,21.2428571428571,15.6857142857143,0.568142857142857,81.5714285714286,29.285,14.9116666666667,303,0,0,0,0,474,303,474
2018,19,48,"Silivri",41.0749,28.2488,20.5142857142857,16.7857142857143,4.07514285714286,81.0285714285714,29.63,23.73,275,0,0,108,222,467,275,467
2018,20,48,"Silivri",41.0749,28.2488,19.1714285714286,20.8571428571429,0.234142857142857,64.8142857142857,43.68,28.49,204,43,110,1,1,306,161,196
2018,21,48,"Silivri",41.0749,28.2488,28.6857142857143,20.0714285714286,2.05771428571429,78.2428571428571,25.1571428571429,11.74,252,0,0,95,102,281,252,281
2018,22,48,"Silivri",41.0749,28.2488,27.6428571428571,20.0285714285714,0.166285714285714,67.7571428571429,31.2571428571429,14.2928571428571,249,0,0,99,236,427,249,427
2018,23,48,"Silivri",41.0749,28.2488,23.1714285714286,22.9857142857143,0.920714285714286,71.9428571428571,45.6428571428571,23.8128571428571,267,0,0,40,109,812,267,812
2018,24,48,"Silivri",41.0749,28.2488,23.5,23.1142857142857,1.21614285714286,68.7428571428571,25.2514285714286,15.1057142857143,267,0,0,39,162,448,267,448
2018,25,48,"Silivri",41.0749,28.2488,24.6285714285714,22.5714285714286,2.69142857142857,71.8571428571429,30.0885714285714,18.8642857142857,358,4,4,113,149,518,354,514
2018,26,48,"Silivri",41.0749,28.2488,25.3857142857143,22.0571428571429,6.32628571428571,77.8142857142857,19.5914285714286,13.14,355,59,86,37,65,587,296,501
2018,27,48,"Silivri",41.0749,28.2488,16.9428571428571,25,0,63.8285714285714,40.4557142857143,20.01,342,0,0,0,0,418,342,418
2018,28,48,"Silivri",41.0749,28.2488,19.5142857142857,25.1,0.554857142857143,70.0428571428571,31.5566666666667,15.5783333333333,286,0,0,86,155,585,286,585
2018,29,48,"Silivri",41.0749,28.2488,18.7857142857143,25.4857142857143,0.695142857142857,64.3,45.0328571428571,27.1771428571429,260,0,0,160,443,756,260,756
2018,30,48,"Silivri",41.0749,28.2488,19.4142857142857,24.1142857142857,8.01442857142857,79.0857142857143,28.7542857142857,24.5271428571429,265,0,0,220,746,822,265,822
2018,31,48,"Silivri",41.0749,28.2488,28.2571428571429,26.2428571428571,0.0197142857142857,74.6857142857143,25.685,12.36,267,0,0,34,94,499,267,499
2018,32,48,"Silivri",41.0749,28.2488,30.2,25.5285714285714,0,65.6571428571429,28.42,12.9757142857143,297,0,0,7,14,403,297,403
2018,33,48,"Silivri",41.0749,28.2488,27.5,25.5857142857143,0.0577142857142857,69.1142857142857,30.0585714285714,15.0642857142857,216,0,0,16,46,332,216,332
2018,34,48,"Silivri",41.0749,28.2488,27.6428571428571,25.1857142857143,0,68.7571428571429,28.3128571428571,10.1785714285714,144,0,0,14,12,227,144,227
2018,35,48,"Silivri",41.0749,28.2488,27.9428571428571,25.7142857142857,0.0625714285714286,70.0571428571428,32.9228571428571,10.7928571428571,201,0,0,47,64,314,201,314
2018,36,48,"Silivri",41.0749,28.2488,19.4857142857143,23.4857142857143,2.52757142857143,75.6571428571429,39.4042857142857,25.1971428571429,341,0,0,61,78,370,341,370
2018,37,48,"Silivri",41.0749,28.2488,22.0285714285714,21.3428571428571,9.08228571428571,72.8142857142857,26.6128571428571,25.9828571428571,241,0,0,146,294,419,241,419
2018,38,48,"Silivri",41.0749,28.2488,25.7857142857143,21.0857142857143,0,72.2142857142857,25.8114285714286,17.5671428571429,189,0,0,0,0,344,189,344
2018,39,48,"Silivri",41.0749,28.2488,32.5428571428571,17.2142857142857,2.37057142857143,73.9714285714286,20.8285714285714,14.2142857142857,180,0,0,75,156,353,180,353
2018,40,48,"Silivri",41.0749,28.2488,26.1285714285714,17.4857142857143,1.44314285714286,76.9285714285714,27.0371428571429,22.4714285714286,191,0,0,8,9,341,191,341
2018,41,48,"Silivri",41.0749,28.2488,31.1714285714286,17.0285714285714,0.931,81.4,26.8016666666667,13.0414285714286,187,0,0,113,227,422,187,422
2018,42,48,"Silivri",41.0749,28.2488,21.2857142857143,16.9142857142857,1.19885714285714,85.1428571428571,38.22,14.5057142857143,168,0,0,134,349,381,168,381
2018,43,48,"Silivri",41.0749,28.2488,26.4142857142857,14.1714285714286,0.482428571428571,70,37.7485714285714,21.31,187,4,3,51,112,402,183,399
2018,44,48,"Silivri",41.0749,28.2488,23.7714285714286,16,0,79.7,40.5985714285714,26.3014285714286,196,0,0,0,0,264,196,264
2018,45,48,"Silivri",41.0749,28.2488,23.6428571428571,14.1285714285714,0.121857142857143,79.9571428571429,20.5571428571429,18.3071428571429,231,0,0,17,80,473,231,473
2018,46,48,"Silivri",41.0749,28.2488,29.5857142857143,9.62857142857143,4.41157142857143,79.9142857142857,14.6585714285714,17.4214285714286,230,0,0,115,202,465,230,465
2018,47,48,"Silivri",41.0749,28.2488,23.7285714285714,10.2571428571429,3.64157142857143,85.6857142857143,20.7557142857143,20.8971428571429,270,45,21,118,382,499,225,478
2018,48,48,"Silivri",41.0749,28.2488,32.4285714285714,7.57142857142857,5.61914285714286,86.2,18.6257142857143,14.7885714285714,245,70,20,131,152,201,175,181
2018,49,48,"Silivri",41.0749,28.2488,24.2714285714286,6.72857142857143,2.90342857142857,80.2571428571429,22.5685714285714,23.8214285714286,257,39,35,123,296,420,218,385
2018,50,48,"Silivri",41.0749,28.2488,21.7,7.3,5.92585714285714,83.2428571428571,28.8657142857143,35.6557142857143,256,22,3,102,126,305,234,302
2018,51,48,"Silivri",41.0749,28.2488,28.0142857142857,5.12857142857143,4.03128571428571,88.8142857142857,22.4028571428571,20.57,250,0,0,156,191,248,250,248
2018,52,48,"Silivri",41.0749,28.2488,20.0571428571429,4.41428571428571,4.83828571428571,80.3,32.0114285714286,35.8871428571429,244,2,10,185,209,273,242,263
2019,1,48,"Silivri",41.0749,28.2488,34.8625,3.275,5.34125,81.825,14.49,15.53625,343,0,0,183,293,784,343,784
2019,2,48,"Silivri",41.0749,28.2488,27.2,3.02857142857143,3.40357142857143,80.0142857142857,19.7042857142857,16.2757142857143,255,100,77,83,117,208,155,131
2019,3,48,"Silivri",41.0749,28.2488,21.3428571428571,4.91428571428571,0.890285714285714,78.8857142857143,31.5857142857143,36.3785714285714,192,29,56,30,12,198,163,142
2019,4,48,"Silivri",41.0749,28.2488,25.4,7.82857142857143,1.26528571428571,83.5714285714286,30.9571428571429,32.4971428571429,308,66,26,1,6,314,242,288
2019,5,48,"Silivri",41.0749,28.2488,19.3571428571429,9.75714285714286,1.024,78.0142857142857,29.1071428571429,27.1971428571429,253,215,125,0,0,143,38,18
2019,6,48,"Silivri",41.0749,28.2488,29.2857142857143,6.32857142857143,1.28971428571429,80.8285714285714,23.5414285714286,21.3471428571429,276,0,0,135,71,127,276,127
2019,7,48,"Silivri",41.0749,28.2488,28.7857142857143,5.77142857142857,3.863,76.4142857142857,21.3442857142857,20.76,325,21,98,52,50,234,304,136
2019,8,48,"Silivri",41.0749,28.2488,23.5,4.67142857142857,1.75757142857143,80.9428571428571,43.57,37.9185714285714,305,0,0,174,160,219,305,219
2019,9,48,"Silivri",41.0749,28.2488,27.3571428571429,5.4,1.07742857142857,74.6285714285714,21.4514285714286,18.6685714285714,331,0,0,165,111,310,331,310
2019,10,48,"Silivri",41.0749,28.2488,18.7857142857143,10.1285714285714,0.289,71.0428571428571,45.2271428571429,37.6942857142857,359,51,18,48,40,252,308,234
2019,11,48,"Silivri",41.0749,28.2488,23.9142857142857,8.92857142857143,3.85857142857143,75.3714285714286,27.5185714285714,27.4457142857143,373,21,29,70,46,400,352,371
2019,12,48,"Silivri",41.0749,28.2488,22.3714285714286,9.92857142857143,0,70.2857142857143,43.6685714285714,33.3428571428571,343,0,0,51,274,416,343,416
2019,13,48,"Silivri",41.0749,28.2488,32.2857142857143,8.04285714285714,0,63.8857142857143,32.62,23.5671428571429,256,0,0,0,0,194,256,194
2019,14,48,"Silivri",41.0749,28.2488,24.8571428571429,9.3,0.0257142857142857,72.5428571428571,35.5714285714286,23.4114285714286,365,0,0,35,29,208,365,208
2019,15,48,"Silivri",41.0749,28.2488,22.7142857142857,12.8428571428571,4.09042857142857,83.5142857142857,21.7142857142857,21.1,359,55,29,50,24,183,304,154
2019,16,48,"Silivri",41.0749,28.2488,22.7285714285714,9.1,0.360428571428571,69.2571428571429,21.5314285714286,22.0942857142857,318,0,0,248,187,208,318,208
2019,17,48,"Silivri",41.0749,28.2488,15.7142857142857,13.9428571428571,0.0264285714285714,61.2571428571429,39.0385714285714,29.875,412,0,0,0,0,313,412,313
2019,18,48,"Silivri",41.0749,28.2488,19.0428571428571,16.8285714285714,0.348285714285714,68.5,40.6785714285714,24.9483333333333,523,182,65,0,0,353,341,288
2019,19,48,"Silivri",41.0749,28.2488,17.2142857142857,15.0285714285714,3.47757142857143,73.8428571428571,23.8428571428571,21.0316666666667,452,118,99,76,72,386,334,287
2019,20,48,"Silivri",41.0749,28.2488,24.0714285714286,18.1,0.273,74.6428571428571,27.1214285714286,17.5128571428571,454,0,0,117,99,389,454,389
2019,21,48,"Silivri",41.0749,28.2488,19.4285714285714,20.0285714285714,2.45814285714286,67.7428571428571,31.4785714285714,22.4085714285714,457,171,252,19,20,413,286,161
2019,22,48,"Silivri",41.0749,28.2488,17.9285714285714,22.0428571428571,0.140714285714286,69.0714285714286,31.8671428571429,20.3257142857143,453,0,0,10,6,323,453,323
2019,23,48,"Silivri",41.0749,28.2488,17.7428571428571,22.7571428571429,0.0231428571428571,63.3714285714286,30.3157142857143,22.0957142857143,378,0,0,56,53,532,378,532
2019,24,48,"Silivri",41.0749,28.2488,23.2142857142857,24,1.04585714285714,72.0857142857143,25.8457142857143,14.3457142857143,378,0,0,277,152,244,378,244
2019,25,48,"Silivri",41.0749,28.2488,20.9,25.1142857142857,0.967714285714286,68.8571428571429,26.1185714285714,14.9671428571429,306,0,0,188,225,325,306,325
2019,26,48,"Silivri",41.0749,28.2488,30.3571428571429,25.2571428571429,0.0137142857142857,64.1,28.9571428571429,16.5857142857143,377,0,0,26,24,342,377,342
2019,27,48,"Silivri",41.0749,28.2488,21.5142857142857,25.1,0,63.8285714285714,27.6485714285714,17.0085714285714,456,0,0,74,21,222,456,222
2019,28,48,"Silivri",41.0749,28.2488,21.0428571428571,22.5,1.91871428571429,67.9285714285714,23.7714285714286,24.3557142857143,398,0,0,209,224,421,398,421
2019,29,48,"Silivri",41.0749,28.2488,25.7571428571429,23.0142857142857,0.97,67.3571428571429,22.7642857142857,16.7657142857143,453,0,0,35,7,203,453,203
2019,30,48,"Silivri",41.0749,28.2488,24.5857142857143,24.6428571428571,1.95014285714286,65.9142857142857,23.7271428571429,14.9557142857143,456,0,0,30,19,335,456,335
2019,31,48,"Silivri",41.0749,28.2488,20.2714285714286,25.7714285714286,0,68.5142857142857,23.9057142857143,16.7014285714286,334,30,39,41,62,375,304,336
2019,32,48,"Silivri",41.0749,28.2488,25.6714285714286,24.5857142857143,0,64.5285714285714,21.8442857142857,16.9571428571429,346,0,0,0,0,395,346,395
2019,33,48,"Silivri",41.0749,28.2488,29.8714285714286,24.3571428571429,4.17942857142857,69.5,19.5514285714286,10.19,337,0,0,67,107,531,337,531
2019,34,48,"Silivri",41.0749,28.2488,32.1428571428571,24.8714285714286,0.589857142857143,68.4857142857143,25.4628571428571,12.5385714285714,299,0,0,136,125,345,299,345
2019,35,48,"Silivri",41.0749,28.2488,33.6714285714286,24.8428571428571,0,66.4857142857143,28.5314285714286,10.37,307,0,0,7,4,415,307,415
2019,36,48,"Silivri",41.0749,28.2488,30.4571428571429,23.5142857142857,0.0151428571428571,68.3,25.09,12.5833333333333,171,0,0,10,5,67,171,67
2019,37,48,"Silivri",41.0749,28.2488,34.1857142857143,22.4,0.165,65.4571428571429,24.01,12.7216666666667,218,0,0,15,17,55,218,55
2019,38,48,"Silivri",41.0749,28.2488,23,19.0857142857143,1.46928571428571,64.0285714285714,19.525,22.265,266,3,0,39,7,91,263,91
2019,39,48,"Silivri",41.0749,28.2488,15.1428571428571,18.9857142857143,0.229,73.7571428571429,18.0033333333333,22.1066666666667,237,0,0,59,15,79,237,79
2019,40,48,"Silivri",41.0749,28.2488,21.1571428571429,19.9714285714286,4.41757142857143,72.1,21.19,23.0428571428571,241,54,30,60,30,111,187,81
2019,41,48,"Silivri",41.0749,28.2488,22.2142857142857,16.4857142857143,1.38271428571429,78.8,15.9871428571429,22.8471428571429,416,0,0,59,151,448,416,448
2019,42,48,"Silivri",41.0749,28.2488,14.4142857142857,17.5428571428571,0.011,81.7,26.3833333333333,24.8885714285714,356,0,0,11,8,408,356,408
2019,43,48,"Silivri",41.0749,28.2488,20.6714285714286,16.3857142857143,0,78.6714285714286,17.455,18.7928571428571,306,0,0,93,156,300,306,300
2019,44,48,"Silivri",41.0749,28.2488,22.2285714285714,13.2857142857143,3.22114285714286,81.7714285714286,18.6557142857143,25.5842857142857,350,25,14,103,72,250,325,236
2019,45,48,"Silivri",41.0749,28.2488,21.2857142857143,17.9857142857143,0.00942857142857143,74.3428571428571,33.1271428571429,26.4342857142857,417,284,237,0,0,328,133,91
2019,46,48,"Silivri",41.0749,28.2488,16.4285714285714,16.0428571428571,0.228142857142857,79.4571428571429,42.2214285714286,34.4371428571429,401,0,0,18,7,337,401,337
2019,47,48,"Silivri",41.0749,28.2488,20.4714285714286,14.0857142857143,0.269571428571429,82.5857142857143,36.8242857142857,26.22,391,0,0,12,7,339,391,339
2019,48,48,"Silivri",41.0749,28.2488,28.3,12.4428571428571,3.39014285714286,82.1428571428571,22.5857142857143,19.5771428571429,320,15,10,154,135,251,305,241
2019,49,48,"Silivri",41.0749,28.2488,21.0428571428571,7.08571428571429,0.933857142857143,79.1,20.4942857142857,29.3171428571429,393,0,0,228,132,274,393,274
2019,50,48,"Silivri",41.0749,28.2488,17.1714285714286,9.61428571428571,0.252285714285714,82.6714285714286,30.8385714285714,32.3671428571429,218,40,9,17,17,119,178,110
2019,51,48,"Silivri",41.0749,28.2488,19.1571428571429,11.4571428571429,0.11,84.3714285714286,41.7185714285714,28.51,361,194,314,0,0,488,167,174
2019,52,48,"Silivri",41.0749,28.2488,22.7714285714286,7.15714285714286,3.51642857142857,78.9714285714286,15.0971428571429,17.9442857142857,279,49,66,230,215,281,230,215
2020,1,48,"Silivri",41.0749,28.2488,25.26,4.48,1.935,73.44,29.542,27.4,160,0,0,135,104,126,160,126
2020,2,48,"Silivri",41.0749,28.2488,28.7428571428571,4.18571428571429,7.45942857142857,79.2285714285714,26.3142857142857,21.9914285714286,240,0,0,154,138,173,240,173
2020,3,48,"Silivri",41.0749,28.2488,22.7571428571429,5.91428571428571,0.232857142857143,77.7714285714286,17.2914285714286,19.5771428571429,270,0,0,48,41,382,270,382
2020,4,48,"Silivri",41.0749,28.2488,23.2571428571429,3.95714285714286,0.406,74.7857142857143,31.8233333333333,27.2766666666667,358,0,0,180,120,295,358,295
2020,5,48,"Silivri",41.0749,28.2488,22.7142857142857,8.71428571428571,3.31714285714286,81.7285714285714,29.5514285714286,28.62,331,64,57,40,26,272,267,215
2020,6,48,"Silivri",41.0749,28.2488,27.3571428571429,5.52857142857143,3.25057142857143,77.0571428571429,18.1928571428571,18.5657142857143,343,0,0,143,111,267,343,267
2020,7,48,"Silivri",41.0749,28.2488,23.8142857142857,7.24285714285714,1.17514285714286,75.3142857142857,26.7128571428571,21.8485714285714,341,49,48,41,22,338,292,290
2020,8,48,"Silivri",41.0749,28.2488,20.7714285714286,6.02857142857143,0.919571428571429,80.0857142857143,30.1928571428571,25.3171428571429,283,0,0,62,42,187,283,187
2020,9,48,"Silivri",41.0749,28.2488,26.7142857142857,8.41428571428571,2.46671428571429,74.4285714285714,26.1685714285714,26.4828571428571,393,25,5,63,136,528,368,523
2020,10,48,"Silivri",41.0749,28.2488,18.6,12.1428571428571,0.527428571428571,74.4428571428572,35.7642857142857,31.53,205,46,42,0,0,210,159,168
2020,11,48,"Silivri",41.0749,28.2488,28.2571428571429,10.7,1.17928571428571,77.5,35.2814285714286,23.9871428571429,115,0,0,19,9,94,115,94
2020,12,48,"Silivri",41.0749,28.2488,26.3285714285714,6.57142857142857,0.366428571428571,65.5142857142857,29.9642857142857,26.0414285714286,117,10,5,19,10,118,107,113
2020,13,48,"Silivri",41.0749,28.2488,29.8,7.98571428571429,3.02285714285714,86.3142857142857,52.7628571428571,10.7228571428571,136,0,0,20,24,92,136,92
2020,14,48,"Silivri",41.0749,28.2488,35.3714285714286,7.67142857142857,4.00728571428571,84.9714285714286,27.13,14.7285714285714,155,0,0,22,19,121,155,121
2020,15,48,"Silivri",41.0749,28.2488,33.8714285714286,9.78571428571429,0.243142857142857,60.7,31.7442857142857,12.44,133,0,0,2,0,118,133,118
2020,16,48,"Silivri",41.0749,28.2488,19.9285714285714,11.8571428571429,1.00485714285714,66.0714285714286,36.1314285714286,18.0257142857143,141,0,0,1,1,106,141,106
2020,17,48,"Silivri",41.0749,28.2488,30.2714285714286,10.5285714285714,0.0672857142857143,67.7285714285714,25.52,14.2828571428571,137,9,1,16,7,123,128,122
2020,18,48,"Silivri",41.0749,28.2488,18.8428571428571,16.0285714285714,1.57985714285714,67.5428571428571,30.74,18.66,146,11,7,0,0,164,135,157
2020,19,48,"Silivri",41.0749,28.2488,20,13.8714285714286,5.33771428571429,74.2857142857143,20.5085714285714,17.7157142857143,137,37,80,39,25,157,100,77
2020,20,48,"Silivri",41.0749,28.2488,23.2142857142857,19.9857142857143,0,66.5142857142857,41.6357142857143,19.2457142857143,164,29,15,0,0,164,135,149
2020,21,48,"Silivri",41.0749,28.2488,30.4142857142857,16.9,1.88,70.3142857142857,22.4185714285714,9.87857142857143,146,2,0,0,0,96,144,96
2020,22,48,"Silivri",41.0749,28.2488,21.8428571428571,15.1571428571429,1.77,75.8285714285714,17.9214285714286,12.9271428571429,118,0,0,17,40,100,118,100
2020,23,48,"Silivri",41.0749,28.2488,18.5857142857143,18.3571428571429,1.22657142857143,71.1571428571429,26.7171428571429,20.6185714285714,112,13,2,19,2,70,99,68
2020,24,48,"Silivri",41.0749,28.2488,19.5857142857143,21.5285714285714,1.06271428571429,71.2285714285714,32.5571428571429,16.5328571428571,140,20,10,7,14,150,120,140
2020,25,48,"Silivri",41.0749,28.2488,18.2857142857143,22.1571428571429,3.20928571428571,76.7428571428571,27.09,17.3785714285714,137,0,0,62,54,108,137,108
2020,26,48,"Silivri",41.0749,28.2488,24.4285714285714,22.1285714285714,0.195428571428571,76.3857142857143,18.0128571428571,12.4628571428571,173,0,0,37,41,133,173,133
2020,27,48,"Silivri",41.0749,28.2488,21.8571428571429,25.2857142857143,0.344428571428571,68.1571428571429,19.8642857142857,12.2442857142857,113,0,0,24,7,113,113,113
2020,28,48,"Silivri",41.0749,28.2488,33.0571428571429,23.9285714285714,0.011,69.2142857142857,17.0542857142857,9.50285714285714,164,0,0,0,0,122,164,122
2020,29,48,"Silivri",41.0749,28.2488,27.2142857142857,21.8285714285714,0,66.1142857142857,12.7142857142857,12.2914285714286,186,0,0,0,0,111,186,111
2020,30,48,"Silivri",41.0749,28.2488,27.3714285714286,24.3857142857143,0.376428571428571,68.4142857142857,16.75,9.25,190,0,0,0,0,142,190,142
2020,31,48,"Silivri",41.0749,28.2488,24.0857142857143,25.8857142857143,0,64.2285714285714,16.82,12.72,150,0,0,0,0,127,150,127
2020,32,48,"Silivri",41.0749,28.2488,31.6857142857143,24.9285714285714,0.00471428571428572,70.2285714285714,15.2414285714286,9.106,146,0,0,0,0,107,146,107
2020,33,48,"Silivri",41.0749,28.2488,26.7714285714286,24.8857142857143,0.892571428571429,62.8,15.1728571428571,11.7571428571429,183,0,0,0,0,83,183,83
2020,34,48,"Silivri",41.0749,28.2488,22.5428571428571,23.6714285714286,0.889,66.7,16.155,16.1916666666667,197,0,0,30,18,97,197,97
2020,35,48,"Silivri",41.0749,28.2488,22.1142857142857,24.6428571428571,0,66.8428571428571,14.7742857142857,14.2071428571429,164,0,0,0,0,157,164,157
2020,36,48,"Silivri",41.0749,28.2488,22.8571428571429,23.5857142857143,0.0778571428571429,69.3714285714286,14.23,11.8871428571429,179,0,0,38,45,112,179,112
2020,37,48,"Silivri",41.0749,28.2488,30.7,23.4285714285714,0.0362857142857143,72.3428571428571,28.1328571428571,10.3028571428571,193,0,0,0,0,91,193,91
2020,38,48,"Silivri",41.0749,28.2488,31.9428571428571,22.4142857142857,0.0568571428571429,69.2571428571429,28.0585714285714,8.99428571428571,235,0,0,0,0,157,235,157
2020,39,48,"Silivri",41.0749,28.2488,20.8,21.7714285714286,1.16342857142857,69.1428571428571,34.9614285714286,17.3757142857143,220,54,12,33,10,129,166,117
2020,40,48,"Silivri",41.0749,28.2488,18.9285714285714,20.0428571428571,1.03542857142857,62.8142857142857,35.1214285714286,29.5057142857143,187,45,18,20,8,154,142,136
2020,41,48,"Silivri",41.0749,28.2488,14.6857142857143,20.1571428571429,3.38871428571429,74.3714285714286,46.3571428571429,27.6585714285714,182,44,24,56,39,127,138,103
2020,42,48,"Silivri",41.0749,28.2488,20.3857142857143,18.7714285714286,2.36557142857143,76.5,36.0614285714286,23.5628571428571,177,34,9,0,0,111,143,102
2020,43,48,"Silivri",41.0749,28.2488,19.6428571428571,16.6285714285714,1.387,77.6714285714286,29.4933333333333,14.035,194,0,0,8,10,161,194,161
2020,44,48,"Silivri",41.0749,28.2488,18.5,14.9285714285714,5.144,82.1428571428571,38.1271428571429,13.86,255,0,0,117,119,233,255,233
2020,45,48,"Silivri",41.0749,28.2488,24.2142857142857,12.3,2.61271428571429,80.2571428571429,30.8614285714286,19.0971428571429,156,0,0,81,54,103,156,103
2020,46,48,"Silivri",41.0749,28.2488,22.9857142857143,12.7428571428571,0.421428571428571,80.9857142857143,21.5614285714286,14.7985714285714,208,0,0,30,20,109,208,109
2020,47,48,"Silivri",41.0749,28.2488,25.8714285714286,10.1142857142857,0.689142857142857,78.7285714285714,20.3842857142857,13.9442857142857,173,0,0,15,4,83,173,83
2020,48,48,"Silivri",41.0749,28.2488,18.3285714285714,8.74285714285714,0.091,78.0857142857143,41.5714285714286,22.9885714285714,199,38,20,0,0,262,161,242
2020,49,48,"Silivri",41.0749,28.2488,22.3857142857143,8.08571428571429,0.308857142857143,84.5,29.8014285714286,15.8942857142857,207,0,0,59,44,116,207,116
2020,50,48,"Silivri",41.0749,28.2488,23.6571428571429,11.2571428571429,1.80714285714286,82.6428571428571,28.5414285714286,20.3442857142857,181,48,56,22,8,98,133,42
2020,51,48,"Silivri",41.0749,28.2488,25.9285714285714,7.81428571428571,1.36628571428571,88.6285714285714,14.8271428571429,11.5157142857143,171,0,0,21,17,90,171,90
2020,52,48,"Silivri",41.0749,28.2488,17.1,9.3,0.309142857142857,82.7428571428571,33.5971428571429,14.2542857142857,203,10,0,13,25,113,193,113
2020,53,48,"Silivri",41.0749,28.2488,21.125,12.475,0.18775,76.575,24.835,9.1725,122,88,87,0,0,111,34,24
2017,1,49,"Uskudar",41.0328,29.0312,22.2428571428571,3.98571428571429,7.67142857142857,80.3,33.3471428571429,49.1242857142857,563,167,216,178,337,847,396,631
2017,2,49,"Uskudar",41.0328,29.0312,20.5857142857143,4.04285714285714,5.499,79.0142857142857,30.4857142857143,56.7542857142857,757,119,215,44,158,1214,638,999
2017,3,49,"Uskudar",41.0328,29.0312,19.5428571428571,4.65714285714286,3.63442857142857,88.9714285714286,28.2842857142857,49.5057142857143,762,0,0,0,0,1449,762,1449
2017,4,49,"Uskudar",41.0328,29.0312,19.4857142857143,2.61428571428571,0.699857142857143,79.0285714285714,32.6657142857143,44.0714285714286,639,0,0,186,228,889,639,889
2017,5,49,"Uskudar",41.0328,29.0312,15.9285714285714,5.98571428571429,0.454285714285714,69.6714285714286,54.8185714285714,64.4414285714286,588,0,0,0,0,1163,588,1163
2017,6,49,"Uskudar",41.0328,29.0312,17.7571428571429,7.5,0.783,76.7142857142857,47.1185714285714,50.9671428571429,736,131,203,192,511,1519,605,1316
2017,7,49,"Uskudar",41.0328,29.0312,16.4285714285714,4.12857142857143,0.531571428571429,73.0428571428571,41.4233333333333,57.2485714285714,492,61,47,87,172,717,431,670
2017,8,49,"Uskudar",41.0328,29.0312,16.9285714285714,9.87142857142857,3.41285714285714,76.2285714285714,58.12,62.586,739,0,0,0,0,1747,739,1747
2017,9,49,"Uskudar",41.0328,29.0312,12.1571428571429,8.77142857142857,0.0117142857142857,80.9428571428572,62.182,66.622,574,0,0,304,554,866,574,866
2017,10,49,"Uskudar",41.0328,29.0312,18.3428571428571,10.3714285714286,1.40757142857143,78.6142857142857,44.9983333333333,49.0183333333333,712,0,0,103,172,1043,712,1043
2017,11,49,"Uskudar",41.0328,29.0312,12.8285714285714,6.84285714285714,5.65914285714286,84.3571428571429,41.0685714285714,55.9442857142857,525,0,0,362,498,725,525,725
2017,12,49,"Uskudar",41.0328,29.0312,16.9142857142857,9.7,0.293714285714286,76.4,50.23,63.6471428571429,589,0,0,89,184,1077,589,1077
2017,13,49,"Uskudar",41.0328,29.0312,21.8571428571429,8.98571428571429,0.325857142857143,72.3714285714286,31.88,50.4885714285714,574,0,0,0,0,887,574,887
2017,14,49,"Uskudar",41.0328,29.0312,13.0571428571429,10.1,0.509,79.3571428571429,45.788,62.608,639,0,0,330,633,1336,639,1336
2017,15,49,"Uskudar",41.0328,29.0312,15.6285714285714,12.7,0.0205714285714286,63.8428571428571,50.4483333333333,74.3183333333333,587,2,10,69,292,1187,585,1177
2017,16,49,"Uskudar",41.0328,29.0312,16.9,11.2571428571429,3.16128571428571,71.9142857142857,37.1128571428571,52.9,717,0,0,292,508,920,717,920
2017,17,49,"Uskudar",41.0328,29.0312,16.5428571428571,14.6571428571429,0.321,58.5,57.6657142857143,84.85,731,0,0,284,552,1478,731,1478
2017,18,49,"Uskudar",41.0328,29.0312,16.3142857142857,15,1.07457142857143,79.3,45.8628571428571,48.26,506,0,0,149,340,923,506,923
2017,19,49,"Uskudar",41.0328,29.0312,13.7142857142857,18.3285714285714,1.65714285714286,71.4142857142857,50.5571428571429,66.3242857142857,471,52,131,71,192,966,419,835
2017,20,49,"Uskudar",41.0328,29.0312,20.2142857142857,16.0857142857143,1.16,76.3428571428571,30.9585714285714,47.0128571428571,472,0,0,126,291,1205,472,1205
2017,21,49,"Uskudar",41.0328,29.0312,17.5428571428571,17.1857142857143,0.0635714285714286,74.5428571428571,29.4,49.4542857142857,448,0,0,92,132,849,448,849
2017,22,49,"Uskudar",41.0328,29.0312,16.1142857142857,20.6857142857143,0.616142857142857,76.3285714285714,40.295,53.3233333333333,522,0,0,49,130,1015,522,1015
2017,23,49,"Uskudar",41.0328,29.0312,15.9857142857143,20.5285714285714,3.033,80.0714285714286,41.0485714285714,51.0814285714286,578,0,0,222,663,1388,578,1388
2017,24,49,"Uskudar",41.0328,29.0312,17.5142857142857,21.5142857142857,0.615428571428571,72.5142857142857,28.9085714285714,47.7842857142857,552,0,0,113,256,1139,552,1139
2017,25,49,"Uskudar",41.0328,29.0312,13.1571428571429,23.1714285714286,3.04685714285714,70.3571428571429,36.7271428571429,61.8914285714286,584,0,0,396,665,1041,584,1041
2017,26,49,"Uskudar",41.0328,29.0312,14.3428571428571,27.2714285714286,0,60.6857142857143,38.0285714285714,57.8528571428571,564,0,0,64,84,971,564,971
2017,27,49,"Uskudar",41.0328,29.0312,19.4428571428571,23.9857142857143,0.219,64.5,23.3628571428571,35.23,511,0,0,83,116,642,511,642
2017,28,49,"Uskudar",41.0328,29.0312,17.3571428571429,24.5857142857143,0.475285714285714,71.0857142857143,22.905,38.2614285714286,481,0,0,21,119,864,481,864
2017,29,49,"Uskudar",41.0328,29.0312,17.8571428571429,23.9428571428571,8.326,75.6428571428571,22.0714285714286,29.65,532,0,0,51,163,1272,532,1272
2017,30,49,"Uskudar",41.0328,29.0312,13.5571428571429,25.4714285714286,2.85628571428571,71.3142857142857,37.2028571428571,53.8242857142857,531,0,0,192,299,928,531,928
2017,31,49,"Uskudar",41.0328,29.0312,16.9857142857143,26.2,0.172142857142857,73.6,26.6971428571429,33.98,559,0,0,10,9,1047,559,1047
2017,32,49,"Uskudar",41.0328,29.0312,16.6857142857143,26.6285714285714,0,77.5142857142857,29.56,28.8642857142857,567,0,0,43,164,1092,567,1092
2017,33,49,"Uskudar",41.0328,29.0312,14.4428571428571,25.2285714285714,2.86971428571429,77.1571428571429,30.9228571428571,35.1971428571429,596,0,0,304,712,1199,596,1199
2017,34,49,"Uskudar",41.0328,29.0312,17.9571428571429,23.0857142857143,2.46442857142857,70.0428571428571,24.4571428571429,33.6085714285714,601,0,0,81,112,1280,601,1280
2017,35,49,"Uskudar",41.0328,29.0312,17.2857142857143,22.9285714285714,0.185857142857143,64.6571428571429,17.9842857142857,30.1771428571429,493,0,0,0,0,1014,493,1014
2017,36,49,"Uskudar",41.0328,29.0312,12.2857142857143,23.2857142857143,0.0598571428571429,62.1142857142857,36.6228571428571,42.7785714285714,507,0,0,62,148,1321,507,1321
2017,37,49,"Uskudar",41.0328,29.0312,13.6857142857143,25.1571428571429,0,68.8,45.3516666666667,38.0671428571429,589,0,0,197,388,1138,589,1138
2017,38,49,"Uskudar",41.0328,29.0312,14.8857142857143,22.3428571428571,2.17128571428571,71.1714285714286,40.5528571428571,35.6671428571429,671,0,0,281,600,1312,671,1312
2017,39,49,"Uskudar",41.0328,29.0312,20.9857142857143,19.0285714285714,13.1365714285714,77.9714285714286,27.2814285714286,25.7757142857143,782,0,0,68,98,1630,782,1630
2017,40,49,"Uskudar",41.0328,29.0312,11.3428571428571,16.9428571428571,1.581,71.0285714285714,35.8457142857143,34.9357142857143,543,134,360,71,127,1137,409,777
2017,41,49,"Uskudar",41.0328,29.0312,11.3428571428571,15.2857142857143,0.589142857142857,72.1285714285714,40.0185714285714,37.7071428571429,487,0,0,116,121,843,487,843
2017,42,49,"Uskudar",41.0328,29.0312,11.2,17.2,0.0172857142857143,78.6428571428571,63.9314285714286,36.2228571428571,530,0,0,169,227,815,530,815
2017,43,49,"Uskudar",41.0328,29.0312,14.3857142857143,14.8857142857143,6.06485714285714,83.3571428571429,42.3371428571429,30.4642857142857,506,0,0,77,274,919,506,919
2017,44,49,"Uskudar",41.0328,29.0312,12.7857142857143,11.1571428571429,2.85,68.2857142857143,35.8342857142857,28.8828571428571,561,0,0,189,398,1102,561,1102
2017,45,49,"Uskudar",41.0328,29.0312,12.5,13.7142857142857,0.146857142857143,78.9142857142857,49.4342857142857,32.8428571428571,577,91,235,99,149,829,486,594
2017,46,49,"Uskudar",41.0328,29.0312,12.8142857142857,14.8142857142857,0.167857142857143,80.5857142857143,54.5642857142857,31.7428571428571,587,0,0,4,16,1085,587,1085
2017,47,49,"Uskudar",41.0328,29.0312,14.9428571428571,10.4857142857143,6.64485714285714,79.4,52.52,38.93,418,45,170,165,242,804,373,634
2017,48,49,"Uskudar",41.0328,29.0312,12.2571428571429,14.5285714285714,1.59514285714286,67.9571428571429,40.5385714285714,55.4714285714286,386,140,225,68,118,619,246,394
2017,49,49,"Uskudar",41.0328,29.0312,16.5,9.98571428571429,4.069,70.4714285714286,29.254,44.418,407,0,0,185,368,645,407,645
2017,50,49,"Uskudar",41.0328,29.0312,14.1714285714286,14.1857142857143,1.03371428571429,71.7571428571429,36.6771428571429,56.2142857142857,346,0,0,0,0,442,346,442
2017,51,49,"Uskudar",41.0328,29.0312,18.5571428571429,5.9,10.5044285714286,84.1857142857143,15.3814285714286,34.4357142857143,386,0,0,117,112,349,386,349
2017,52,49,"Uskudar",41.0328,29.0312,14.6375,9.4625,3.578375,74.375,41.87875,55.7525,528,175,212,99,161,507,353,295
2018,1,49,"Uskudar",41.0328,29.0312,13.55,8.825,0.70725,79.95,49.27375,54.27375,618,191,267,123,151,914,427,647
2018,2,49,"Uskudar",41.0328,29.0312,16.6714285714286,8.87142857142857,1.43642857142857,85.4571428571429,51.2233333333333,46.1985714285714,624,0,0,0,0,1309,624,1309
2018,3,49,"Uskudar",41.0328,29.0312,16.0285714285714,8,3.57414285714286,72.9285714285714,32.7328571428571,50.3928571428571,639,84,59,54,26,655,555,596
2018,4,49,"Uskudar",41.0328,29.0312,21.2428571428571,4.7,1.61714285714286,71.5285714285714,20.98,39.5114285714286,604,0,0,145,234,764,604,764
2018,5,49,"Uskudar",41.0328,29.0312,14.4428571428571,10.6,1.623,71.3142857142857,52.25,55.5385714285714,670,0,0,46,50,819,670,819
2018,6,49,"Uskudar",41.0328,29.0312,14.1285714285714,8.61428571428571,4.048,85.2714285714286,42.2085714285714,49.7828571428571,704,0,0,255,406,1022,704,1022
2018,7,49,"Uskudar",41.0328,29.0312,14.2714285714286,7.1,0.629428571428571,82.2142857142857,29.5816666666667,44.3657142857143,478,71,104,72,70,557,407,453
2018,8,49,"Uskudar",41.0328,29.0312,18.4,7.31428571428571,1.63042857142857,85.7142857142857,23.8566666666667,38.13,711,0,0,0,0,1321,711,1321
2018,9,49,"Uskudar",41.0328,29.0312,17.0285714285714,6.2,7.847,82.9571428571429,40.1585714285714,47.9571428571429,621,65,92,243,336,956,556,864
2018,10,49,"Uskudar",41.0328,29.0312,12.0285714285714,10.7571428571429,3.32814285714286,82.5285714285714,53.3642857142857,56.8314285714286,556,0,0,66,126,1330,556,1330
2018,11,49,"Uskudar",41.0328,29.0312,11.5428571428571,14.3857142857143,0.309142857142857,65.5285714285714,50.4833333333333,61.6114285714286,551,45,169,52,77,1426,506,1257
2018,12,49,"Uskudar",41.0328,29.0312,18.1714285714286,9.07142857142857,2.05814285714286,84.9428571428572,29.07,43.7171428571429,425,0,0,0,0,1187,425,1187
2018,13,49,"Uskudar",41.0328,29.0312,13.7714285714286,11.6857142857143,2.24457142857143,72.8428571428571,79.256,58.5985714285714,356,91,70,86,134,428,265,358
2018,14,49,"Uskudar",41.0328,29.0312,14.1714285714286,12.4857142857143,2.17728571428571,69.2,47.1657142857143,62.1214285714286,407,0,0,90,62,486,407,486
2018,15,49,"Uskudar",41.0328,29.0312,13.9571428571429,12.2571428571429,0.059,82.1,43.1385714285714,49.7257142857143,374,0,0,174,285,450,374,450
2018,16,49,"Uskudar",41.0328,29.0312,14.4285714285714,13.0142857142857,0.371857142857143,73.5571428571428,36.6071428571429,52.1271428571429,411,2,1,25,61,648,409,647
2018,17,49,"Uskudar",41.0328,29.0312,14.3428571428571,18.3857142857143,0,63.0571428571429,48.026,60.854,419,0,0,79,76,652,419,652
2018,18,49,"Uskudar",41.0328,29.0312,15.4857142857143,15.1714285714286,0.635,83.5142857142857,33.4342857142857,33.2657142857143,303,0,0,1,33,474,303,474
2018,19,49,"Uskudar",41.0328,29.0312,12.2714285714286,16.9714285714286,4.13585714285714,81.6714285714286,34.15,53.3914285714286,275,0,0,115,129,467,275,467
2018,20,49,"Uskudar",41.0328,29.0312,12.4857142857143,22.0142857142857,0.187428571428571,61.6857142857143,49.74,82.2942857142857,204,2,1,2,0,306,202,305
2018,21,49,"Uskudar",41.0328,29.0312,17.1714285714286,20.4,1.49585714285714,79.9857142857143,25.5,37.2033333333333,252,0,0,0,0,281,252,281
2018,22,49,"Uskudar",41.0328,29.0312,16.3714285714286,20.5857142857143,0.215285714285714,72.0142857142857,27.1271428571429,29.242,249,0,0,10,10,427,249,427
2018,23,49,"Uskudar",41.0328,29.0312,14.6,23.8,0.229428571428571,69.2857142857143,41.76,46.9857142857143,267,0,0,106,369,812,267,812
2018,24,49,"Uskudar",41.0328,29.0312,16.2714285714286,23.4,1.64557142857143,70.6857142857143,25.0314285714286,35.1985714285714,267,0,0,15,10,448,267,448
2018,25,49,"Uskudar",41.0328,29.0312,16.1428571428571,23.6571428571429,2.60042857142857,74.4142857142857,27.94,31.9442857142857,358,0,0,128,101,518,358,518
2018,26,49,"Uskudar",41.0328,29.0312,15.9,23.6,3.90928571428571,72.1571428571429,24.5133333333333,33.5014285714286,355,0,0,62,71,587,355,587
2018,27,49,"Uskudar",41.0328,29.0312,15.1428571428571,25.9428571428571,0,58.8,33.2142857142857,36.5071428571429,342,0,0,0,0,418,342,418
2018,28,49,"Uskudar",41.0328,29.0312,14.1714285714286,26.3857142857143,0.254857142857143,69.0571428571428,33.41,30.8957142857143,286,0,0,11,29,585,286,585
2018,29,49,"Uskudar",41.0328,29.0312,12.1285714285714,26.3571428571429,0.579,64.4,39.4657142857143,47.4928571428571,260,65,261,121,209,756,195,495
2018,30,49,"Uskudar",41.0328,29.0312,13.8571428571429,25.3285714285714,6.92471428571429,75.1,37.4716666666667,51.8342857142857,265,0,0,133,597,822,265,822
2018,31,49,"Uskudar",41.0328,29.0312,18.2,27.2285714285714,0.286428571428571,73.1571428571429,24.5414285714286,31.2257142857143,267,0,0,0,0,499,267,499
2018,32,49,"Uskudar",41.0328,29.0312,19.9142857142857,26.7,0,63.8,23.3542857142857,32.2957142857143,297,0,0,0,0,403,297,403
2018,33,49,"Uskudar",41.0328,29.0312,17.8571428571429,26.1285714285714,0.0677142857142857,69.3142857142857,25.5028571428571,35.8242857142857,216,0,0,0,0,332,216,332
2018,34,49,"Uskudar",41.0328,29.0312,18.1142857142857,26.1285714285714,0,67.1142857142857,24.7785714285714,29.5228571428571,144,0,0,0,0,227,144,227
2018,35,49,"Uskudar",41.0328,29.0312,18.0142857142857,26.5571428571429,0.271,75.1571428571429,29.14,27.2542857142857,201,0,0,29,52,314,201,314
2018,36,49,"Uskudar",41.0328,29.0312,13.7857142857143,24.4571428571429,8.92757142857143,74.1857142857143,35.7014285714286,44.5085714285714,341,0,0,101,119,370,341,370
2018,37,49,"Uskudar",41.0328,29.0312,16.1142857142857,21.8714285714286,10.9928571428571,75.0285714285714,24.78,46.6642857142857,241,0,0,61,127,419,241,419
2018,38,49,"Uskudar",41.0328,29.0312,22.9571428571429,22.2142857142857,0.0142857142857143,70.3571428571429,22.108,32.7733333333333,189,0,0,1,0,344,189,344
2018,39,49,"Uskudar",41.0328,29.0312,22.7428571428571,18.2714285714286,5.63428571428571,76.1571428571429,18.6957142857143,31.8328571428571,180,0,0,34,62,353,180,353
2018,40,49,"Uskudar",41.0328,29.0312,18.1,18.8714285714286,1.126,74.2142857142857,24.89,37.6785714285714,191,0,0,4,5,341,191,341
2018,41,49,"Uskudar",41.0328,29.0312,18.3428571428571,18.1,0.905,80.3142857142857,29.1014285714286,37.2171428571429,187,0,0,12,13,422,187,422
2018,42,49,"Uskudar",41.0328,29.0312,14.1142857142857,18.4714285714286,0.953285714285714,83.5714285714286,40.87,43.1471428571429,168,0,0,16,7,381,168,381
2018,43,49,"Uskudar",41.0328,29.0312,19.0857142857143,15.9571428571429,1.06614285714286,66.1428571428571,44.6857142857143,39.8342857142857,187,52,75,33,45,402,135,327
2018,44,49,"Uskudar",41.0328,29.0312,13.3571428571429,17,0,73.2857142857143,50.38,29.5828571428571,196,0,0,87,116,264,196,264
2018,45,49,"Uskudar",41.0328,29.0312,15.6714285714286,15.4142857142857,0.502571428571429,77.8285714285714,21.28,27.9857142857143,231,0,0,0,0,473,231,473
2018,46,49,"Uskudar",41.0328,29.0312,17.1142857142857,11.1142857142857,8.098,79.1428571428571,17.32,39.8616666666667,230,0,0,59,106,465,230,465
2018,47,49,"Uskudar",41.0328,29.0312,16.5142857142857,11.8428571428571,4.369,79.9714285714286,30.0714285714286,34.0142857142857,270,38,19,3,69,499,232,480
2018,48,49,"Uskudar",41.0328,29.0312,23.5428571428571,9.87142857142857,8.20928571428571,81.0428571428571,25.5042857142857,29.1771428571429,245,0,0,68,89,201,245,201
2018,49,49,"Uskudar",41.0328,29.0312,19.0428571428571,8.55714285714286,4.59842857142857,74.4714285714286,31.2266666666667,32.4114285714286,257,44,50,48,74,420,213,370
2018,50,49,"Uskudar",41.0328,29.0312,17.5428571428571,8.85714285714286,7.61514285714286,75.0142857142857,44.0514285714286,44.3871428571429,256,29,3,101,126,305,227,302
2018,51,49,"Uskudar",41.0328,29.0312,20.6285714285714,7.57142857142857,8.01585714285714,83.1,28.8328571428571,27.5157142857143,250,0,0,138,178,248,250,248
2018,52,49,"Uskudar",41.0328,29.0312,17.4428571428571,5.8,6.96042857142857,76.8,27.72,35.0514285714286,244,0,0,148,171,273,244,273
2019,1,49,"Uskudar",41.0328,29.0312,26.6125,5.0875,8.62975,79.4875,18.29625,27.1075,343,0,0,79,205,784,343,784
2019,2,49,"Uskudar",41.0328,29.0312,23.7428571428571,4.72857142857143,4.73571428571429,73.8428571428571,27.0685714285714,28.7,255,94,63,67,85,208,161,145
2019,3,49,"Uskudar",41.0328,29.0312,17,7.04285714285714,1.48228571428571,70.4285714285714,31.7528571428571,37.4942857142857,192,22,56,85,54,198,170,142
2019,4,49,"Uskudar",41.0328,29.0312,16.8428571428571,9.54285714285714,0.736571428571429,72.6142857142857,48.8657142857143,42.7128571428571,308,80,97,0,0,314,228,217
2019,5,49,"Uskudar",41.0328,29.0312,15.6,11.5285714285714,1.22042857142857,64.7714285714286,37.4757142857143,44.3985714285714,253,158,92,0,0,143,95,51
2019,6,49,"Uskudar",41.0328,29.0312,18.8285714285714,7.61428571428571,2.00214285714286,78.2,29.4171428571429,30.7614285714286,276,0,0,25,21,127,276,127
2019,7,49,"Uskudar",41.0328,29.0312,19.6142857142857,6.98571428571429,4.41157142857143,72.6285714285714,22.9733333333333,30.0383333333333,325,2,0,0,0,234,323,234
2019,8,49,"Uskudar",41.0328,29.0312,16.6142857142857,5.37142857142857,4.15514285714286,82.8857142857143,55.5642857142857,44.5985714285714,305,0,0,181,120,219,305,219
2019,9,49,"Uskudar",41.0328,29.0312,20.9,6.72857142857143,1.75585714285714,72.7571428571429,29.8242857142857,36.0085714285714,331,0,0,83,97,310,331,310
2019,10,49,"Uskudar",41.0328,29.0312,12.5714285714286,11.2714285714286,0.228142857142857,62.8428571428571,53.2471428571429,60.3414285714286,359,0,0,52,44,252,359,252
2019,11,49,"Uskudar",41.0328,29.0312,18.4142857142857,10,3.877,70.3857142857143,32.8442857142857,42.7342857142857,373,0,0,82,69,400,373,400
2019,12,49,"Uskudar",41.0328,29.0312,15.7,10.4428571428571,0,65.8428571428571,40.8728571428571,46.8942857142857,343,0,0,45,267,416,343,416
2019,13,49,"Uskudar",41.0328,29.0312,22.4,8.41428571428571,0.00114285714285714,64.2857142857143,31.97,36.6042857142857,256,0,0,7,14,194,256,194
2019,14,49,"Uskudar",41.0328,29.0312,16.6,9.71428571428571,0.0238571428571429,73.6,35.3114285714286,34.5771428571429,365,0,0,10,6,208,365,208
2019,15,49,"Uskudar",41.0328,29.0312,13.7428571428571,13.6,3.04785714285714,78.4285714285714,32.9557142857143,45.1757142857143,359,0,0,136,93,183,359,183
2019,16,49,"Uskudar",41.0328,29.0312,16.9428571428571,9.44285714285714,0.816571428571429,69.5428571428571,23.0171428571429,45.308,318,0,0,98,123,208,318,208
2019,17,49,"Uskudar",41.0328,29.0312,14.2142857142857,13.5,0.0308571428571429,62.8285714285714,36.5814285714286,58.8085714285714,412,0,0,79,66,313,412,313
2019,18,49,"Uskudar",41.0328,29.0312,13.2,18.2428571428571,1.46957142857143,61.9714285714286,49.1457142857143,60.26,523,105,42,47,28,353,418,311
2019,19,49,"Uskudar",41.0328,29.0312,13.3,15.8714285714286,4.05885714285714,69.1428571428571,35.4157142857143,49.4728571428571,452,53,62,136,108,386,399,324
2019,20,49,"Uskudar",41.0328,29.0312,18.3285714285714,18.3428571428571,0.157428571428571,70.9285714285714,30.9885714285714,46.67,454,0,0,65,57,389,454,389
2019,21,49,"Uskudar",41.0328,29.0312,12.9,21.1142857142857,3.73714285714286,64.5285714285714,40.1471428571429,58.7871428571429,457,34,53,202,228,413,423,360
2019,22,49,"Uskudar",41.0328,29.0312,13.7714285714286,22.9428571428571,0.137428571428571,67.3857142857143,35.7971428571429,53.0985714285714,453,0,0,6,2,323,453,323
2019,23,49,"Uskudar",41.0328,29.0312,13.7857142857143,23.2571428571429,0.177857142857143,64.5428571428571,28.3371428571429,47.2414285714286,378,0,0,122,74,532,378,532
2019,24,49,"Uskudar",41.0328,29.0312,14.4857142857143,24.1428571428571,0.792857142857143,76.2857142857143,30.01,36.2628571428571,378,0,0,171,56,244,378,244
2019,25,49,"Uskudar",41.0328,29.0312,13.4285714285714,25.0142857142857,1.47442857142857,75.3285714285714,33.5528571428571,47.4314285714286,306,0,0,88,128,325,306,325
2019,26,49,"Uskudar",41.0328,29.0312,19.9857142857143,25.5857142857143,0.0937142857142857,63.9285714285714,24.1085714285714,35.4471428571429,377,0,0,0,0,342,377,342
2019,27,49,"Uskudar",41.0328,29.0312,17.5,25.0571428571429,0,65.4142857142857,21.67,35.36,456,0,0,5,2,222,456,222
2019,28,49,"Uskudar",41.0328,29.0312,15.3571428571429,23.2285714285714,4.55242857142857,65.5,21.4642857142857,47.8642857142857,398,0,0,17,32,421,398,421
2019,29,49,"Uskudar",41.0328,29.0312,17.7571428571429,23.2571428571429,3.43585714285714,69.6,19.3428571428571,33.3914285714286,453,0,0,57,5,203,453,203
2019,30,49,"Uskudar",41.0328,29.0312,17.3857142857143,24.4142857142857,2.66928571428571,70.8428571428571,17.55,31.2528571428571,456,0,0,0,0,335,456,335
2019,31,49,"Uskudar",41.0328,29.0312,14.6857142857143,26.1428571428571,0.058,67.9285714285714,18.3685714285714,35.0742857142857,334,0,0,66,97,375,334,375
2019,32,49,"Uskudar",41.0328,29.0312,18.5857142857143,24.8,0.0125714285714286,64.7857142857143,12.7557142857143,29.5114285714286,346,0,0,0,0,395,346,395
2019,33,49,"Uskudar",41.0328,29.0312,18.9285714285714,24.0714285714286,5.771,74,17.11,24.86,337,0,0,2,2,531,337,531
2019,34,49,"Uskudar",41.0328,29.0312,18.6857142857143,24.6142857142857,1.023,77.1571428571429,23.8085714285714,28.5771428571429,299,0,0,89,102,345,299,345
2019,35,49,"Uskudar",41.0328,29.0312,20.6571428571429,24.9571428571429,0,70.4857142857143,20.5557142857143,24.1157142857143,307,0,0,0,0,415,307,415
2019,36,49,"Uskudar",41.0328,29.0312,21.3714285714286,23.9285714285714,0.194428571428571,68.0428571428571,18.65,24.7428571428571,171,0,0,0,0,67,171,67
2019,37,49,"Uskudar",41.0328,29.0312,21.6285714285714,23.0714285714286,0.109857142857143,67.0428571428571,18.9542857142857,23.5285714285714,218,0,0,0,0,55,218,55
2019,38,49,"Uskudar",41.0328,29.0312,15.2857142857143,20.1142857142857,2.30557142857143,65.5285714285714,20.76,37.8514285714286,266,0,0,10,1,91,266,91
2019,39,49,"Uskudar",41.0328,29.0312,11.0142857142857,19.6571428571429,0.339571428571429,73.6857142857143,26.7642857142857,41.1728571428571,237,0,0,100,43,79,237,79
2019,40,49,"Uskudar",41.0328,29.0312,16.0428571428571,20.7857142857143,4.42871428571429,70.3285714285714,31.19,NA,241,0,0,36,26,111,241,111
2019,41,49,"Uskudar",41.0328,29.0312,15.5428571428571,17.5857142857143,2.55371428571429,78.0285714285714,22.7528571428571,42.4275,416,0,0,0,0,448,416,448
2019,42,49,"Uskudar",41.0328,29.0312,14.5857142857143,18.5,0.00485714285714286,82,32.5942857142857,45.0657142857143,356,0,0,0,0,408,356,408
2019,43,49,"Uskudar",41.0328,29.0312,19.6857142857143,17.6571428571429,0,77.1285714285714,25.1371428571429,36.4685714285714,306,0,0,0,0,300,306,300
2019,44,49,"Uskudar",41.0328,29.0312,15.6428571428571,14.6714285714286,5.82342857142857,79.8714285714286,28.7557142857143,47.8842857142857,350,0,0,9,29,250,350,250
2019,45,49,"Uskudar",41.0328,29.0312,11.7428571428571,19.4571428571429,0.000428571428571429,65.4,54.7657142857143,66.3014285714286,417,67,38,0,0,328,350,290
2019,46,49,"Uskudar",41.0328,29.0312,12.5428571428571,16.8428571428571,0.126428571428571,76.3714285714286,58.7985714285714,63.4071428571429,401,0,0,55,36,337,401,337
2019,47,49,"Uskudar",41.0328,29.0312,15.3428571428571,14.7714285714286,0.193857142857143,79.2142857142857,49.6442857142857,53.4714285714286,391,0,0,0,0,339,391,339
2019,48,49,"Uskudar",41.0328,29.0312,21.6857142857143,14.0714285714286,5.57857142857143,77.9428571428572,31.9857142857143,40.3114285714286,320,0,0,48,42,251,320,251
2019,49,49,"Uskudar",41.0328,29.0312,17.3571428571429,8.81428571428571,1.74957142857143,73.6857142857143,34.2566666666667,41.7985714285714,393,0,0,73,67,274,393,274
2019,50,49,"Uskudar",41.0328,29.0312,12.5285714285714,11.0142857142857,0.385857142857143,76.5142857142857,57.6425,63.6828571428571,218,48,11,0,0,119,170,108
2019,51,49,"Uskudar",41.0328,29.0312,15.2714285714286,12.8857142857143,0.0481428571428571,71.9285714285714,65.3166666666667,63.8114285714286,361,106,130,0,0,488,255,358
2019,52,49,"Uskudar",41.0328,29.0312,19.8428571428571,8.8,6.19528571428571,77.8714285714286,17.575,30.19,279,0,0,155,158,281,279,281
2020,1,49,"Uskudar",41.0328,29.0312,17.44,6.34,4.5106,75.9,15.96,46.878,160,0,0,38,19,126,160,126
2020,2,49,"Uskudar",41.0328,29.0312,24.1714285714286,6.15714285714286,12.8331428571429,81.1571428571429,30.888,42.1216666666667,240,0,0,64,42,173,240,173
2020,3,49,"Uskudar",41.0328,29.0312,19.4857142857143,7.2,0.267714285714286,78.0571428571429,30.01,39.9928571428571,270,0,0,0,0,382,270,382
2020,4,49,"Uskudar",41.0328,29.0312,18.9285714285714,6.1,1.75871428571429,71.8428571428571,31.5033333333333,36.2216666666667,358,0,0,163,89,295,358,295
2020,5,49,"Uskudar",41.0328,29.0312,15.9285714285714,9.84285714285714,3.91042857142857,76.8142857142857,40.9542857142857,52.2771428571429,331,64,57,61,80,272,267,215
2020,6,49,"Uskudar",41.0328,29.0312,21.7285714285714,7.11428571428571,4.55642857142857,75.8285714285714,23.9642857142857,35.2314285714286,343,0,0,140,109,267,343,267
2020,7,49,"Uskudar",41.0328,29.0312,20.2,8.27142857142857,1.58628571428571,72.2714285714286,38.2714285714286,48.8228571428571,341,43,48,38,22,338,298,290
2020,8,49,"Uskudar",41.0328,29.0312,16.5714285714286,6.91428571428571,1.73857142857143,80.2142857142857,36.5542857142857,43.2028571428571,283,0,0,39,21,187,283,187
2020,9,49,"Uskudar",41.0328,29.0312,20.8571428571429,10.3428571428571,2.597,67.9857142857143,43.605,45.9814285714286,393,0,0,27,48,528,393,528
2020,10,49,"Uskudar",41.0328,29.0312,12.8285714285714,13.7571428571429,0.299285714285714,66.6,59.6242857142857,69.9957142857143,205,0,0,47,17,210,205,210
2020,11,49,"Uskudar",41.0328,29.0312,20.1571428571429,10.8428571428571,1.791,79.8428571428571,40.1657142857143,44.5942857142857,115,0,0,23,11,94,115,94
2020,12,49,"Uskudar",41.0328,29.0312,22.3571428571429,7.45714285714286,0.552571428571429,67.4,28.2628571428571,38.2042857142857,117,0,0,11,10,118,117,118
2020,13,49,"Uskudar",41.0328,29.0312,22.7,8.6,3.69857142857143,85.4285714285714,42.002,20.38,136,0,0,23,27,92,136,92
2020,14,49,"Uskudar",41.0328,29.0312,24.0142857142857,8.8,3.09414285714286,83.8,29.635,26.8371428571429,155,0,0,25,22,121,155,121
2020,15,49,"Uskudar",41.0328,29.0312,26.6571428571429,10.0285714285714,0.187142857142857,66.6142857142857,27.724,25.8183333333333,133,0,0,23,11,118,133,118
2020,16,49,"Uskudar",41.0328,29.0312,14.9,12.9714285714286,0.823428571428571,62.2571428571429,30.98,44.4314285714286,141,0,0,23,7,106,141,106
2020,17,49,"Uskudar",41.0328,29.0312,26.0857142857143,11.5857142857143,0.0881428571428571,66.3285714285714,21.08,20.5616666666667,137,0,0,36,18,123,137,123
2020,18,49,"Uskudar",41.0328,29.0312,16.1857142857143,17.1285714285714,1.31671428571429,62.6714285714286,24.9742857142857,40.77,146,24,19,0,0,164,122,145
2020,19,49,"Uskudar",41.0328,29.0312,20,14.7571428571429,3.72414285714286,71.4857142857143,21.2142857142857,31.25,137,0,0,95,118,157,137,157
2020,20,49,"Uskudar",41.0328,29.0312,18.5714285714286,21.2142857142857,0,62.0428571428571,41.9828571428571,51.345,164,0,0,31,20,164,164,164
2020,21,49,"Uskudar",41.0328,29.0312,25.9285714285714,17.5571428571429,2.66771428571429,71.4571428571429,21.06,22.8928571428571,146,0,0,56,43,96,146,96
2020,22,49,"Uskudar",41.0328,29.0312,18.0142857142857,16.2571428571429,1.67514285714286,73.1142857142857,15.2428571428571,21.88,118,0,0,19,32,100,118,100
2020,23,49,"Uskudar",41.0328,29.0312,14.5714285714286,19.9857142857143,1.70157142857143,65.6428571428571,28.5042857142857,51.6242857142857,112,12,2,19,2,70,100,68
2020,24,49,"Uskudar",41.0328,29.0312,17.5428571428571,22.9142857142857,0.440857142857143,66.5857142857143,26.8514285714286,42.54,140,0,0,15,5,150,140,150
2020,25,49,"Uskudar",41.0328,29.0312,17.5857142857143,23.2428571428571,2.95614285714286,74.5428571428571,29.3071428571429,42.8471428571429,137,0,0,76,53,108,137,108
2020,26,49,"Uskudar",41.0328,29.0312,19.4571428571429,23.4857142857143,0.388857142857143,73.9571428571429,19.7014285714286,26.8385714285714,173,0,0,37,41,133,173,133
2020,27,49,"Uskudar",41.0328,29.0312,19.1571428571429,25.9285714285714,0.00285714285714286,71.7857142857143,25.0471428571429,30.4442857142857,113,0,0,2,0,113,113,113
2020,28,49,"Uskudar",41.0328,29.0312,26.1714285714286,24.9714285714286,0.0142857142857143,69.8285714285714,20.06,20.93,164,0,0,5,0,122,164,122
2020,29,49,"Uskudar",41.0328,29.0312,21.3142857142857,22.9714285714286,0.0127142857142857,67.3857142857143,16.6342857142857,20.3685714285714,186,0,0,0,0,111,186,111
2020,30,49,"Uskudar",41.0328,29.0312,22.7142857142857,25.1428571428571,0,69.7,22.4057142857143,25.2614285714286,190,0,0,5,8,142,190,142
2020,31,49,"Uskudar",41.0328,29.0312,21.3571428571429,26.2142857142857,0,68.5857142857143,20.375,27.3228571428571,150,0,0,0,0,127,150,127
2020,32,49,"Uskudar",41.0328,29.0312,25.1857142857143,25.6857142857143,0,69.8428571428571,17.3628571428571,21.4228571428571,146,0,0,0,0,107,146,107
2020,33,49,"Uskudar",41.0328,29.0312,23.6428571428571,25.6857142857143,0,63.3571428571429,18.0728571428571,24.56,183,0,0,0,0,83,183,83
2020,34,49,"Uskudar",41.0328,29.0312,19.3571428571429,24.2,1.20957142857143,69.1857142857143,22.635,34.315,197,0,0,23,14,97,197,97
2020,35,49,"Uskudar",41.0328,29.0312,20.2285714285714,25.2142857142857,0,66.6857142857143,17.12,26.7571428571429,164,0,0,0,0,157,164,157
2020,36,49,"Uskudar",41.0328,29.0312,19.0857142857143,24.3142857142857,0.396571428571429,71.7857142857143,18.2928571428571,25.0957142857143,179,0,0,34,17,112,179,112
2020,37,49,"Uskudar",41.0328,29.0312,25.1714285714286,24.2428571428571,0.0695714285714286,73.3571428571429,22.5928571428571,22.9728571428571,193,0,0,3,2,91,193,91
2020,38,49,"Uskudar",41.0328,29.0312,24.8,23.4571428571429,0.0802857142857143,69.9,22.56,21.1842857142857,235,0,0,5,4,157,235,157
2020,39,49,"Uskudar",41.0328,29.0312,18.5428571428571,23.2,0.420285714285714,65.5714285714286,33.2871428571429,51.66,220,21,6,59,23,129,199,123
2020,40,49,"Uskudar",41.0328,29.0312,11.2142857142857,21.3428571428571,1.67114285714286,61.2428571428571,32.9514285714286,62.0814285714286,187,0,0,102,78,154,187,154
2020,41,49,"Uskudar",41.0328,29.0312,11.5571428571429,21.6571428571429,5.12542857142857,71.7857142857143,52.5728571428571,65.915,182,0,0,124,94,127,182,127
2020,42,49,"Uskudar",41.0328,29.0312,13.8714285714286,20.6857142857143,2.52885714285714,71.2,34.4171428571429,51.5557142857143,177,33,8,28,21,111,144,103
2020,43,49,"Uskudar",41.0328,29.0312,16.3428571428571,17.8428571428571,2.777,80.1714285714286,37.7742857142857,41.2183333333333,194,0,0,29,8,161,194,161
2020,44,49,"Uskudar",41.0328,29.0312,16.2285714285714,16.5285714285714,7.40985714285714,80.7428571428571,33.5185714285714,40.2157142857143,255,0,0,146,127,233,255,233
2020,45,49,"Uskudar",41.0328,29.0312,17.9142857142857,13.6285714285714,3.56285714285714,81.3285714285714,27.3942857142857,34.8057142857143,156,0,0,30,25,103,156,103
2020,46,49,"Uskudar",41.0328,29.0312,18.6571428571429,14.2285714285714,0.967142857142857,78.6142857142857,19.9185714285714,33.6128571428571,208,0,0,2,2,109,208,109
2020,47,49,"Uskudar",41.0328,29.0312,21.3571428571429,11.4714285714286,2.07771428571429,78.0428571428571,22.1428571428571,35.1528571428571,173,0,0,0,0,83,173,83
2020,48,49,"Uskudar",41.0328,29.0312,15.3857142857143,10.4428571428571,0.159571428571429,71.1142857142857,35.6485714285714,47.7728571428571,199,3,3,1,1,262,196,259
2020,49,49,"Uskudar",41.0328,29.0312,19.4428571428571,9.9,0.450428571428571,82.9142857142857,36.7814285714286,34.7614285714286,207,0,0,45,12,116,207,116
2020,50,49,"Uskudar",41.0328,29.0312,14.7142857142857,12.9428571428571,1.21785714285714,74.7142857142857,41.775,48.3466666666667,181,46,56,0,0,98,135,42
2020,51,49,"Uskudar",41.0328,29.0312,19.3714285714286,9.8,2.621,86.7571428571429,22.4685714285714,30.03,171,0,0,6,2,90,171,90
2020,52,49,"Uskudar",41.0328,29.0312,15.9857142857143,10.7142857142857,0.466857142857143,73.9142857142857,40.23,41.6528571428571,203,17,22,0,0,113,186,91
2020,53,49,"Uskudar",41.0328,29.0312,14.675,13.875,0.386,64.95,50.155,51.51,122,34,30,0,0,111,88,81
2017,1,50,"Bayrakli",38.4656,27.1624,22.3,6.65714285714286,22.7667142857143,68.3857142857143,79.01,NA,563,337,471,79,138,847,226,376
2017,2,50,"Bayrakli",38.4656,27.1624,18.5428571428571,6.55714285714286,9.81314285714286,71.0285714285714,80.2,NA,757,625,1091,0,0,1214,132,123
2017,3,50,"Bayrakli",38.4656,27.1624,14.7571428571429,8.82857142857143,9.15885714285714,75.5857142857143,55.9685714285714,NA,762,305,491,65,128,1449,457,958
2017,4,50,"Bayrakli",38.4656,27.1624,16.4571428571429,5,2.05971428571429,62.6428571428571,44.4871428571429,NA,639,67,64,204,239,889,572,825
2017,5,50,"Bayrakli",38.4656,27.1624,15.3428571428571,8.12857142857143,0.926714285714286,59.7428571428571,81.4514285714286,NA,588,323,416,9,34,1163,265,747
2017,6,50,"Bayrakli",38.4656,27.1624,19.6,11.2428571428571,3.50114285714286,64.7,41.2957142857143,NA,736,245,370,118,255,1519,491,1149
2017,7,50,"Bayrakli",38.4656,27.1624,20.8714285714286,7.18571428571429,0.00328571428571429,51.8,52.2142857142857,NA,492,134,113,148,275,717,358,604
2017,8,50,"Bayrakli",38.4656,27.1624,17.3,13.6714285714286,0.166571428571429,68.7,61.75,NA,739,643,1552,0,0,1747,96,195
2017,9,50,"Bayrakli",38.4656,27.1624,13.0571428571429,13.1571428571429,3.38642857142857,74.5571428571429,83.92,NA,574,120,171,225,396,866,454,695
2017,10,50,"Bayrakli",38.4656,27.1624,15.6428571428571,13.1,11.8871428571429,73.3857142857143,45.3771428571429,NA,712,533,688,96,169,1043,179,355
2017,11,50,"Bayrakli",38.4656,27.1624,18.0571428571429,9.97142857142857,1.357,62.4714285714286,43.5542857142857,NA,525,68,137,385,542,725,457,588
2017,12,50,"Bayrakli",38.4656,27.1624,13.6142857142857,15.6428571428571,0,61.2,77.9171428571429,NA,589,163,425,134,159,1077,426,652
2017,13,50,"Bayrakli",38.4656,27.1624,17.3714285714286,14.5,0.260142857142857,59.5142857142857,51.38,NA,574,0,0,360,574,887,574,887
2017,14,50,"Bayrakli",38.4656,27.1624,15.3285714285714,15.6285714285714,1.012,58.3714285714286,49.3728571428571,NA,639,96,276,261,436,1336,543,1060
2017,15,50,"Bayrakli",38.4656,27.1624,18.1142857142857,16.8857142857143,0.00457142857142857,48.0571428571429,50.3014285714286,NA,587,99,259,206,486,1187,488,928
2017,16,50,"Bayrakli",38.4656,27.1624,19.6,15.1,1.83171428571429,62.9285714285714,28.5185714285714,NA,717,305,361,110,97,920,412,559
2017,17,50,"Bayrakli",38.4656,27.1624,15,18.3,0,45.8857142857143,51.34,NA,731,166,463,154,315,1478,565,1015
2017,18,50,"Bayrakli",38.4656,27.1624,18.6571428571429,21.3285714285714,0,55.7,59.824,NA,506,41,91,210,327,923,465,832
2017,19,50,"Bayrakli",38.4656,27.1624,21.5857142857143,22.7714285714286,0,49.4857142857143,47.6642857142857,NA,471,243,502,43,40,966,228,464
2017,20,50,"Bayrakli",38.4656,27.1624,18.4857142857143,20.8,0.44,52.9571428571429,26.7114285714286,NA,472,72,249,267,707,1205,400,956
2017,21,50,"Bayrakli",38.4656,27.1624,16.9714285714286,21.2714285714286,0.84,53.2428571428571,28.4342857142857,NA,448,106,268,268,403,849,342,581
2017,22,50,"Bayrakli",38.4656,27.1624,15.5714285714286,22.9142857142857,4.60985714285714,60.6285714285714,48.7314285714286,NA,522,0,0,352,627,1015,522,1015
2017,23,50,"Bayrakli",38.4656,27.1624,19.7857142857143,24.1,0.299857142857143,60.4714285714286,43.2114285714286,NA,578,0,0,548,1266,1388,578,1388
2017,24,50,"Bayrakli",38.4656,27.1624,20.0571428571429,25.7142857142857,0.0497142857142857,51.0142857142857,43.2566666666667,NA,552,0,0,405,839,1139,552,1139
2017,25,50,"Bayrakli",38.4656,27.1624,20.6142857142857,26.3428571428571,0,47.3714285714286,36.8485714285714,NA,584,0,0,444,759,1041,584,1041
2017,26,50,"Bayrakli",38.4656,27.1624,18.9428571428571,31.2142857142857,0,40.3857142857143,44.7825,NA,564,0,0,401,629,971,564,971
2017,27,50,"Bayrakli",38.4656,27.1624,26.3571428571429,28.4714285714286,0,42.2142857142857,29.0083333333333,NA,511,0,0,464,605,642,511,642
2017,28,50,"Bayrakli",38.4656,27.1624,20.4285714285714,30.2285714285714,0,41.4,39.6785714285714,NA,481,0,0,230,294,864,481,864
2017,29,50,"Bayrakli",38.4656,27.1624,21.0285714285714,27.8571428571429,0.00228571428571429,51.6857142857143,35.0457142857143,NA,532,0,0,495,1166,1272,532,1272
2017,30,50,"Bayrakli",38.4656,27.1624,18.1714285714286,28.9857142857143,0.002,43.7571428571429,42.74,NA,531,157,271,303,497,928,374,657
2017,31,50,"Bayrakli",38.4656,27.1624,20.2285714285714,30.1,0.0127142857142857,45.7857142857143,39.9866666666667,NA,559,0,0,547,1037,1047,559,1047
2017,32,50,"Bayrakli",38.4656,27.1624,19.3714285714286,30.9428571428571,0.005,48.2,46.8616666666667,NA,567,0,0,542,1017,1092,567,1092
2017,33,50,"Bayrakli",38.4656,27.1624,21.6714285714286,28.8714285714286,0,49.7857142857143,38.2314285714286,NA,596,0,0,583,1183,1199,596,1199
2017,34,50,"Bayrakli",38.4656,27.1624,22,26.9857142857143,0.0404285714285714,49.2428571428571,33.6157142857143,NA,601,0,0,567,1249,1280,601,1280
2017,35,50,"Bayrakli",38.4656,27.1624,17.8571428571429,26.1857142857143,0,44.7142857142857,32.6128571428571,NA,493,0,0,472,996,1014,493,1014
2017,36,50,"Bayrakli",38.4656,27.1624,18.6857142857143,25.0142857142857,0,44.6857142857143,43.19,NA,507,0,0,391,1024,1321,507,1321
2017,37,50,"Bayrakli",38.4656,27.1624,17.0714285714286,26.7571428571429,0,52.1857142857143,58.9728571428571,NA,589,13,2,425,814,1138,576,1136
2017,38,50,"Bayrakli",38.4656,27.1624,18.7571428571429,24.9285714285714,0,45.8142857142857,46.9485714285714,NA,671,19,29,548,1082,1312,652,1283
2017,39,50,"Bayrakli",38.4656,27.1624,18.1857142857143,21.8571428571429,0.0405714285714286,57.3,38.7085714285714,NA,782,0,0,618,1266,1630,782,1630
2017,40,50,"Bayrakli",38.4656,27.1624,19.6142857142857,20.2571428571429,0.0961428571428571,50.9285714285714,33.69,NA,543,156,365,286,594,1137,387,772
2017,41,50,"Bayrakli",38.4656,27.1624,19.3857142857143,18.8,0,45,28.4442857142857,NA,487,0,0,356,645,843,487,843
2017,42,50,"Bayrakli",38.4656,27.1624,14.4,19.4142857142857,0,56.1285714285714,62.62,NA,530,0,0,344,557,815,530,815
2017,43,50,"Bayrakli",38.4656,27.1624,15.5428571428571,16.8571428571429,7.25985714285714,71.3285714285714,39.5214285714286,NA,506,299,529,91,165,919,207,390
2017,44,50,"Bayrakli",38.4656,27.1624,14.3428571428571,13.1857142857143,0,53.0428571428571,48.8666666666667,NA,561,127,225,120,240,1102,434,877
2017,45,50,"Bayrakli",38.4656,27.1624,13.1857142857143,14.9714285714286,0,64.3714285714286,81.0466666666667,NA,577,366,601,5,1,829,211,228
2017,46,50,"Bayrakli",38.4656,27.1624,15.8428571428571,16.5714285714286,2.03285714285714,70.1857142857143,71.4371428571429,NA,587,587,1085,0,0,1085,0,0
2017,47,50,"Bayrakli",38.4656,27.1624,15.1857142857143,11.2428571428571,2.13628571428571,63.8142857142857,77.8185714285714,NA,418,281,636,92,114,804,137,168
2017,48,50,"Bayrakli",38.4656,27.1624,20.5,14.6571428571429,4.37057142857143,71.2142857142857,40.5857142857143,NA,386,335,521,0,0,619,51,98
2017,49,50,"Bayrakli",38.4656,27.1624,17.9428571428571,10.9428571428571,2.20385714285714,65.0714285714286,54.2942857142857,NA,407,277,436,130,209,645,130,209
2017,50,50,"Bayrakli",38.4656,27.1624,16.0857142857143,15,2.91585714285714,74.4142857142857,64.2585714285714,NA,346,339,438,0,0,442,7,4
2017,51,50,"Bayrakli",38.4656,27.1624,15.8142857142857,9.31428571428571,2.18771428571429,67.9,31.1042857142857,NA,386,58,40,121,110,349,328,309
2017,52,50,"Bayrakli",38.4656,27.1624,15.525,9.6125,7.800375,72.5625,56.00125,NA,528,387,411,42,39,507,141,96
2018,1,50,"Bayrakli",38.4656,27.1624,13.925,9.75,2.777125,73.1375,73.415,NA,618,506,824,2,0,914,112,90
2018,2,50,"Bayrakli",38.4656,27.1624,13.7714285714286,11.1142857142857,5.53357142857143,79.0142857142857,94.4542857142857,NA,624,251,422,78,562,1309,373,887
2018,3,50,"Bayrakli",38.4656,27.1624,19.3714285714286,9.84285714285714,2.67128571428571,66.1142857142857,52.1714285714286,NA,639,454,567,3,1,655,185,88
2018,4,50,"Bayrakli",38.4656,27.1624,21.7428571428571,6.97142857142857,2.116,58.6285714285714,39.88,NA,604,86,169,410,470,764,518,595
2018,5,50,"Bayrakli",38.4656,27.1624,15.2285714285714,11.5571428571429,0.0994285714285714,67.9714285714286,105.862857142857,NA,670,351,592,0,0,819,319,227
2018,6,50,"Bayrakli",38.4656,27.1624,18.7,13.3857142857143,3.72242857142857,73.0571428571428,77.4042857142857,NA,704,534,826,125,150,1022,170,196
2018,7,50,"Bayrakli",38.4656,27.1624,15.6,10.7142857142857,4.23685714285714,73.4714285714286,40.9185714285714,NA,478,287,345,111,141,557,191,212
2018,8,50,"Bayrakli",38.4656,27.1624,13.4142857142857,11.5857142857143,4.20671428571429,78.2,72.5271428571428,NA,711,385,742,312,578,1321,326,579
2018,9,50,"Bayrakli",38.4656,27.1624,20.3,12.7857142857143,4.78842857142857,68.4142857142857,59.6128571428571,NA,621,486,715,0,0,956,135,241
2018,10,50,"Bayrakli",38.4656,27.1624,19.0714285714286,16.4857142857143,0.0794285714285714,63.7142857142857,74.9457142857143,NA,556,303,848,111,228,1330,253,482
2018,11,50,"Bayrakli",38.4656,27.1624,19.9428571428571,16.3428571428571,0.474857142857143,60.2,37.15,NA,551,320,980,0,0,1426,231,446
2018,12,50,"Bayrakli",38.4656,27.1624,22.3,16.3,2.98871428571429,57.3285714285714,57.8671428571429,NA,425,358,1104,0,0,1187,67,83
2018,13,50,"Bayrakli",38.4656,27.1624,22.3285714285714,15.4,0.348,59.2,73.8528571428571,NA,356,228,236,128,192,428,128,192
2018,14,50,"Bayrakli",38.4656,27.1624,15.3,16.1857142857143,0.592857142857143,58.7857142857143,54.66,NA,407,0,0,223,295,486,407,486
2018,15,50,"Bayrakli",38.4656,27.1624,15.0571428571429,18.5714285714286,0.00114285714285714,64.2857142857143,77.4557142857143,NA,374,47,41,285,339,450,327,409
2018,16,50,"Bayrakli",38.4656,27.1624,18.2571428571429,19.0857142857143,0,52.6857142857143,52.4114285714286,NA,411,0,0,406,648,648,411,648
2018,17,50,"Bayrakli",38.4656,27.1624,16.7285714285714,21.8142857142857,0.01,51.2571428571429,67.024,NA,419,0,0,338,597,652,419,652
2018,18,50,"Bayrakli",38.4656,27.1624,16.3714285714286,23.6428571428571,2.71857142857143,52.2142857142857,54.01,NA,303,2,2,128,274,474,301,472
2018,19,50,"Bayrakli",38.4656,27.1624,19.2714285714286,20.9714285714286,0.087,57.8714285714286,33.2442857142857,NA,275,0,0,245,438,467,275,467
2018,20,50,"Bayrakli",38.4656,27.1624,13.4428571428571,25.3428571428571,0,44.6571428571429,44.2757142857143,NA,204,5,2,82,138,306,199,304
2018,21,50,"Bayrakli",38.4656,27.1624,18.7857142857143,24.1428571428571,0.294142857142857,59.6714285714286,39.1028571428571,NA,252,0,0,232,269,281,252,281
2018,22,50,"Bayrakli",38.4656,27.1624,20.5142857142857,24.8142857142857,0,47.8571428571429,29.3657142857143,NA,249,0,0,222,383,427,249,427
2018,23,50,"Bayrakli",38.4656,27.1624,16.8714285714286,27.3571428571429,0,45.1,51.8928571428571,NA,267,7,5,159,423,812,260,807
2018,24,50,"Bayrakli",38.4656,27.1624,17.3571428571429,26.6428571428571,0.184142857142857,47.6,30.5314285714286,NA,267,0,0,187,381,448,267,448
2018,25,50,"Bayrakli",38.4656,27.1624,16.4,25.4857142857143,0.831571428571429,61.2571428571429,31.28,NA,358,0,0,358,518,518,358,518
2018,26,50,"Bayrakli",38.4656,27.1624,18.3285714285714,25.3857142857143,1.01357142857143,57.8857142857143,23.2742857142857,NA,355,0,0,268,488,587,355,587
2018,27,50,"Bayrakli",38.4656,27.1624,19.7285714285714,29.4857142857143,0,43.1857142857143,34.4557142857143,NA,342,0,0,15,19,418,342,418
2018,28,50,"Bayrakli",38.4656,27.1624,23.1285714285714,28.6571428571429,0,52.4571428571429,33.5485714285714,NA,286,0,0,108,219,585,286,585
2018,29,50,"Bayrakli",38.4656,27.1624,22.2571428571429,28.8428571428571,0,49.0142857142857,35.93,NA,260,0,0,119,383,756,260,756
2018,30,50,"Bayrakli",38.4656,27.1624,17.3428571428571,28.2857142857143,0.116857142857143,56.1714285714286,37.2985714285714,NA,265,31,62,52,141,822,234,760
2018,31,50,"Bayrakli",38.4656,27.1624,20.2428571428571,30.0428571428571,0.0867142857142857,53.5285714285714,38.8585714285714,NA,267,0,0,121,218,499,267,499
2018,32,50,"Bayrakli",38.4656,27.1624,21.6142857142857,30.2142857142857,0,42.8142857142857,38.3457142857143,NA,297,0,0,226,300,403,297,403
2018,33,50,"Bayrakli",38.4656,27.1624,19.8428571428571,28.0428571428571,0,52.1,46.7514285714286,NA,216,0,0,40,47,332,216,332
2018,34,50,"Bayrakli",38.4656,27.1624,18.7714285714286,28.0857142857143,0,53.5714285714286,36.9085714285714,NA,144,0,0,20,10,227,144,227
2018,35,50,"Bayrakli",38.4656,27.1624,17.8142857142857,28.2428571428571,0.159285714285714,56.2142857142857,49.1628571428571,NA,201,0,0,65,81,314,201,314
2018,36,50,"Bayrakli",38.4656,27.1624,18.3714285714286,27.0285714285714,0,55.1714285714286,50.7157142857143,NA,341,0,0,7,33,370,341,370
2018,37,50,"Bayrakli",38.4656,27.1624,20.9571428571429,25.1,0.0157142857142857,47.3428571428571,32.116,NA,241,0,0,135,252,419,241,419
2018,38,50,"Bayrakli",38.4656,27.1624,26.2,24.4285714285714,0,54.4571428571429,40.6128571428571,NA,189,0,0,186,330,344,189,344
2018,39,50,"Bayrakli",38.4656,27.1624,23.2428571428571,22.2142857142857,3.57685714285714,55.0714285714286,48.815,NA,180,42,78,35,46,353,138,275
2018,40,50,"Bayrakli",38.4656,27.1624,17.2714285714286,20.7142857142857,2.30185714285714,63.8285714285714,40.865,NA,191,58,92,26,54,341,133,249
2018,41,50,"Bayrakli",38.4656,27.1624,18.4571428571429,20.6,0.0307142857142857,63.2571428571429,39.7757142857143,NA,187,0,0,158,351,422,187,422
2018,42,50,"Bayrakli",38.4656,27.1624,15.6857142857143,20,0,72.1142857142857,67.8542857142857,NA,168,0,0,14,6,381,168,381
2018,43,50,"Bayrakli",38.4656,27.1624,14.1285714285714,16.7142857142857,0.156285714285714,55.6714285714286,51.9933333333333,NA,187,31,55,52,71,402,156,347
2018,44,50,"Bayrakli",38.4656,27.1624,14.2,18.4571428571429,0,57.2,85.6266666666667,NA,196,43,77,0,0,264,153,187
2018,45,50,"Bayrakli",38.4656,27.1624,12.8857142857143,16.1142857142857,0,67.4857142857143,67.93,NA,231,0,0,7,15,473,231,473
2018,46,50,"Bayrakli",38.4656,27.1624,17.2285714285714,13.3428571428571,2.67642857142857,61.9571428571429,33.0671428571429,NA,230,0,0,95,167,465,230,465
2018,47,50,"Bayrakli",38.4656,27.1624,16.5714285714286,15.1,2.78428571428571,73.1,49.1385714285714,NA,270,205,372,27,58,499,65,127
2018,48,50,"Bayrakli",38.4656,27.1624,19.1285714285714,12.5142857142857,2.85485714285714,74.3142857142857,33.4885714285714,NA,245,110,70,46,44,201,135,131
2018,49,50,"Bayrakli",38.4656,27.1624,15.8428571428571,10,3.42028571428571,69.1857142857143,77.8442857142857,NA,257,65,61,69,174,420,192,359
2018,50,50,"Bayrakli",38.4656,27.1624,15.4285714285714,10.8285714285714,10.0807142857143,75.6428571428571,60.49,NA,256,154,159,67,105,305,102,146
2018,51,50,"Bayrakli",38.4656,27.1624,13.1285714285714,8.75714285714286,1.80028571428571,76.3428571428571,67.9242857142857,NA,250,56,27,79,90,248,194,221
2018,52,50,"Bayrakli",38.4656,27.1624,15.5714285714286,7.04285714285714,1.28471428571429,66.1714285714286,45.6114285714286,NA,244,21,15,109,133,273,223,258
2019,1,50,"Bayrakli",38.4656,27.1624,19.0375,7.75,3.106125,72.1375,34.44125,NA,343,105,369,83,211,784,238,415
2019,2,50,"Bayrakli",38.4656,27.1624,22.2571428571429,7.52857142857143,22.423,71.4714285714286,36.09,NA,255,160,90,41,26,208,95,118
2019,3,50,"Bayrakli",38.4656,27.1624,18.4857142857143,8.37142857142857,3.13557142857143,67.5285714285714,76.6285714285714,NA,192,135,151,54,45,198,57,47
2019,4,50,"Bayrakli",38.4656,27.1624,18.7857142857143,11.2,16.6555714285714,77.7,67.9585714285714,NA,308,305,307,0,0,314,3,7
2019,5,50,"Bayrakli",38.4656,27.1624,18.6428571428571,12.3,9.44171428571429,69.4714285714286,49.3985714285714,NA,253,248,141,0,0,143,5,2
2019,6,50,"Bayrakli",38.4656,27.1624,15.3285714285714,10.9142857142857,2.11385714285714,68.0285714285714,53.6285714285714,NA,276,129,38,25,15,127,147,89
2019,7,50,"Bayrakli",38.4656,27.1624,21.3571428571429,9.98571428571429,8.08514285714286,65.7285714285714,28.9128571428571,NA,325,95,129,83,39,234,230,105
2019,8,50,"Bayrakli",38.4656,27.1624,14.5428571428571,9.72857142857143,1.17028571428571,69.7714285714286,80.4457142857143,NA,305,45,10,0,0,219,260,209
2019,9,50,"Bayrakli",38.4656,27.1624,18.7571428571429,9.97142857142857,0.738714285714286,62.2428571428571,47.1414285714286,NA,331,94,122,135,121,310,237,188
2019,10,50,"Bayrakli",38.4656,27.1624,15.4,14.0571428571429,0,59.7714285714286,46.46,NA,359,318,245,0,0,252,41,7
2019,11,50,"Bayrakli",38.4656,27.1624,22.9285714285714,12.8142857142857,4.90457142857143,67.8,34.6714285714286,NA,373,145,109,210,247,400,228,291
2019,12,50,"Bayrakli",38.4656,27.1624,21.1142857142857,15.0285714285714,0,51.2428571428571,37.18,NA,343,88,301,138,75,416,255,115
2019,13,50,"Bayrakli",38.4656,27.1624,20.9857142857143,12.5428571428571,0.002,46.0857142857143,41.8883333333333,NA,256,0,0,96,57,194,256,194
2019,14,50,"Bayrakli",38.4656,27.1624,17.4714285714286,14.4571428571429,0.427857142857143,58.1571428571429,43.5616666666667,NA,365,154,87,133,54,208,211,121
2019,15,50,"Bayrakli",38.4656,27.1624,18.5285714285714,15.9571428571429,6.43542857142857,70.0571428571428,28.3571428571429,NA,359,248,134,4,3,183,111,49
2019,16,50,"Bayrakli",38.4656,27.1624,18.9,13.6,0.0121428571428571,50.6714285714286,26.02,NA,318,53,51,214,141,208,265,157
2019,17,50,"Bayrakli",38.4656,27.1624,14.4,18.7285714285714,0.0661428571428572,47.0571428571429,33.335,NA,412,118,73,38,12,313,294,240
2019,18,50,"Bayrakli",38.4656,27.1624,19.2285714285714,19.4285714285714,0.162857142857143,52.9142857142857,29.59,NA,523,374,276,0,0,353,149,77
2019,19,50,"Bayrakli",38.4656,27.1624,16.5285714285714,18.0571428571429,0.476285714285714,59.1285714285714,34.7316666666667,NA,452,145,127,78,72,386,307,259
2019,20,50,"Bayrakli",38.4656,27.1624,14.9571428571429,22.4142857142857,0,54,39.72,NA,454,133,132,69,36,389,321,257
2019,21,50,"Bayrakli",38.4656,27.1624,16.1857142857143,23.4285714285714,0.00157142857142857,52.0285714285714,33.2557142857143,NA,457,179,207,68,23,413,278,206
2019,22,50,"Bayrakli",38.4656,27.1624,19.0857142857143,24.9285714285714,0,49.4714285714286,43.2771428571429,NA,453,161,112,3,2,323,292,211
2019,23,50,"Bayrakli",38.4656,27.1624,19.1,25.2285714285714,0,49.4857142857143,31.3285714285714,NA,378,46,97,118,247,532,332,435
2019,24,50,"Bayrakli",38.4656,27.1624,18.8,27.0285714285714,0.269857142857143,55.9857142857143,47.7728571428571,NA,378,0,0,258,155,244,378,244
2019,25,50,"Bayrakli",38.4656,27.1624,19.0857142857143,27.4714285714286,2.85071428571429,54.4285714285714,42.63,NA,306,0,0,102,81,325,306,325
2019,26,50,"Bayrakli",38.4656,27.1624,20.7142857142857,30.3,0.0127142857142857,41.5142857142857,39.822,NA,377,0,0,227,266,342,377,342
2019,27,50,"Bayrakli",38.4656,27.1624,20.7857142857143,29.1428571428571,0,40.9571428571429,38.9914285714286,NA,456,0,0,121,104,222,456,222
2019,28,50,"Bayrakli",38.4656,27.1624,19.2857142857143,27.2,0.174571428571429,46.4857142857143,37.9114285714286,NA,398,0,0,99,123,421,398,421
2019,29,50,"Bayrakli",38.4656,27.1624,18.9142857142857,26.8571428571429,0.0624285714285714,49.6142857142857,31.3942857142857,NA,453,0,0,185,98,203,453,203
2019,30,50,"Bayrakli",38.4656,27.1624,20.6714285714286,28.6428571428571,0,41.6,35.0128571428571,NA,456,0,0,272,222,335,456,335
2019,31,50,"Bayrakli",38.4656,27.1624,19.3285714285714,29.7857142857143,0,45.3571428571429,42.0885714285714,NA,334,54,55,9,8,375,280,320
2019,32,50,"Bayrakli",38.4656,27.1624,20.1857142857143,29.2857142857143,0,36.0285714285714,33.1742857142857,NA,346,0,0,234,286,395,346,395
2019,33,50,"Bayrakli",38.4656,27.1624,20.1571428571429,28.2714285714286,0,50.5428571428571,34.6171428571429,NA,337,0,0,133,221,531,337,531
2019,34,50,"Bayrakli",38.4656,27.1624,21.1857142857143,29.6714285714286,0,43.1285714285714,35.6971428571429,NA,299,0,0,251,323,345,299,345
2019,35,50,"Bayrakli",38.4656,27.1624,20.6,29.0285714285714,0,46.2571428571429,40.6771428571429,NA,307,0,0,152,188,415,307,415
2019,36,50,"Bayrakli",38.4656,27.1624,19.9714285714286,26.9428571428571,0,49.9428571428571,38.8783333333333,NA,171,0,0,11,1,67,171,67
2019,37,50,"Bayrakli",38.4656,27.1624,21.5857142857143,25.0428571428571,0.501714285714286,52.1571428571429,34.675,NA,218,0,0,40,22,55,218,55
2019,38,50,"Bayrakli",38.4656,27.1624,17.4857142857143,22.5857142857143,0,49.6714285714286,41.75,NA,266,34,2,100,20,91,232,89
2019,39,50,"Bayrakli",38.4656,27.1624,14.8142857142857,22.1142857142857,2.80985714285714,61.8142857142857,38.4171428571429,NA,237,72,40,7,6,79,165,39
2019,40,50,"Bayrakli",38.4656,27.1624,18.4571428571429,23.3,1.646,56.5285714285714,41.3442857142857,NA,241,102,44,0,0,111,139,67
2019,41,50,"Bayrakli",38.4656,27.1624,13.8,20,1.56557142857143,71.4571428571429,45.6185714285714,NA,416,18,2,16,12,448,398,446
2019,42,50,"Bayrakli",38.4656,27.1624,11.5714285714286,20.4714285714286,0.0127142857142857,78.4428571428571,87.6257142857143,NA,356,0,0,0,0,408,356,408
2019,43,50,"Bayrakli",38.4656,27.1624,17.3857142857143,20.4,0,58.8571428571429,44.4385714285714,NA,306,0,0,178,159,300,306,300
2019,44,50,"Bayrakli",38.4656,27.1624,13.8428571428571,17.1714285714286,0.319142857142857,65.7857142857143,52.5,NA,350,124,90,56,37,250,226,160
2019,45,50,"Bayrakli",38.4656,27.1624,17.3857142857143,20.6285714285714,0.928571428571429,65,44.9528571428571,NA,417,417,328,0,0,328,0,0
2019,46,50,"Bayrakli",38.4656,27.1624,12.2714285714286,18.3142857142857,0.736,66.2428571428571,61.6416666666667,NA,401,280,248,0,0,337,121,89
2019,47,50,"Bayrakli",38.4656,27.1624,11.3571428571429,16.3285714285714,1.12,67.5571428571429,80.6414285714286,NA,391,258,197,0,0,339,133,142
2019,48,50,"Bayrakli",38.4656,27.1624,15.5571428571429,15.4571428571429,6.33628571428571,77.4,45.0685714285714,NA,320,246,161,0,0,251,74,90
2019,49,50,"Bayrakli",38.4656,27.1624,14.5,10.1857142857143,0.829857142857143,64.8714285714286,49.1514285714286,NA,393,50,38,59,41,274,343,236
2019,50,50,"Bayrakli",38.4656,27.1624,13.1571428571429,12.5428571428571,2.36857142857143,72.6285714285714,53.7985714285714,NA,218,137,83,0,0,119,81,36
2019,51,50,"Bayrakli",38.4656,27.1624,14.7571428571429,13.5714285714286,0,72.8428571428571,84.02,NA,361,306,439,0,0,488,55,49
2019,52,50,"Bayrakli",38.4656,27.1624,18.1,9.98571428571429,7.14185714285714,70.0714285714286,26.1285714285714,NA,279,49,66,88,61,281,230,215
2020,1,50,"Bayrakli",38.4656,27.1624,17.24,7.76,0.7294,58.36,31.086,NA,160,0,0,42,21,126,160,126
2020,2,50,"Bayrakli",38.4656,27.1624,16.9857142857143,7.64285714285714,0.824428571428572,62.2285714285714,46.6,NA,240,54,34,80,80,173,186,139
2020,3,50,"Bayrakli",38.4656,27.1624,17.2428571428571,8.5,0.00157142857142857,62.0571428571429,60.69,NA,270,38,34,73,172,382,232,348
2020,4,50,"Bayrakli",38.4656,27.1624,19.9285714285714,7.18571428571429,0,53.0857142857143,54.51,NA,358,118,159,194,123,295,240,136
2020,5,50,"Bayrakli",38.4656,27.1624,16.6,12,3.87757142857143,65.6285714285714,50.7414285714286,NA,331,291,246,0,0,272,40,26
2020,6,50,"Bayrakli",38.4656,27.1624,23,9.42857142857143,3.96257142857143,63.4,22.3914285714286,NA,343,203,163,14,24,267,140,104
2020,7,50,"Bayrakli",38.4656,27.1624,16.5285714285714,11.4,2.00914285714286,63.8142857142857,37.39,NA,341,181,225,73,77,338,160,113
2020,8,50,"Bayrakli",38.4656,27.1624,17.6285714285714,10.3714285714286,1.58357142857143,64.3714285714286,38.1085714285714,NA,283,122,102,157,83,187,161,85
2020,9,50,"Bayrakli",38.4656,27.1624,19.3142857142857,12.1285714285714,2.36671428571429,60.8857142857143,40.7714285714286,NA,393,213,273,59,116,528,180,255
2020,10,50,"Bayrakli",38.4656,27.1624,19.3428571428571,14.9428571428571,2.01771428571429,63.0142857142857,35.3057142857143,NA,205,205,210,0,0,210,0,0
2020,11,50,"Bayrakli",38.4656,27.1624,14.2571428571429,15.5,1.21571428571429,63.1857142857143,38.9614285714286,NA,115,50,46,8,14,94,65,48
2020,12,50,"Bayrakli",38.4656,27.1624,23.2,10.1714285714286,0.176285714285714,49.4714285714286,25.1871428571429,NA,117,11,10,96,102,118,106,108
2020,13,50,"Bayrakli",38.4656,27.1624,13.8571428571429,12.7428571428571,3.00242857142857,73.6571428571429,48.79,NA,136,0,0,79,72,92,136,92
2020,14,50,"Bayrakli",38.4656,27.1624,18.5571428571429,13.2571428571429,4.19028571428571,71.4714285714286,38.1385714285714,NA,155,43,44,85,47,121,112,77
2020,15,50,"Bayrakli",38.4656,27.1624,22.1571428571429,14.6285714285714,1.46957142857143,53.4857142857143,22.946,NA,133,0,0,121,104,118,133,118
2020,16,50,"Bayrakli",38.4656,27.1624,19.9571428571429,15.7428571428571,1.55828571428571,57.3,25.0283333333333,NA,141,34,22,98,80,106,107,84
2020,17,50,"Bayrakli",38.4656,27.1624,21.0142857142857,15.9,0,55.7714285714286,27.59,NA,137,26,17,89,69,123,111,106
2020,18,50,"Bayrakli",38.4656,27.1624,16.7714285714286,18.4,2.144,62.9142857142857,24.5857142857143,NA,146,73,65,19,20,164,73,99
2020,19,50,"Bayrakli",38.4656,27.1624,21.2285714285714,17.5857142857143,3.21242857142857,60.7428571428571,17.12,NA,137,12,7,112,147,157,125,150
2020,20,50,"Bayrakli",38.4656,27.1624,17.1142857142857,24.4142857142857,0,49.6571428571429,39.14,NA,164,41,61,102,97,164,123,103
2020,21,50,"Bayrakli",38.4656,27.1624,22.6285714285714,22.8285714285714,0.998857142857143,53.7571428571429,47.4242857142857,NA,146,21,10,105,78,96,125,86
2020,22,50,"Bayrakli",38.4656,27.1624,19.6714285714286,18.2571428571429,4.25357142857143,65.7,14.0342857142857,NA,118,38,26,64,65,100,80,74
2020,23,50,"Bayrakli",38.4656,27.1624,17.6142857142857,21.0714285714286,4.942,59.5,21.4457142857143,NA,112,69,51,19,2,70,43,19
2020,24,50,"Bayrakli",38.4656,27.1624,17.7142857142857,24.1857142857143,0.02,56.5571428571429,27.3357142857143,NA,140,52,40,2,0,150,88,110
2020,25,50,"Bayrakli",38.4656,27.1624,17.9142857142857,26.2857142857143,0.136714285714286,50.9,24.5757142857143,NA,137,45,21,7,23,108,92,87
2020,26,50,"Bayrakli",38.4656,27.1624,17.0571428571429,26.7,0.241285714285714,53.8857142857143,25.2114285714286,NA,173,34,40,61,36,133,139,93
2020,27,50,"Bayrakli",38.4656,27.1624,21.5714285714286,29.8857142857143,0,43.9857142857143,33.59,NA,113,0,0,24,17,113,113,113
2020,28,50,"Bayrakli",38.4656,27.1624,21.0571428571429,28.9,0.00485714285714286,52.7,31.5357142857143,NA,164,0,0,97,44,122,164,122
2020,29,50,"Bayrakli",38.4656,27.1624,23.7285714285714,26.7857142857143,0,48.9,26.9185714285714,NA,186,0,0,69,57,111,186,111
2020,30,50,"Bayrakli",38.4656,27.1624,21.3857142857143,29.3142857142857,0,45.6428571428571,34.0428571428571,NA,190,0,0,91,95,142,190,142
2020,31,50,"Bayrakli",38.4656,27.1624,21.7714285714286,31.0857142857143,0,38.9142857142857,31.6033333333333,NA,150,0,0,60,52,127,150,127
2020,32,50,"Bayrakli",38.4656,27.1624,18.9285714285714,28.0714285714286,0.00185714285714286,53.0428571428571,35.546,NA,146,0,0,24,50,107,146,107
2020,33,50,"Bayrakli",38.4656,27.1624,22.1285714285714,29.4714285714286,0.00314285714285714,38.2142857142857,26.9457142857143,NA,183,0,0,112,52,83,183,83
2020,34,50,"Bayrakli",38.4656,27.1624,21.4142857142857,27.9,0,44.9,32.3971428571429,NA,197,0,0,54,21,97,197,97
2020,35,50,"Bayrakli",38.4656,27.1624,19.6714285714286,28.2714285714286,0,46.3285714285714,41.4042857142857,NA,164,0,0,3,2,157,164,157
2020,36,50,"Bayrakli",38.4656,27.1624,18.8571428571429,27.9428571428571,0,47.1142857142857,44.7271428571429,NA,179,0,0,67,50,112,179,112
2020,37,50,"Bayrakli",38.4656,27.1624,20.6571428571429,28.1142857142857,0,50.1714285714286,36.5971428571429,NA,193,0,0,59,29,91,193,91
2020,38,50,"Bayrakli",38.4656,27.1624,19.5714285714286,26.9142857142857,0,54.5,37.5185714285714,NA,235,0,0,141,115,157,235,157
2020,39,50,"Bayrakli",38.4656,27.1624,19.2,24.8428571428571,0,55.9,32.6428571428571,NA,220,96,39,45,29,129,124,90
2020,40,50,"Bayrakli",38.4656,27.1624,14.0857142857143,23.8285714285714,0,48.4,39.74,NA,187,92,64,19,8,154,95,90
2020,41,50,"Bayrakli",38.4656,27.1624,14.6428571428571,23.3142857142857,1.45542857142857,56.7285714285714,52.7442857142857,NA,182,44,24,4,2,127,138,103
2020,42,50,"Bayrakli",38.4656,27.1624,16.6428571428571,22.4857142857143,4.236,59.2428571428571,30.672,NA,177,153,87,0,0,111,24,24
2020,43,50,"Bayrakli",38.4656,27.1624,13.9857142857143,20.2285714285714,0.0164285714285714,66.2285714285714,50.6033333333333,NA,194,13,7,72,56,161,181,154
2020,44,50,"Bayrakli",38.4656,27.1624,13.8857142857143,17.7714285714286,2.17385714285714,68.1857142857143,29.0966666666667,NA,255,59,30,63,56,233,196,203
2020,45,50,"Bayrakli",38.4656,27.1624,21.2714285714286,16.5571428571429,0,53.2142857142857,31.1157142857143,NA,156,0,0,64,49,103,156,103
2020,46,50,"Bayrakli",38.4656,27.1624,18.2142857142857,14.8714285714286,0.120142857142857,63.5714285714286,42.5314285714286,NA,208,0,0,143,66,109,208,109
2020,47,50,"Bayrakli",38.4656,27.1624,18.3,12.3571428571429,0.486571428571429,62.0571428571429,41.9728571428571,NA,173,0,0,135,77,83,173,83
2020,48,50,"Bayrakli",38.4656,27.1624,18.4142857142857,11.1285714285714,0,52.2857142857143,51.31,NA,199,41,73,132,173,262,158,189
2020,49,50,"Bayrakli",38.4656,27.1624,11.1857142857143,12.0857142857143,0.001,67.7428571428571,80.8928571428571,NA,207,68,32,60,44,116,139,84
2020,50,50,"Bayrakli",38.4656,27.1624,19.3142857142857,13.6142857142857,25.8412857142857,80.5571428571428,45.2471428571429,NA,181,179,96,0,0,98,2,2
2020,51,50,"Bayrakli",38.4656,27.1624,17.4571428571429,10.8857142857143,2.267,77.8571428571429,47.9642857142857,NA,171,0,0,101,52,90,171,90
2020,52,50,"Bayrakli",38.4656,27.1624,17.6,10.6285714285714,0.618714285714286,72.0285714285714,53.6628571428571,NA,203,101,48,73,48,113,102,65
2020,53,50,"Bayrakli",38.4656,27.1624,15.3,13.275,8.7645,80.375,52.6275,NA,122,122,111,0,0,111,0,0
2017,1,51,"Bornova",38.4717,27.2185,21.1714285714286,6.34285714285714,21.7674285714286,69.3428571428571,47.8757142857143,39.4814285714286,563,276,361,84,139,847,287,486
2017,2,51,"Bornova",38.4717,27.2185,17.7857142857143,6.24285714285714,9.48414285714286,72.0285714285714,48.25,50.91,757,573,994,0,0,1214,184,220
2017,3,51,"Bornova",38.4717,27.2185,14.7142857142857,8.61428571428571,9.27942857142857,76.1428571428571,NA,NA,762,254,390,127,191,1449,508,1059
2017,4,51,"Bornova",38.4717,27.2185,16.6,4.58571428571429,2.07628571428571,63.6428571428571,22.84,16.09,639,0,0,203,229,889,639,889
2017,5,51,"Bornova",38.4717,27.2185,14.9285714285714,7.68571428571429,0.865571428571429,60.8,21.9614285714286,22.9566666666667,588,297,396,108,242,1163,291,767
2017,6,51,"Bornova",38.4717,27.2185,19.7857142857143,11.0571428571429,3.59957142857143,65.1,21.5725,13.9733333333333,736,245,370,246,606,1519,491,1149
2017,7,51,"Bornova",38.4717,27.2185,20.5428571428571,6.95714285714286,0.005,52.2857142857143,27.4371428571429,20.7342857142857,492,134,113,153,297,717,358,604
2017,8,51,"Bornova",38.4717,27.2185,16.9428571428571,13.4142857142857,0.210428571428571,69.4857142857143,38.0185714285714,28.6585714285714,739,643,1552,0,0,1747,96,195
2017,9,51,"Bornova",38.4717,27.2185,13.2571428571429,13.0142857142857,3.14442857142857,74.7571428571429,58.1257142857143,31.08,574,71,109,275,426,866,503,757
2017,10,51,"Bornova",38.4717,27.2185,15.1571428571429,12.9285714285714,11.4338571428571,74,33.484,28.9214285714286,712,476,647,96,169,1043,236,396
2017,11,51,"Bornova",38.4717,27.2185,17.9,9.72857142857143,1.27542857142857,63.1857142857143,28.4814285714286,25.4157142857143,525,68,137,390,543,725,457,588
2017,12,51,"Bornova",38.4717,27.2185,13.7571428571429,15.4714285714286,0,61.4285714285714,55.1385714285714,38.7385714285714,589,62,55,335,693,1077,527,1022
2017,13,51,"Bornova",38.4717,27.2185,17.4428571428571,14.3571428571429,0.277285714285714,59.6285714285714,38.2271428571429,29.2471428571429,574,0,0,474,774,887,574,887
2017,14,51,"Bornova",38.4717,27.2185,15.3714285714286,15.4428571428571,0.979428571428571,58.6142857142857,41.3971428571429,36.0685714285714,639,96,276,401,768,1336,543,1060
2017,15,51,"Bornova",38.4717,27.2185,17.8714285714286,16.7285714285714,0.0101428571428571,48.3714285714286,37.14,32.0871428571429,587,99,259,264,574,1187,488,928
2017,16,51,"Bornova",38.4717,27.2185,19.3,14.9285714285714,1.84,63.5857142857143,26.705,25.5871428571429,717,305,361,183,175,920,412,559
2017,17,51,"Bornova",38.4717,27.2185,14.9142857142857,18.1,0,46.5285714285714,48.04,40.9485714285714,731,166,463,469,758,1478,565,1015
2017,18,51,"Bornova",38.4717,27.2185,18.7142857142857,21.2142857142857,0.003,56.1142857142857,52.3666666666667,36.9571428571429,506,41,91,314,471,923,465,832
2017,19,51,"Bornova",38.4717,27.2185,21.3,22.5,0.000142857142857143,50.0428571428571,NA,33.6928571428571,471,243,502,97,144,966,228,464
2017,20,51,"Bornova",38.4717,27.2185,18.5142857142857,20.5142857142857,0.587285714285714,53.5142857142857,1.73,22.3928571428571,472,18,22,300,798,1205,454,1183
2017,21,51,"Bornova",38.4717,27.2185,16.9142857142857,21.0285714285714,0.951428571428572,53.8285714285714,37.216,25.1571428571429,448,106,268,316,488,849,342,581
2017,22,51,"Bornova",38.4717,27.2185,15.7285714285714,22.7857142857143,4.28057142857143,60.9285714285714,46.73,31.33,522,0,0,374,678,1015,522,1015
2017,23,51,"Bornova",38.4717,27.2185,19.6428571428571,24,0.285857142857143,60.6,41.6585714285714,26.8085714285714,578,0,0,578,1388,1388,578,1388
2017,24,51,"Bornova",38.4717,27.2185,20.0428571428571,25.5428571428571,0.0752857142857143,51.3142857142857,38.8433333333333,27.0185714285714,552,0,0,520,1000,1139,552,1139
2017,25,51,"Bornova",38.4717,27.2185,20.9142857142857,26.1714285714286,0,47.6,38.8671428571429,26.0442857142857,584,0,0,541,956,1041,584,1041
2017,26,51,"Bornova",38.4717,27.2185,19.4571428571429,31.0714285714286,0,40.7,53.302,33.5542857142857,564,0,0,500,821,971,564,971
2017,27,51,"Bornova",38.4717,27.2185,26.6714285714286,28.2857142857143,0,42.3714285714286,49.7533333333333,19.1185714285714,511,0,0,482,634,642,511,642
2017,28,51,"Bornova",38.4717,27.2185,20.7142857142857,30.1,0,41.3857142857143,46.35,22.552,481,0,0,416,728,864,481,864
2017,29,51,"Bornova",38.4717,27.2185,20.9857142857143,27.5714285714286,0.006,52.1428571428571,37.87,NA,532,0,0,511,1218,1272,532,1272
2017,30,51,"Bornova",38.4717,27.2185,18.2714285714286,28.6857142857143,0.00571428571428571,44.1714285714286,43.2728571428571,NA,531,139,241,324,520,928,392,687
2017,31,51,"Bornova",38.4717,27.2185,20.6428571428571,29.9428571428571,0.0112857142857143,45.9,42.9328571428571,1.53,559,0,0,547,1037,1047,559,1047
2017,32,51,"Bornova",38.4717,27.2185,19.7428571428571,30.7571428571429,0.0194285714285714,48.4285714285714,48.4528571428571,NA,567,0,0,564,1092,1092,567,1092
2017,33,51,"Bornova",38.4717,27.2185,21.6714285714286,28.7571428571429,0,49.6142857142857,41.1228571428571,NA,596,0,0,576,1173,1199,596,1199
2017,34,51,"Bornova",38.4717,27.2185,22.3428571428571,26.8714285714286,0.0984285714285714,49.2,39.7357142857143,NA,601,0,0,582,1272,1280,601,1280
2017,35,51,"Bornova",38.4717,27.2185,18.2,26.0857142857143,0,44.6285714285714,35.2414285714286,NA,493,0,0,474,996,1014,493,1014
2017,36,51,"Bornova",38.4717,27.2185,18.8285714285714,24.7857142857143,0,44.6857142857143,52.944,NA,507,0,0,425,1118,1321,507,1321
2017,37,51,"Bornova",38.4717,27.2185,17.3857142857143,26.6,0,52.1428571428571,65.4757142857143,NA,589,65,133,459,927,1138,524,1005
2017,38,51,"Bornova",38.4717,27.2185,18.7142857142857,24.6857142857143,0,46.0857142857143,51.6628571428571,NA,671,22,31,559,1085,1312,649,1281
2017,39,51,"Bornova",38.4717,27.2185,18.0428571428571,21.6714285714286,0.0981428571428571,57.5571428571429,43.525,NA,782,0,0,708,1408,1630,782,1630
2017,40,51,"Bornova",38.4717,27.2185,19.8,20.1142857142857,0.168428571428571,51.1,NA,NA,543,156,365,349,757,1137,387,772
2017,41,51,"Bornova",38.4717,27.2185,19.6142857142857,18.6714285714286,0,44.8428571428571,NA,NA,487,0,0,469,828,843,487,843
2017,42,51,"Bornova",38.4717,27.2185,14.8571428571429,19.2571428571429,0,55.8714285714286,NA,NA,530,0,0,412,696,815,530,815
2017,43,51,"Bornova",38.4717,27.2185,15.2142857142857,16.7,7.10985714285714,71.6714285714286,36.145,2.3575,506,291,524,204,370,919,215,395
2017,44,51,"Bornova",38.4717,27.2185,14.6285714285714,12.9142857142857,0,53.6428571428571,32.2714285714286,2.35142857142857,561,62,162,175,346,1102,499,940
2017,45,51,"Bornova",38.4717,27.2185,12.4,14.5714285714286,0,65.2571428571429,63.8228571428571,2.34857142857143,577,275,414,108,109,829,302,415
2017,46,51,"Bornova",38.4717,27.2185,15.3571428571429,16.2714285714286,2.01085714285714,71.0571428571428,64.88,2.33,587,535,936,0,0,1085,52,149
2017,47,51,"Bornova",38.4717,27.2185,14.5714285714286,10.8857142857143,2.006,65.0571428571429,45.4271428571429,2.31428571428571,418,234,580,92,114,804,184,224
2017,48,51,"Bornova",38.4717,27.2185,19.4428571428571,14.4428571428571,4.45257142857143,72.0714285714286,33.7585714285714,2.29714285714286,386,319,505,0,0,619,67,114
2017,49,51,"Bornova",38.4717,27.2185,17.3428571428571,10.6285714285714,2.22457142857143,66.0857142857143,46.0357142857143,2.32714285714286,407,249,427,130,209,645,158,218
2017,50,51,"Bornova",38.4717,27.2185,15.5142857142857,14.6714285714286,2.89714285714286,75.2857142857143,57.7,2.31857142857143,346,298,370,0,0,442,48,72
2017,51,51,"Bornova",38.4717,27.2185,16.2571428571429,9.08571428571429,2.23942857142857,68.7571428571429,23.08,13.55,386,58,40,122,120,349,328,309
2017,52,51,"Bornova",38.4717,27.2185,15.2375,9.2375,7.56275,73.55,33.49875,28.48625,528,335,372,105,74,507,193,135
2018,1,51,"Bornova",38.4717,27.2185,13.75,9.3,2.634875,74.425,44.2175,27.8914285714286,618,417,654,22,23,914,201,260
2018,2,51,"Bornova",38.4717,27.2185,13.3,10.7857142857143,5.43442857142857,80.1714285714286,64.8128571428571,32.0428571428571,624,139,254,78,562,1309,485,1055
2018,3,51,"Bornova",38.4717,27.2185,18.3714285714286,9.57142857142857,2.66957142857143,67.3,43.4685714285714,30.2771428571429,639,427,551,16,4,655,212,104
2018,4,51,"Bornova",38.4717,27.2185,22.2714285714286,6.77142857142857,2.05028571428571,58.9,23.6842857142857,20.7414285714286,604,86,169,484,529,764,518,595
2018,5,51,"Bornova",38.4717,27.2185,15.1,11.2285714285714,0.0965714285714286,68.7285714285714,68.97,36.7328571428571,670,351,592,21,20,819,319,227
2018,6,51,"Bornova",38.4717,27.2185,17.9428571428571,13.1142857142857,3.70614285714286,74.0714285714286,69.2157142857143,33.76,704,356,544,125,150,1022,348,478
2018,7,51,"Bornova",38.4717,27.2185,15.7857142857143,10.4714285714286,4.32957142857143,74.2,30.6814285714286,NA,478,241,297,150,184,557,237,260
2018,8,51,"Bornova",38.4717,27.2185,12.6428571428571,11.2857142857143,4.25728571428571,78.9857142857143,61.6285714285714,27.948,711,314,706,306,578,1321,397,615
2018,9,51,"Bornova",38.4717,27.2185,19.9,12.5571428571429,5.09728571428571,69.4,37.556,30.2285714285714,621,425,619,33,60,956,196,337
2018,10,51,"Bornova",38.4717,27.2185,18.5285714285714,16.2428571428571,0.104714285714286,64.5571428571428,62.7983333333333,37.4728571428571,556,244,679,126,269,1330,312,651
2018,11,51,"Bornova",38.4717,27.2185,19.3571428571429,16,0.525714285714286,61.5285714285714,42.7285714285714,35.4214285714286,551,282,925,0,0,1426,269,501
2018,12,51,"Bornova",38.4717,27.2185,21.4,16.0428571428571,3.085,58.2857142857143,67.8742857142857,36.7785714285714,425,275,695,0,0,1187,150,492
2018,13,51,"Bornova",38.4717,27.2185,22.2285714285714,15.1428571428571,0.392428571428571,60.2285714285714,78.6985714285714,37.4042857142857,356,228,236,128,192,428,128,192
2018,14,51,"Bornova",38.4717,27.2185,15.4142857142857,15.9857142857143,0.599285714285714,59.5714285714286,51.0414285714286,36.4071428571429,407,0,0,315,420,486,407,486
2018,15,51,"Bornova",38.4717,27.2185,14.9714285714286,18.4428571428571,0,64.8,75.8085714285714,42.0214285714286,374,47,41,313,372,450,327,409
2018,16,51,"Bornova",38.4717,27.2185,18.3428571428571,18.8714285714286,0,53,53.6128571428571,29.6157142857143,411,0,0,410,644,648,411,648
2018,17,51,"Bornova",38.4717,27.2185,16.9,21.7,0.0355714285714286,51.3142857142857,68.2314285714286,58.8185714285714,419,0,0,405,621,652,419,652
2018,18,51,"Bornova",38.4717,27.2185,16.4428571428571,23.5,2.61428571428571,52.7142857142857,64.54,37.9314285714286,303,0,0,190,323,474,303,474
2018,19,51,"Bornova",38.4717,27.2185,19.3714285714286,20.7857142857143,0.145142857142857,58.3857142857143,38.9557142857143,30.3742857142857,275,0,0,275,467,467,275,467
2018,20,51,"Bornova",38.4717,27.2185,13.4285714285714,25.1714285714286,0,44.8428571428571,44.22,48.8614285714286,204,34,39,140,192,306,170,267
2018,21,51,"Bornova",38.4717,27.2185,18.8857142857143,24.0857142857143,0.35,59.6142857142857,43.818,22.9257142857143,252,0,0,235,270,281,252,281
2018,22,51,"Bornova",38.4717,27.2185,21.1,24.7285714285714,0,47.7428571428571,34.35,13.8857142857143,249,0,0,222,383,427,249,427
2018,23,51,"Bornova",38.4717,27.2185,17,27.2,0,45.1857142857143,57.9057142857143,32.1471428571429,267,0,0,173,489,812,267,812
2018,24,51,"Bornova",38.4717,27.2185,17.2285714285714,26.4428571428571,0.442428571428571,48.1571428571429,40.6557142857143,20.9385714285714,267,0,0,233,417,448,267,448
2018,25,51,"Bornova",38.4717,27.2185,16.4285714285714,25.2857142857143,0.840857142857143,61.8142857142857,39.8942857142857,16.6728571428571,358,0,0,358,518,518,358,518
2018,26,51,"Bornova",38.4717,27.2185,18.3571428571429,25.2285714285714,1.31628571428571,58.2857142857143,37.2514285714286,17.5042857142857,355,0,0,295,501,587,355,587
2018,27,51,"Bornova",38.4717,27.2185,20.1,29.4714285714286,0,42.7857142857143,37.2657142857143,16.3757142857143,342,0,0,124,148,418,342,418
2018,28,51,"Bornova",38.4717,27.2185,23.8857142857143,28.6142857142857,0,52,37.8342857142857,18.3428571428571,286,0,0,136,351,585,286,585
2018,29,51,"Bornova",38.4717,27.2185,22.6857142857143,28.8,0.00514285714285714,48.6285714285714,40.0042857142857,13.7228571428571,260,0,0,146,612,756,260,756
2018,30,51,"Bornova",38.4717,27.2185,17.5714285714286,28.1142857142857,0.292285714285714,56.2714285714286,44.696,12.1485714285714,265,14,29,90,584,822,251,793
2018,31,51,"Bornova",38.4717,27.2185,20.5142857142857,29.9142857142857,0.207285714285714,53.6857142857143,39.3457142857143,NA,267,0,0,170,385,499,267,499
2018,32,51,"Bornova",38.4717,27.2185,21.4857142857143,30.1285714285714,0.000142857142857143,42.8571428571429,37.9,NA,297,0,0,243,326,403,297,403
2018,33,51,"Bornova",38.4717,27.2185,20.1428571428571,27.9714285714286,0,52.0142857142857,55.7242857142857,NA,216,0,0,102,164,332,216,332
2018,34,51,"Bornova",38.4717,27.2185,19.1,27.9714285714286,0,53.7714285714286,42.0157142857143,NA,144,0,0,30,76,227,144,227
2018,35,51,"Bornova",38.4717,27.2185,18,28.1285714285714,0.210285714285714,56.6,61.4785714285714,NA,201,0,0,93,162,314,201,314
2018,36,51,"Bornova",38.4717,27.2185,18.8,26.8571428571429,0,55.0857142857143,64.8585714285714,NA,341,0,0,66,123,370,341,370
2018,37,51,"Bornova",38.4717,27.2185,21.4,24.8,0.0364285714285714,47.8428571428571,33.1914285714286,NA,241,0,0,212,342,419,241,419
2018,38,51,"Bornova",38.4717,27.2185,25.9857142857143,24.1857142857143,0,54.6571428571429,42.14,NA,189,0,0,186,330,344,189,344
2018,39,51,"Bornova",38.4717,27.2185,23.1285714285714,22.0285714285714,3.52271428571429,55.5,42.855,NA,180,42,78,39,47,353,138,275
2018,40,51,"Bornova",38.4717,27.2185,17.5142857142857,20.5714285714286,2.26071428571429,64.2714285714286,38.09,NA,191,58,92,54,138,341,133,249
2018,41,51,"Bornova",38.4717,27.2185,18.1857142857143,20.4571428571429,0.048,63.4714285714286,38.492,NA,187,0,0,161,352,422,187,422
2018,42,51,"Bornova",38.4717,27.2185,15.7857142857143,19.9142857142857,0,72.1428571428571,65.8414285714286,NA,168,0,0,37,34,381,168,381
2018,43,51,"Bornova",38.4717,27.2185,13.8428571428571,16.4142857142857,0.311142857142857,56.7428571428571,48.4185714285714,NA,187,43,66,52,71,402,144,336
2018,44,51,"Bornova",38.4717,27.2185,13.7285714285714,18.2,0,57.6714285714286,65.2871428571429,NA,196,28,42,1,0,264,168,222
2018,45,51,"Bornova",38.4717,27.2185,13.4571428571429,15.7428571428571,0,68.0285714285714,57.0771428571429,NA,231,0,0,122,273,473,231,473
2018,46,51,"Bornova",38.4717,27.2185,17.4285714285714,12.8714285714286,2.70628571428571,63.0428571428571,25.1057142857143,NA,230,0,0,114,222,465,230,465
2018,47,51,"Bornova",38.4717,27.2185,16.0571428571429,14.7428571428571,2.82085714285714,74.0428571428571,40.3014285714286,NA,270,172,308,33,58,499,98,191
2018,48,51,"Bornova",38.4717,27.2185,18.8571428571429,12.3142857142857,3.166,75.0714285714286,30.1871428571429,NA,245,110,70,48,45,201,135,131
2018,49,51,"Bornova",38.4717,27.2185,16.1428571428571,9.72857142857143,3.37657142857143,69.9857142857143,74.4733333333333,NA,257,39,35,152,330,420,218,385
2018,50,51,"Bornova",38.4717,27.2185,14.8142857142857,10.5142857142857,9.67728571428571,76.8142857142857,41.62,NA,256,149,153,69,106,305,107,152
2018,51,51,"Bornova",38.4717,27.2185,13.1714285714286,8.35714285714286,1.78928571428571,77.5428571428571,48.8542857142857,NA,250,40,15,105,126,248,210,233
2018,52,51,"Bornova",38.4717,27.2185,15.7714285714286,6.58571428571429,1.30271428571429,67.2857142857143,29.5028571428571,NA,244,20,12,112,148,273,224,261
2019,1,51,"Bornova",38.4717,27.2185,18.8,7.55,3.27925,73.05,28.5114285714286,3.04,343,105,369,88,213,784,238,415
2019,2,51,"Bornova",38.4717,27.2185,22.3857142857143,7.37142857142857,22.8528571428571,72.1857142857143,21.9814285714286,2.44142857142857,255,156,83,42,26,208,99,125
2019,3,51,"Bornova",38.4717,27.2185,17.8428571428571,8.05714285714286,3.20314285714286,68.8571428571429,46.1085714285714,2.42571428571429,192,132,151,54,45,198,60,47
2019,4,51,"Bornova",38.4717,27.2185,18.4714285714286,11,16.4851428571429,78.6428571428571,47.2683333333333,2.37285714285714,308,285,296,0,0,314,23,18
2019,5,51,"Bornova",38.4717,27.2185,18.0285714285714,12.0857142857143,9.211,70.4285714285714,34.9671428571429,2.37,253,247,140,0,0,143,6,3
2019,6,51,"Bornova",38.4717,27.2185,15.4142857142857,10.7285714285714,2.06042857142857,68.8285714285714,37.7857142857143,2.38142857142857,276,119,29,72,59,127,157,98
2019,7,51,"Bornova",38.4717,27.2185,21.5142857142857,9.81428571428571,8.07885714285714,66.3714285714286,21.67,4.27428571428571,325,95,129,130,50,234,230,105
2019,8,51,"Bornova",38.4717,27.2185,14.5428571428571,9.52857142857143,1.13571428571429,70.4428571428572,62.0285714285714,4.80142857142857,305,1,1,6,5,219,304,218
2019,9,51,"Bornova",38.4717,27.2185,18.6285714285714,9.78571428571429,0.715428571428572,62.9857142857143,39.1228571428571,4.70714285714286,331,94,122,199,173,310,237,188
2019,10,51,"Bornova",38.4717,27.2185,15.0571428571429,13.7857142857143,0,60.6714285714286,44.7085714285714,4.71857142857143,359,275,219,3,1,252,84,33
2019,11,51,"Bornova",38.4717,27.2185,22.2,12.6142857142857,5.01971428571429,68.5,32.9628571428571,4.68428571428571,373,139,105,222,280,400,234,295
2019,12,51,"Bornova",38.4717,27.2185,20.9571428571429,14.8142857142857,0,51.9,38.1485714285714,4.69428571428571,343,88,301,145,75,416,255,115
2019,13,51,"Bornova",38.4717,27.2185,21.4714285714286,12.2857142857143,0,46.7571428571429,37.6614285714286,4.67,256,0,0,134,97,194,256,194
2019,14,51,"Bornova",38.4717,27.2185,17.0428571428571,14.2714285714286,0.539428571428571,58.9714285714286,45.0714285714286,29.8328571428571,365,90,66,187,76,208,275,142
2019,15,51,"Bornova",38.4717,27.2185,18.2571428571429,15.7714285714286,6.59842857142857,70.9,35.6866666666667,36.4142857142857,359,248,134,4,3,183,111,49
2019,16,51,"Bornova",38.4717,27.2185,19.1142857142857,13.3857142857143,0.0267142857142857,51.3285714285714,24.6942857142857,15.9971428571429,318,0,0,220,144,208,318,208
2019,17,51,"Bornova",38.4717,27.2185,14.0142857142857,18.5571428571429,0.061,47.7285714285714,29.845,13.75,412,118,73,127,78,313,294,240
2019,18,51,"Bornova",38.4717,27.2185,19.1428571428571,19.1857142857143,0.171428571428571,53.8142857142857,36.672,26.866,523,374,276,2,1,353,149,77
2019,19,51,"Bornova",38.4717,27.2185,16.7,17.8857142857143,0.473142857142857,59.6857142857143,29.1,24.78,452,145,127,81,77,386,307,259
2019,20,51,"Bornova",38.4717,27.2185,14.6285714285714,22.3,0,54.1857142857143,29.578,15.608,454,98,87,56,48,389,356,302
2019,21,51,"Bornova",38.4717,27.2185,15.9714285714286,23.2571428571429,0.00442857142857143,52.3857142857143,16.3357142857143,4.36571428571429,457,111,130,75,25,413,346,283
2019,22,51,"Bornova",38.4717,27.2185,18.7857142857143,24.8428571428571,0,49.5142857142857,19.5614285714286,4.47285714285714,453,88,54,8,5,323,365,269
2019,23,51,"Bornova",38.4717,27.2185,19.3285714285714,25.0857142857143,0,49.4428571428571,17.1242857142857,4.88,378,41,85,124,258,532,337,447
2019,24,51,"Bornova",38.4717,27.2185,18.8142857142857,26.8857142857143,0.492571428571429,56.3857142857143,22.8214285714286,4.91571428571429,378,0,0,268,167,244,378,244
2019,25,51,"Bornova",38.4717,27.2185,19,27.4,2.54442857142857,54.5714285714286,23.8,4.91714285714286,306,0,0,172,201,325,306,325
2019,26,51,"Bornova",38.4717,27.2185,20.8428571428571,30.1857142857143,0.0112857142857143,41.7285714285714,27.01,4.91428571428571,377,0,0,223,260,342,377,342
2019,27,51,"Bornova",38.4717,27.2185,20.9571428571429,29.1,0,40.8428571428571,28.8057142857143,4.91428571428571,456,0,0,146,118,222,456,222
2019,28,51,"Bornova",38.4717,27.2185,19.8714285714286,27.0142857142857,0.286714285714286,46.7285714285714,34.9914285714286,4.91571428571429,398,0,0,109,139,421,398,421
2019,29,51,"Bornova",38.4717,27.2185,18.9285714285714,26.6285714285714,0.125714285714286,50.0714285714286,33.4514285714286,4.92,453,0,0,221,109,203,453,203
2019,30,51,"Bornova",38.4717,27.2185,21.1285714285714,28.4571428571429,0,41.8857142857143,35.4442857142857,4.92142857142857,456,0,0,326,247,335,456,335
2019,31,51,"Bornova",38.4717,27.2185,19.7714285714286,29.5428571428571,0,45.8142857142857,44.1714285714286,4.92428571428571,334,5,0,77,93,375,329,375
2019,32,51,"Bornova",38.4717,27.2185,20.5,28.9428571428571,0,36.5,37.7485714285714,4.92142857142857,346,0,0,242,293,395,346,395
2019,33,51,"Bornova",38.4717,27.2185,20.4285714285714,28,0,50.7714285714286,41.3728571428571,4.93142857142857,337,0,0,207,328,531,337,531
2019,34,51,"Bornova",38.4717,27.2185,21.5142857142857,29.3285714285714,0,43.7571428571429,41.6985714285714,4.94142857142857,299,0,0,256,326,345,299,345
2019,35,51,"Bornova",38.4717,27.2185,20.4714285714286,28.9285714285714,0,46.2428571428571,47.1985714285714,4.94571428571429,307,0,0,222,342,415,307,415
2019,36,51,"Bornova",38.4717,27.2185,20.0428571428571,26.8,0,50.1285714285714,45.84,4.95,171,0,0,61,15,67,171,67
2019,37,51,"Bornova",38.4717,27.2185,21.8142857142857,24.9428571428571,0.564285714285714,52.3142857142857,43.2685714285714,4.96571428571429,218,0,0,67,27,55,218,55
2019,38,51,"Bornova",38.4717,27.2185,17.7428571428571,22.2571428571429,0,49.9714285714286,52.1357142857143,4.97571428571429,266,0,0,138,38,91,266,91
2019,39,51,"Bornova",38.4717,27.2185,14.7857142857143,21.9428571428571,2.57157142857143,61.7857142857143,45.68,4.94714285714286,237,72,40,46,16,79,165,39
2019,40,51,"Bornova",38.4717,27.2185,18.3714285714286,23.0571428571429,1.59271428571429,56.9428571428571,50.4257142857143,4.94285714285714,241,102,44,8,4,111,139,67
2019,41,51,"Bornova",38.4717,27.2185,13.9571428571429,19.9,1.54342857142857,71.5714285714286,49.8728571428571,4.95,416,0,0,49,15,448,416,448
2019,42,51,"Bornova",38.4717,27.2185,11.7714285714286,20.4428571428571,0.0112857142857143,78.1142857142857,103.287142857143,4.95428571428571,356,0,0,14,11,408,356,408
2019,43,51,"Bornova",38.4717,27.2185,17.8285714285714,20.2857142857143,0,58.8857142857143,51.0628571428571,4.96857142857143,306,0,0,235,195,300,306,300
2019,44,51,"Bornova",38.4717,27.2185,13.6142857142857,16.9142857142857,0.358714285714286,66.1,53.3757142857143,4.97285714285714,350,122,90,63,44,250,228,160
2019,45,51,"Bornova",38.4717,27.2185,16.3857142857143,20.2857142857143,1.06785714285714,66.1714285714286,54.0271428571429,4.98857142857143,417,417,328,0,0,328,0,0
2019,46,51,"Bornova",38.4717,27.2185,11.3428571428571,17.9714285714286,0.755142857142857,67.5571428571428,66.7085714285714,4.99285714285714,401,249,221,0,0,337,152,116
2019,47,51,"Bornova",38.4717,27.2185,10.5714285714286,15.9285714285714,1.148,68.9285714285714,82.6457142857143,4.99,391,241,194,0,0,339,150,145
2019,48,51,"Bornova",38.4717,27.2185,15.0285714285714,15.2,6.18728571428571,78.4,53.2814285714286,4.99285714285714,320,231,152,0,0,251,89,99
2019,49,51,"Bornova",38.4717,27.2185,14.1428571428571,9.87142857142857,0.871,66.2,45.8328571428571,5.01857142857143,393,46,31,100,77,274,347,243
2019,50,51,"Bornova",38.4717,27.2185,12.7,12.2142857142857,2.32071428571429,73.8428571428571,47.0585714285714,4.98571428571429,218,142,70,0,0,119,76,49
2019,51,51,"Bornova",38.4717,27.2185,13.6714285714286,13.1285714285714,0,74,51.1485714285714,4.97428571428571,361,262,378,0,0,488,99,110
2019,52,51,"Bornova",38.4717,27.2185,17.9714285714286,9.81428571428571,7.097,70.7285714285714,22.595,4.89285714285714,279,49,66,155,166,281,230,215
2020,1,51,"Bornova",38.4717,27.2185,17.38,7.56,0.6568,59.12,23.9966666666667,4.882,160,0,0,72,39,126,160,126
2020,2,51,"Bornova",38.4717,27.2185,17.4714285714286,7.42857142857143,1.045,63.1285714285714,NA,4.90142857142857,240,54,34,82,80,173,186,139
2020,3,51,"Bornova",38.4717,27.2185,17.4285714285714,8.28571428571429,0.00242857142857143,62.8428571428571,15.5,4.90428571428571,270,38,34,175,273,382,232,348
2020,4,51,"Bornova",38.4717,27.2185,19.9285714285714,6.88571428571429,0,54.0142857142857,45.2225,4.92,358,109,157,201,123,295,249,138
2020,5,51,"Bornova",38.4717,27.2185,15.9857142857143,11.6571428571429,3.76957142857143,67.1142857142857,51.6266666666667,4.80571428571429,331,291,246,3,0,272,40,26
2020,6,51,"Bornova",38.4717,27.2185,22.8285714285714,9.21428571428572,3.86171428571429,64.3285714285714,22.475,4.74857142857143,343,200,156,16,25,267,143,111
2020,7,51,"Bornova",38.4717,27.2185,16,11.0571428571429,2.14785714285714,65.2285714285714,36.5071428571429,4.81428571428571,341,181,225,106,92,338,160,113
2020,8,51,"Bornova",38.4717,27.2185,17.3428571428571,10.1857142857143,1.59214285714286,65.1571428571429,32.7514285714286,4.82714285714286,283,121,100,157,83,187,162,87
2020,9,51,"Bornova",38.4717,27.2185,19.2857142857143,11.8571428571429,2.31128571428571,62.0714285714286,37.8542857142857,4.78428571428571,393,200,239,118,196,528,193,289
2020,10,51,"Bornova",38.4717,27.2185,18.5714285714286,14.6571428571429,2.356,64.5,39.8983333333333,4.76142857142857,205,205,210,0,0,210,0,0
2020,11,51,"Bornova",38.4717,27.2185,14.5142857142857,15.3142857142857,1.21142857142857,64.0714285714286,49.0785714285714,4.80142857142857,115,49,45,39,28,94,66,49
2020,12,51,"Bornova",38.4717,27.2185,23.8142857142857,10.0142857142857,0.188142857142857,49.8857142857143,26.8757142857143,4.82857142857143,117,11,10,97,103,118,106,108
2020,13,51,"Bornova",38.4717,27.2185,14.4714285714286,12.6142857142857,2.81471428571429,74.1285714285714,57.51,4.82142857142857,136,0,0,99,81,92,136,92
2020,14,51,"Bornova",38.4717,27.2185,18.2,13.0571428571429,4.29228571428571,72.1,45.6442857142857,4.8,155,36,38,108,73,121,119,83
2020,15,51,"Bornova",38.4717,27.2185,22.2857142857143,14.5857142857143,1.39771428571429,53.5142857142857,34.56,4.81142857142857,133,0,0,130,115,118,133,118
2020,16,51,"Bornova",38.4717,27.2185,20.2571428571429,15.6571428571429,1.52085714285714,57.6428571428571,37.2671428571429,4.81142857142857,141,34,22,105,84,106,107,84
2020,17,51,"Bornova",38.4717,27.2185,21.0428571428571,15.7142857142857,0,56.1571428571429,39.5071428571429,4.8,137,18,9,91,72,123,119,114
2020,18,51,"Bornova",38.4717,27.2185,16.5,18.2285714285714,2.12085714285714,63.5,33.4985714285714,4.78714285714286,146,66,54,36,79,164,80,110
2020,19,51,"Bornova",38.4717,27.2185,21.3714285714286,17.5142857142857,2.98657142857143,61,23.42,4.82285714285714,137,13,8,123,149,157,124,149
2020,20,51,"Bornova",38.4717,27.2185,17.5571428571429,24.3714285714286,0,49.5285714285714,74.5214285714286,4.82571428571429,164,41,61,107,99,164,123,103
2020,21,51,"Bornova",38.4717,27.2185,22.9,22.8,1.05971428571429,53.4285714285714,71.8028571428571,4.83428571428571,146,21,10,102,81,96,125,86
2020,22,51,"Bornova",38.4717,27.2185,19.7142857142857,18.1571428571429,4.19457142857143,66.1571428571429,14.8242857142857,4.83285714285714,118,38,26,51,52,100,80,74
2020,23,51,"Bornova",38.4717,27.2185,17.7,20.9428571428571,4.70257142857143,60.0714285714286,24.656,4.82571428571429,112,68,51,19,2,70,44,19
2020,24,51,"Bornova",38.4717,27.2185,17.5857142857143,24.0285714285714,0.0551428571428571,57.1571428571429,33.3925,4.81285714285714,140,50,37,2,1,150,90,113
2020,25,51,"Bornova",38.4717,27.2185,17.7857142857143,26.0857142857143,0.314428571428571,51.7,35.31,4.81142857142857,137,45,21,13,27,108,92,87
2020,26,51,"Bornova",38.4717,27.2185,17.0428571428571,26.5714285714286,0.38,54.4857142857143,37.7542857142857,4.78571428571429,173,34,40,74,48,133,139,93
2020,27,51,"Bornova",38.4717,27.2185,21.6428571428571,29.8428571428571,0,44.2857142857143,27.9485714285714,4.81857142857143,113,0,0,58,25,113,113,113
2020,28,51,"Bornova",38.4717,27.2185,20.8571428571429,28.8285714285714,0.0147142857142857,53,26.0928571428571,4.82285714285714,164,0,0,110,48,122,164,122
2020,29,51,"Bornova",38.4717,27.2185,23.6142857142857,26.7428571428571,0,48.8857142857143,23.3171428571429,4.82571428571429,186,0,0,79,61,111,186,111
2020,30,51,"Bornova",38.4717,27.2185,21.7714285714286,29.2857142857143,0,45.6571428571429,32.602,4.81857142857143,190,0,0,122,110,142,190,142
2020,31,51,"Bornova",38.4717,27.2185,22.3142857142857,31.0714285714286,0,38.8571428571429,22.8314285714286,4.81714285714286,150,0,0,90,65,127,150,127
2020,32,51,"Bornova",38.4717,27.2185,19.2714285714286,28.0285714285714,0.004,53.1428571428571,28.2028571428571,4.81857142857143,146,0,0,69,67,107,146,107
2020,33,51,"Bornova",38.4717,27.2185,22.6142857142857,29.4714285714286,0.00742857142857143,38.1142857142857,21.2285714285714,4.83428571428571,183,0,0,123,56,83,183,83
2020,34,51,"Bornova",38.4717,27.2185,21.7285714285714,27.8857142857143,0,44.8571428571429,27.86,4.82285714285714,197,0,0,82,33,97,197,97
2020,35,51,"Bornova",38.4717,27.2185,20.3,28.2571428571429,0,46.4285714285714,33.4371428571429,4.81857142857143,164,0,0,44,59,157,164,157
2020,36,51,"Bornova",38.4717,27.2185,20.0857142857143,27.8714285714286,0,47.1857142857143,43.1857142857143,4.83285714285714,179,0,0,81,58,112,179,112
2020,37,51,"Bornova",38.4717,27.2185,20.7571428571429,28.0285714285714,0,50.4142857142857,35.4142857142857,4.85285714285714,193,0,0,99,48,91,193,91
2020,38,51,"Bornova",38.4717,27.2185,19.4571428571429,26.8142857142857,0,54.7,38.86,4.83,235,0,0,141,115,157,235,157
2020,39,51,"Bornova",38.4717,27.2185,19.5857142857143,24.7571428571429,0,56.1714285714286,33.0785714285714,4.81571428571429,220,71,38,48,31,129,149,91
2020,40,51,"Bornova",38.4717,27.2185,13.9428571428571,23.6285714285714,0,48.9428571428571,33.9257142857143,4.83571428571429,187,61,63,30,23,154,126,91
2020,41,51,"Bornova",38.4717,27.2185,14.4142857142857,23.1714285714286,1.45328571428571,57.0285714285714,57.1628571428571,4.81,182,44,24,8,7,127,138,103
2020,42,51,"Bornova",38.4717,27.2185,15.9857142857143,22.2142857142857,3.954,60.3142857142857,38.8914285714286,4.82428571428571,177,134,70,0,0,111,43,41
2020,43,51,"Bornova",38.4717,27.2185,13.7285714285714,20.0714285714286,0.0287142857142857,66.7714285714286,37.5642857142857,4.83857142857143,194,17,9,84,64,161,177,152
2020,44,51,"Bornova",38.4717,27.2185,13.6714285714286,17.5857142857143,2.10785714285714,68.9714285714286,27.8228571428571,4.83,255,58,30,68,61,233,197,203
2020,45,51,"Bornova",38.4717,27.2185,21.5142857142857,16.4142857142857,0,53.6428571428571,29.06,4.82857142857143,156,0,0,107,74,103,156,103
2020,46,51,"Bornova",38.4717,27.2185,19.1571428571429,14.7142857142857,0.113,63.9428571428571,39.67,4.83285714285714,208,0,0,170,79,109,208,109
2020,47,51,"Bornova",38.4717,27.2185,18.5571428571429,12.2714285714286,0.481142857142857,62.4142857142857,36.4814285714286,4.82,173,0,0,140,79,83,173,83
2020,48,51,"Bornova",38.4717,27.2185,18.8428571428571,10.9285714285714,0,52.8142857142857,41.8514285714286,4.82714285714286,199,22,21,132,173,262,177,241
2020,49,51,"Bornova",38.4717,27.2185,11.2857142857143,11.8714285714286,0.00357142857142857,68.4714285714286,64.5514285714286,4.80571428571429,207,14,4,60,44,116,193,112
2020,50,51,"Bornova",38.4717,27.2185,18.9,13.4,25.0477142857143,81.7428571428571,37.7171428571429,4.79,181,181,98,0,0,98,0,0
2020,51,51,"Bornova",38.4717,27.2185,18.0857142857143,10.7714285714286,2.26128571428571,78.4285714285714,36.9457142857143,4.81285714285714,171,0,0,109,61,90,171,90
2020,52,51,"Bornova",38.4717,27.2185,17.4428571428571,10.4571428571429,0.598,72.7142857142857,42.48,4.80714285714286,203,101,48,73,48,113,102,65
2020,53,51,"Bornova",38.4717,27.2185,14.525,13.075,8.646,81.6,40.05,4.8,122,122,111,0,0,111,0,0
2017,1,52,"Elbistan",38.2004,37.1931,18.3285714285714,4.3,5.98571428571428,86.5,77.07,NA,563,331,445,142,216,847,232,402
2017,2,52,"Elbistan",38.2004,37.1931,15.4,3.62857142857143,2.27142857142857,76.2428571428571,82.9642857142857,NA,757,453,832,239,272,1214,304,382
2017,3,52,"Elbistan",38.2004,37.1931,14.8428571428571,3.68571428571429,0,64.8142857142857,167.977142857143,NA,762,555,963,0,0,1449,207,486
2017,4,52,"Elbistan",38.2004,37.1931,21.5285714285714,2.3,1.11428571428571,65.1428571428571,101.674285714286,NA,639,373,534,78,92,889,266,355
2017,5,52,"Elbistan",38.2004,37.1931,27.3571428571429,2.68571428571429,0.0857142857142857,49.0142857142857,136.01,NA,588,256,589,113,268,1163,332,574
2017,6,52,"Elbistan",38.2004,37.1931,16.6857142857143,8.01428571428571,0.228571428571429,66.3857142857143,135.022857142857,NA,736,429,953,115,221,1519,307,566
2017,7,52,"Elbistan",38.2004,37.1931,25.6714285714286,3.01428571428571,0,42.6,82.2785714285714,NA,492,131,103,100,254,717,361,614
2017,8,52,"Elbistan",38.2004,37.1931,17.7142857142857,8.21428571428571,0.0142857142857143,52.3714285714286,115.651428571429,NA,739,349,708,93,291,1747,390,1039
2017,9,52,"Elbistan",38.2004,37.1931,25.8714285714286,11.4428571428571,0.9,54.6571428571429,81.4485714285714,NA,574,465,754,88,95,866,109,112
2017,10,52,"Elbistan",38.2004,37.1931,25.3714285714286,12.5142857142857,4.87142857142857,57.1142857142857,77.2775,NA,712,697,1014,0,0,1043,15,29
2017,11,52,"Elbistan",38.2004,37.1931,26.4,8.5,2.78571428571429,73.2857142857143,NA,NA,525,145,132,303,405,725,380,593
2017,12,52,"Elbistan",38.2004,37.1931,24.9,12.2714285714286,0.0857142857142857,54.3857142857143,NA,NA,589,241,418,311,613,1077,348,659
2017,13,52,"Elbistan",38.2004,37.1931,26.5,12.9428571428571,2.04285714285714,67.2142857142857,NA,NA,574,305,486,254,370,887,269,401
2017,14,52,"Elbistan",38.2004,37.1931,28.8571428571429,14.0571428571429,3,55.7857142857143,NA,NA,639,293,702,252,486,1336,346,634
2017,15,52,"Elbistan",38.2004,37.1931,22.9142857142857,12.6,5.24285714285714,68.5714285714286,NA,NA,587,98,154,310,727,1187,489,1033
2017,16,52,"Elbistan",38.2004,37.1931,28.5857142857143,16.6428571428571,0.528571428571429,60.2142857142857,102.375,NA,717,160,200,350,505,920,557,720
2017,17,52,"Elbistan",38.2004,37.1931,23.5142857142857,17.1285714285714,0.0428571428571429,40.2142857142857,70.0442857142857,NA,731,319,677,291,427,1478,412,801
2017,18,52,"Elbistan",38.2004,37.1931,25.4428571428571,17.5428571428571,3.84285714285714,68.3285714285714,54.5,NA,506,38,135,271,484,923,468,788
2017,19,52,"Elbistan",38.2004,37.1931,28.6571428571429,20.4,0.328571428571429,59.6,82.7728571428571,NA,471,63,109,369,759,966,408,857
2017,20,52,"Elbistan",38.2004,37.1931,29.8714285714286,19.3714285714286,1.95714285714286,56.4428571428571,46.86,NA,472,0,0,459,1195,1205,472,1205
2017,21,52,"Elbistan",38.2004,37.1931,25.4142857142857,17.8857142857143,1.75714285714286,68.0571428571428,46.03,NA,448,0,0,395,731,849,448,849
2017,22,52,"Elbistan",38.2004,37.1931,33.3857142857143,22.2571428571429,0.357142857142857,53.0857142857143,47.82,NA,522,0,0,504,949,1015,522,1015
2017,23,52,"Elbistan",38.2004,37.1931,35.7428571428571,26.0285714285714,0.242857142857143,51.0714285714286,67.5414285714286,NA,578,0,0,571,1376,1388,578,1388
2017,24,52,"Elbistan",38.2004,37.1931,38.1142857142857,24.9,0.285714285714286,52.3857142857143,47.0842857142857,NA,552,0,0,546,1123,1139,552,1139
2017,25,52,"Elbistan",38.2004,37.1931,33.7,25.2714285714286,0.0571428571428571,48.1285714285714,42.1357142857143,NA,584,0,0,578,1038,1041,584,1041
2017,26,52,"Elbistan",38.2004,37.1931,35.7428571428571,30.8428571428571,0,36.5285714285714,63.8742857142857,NA,564,0,0,348,682,971,564,971
2017,27,52,"Elbistan",38.2004,37.1931,38.6857142857143,30.3571428571429,0.0285714285714286,37.0714285714286,68.1042857142857,NA,511,0,0,510,642,642,511,642
2017,28,52,"Elbistan",38.2004,37.1931,37.6142857142857,30.6571428571429,0,39.3142857142857,64.2114285714286,NA,481,0,0,478,858,864,481,864
2017,29,52,"Elbistan",38.2004,37.1931,39.2428571428571,30.1571428571429,0,48.3142857142857,83.6871428571429,NA,532,0,0,517,1248,1272,532,1272
2017,30,52,"Elbistan",38.2004,37.1931,38.3857142857143,30.0714285714286,0,43.5428571428571,77.1042857142857,NA,531,0,0,526,926,928,531,928
2017,31,52,"Elbistan",38.2004,37.1931,34.1,30.2714285714286,0,48.8714285714286,88.5357142857143,NA,559,0,0,553,1026,1047,559,1047
2017,32,52,"Elbistan",38.2004,37.1931,33.3285714285714,30.5142857142857,0,47.8571428571429,94.8442857142857,NA,567,65,43,460,869,1092,502,1049
2017,33,52,"Elbistan",38.2004,37.1931,38.6428571428571,29.2571428571429,0.114285714285714,54.8142857142857,76.7471428571429,NA,596,0,0,594,1160,1199,596,1199
2017,34,52,"Elbistan",38.2004,37.1931,37.6142857142857,29.4571428571429,0.0142857142857143,50.3571428571429,79.1,NA,601,0,0,600,1268,1280,601,1280
2017,35,52,"Elbistan",38.2004,37.1931,36.3142857142857,28.4428571428571,0.1,50.4857142857143,75.6885714285714,NA,493,0,0,468,971,1014,493,1014
2017,36,52,"Elbistan",38.2004,37.1931,27.8285714285714,27.1571428571429,0,32.8285714285714,90.7671428571429,NA,507,49,47,340,1047,1321,458,1274
2017,37,52,"Elbistan",38.2004,37.1931,26.1714285714286,29.3857142857143,0,40.0428571428571,158.582857142857,NA,589,67,108,440,986,1138,522,1030
2017,38,52,"Elbistan",38.2004,37.1931,31.8428571428571,26.9,0,48.8571428571429,138.6875,NA,671,83,182,563,1010,1312,588,1130
2017,39,52,"Elbistan",38.2004,37.1931,32.5142857142857,24.0142857142857,0.285714285714286,49.4857142857143,86.815,NA,782,144,271,584,1144,1630,638,1359
2017,40,52,"Elbistan",38.2004,37.1931,21.6142857142857,19.6714285714286,0,33.6428571428571,83.8985714285714,NA,543,274,514,100,272,1137,269,623
2017,41,52,"Elbistan",38.2004,37.1931,20.6428571428571,18.7285714285714,0.157142857142857,42.3285714285714,96.1142857142857,NA,487,91,170,204,392,843,396,673
2017,42,52,"Elbistan",38.2004,37.1931,22.7428571428571,18.6142857142857,0,31.5142857142857,159.241428571429,NA,530,154,248,143,186,815,376,567
2017,43,52,"Elbistan",38.2004,37.1931,23.0428571428571,18.3571428571429,0.671428571428571,53.8285714285714,193.625714285714,NA,506,351,615,120,213,919,155,304
2017,44,52,"Elbistan",38.2004,37.1931,17.5142857142857,13.8428571428571,1.81428571428571,76.1142857142857,119.825,NA,561,439,949,53,37,1102,122,153
2017,45,52,"Elbistan",38.2004,37.1931,13.2571428571429,13.0428571428571,0.942857142857143,71.1428571428571,250.395714285714,NA,577,419,562,64,38,829,158,267
2017,46,52,"Elbistan",38.2004,37.1931,17.2,13.6,0.585714285714286,60.0714285714286,262.137142857143,NA,587,526,894,0,0,1085,61,191
2017,47,52,"Elbistan",38.2004,37.1931,22.7857142857143,9.27142857142857,2.38571428571429,60.9285714285714,83.605,NA,418,125,291,138,201,804,293,513
2017,48,52,"Elbistan",38.2004,37.1931,13,9.1,1.68571428571429,80.8,198.421428571429,NA,386,257,416,66,103,619,129,203
2017,49,52,"Elbistan",38.2004,37.1931,20.1857142857143,6.48571428571429,1.24285714285714,67.1857142857143,181.76,NA,407,278,438,32,64,645,129,207
2017,50,52,"Elbistan",38.2004,37.1931,13.2571428571429,7.81428571428571,0.0571428571428571,73.1571428571429,351.461428571429,NA,346,300,322,0,0,442,46,120
2017,51,52,"Elbistan",38.2004,37.1931,15.3571428571429,10,1.81428571428571,82.5142857142857,285.402857142857,NA,386,329,259,47,66,349,57,90
2017,52,52,"Elbistan",38.2004,37.1931,17.35,7.825,0.4875,73.725,222.3575,NA,528,302,293,48,48,507,226,214
2018,1,52,"Elbistan",38.2004,37.1931,23.375,6.825,1.9625,78.9,148.2525,NA,618,350,460,173,236,914,268,454
2018,2,52,"Elbistan",38.2004,37.1931,16.6428571428571,7.75714285714286,0.871428571428571,66.6,220.384285714286,NA,624,500,1238,97,41,1309,124,71
2018,3,52,"Elbistan",38.2004,37.1931,19.9142857142857,5.65714285714286,7.01428571428571,79.6428571428571,133.818571428571,NA,639,374,332,5,3,655,265,323
2018,4,52,"Elbistan",38.2004,37.1931,20.7,7.18571428571429,3.6,78.4428571428571,148.75,NA,604,235,334,106,150,764,369,430
2018,5,52,"Elbistan",38.2004,37.1931,14.8428571428571,6.75714285714286,0,70.2,223.954285714286,NA,670,649,816,0,0,819,21,3
2018,6,52,"Elbistan",38.2004,37.1931,14.8,9.7,0.1,69.8142857142857,271.7,NA,704,670,931,0,0,1022,34,91
2018,7,52,"Elbistan",38.2004,37.1931,23.5142857142857,9.72857142857143,3.4,73.6857142857143,103.594285714286,NA,478,172,220,128,150,557,306,337
2018,8,52,"Elbistan",38.2004,37.1931,16.3857142857143,8.74285714285714,1.1,76.3142857142857,135.07,NA,711,598,1081,0,0,1321,113,240
2018,9,52,"Elbistan",38.2004,37.1931,15.8714285714286,9.94285714285714,1.85714285714286,83.4285714285714,93.26,NA,621,339,537,0,0,956,282,419
2018,10,52,"Elbistan",38.2004,37.1931,23.7714285714286,12.9714285714286,1.7,69.4857142857143,156.428571428571,NA,556,242,525,240,632,1330,314,805
2018,11,52,"Elbistan",38.2004,37.1931,22.7857142857143,12.4857142857143,0.585714285714286,73.1857142857143,85.0857142857143,NA,551,64,124,476,1298,1426,487,1302
2018,12,52,"Elbistan",38.2004,37.1931,28.2714285714286,15.6142857142857,0.442857142857143,57.5142857142857,137.271666666667,NA,425,122,527,160,331,1187,303,660
2018,13,52,"Elbistan",38.2004,37.1931,23.8285714285714,14.5285714285714,4.08571428571429,63.4857142857143,92.7185714285714,NA,356,180,239,114,120,428,176,189
2018,14,52,"Elbistan",38.2004,37.1931,21.2,15.3428571428571,0.0428571428571429,48.1285714285714,86.4271428571429,NA,407,290,398,51,35,486,117,88
2018,15,52,"Elbistan",38.2004,37.1931,29.4714285714286,17.1714285714286,1.4,63.6428571428571,74.0542857142857,NA,374,8,18,159,163,450,366,432
2018,16,52,"Elbistan",38.2004,37.1931,27.2714285714286,16.7571428571429,0,51.0857142857143,71.8514285714286,NA,411,35,110,154,319,648,376,538
2018,17,52,"Elbistan",38.2004,37.1931,23.8142857142857,19.3428571428571,0.171428571428571,53.8142857142857,68.9028571428571,NA,419,238,337,169,277,652,181,315
2018,18,52,"Elbistan",38.2004,37.1931,22.6857142857143,19.7428571428571,4.61428571428571,66.1857142857143,69.68,NA,303,210,258,0,0,474,93,216
2018,19,52,"Elbistan",38.2004,37.1931,24.3714285714286,16.5,4,77.6714285714286,54.9485714285714,NA,275,63,166,120,175,467,212,301
2018,20,52,"Elbistan",38.2004,37.1931,26.7571428571429,22.6428571428571,0.457142857142857,47.5714285714286,104.487142857143,NA,204,51,108,101,117,306,153,198
2018,21,52,"Elbistan",38.2004,37.1931,29.9714285714286,23.7714285714286,0.385714285714286,48.1142857142857,128.642857142857,NA,252,21,45,153,196,281,231,236
2018,22,52,"Elbistan",38.2004,37.1931,31.7285714285714,21.6857142857143,3.52857142857143,60.5857142857143,84.3671428571429,NA,249,25,91,152,247,427,224,336
2018,23,52,"Elbistan",38.2004,37.1931,30.5,26.2571428571429,0.357142857142857,45.2428571428571,94.275,NA,267,0,0,253,641,812,267,812
2018,24,52,"Elbistan",38.2004,37.1931,38.7142857142857,24.1714285714286,1.52857142857143,59.8142857142857,78.9514285714286,NA,267,37,25,214,396,448,230,423
2018,25,52,"Elbistan",38.2004,37.1931,45.5428571428571,24.9285714285714,0.514285714285714,56.9428571428571,53.0428571428571,NA,358,0,0,357,518,518,358,518
2018,26,52,"Elbistan",38.2004,37.1931,43.4,26.7857142857143,0,53.6142857142857,89.4216666666667,NA,355,0,0,353,587,587,355,587
2018,27,52,"Elbistan",38.2004,37.1931,42.6285714285714,29.0714285714286,0,49.6285714285714,96.7528571428571,NA,342,0,0,338,417,418,342,418
2018,28,52,"Elbistan",38.2004,37.1931,43.6571428571429,28.6857142857143,0.0428571428571429,53.9571428571429,109.535714285714,NA,286,0,0,279,582,585,286,585
2018,29,52,"Elbistan",38.2004,37.1931,41.5571428571429,28.7571428571429,0.0142857142857143,46.1571428571429,81.1971428571429,NA,260,0,0,259,755,756,260,756
2018,30,52,"Elbistan",38.2004,37.1931,43.4428571428571,28.1,0.0142857142857143,53.3571428571429,101.16,NA,265,0,0,261,819,822,265,822
2018,31,52,"Elbistan",38.2004,37.1931,44.7714285714286,29.1714285714286,0.0571428571428571,54.8428571428571,83.43,NA,267,0,0,266,499,499,267,499
2018,32,52,"Elbistan",38.2004,37.1931,40.5285714285714,29.1428571428571,0.0857142857142857,43.8571428571429,70.22,NA,297,0,0,188,266,403,297,403
2018,33,52,"Elbistan",38.2004,37.1931,44.6857142857143,28.7,0,49.4142857142857,90.0457142857143,NA,216,0,0,212,331,332,216,332
2018,34,52,"Elbistan",38.2004,37.1931,40.5285714285714,29.1428571428571,0,51.3857142857143,83.7185714285714,NA,144,0,0,144,227,227,144,227
2018,35,52,"Elbistan",38.2004,37.1931,35.0285714285714,28.9714285714286,0.0142857142857143,47.9142857142857,103.44,NA,201,0,0,173,295,314,201,314
2018,36,52,"Elbistan",38.2004,37.1931,37.6142857142857,27.2,0.242857142857143,48.5714285714286,82.6257142857143,NA,341,0,0,338,351,370,341,370
2018,37,52,"Elbistan",38.2004,37.1931,29.4285714285714,25.5142857142857,0.314285714285714,45.3714285714286,72.4,NA,241,57,111,183,307,419,184,308
2018,38,52,"Elbistan",38.2004,37.1931,26.1857142857143,26.1714285714286,0.0285714285714286,40.1571428571429,103.21,NA,189,18,34,138,271,344,171,310
2018,39,52,"Elbistan",38.2004,37.1931,31.2285714285714,25.4428571428571,0.0285714285714286,43.3142857142857,138.671428571429,NA,180,1,1,147,295,353,179,352
2018,40,52,"Elbistan",38.2004,37.1931,24.8428571428571,22.7571428571429,0.0571428571428571,36.4857142857143,131.831666666667,NA,191,45,84,86,171,341,146,257
2018,41,52,"Elbistan",38.2004,37.1931,20.8428571428571,21.3285714285714,2.41428571428571,51.2285714285714,156.694,NA,187,70,127,55,134,422,117,295
2018,42,52,"Elbistan",38.2004,37.1931,18.8428571428571,19.5285714285714,1.72857142857143,62.0857142857143,213.216,NA,168,151,309,0,0,381,17,72
2018,43,52,"Elbistan",38.2004,37.1931,20.4285714285714,15.2857142857143,3.8,70.5571428571428,129.035,NA,187,137,211,12,105,402,50,191
2018,44,52,"Elbistan",38.2004,37.1931,17.5,15.2,0.342857142857143,55.1142857142857,239.614285714286,NA,196,135,145,0,0,264,61,119
2018,45,52,"Elbistan",38.2004,37.1931,14.8428571428571,13.9,0.857142857142857,71.5285714285714,124.66,NA,231,161,345,0,0,473,70,128
2018,46,52,"Elbistan",38.2004,37.1931,16.1714285714286,9.31428571428571,1.87142857142857,71.4571428571429,189.657142857143,NA,230,175,330,24,52,465,55,135
2018,47,52,"Elbistan",38.2004,37.1931,13.5571428571429,11.1,0.728571428571429,80.2714285714286,347.177142857143,NA,270,148,133,68,203,499,122,366
2018,48,52,"Elbistan",38.2004,37.1931,20.9,12.1285714285714,4.1,81.5857142857143,144.845714285714,NA,245,219,176,0,0,201,26,25
2018,49,52,"Elbistan",38.2004,37.1931,15.6571428571429,10.6142857142857,2.78571428571429,85.2142857142857,204.908333333333,NA,257,136,148,49,151,420,121,272
2018,50,52,"Elbistan",38.2004,37.1931,17.2,9.07142857142857,3.74285714285714,79.3714285714286,65.9666666666667,NA,256,148,224,0,0,305,108,81
2018,51,52,"Elbistan",38.2004,37.1931,18.5857142857143,8.11428571428571,5.1,85.9571428571429,189.012,NA,250,229,184,0,0,248,21,64
2018,52,52,"Elbistan",38.2004,37.1931,21.2142857142857,5.07142857142857,5.87142857142857,80.8285714285714,107.251428571429,NA,244,110,119,83,78,273,134,154
2019,1,52,"Elbistan",38.2004,37.1931,20.175,6.275,6.5,88.3,159.69,NA,343,176,325,86,286,784,167,459
2019,2,52,"Elbistan",38.2004,37.1931,19.6714285714286,2.98571428571429,2.88571428571429,76.7428571428571,171.68,NA,255,125,150,81,34,208,130,58
2019,3,52,"Elbistan",38.2004,37.1931,28.5428571428571,3.97142857142857,6.7,70.1857142857143,121.582,NA,192,139,128,48,66,198,53,70
2019,4,52,"Elbistan",38.2004,37.1931,19.1,6.91428571428571,0.928571428571428,74.7571428571429,156.09,NA,308,229,291,29,7,314,79,23
2019,5,52,"Elbistan",38.2004,37.1931,26.1857142857143,7.3,1.61428571428571,76.4571428571429,153.895714285714,NA,253,122,62,97,56,143,131,81
2019,6,52,"Elbistan",38.2004,37.1931,16.1285714285714,6.15714285714286,4.18571428571429,82.9857142857143,144.291428571429,NA,276,152,49,105,59,127,124,78
2019,7,52,"Elbistan",38.2004,37.1931,22.2285714285714,7.58571428571429,1.5,78.4714285714286,108.064285714286,NA,325,198,78,121,124,234,127,156
2019,8,52,"Elbistan",38.2004,37.1931,20.9428571428571,8.71428571428572,0.342857142857143,70.3857142857143,133.082857142857,NA,305,92,117,92,71,219,213,102
2019,9,52,"Elbistan",38.2004,37.1931,21.9857142857143,7.58571428571429,1.34285714285714,72.1285714285714,117.645714285714,NA,331,93,106,108,47,310,238,204
2019,10,52,"Elbistan",38.2004,37.1931,29.6285714285714,9.45714285714286,0.657142857142857,63.6571428571429,73.9128571428571,NA,359,50,42,162,124,252,309,210
2019,11,52,"Elbistan",38.2004,37.1931,27.0142857142857,10.4428571428571,1.6,77.1857142857143,64.2114285714286,NA,373,161,223,193,90,400,212,177
2019,12,52,"Elbistan",38.2004,37.1931,19.8714285714286,11.9428571428571,0.0285714285714286,56.5857142857143,65.4557142857143,NA,343,158,330,49,49,416,185,86
2019,13,52,"Elbistan",38.2004,37.1931,27.2,11.0571428571429,4.97142857142857,69.3142857142857,58.5257142857143,NA,256,52,13,157,139,194,204,181
2019,14,52,"Elbistan",38.2004,37.1931,19.8714285714286,12.0714285714286,2.71428571428571,80.5428571428571,48.4985714285714,NA,365,16,30,114,74,208,349,178
2019,15,52,"Elbistan",38.2004,37.1931,25.1571428571429,14.9285714285714,1.4,70.4142857142857,69.3,NA,359,149,82,154,77,183,210,101
2019,16,52,"Elbistan",38.2004,37.1931,26.5428571428571,10.7428571428571,3.87142857142857,77.6285714285714,47.09,NA,318,27,24,232,131,208,291,184
2019,17,52,"Elbistan",38.2004,37.1931,22.4857142857143,14.9,0.9,54.3714285714286,58.9857142857143,NA,412,184,149,75,101,313,228,164
2019,18,52,"Elbistan",38.2004,37.1931,25.7571428571429,19.3,0.5,56.2571428571429,58.23,NA,523,69,52,147,71,353,454,301
2019,19,52,"Elbistan",38.2004,37.1931,32.3571428571429,18,0.9,57.1714285714286,34.4885714285714,NA,452,81,54,364,316,386,371,332
2019,20,52,"Elbistan",38.2004,37.1931,24.8142857142857,23.8857142857143,0.428571428571429,45.2142857142857,28.9825,NA,454,335,270,96,90,389,119,119
2019,21,52,"Elbistan",38.2004,37.1931,32.8285714285714,24.1571428571429,0.0571428571428571,48.9142857142857,NA,NA,457,0,0,391,382,413,457,413
2019,22,52,"Elbistan",38.2004,37.1931,28.0857142857143,27.6,0.114285714285714,39.7,NA,NA,453,0,0,242,199,323,453,323
2019,23,52,"Elbistan",38.2004,37.1931,30.1428571428571,26.3428571428571,0.3,40.3571428571429,NA,NA,378,4,10,311,397,532,374,522
2019,24,52,"Elbistan",38.2004,37.1931,37.8571428571429,24.9714285714286,1.02857142857143,58.1857142857143,NA,NA,378,47,61,282,172,244,331,183
2019,25,52,"Elbistan",38.2004,37.1931,42.6285714285714,25.5714285714286,2.08571428571429,58.9142857142857,NA,NA,306,0,0,304,314,325,306,325
2019,26,52,"Elbistan",38.2004,37.1931,37.6428571428571,29.6428571428571,0,49.5714285714286,16.67,NA,377,0,0,280,301,342,377,342
2019,27,52,"Elbistan",38.2004,37.1931,37.3428571428571,27.7428571428571,0.0142857142857143,45.8142857142857,27.5871428571429,NA,456,0,0,403,192,222,456,222
2019,28,52,"Elbistan",38.2004,37.1931,43.4428571428571,27.9571428571429,0.114285714285714,52.5,27.3785714285714,NA,398,0,0,378,380,421,398,421
2019,29,52,"Elbistan",38.2004,37.1931,38.6285714285714,26.7857142857143,0.0142857142857143,54.9,27.8557142857143,NA,453,0,0,451,203,203,453,203
2019,30,52,"Elbistan",38.2004,37.1931,41.4714285714286,29.0285714285714,0,49.8142857142857,26.5642857142857,NA,456,0,0,455,334,335,456,335
2019,31,52,"Elbistan",38.2004,37.1931,42.3714285714286,29.3142857142857,0,55.8571428571429,37.0114285714286,NA,334,0,0,327,367,375,334,375
2019,32,52,"Elbistan",38.2004,37.1931,38.1714285714286,28.8857142857143,0.0142857142857143,46.3142857142857,26.41,NA,346,0,0,340,394,395,346,395
2019,33,52,"Elbistan",38.2004,37.1931,36.8714285714286,29.4428571428571,0,55.6714285714286,52.8471428571429,NA,337,0,0,301,513,531,337,531
2019,34,52,"Elbistan",38.2004,37.1931,29.4285714285714,28.1571428571429,0.514285714285714,50.8428571428571,37.3885714285714,NA,299,0,0,258,304,345,299,345
2019,35,52,"Elbistan",38.2004,37.1931,31.0714285714286,29.3571428571429,0.128571428571429,52.1142857142857,42.3971428571429,NA,307,0,0,303,415,415,307,415
2019,36,52,"Elbistan",38.2004,37.1931,37.3571428571429,27.9571428571429,0,48.4857142857143,34.79,NA,171,0,0,169,66,67,171,67
2019,37,52,"Elbistan",38.2004,37.1931,28.9714285714286,26.4285714285714,1.22857142857143,43.7857142857143,57.25,NA,218,30,1,152,47,55,188,54
2019,38,52,"Elbistan",38.2004,37.1931,30.9142857142857,24.2,0,41.6,69.4228571428571,NA,266,31,7,158,67,91,235,84
2019,39,52,"Elbistan",38.2004,37.1931,30.9571428571429,23.6714285714286,0,46.0142857142857,103.654285714286,NA,237,0,0,211,76,79,237,79
2019,40,52,"Elbistan",38.2004,37.1931,32.5714285714286,23.7857142857143,0.0285714285714286,51.4285714285714,110.324285714286,NA,241,37,4,176,101,111,204,107
2019,41,52,"Elbistan",38.2004,37.1931,22.5285714285714,22.6285714285714,0.0428571428571429,43.7285714285714,93.4371428571429,NA,416,41,33,179,216,448,375,415
2019,42,52,"Elbistan",38.2004,37.1931,23.7571428571429,21.5714285714286,0.557142857142857,51.0714285714286,108.305714285714,NA,356,136,114,108,159,408,220,294
2019,43,52,"Elbistan",38.2004,37.1931,16.6,17.9285714285714,1.1,67.1142857142857,76.0342857142857,NA,306,232,176,0,0,300,74,124
2019,44,52,"Elbistan",38.2004,37.1931,17.7142857142857,15.0571428571429,1.28571428571429,73.0142857142857,77.3785714285714,NA,350,155,98,42,45,250,195,152
2019,45,52,"Elbistan",38.2004,37.1931,14.5428571428571,14.8714285714286,0,60.5714285714286,95.7714285714286,NA,417,332,183,0,0,328,85,145
2019,46,52,"Elbistan",38.2004,37.1931,16.3857142857143,14.4428571428571,0,45.8285714285714,242.06,NA,401,325,226,0,0,337,76,111
2019,47,52,"Elbistan",38.2004,37.1931,14.2857142857143,9.94285714285714,0.0142857142857143,44.1285714285714,NA,NA,391,337,268,0,0,339,54,71
2019,48,52,"Elbistan",38.2004,37.1931,19.1,11.4142857142857,1.27142857142857,75.4428571428572,62.89,NA,320,263,197,0,0,251,57,54
2019,49,52,"Elbistan",38.2004,37.1931,16.9428571428571,7.92857142857143,3.2,78.5428571428571,150.612,NA,393,276,182,8,5,274,117,92
2019,50,52,"Elbistan",38.2004,37.1931,15.4,7.94285714285714,2.67142857142857,88.9,117.157142857143,NA,218,95,62,69,28,119,123,57
2019,51,52,"Elbistan",38.2004,37.1931,13.7714285714286,8.41428571428571,0,75.3428571428571,315.922857142857,NA,361,327,451,0,0,488,34,37
2019,52,52,"Elbistan",38.2004,37.1931,27.4714285714286,7.51428571428571,11.0285714285714,84.2,96.4785714285714,NA,279,227,234,9,0,281,52,47
2020,1,52,"Elbistan",38.2004,37.1931,12.64,5.72,2.52,89.48,93.8466666666667,NA,160,42,31,24,48,126,118,95
2020,2,52,"Elbistan",38.2004,37.1931,24.3857142857143,6.54285714285714,2.32857142857143,75.1285714285714,118.412857142857,NA,240,129,121,42,4,173,111,52
2020,3,52,"Elbistan",38.2004,37.1931,18.5428571428571,5.02857142857143,1.41428571428571,70.7428571428571,154.295714285714,NA,270,141,196,31,21,382,129,186
2020,4,52,"Elbistan",38.2004,37.1931,27.0571428571429,4.55714285714286,0.257142857142857,58.7,75.6928571428572,NA,358,139,121,63,78,295,219,174
2020,5,52,"Elbistan",38.2004,37.1931,22.7571428571429,6.61428571428571,3.61428571428571,68.3428571428571,99.275,NA,331,176,170,105,68,272,155,102
2020,6,52,"Elbistan",38.2004,37.1931,23.8285714285714,5.47142857142857,3.28571428571429,71.4285714285714,28.56,NA,343,192,189,61,21,267,151,78
2020,7,52,"Elbistan",38.2004,37.1931,15.9285714285714,0.428571428571429,2.3,70.1714285714286,84.54,NA,341,152,152,69,64,338,189,186
2020,8,52,"Elbistan",38.2004,37.1931,20.1285714285714,8.08571428571429,1.81428571428571,76.2428571428571,96.8242857142857,NA,283,158,69,72,93,187,125,118
2020,9,52,"Elbistan",38.2004,37.1931,21.9857142857143,9.82857142857143,0.928571428571428,69.4714285714286,51.7714285714286,NA,393,86,148,54,32,528,307,380
2020,10,52,"Elbistan",38.2004,37.1931,24.9,12.8714285714286,0.2,57.6857142857143,68.056,NA,205,146,126,45,71,210,59,84
2020,11,52,"Elbistan",38.2004,37.1931,28.8,15.0714285714286,2.87142857142857,63.6285714285714,58.398,NA,115,50,49,23,16,94,65,45
2020,12,52,"Elbistan",38.2004,37.1931,25.3285714285714,8.28571428571429,6.1,80.0714285714286,35.2685714285714,NA,117,7,3,79,90,118,110,115
2020,13,52,"Elbistan",38.2004,37.1931,23.8142857142857,12.3,2.9,76.7285714285714,37.6914285714286,NA,136,73,36,42,42,92,63,56
2020,14,52,"Elbistan",38.2004,37.1931,21.7142857142857,10.9,1.75714285714286,78.3,31.9957142857143,NA,155,72,31,37,29,121,83,90
2020,15,52,"Elbistan",38.2004,37.1931,27.5,14.0714285714286,1.72857142857143,69.4857142857143,36.2085714285714,NA,133,8,1,107,51,118,125,117
2020,16,52,"Elbistan",38.2004,37.1931,22.7285714285714,16.3714285714286,1.2,55.8142857142857,38.3457142857143,NA,141,19,9,78,62,106,122,97
2020,17,52,"Elbistan",38.2004,37.1931,25.1,16.0714285714286,0.214285714285714,58.3714285714286,30.5442857142857,NA,137,20,7,94,83,123,117,116
2020,18,52,"Elbistan",38.2004,37.1931,25.1428571428571,15.7714285714286,1.91428571428571,69.2571428571429,22.8342857142857,NA,146,18,21,89,65,164,128,143
2020,19,52,"Elbistan",38.2004,37.1931,27.7714285714286,16.8714285714286,1.08571428571429,63.0428571428571,17.8585714285714,NA,137,0,0,114,157,157,137,157
2020,20,52,"Elbistan",38.2004,37.1931,24.0285714285714,23.9714285714286,0,46.4,34.68,NA,164,36,15,82,132,164,128,149
2020,21,52,"Elbistan",38.2004,37.1931,31.5285714285714,24.8,0.614285714285714,39.3428571428571,NA,NA,146,0,0,89,58,96,146,96
2020,22,52,"Elbistan",38.2004,37.1931,34.7142857142857,20.3285714285714,0.5,50.7,NA,NA,118,28,21,76,76,100,90,79
2020,23,52,"Elbistan",38.2004,37.1931,26.7142857142857,22.7142857142857,0.5,46.8428571428571,NA,NA,112,13,14,82,52,70,99,56
2020,24,52,"Elbistan",38.2004,37.1931,37.9428571428571,24.0142857142857,0.914285714285714,53.0714285714286,43.22,NA,140,0,0,138,150,150,140,150
2020,25,52,"Elbistan",38.2004,37.1931,42.9285714285714,24.5857142857143,0.428571428571429,55.4285714285714,32.9142857142857,NA,137,0,0,135,108,108,137,108
2020,26,52,"Elbistan",38.2004,37.1931,42.8857142857143,26.6285714285714,0,52.9571428571429,37.6314285714286,NA,173,0,0,172,131,133,173,133
2020,27,52,"Elbistan",38.2004,37.1931,34.9571428571429,29.1285714285714,0,43.5571428571429,30.35,NA,113,0,0,95,97,113,113,113
2020,28,52,"Elbistan",38.2004,37.1931,42.6714285714286,29.2714285714286,0.185714285714286,54.2428571428571,NA,NA,164,0,0,146,119,122,164,122
2020,29,52,"Elbistan",38.2004,37.1931,37.8142857142857,29.7285714285714,0,51.4428571428571,NA,NA,186,0,0,183,109,111,186,111
2020,30,52,"Elbistan",38.2004,37.1931,39.4571428571429,30.7285714285714,0.0142857142857143,48.7142857142857,35.67,NA,190,0,0,190,142,142,190,142
2020,31,52,"Elbistan",38.2004,37.1931,34.1571428571429,31.0857142857143,0,45.9857142857143,29.42,NA,150,10,13,118,97,127,140,114
2020,32,52,"Elbistan",38.2004,37.1931,43.9142857142857,29.7428571428571,0,49.6142857142857,21.73,NA,146,0,0,143,106,107,146,107
2020,33,52,"Elbistan",38.2004,37.1931,38.9428571428571,28.6428571428571,0,41.8428571428571,20.302,NA,183,0,0,136,68,83,183,83
2020,34,52,"Elbistan",38.2004,37.1931,40.7428571428571,28.2571428571429,0.0142857142857143,44.1428571428571,24.5333333333333,NA,197,0,0,169,88,97,197,97
2020,35,52,"Elbistan",38.2004,37.1931,29.1142857142857,28.8571428571429,0,39.9714285714286,37.9425,NA,164,17,3,90,96,157,147,154
2020,36,52,"Elbistan",38.2004,37.1931,25.6857142857143,30.5428571428571,0.0285714285714286,32.4714285714286,50.8225,NA,179,54,18,81,67,112,125,94
2020,37,52,"Elbistan",38.2004,37.1931,25.3571428571429,29.4571428571429,0.0714285714285714,38.4142857142857,43.506,NA,193,65,31,76,35,91,128,60
2020,38,52,"Elbistan",38.2004,37.1931,30.7571428571429,28.1571428571429,0.0142857142857143,52.8,48.07,NA,235,0,0,170,137,157,235,157
2020,39,52,"Elbistan",38.2004,37.1931,37.6,26.1571428571429,0.0285714285714286,55.0428571428571,33.7614285714286,NA,220,0,0,212,124,129,220,129
2020,40,52,"Elbistan",38.2004,37.1931,30.9571428571429,25.0571428571429,0.0142857142857143,48.0857142857143,38.5,NA,187,0,0,135,121,154,187,154
2020,41,52,"Elbistan",38.2004,37.1931,21.4571428571429,23.4285714285714,0,26.2571428571429,45.0414285714286,29.77,182,103,61,19,14,127,79,66
2020,42,52,"Elbistan",38.2004,37.1931,25.6857142857143,22.7428571428571,0,47.9142857142857,98.38,46.2975,177,57,38,77,43,111,120,73
2020,43,52,"Elbistan",38.2004,37.1931,19.6571428571429,21.3714285714286,0.0857142857142857,41.7714285714286,86.1614285714286,36.9685714285714,194,80,65,50,39,161,114,96
2020,44,52,"Elbistan",38.2004,37.1931,17.4571428571429,20.6285714285714,0.714285714285714,34.1714285714286,65.3142857142857,34.03,255,237,216,0,0,233,18,17
2020,45,52,"Elbistan",38.2004,37.1931,19.0428571428571,14.8857142857143,6.42857142857143,72.4857142857143,30.0271428571429,29.228,156,116,67,0,0,103,40,36
2020,46,52,"Elbistan",38.2004,37.1931,13.2571428571429,12.9428571428571,0,61.3714285714286,120.437142857143,42.4616666666667,208,150,75,0,0,109,58,34
2020,47,52,"Elbistan",38.2004,37.1931,16.3857142857143,10.8142857142857,0.757142857142857,67.6714285714286,96.33,4.106,173,133,58,0,0,83,40,25
2020,48,52,"Elbistan",38.2004,37.1931,14.5428571428571,8.3,0.2,67.8,120.505714285714,11.3416666666667,199,153,215,0,0,262,46,47
2020,49,52,"Elbistan",38.2004,37.1931,16.1714285714286,8.91428571428571,2.68571428571429,80.8428571428571,77.8557142857143,36.7128571428571,207,138,77,16,0,116,69,39
2020,50,52,"Elbistan",38.2004,37.1931,14.5857142857143,8.77142857142857,0.985714285714286,76.2714285714286,77.4557142857143,35.83,181,99,42,28,8,98,82,56
2020,51,52,"Elbistan",38.2004,37.1931,19.6142857142857,8.5,3.82857142857143,86.7428571428571,81.5571428571428,37.37,171,83,32,10,7,90,88,58
2020,52,52,"Elbistan",38.2004,37.1931,15.1,5.5,0.4,69.2857142857143,113.572857142857,36.6128571428571,203,101,53,19,25,113,102,60
2020,53,52,"Elbistan",38.2004,37.1931,13.45,6.3,0,65.225,165.9675,50.33,122,83,59,0,0,111,39,52
2017,1,53,"Onikisubat",37.5999,36.8403,18.2714285714286,4.37142857142857,9.88571428571429,86.4571428571429,69.9585714285714,NA,563,285,381,138,212,847,278,466
2017,2,53,"Onikisubat",37.5999,36.8403,15.3571428571429,3.65714285714286,4.95714285714286,76.2,100.37,NA,757,371,594,235,271,1214,386,620
2017,3,53,"Onikisubat",37.5999,36.8403,14.7714285714286,3.72857142857143,0,64.8,125.242857142857,NA,762,522,879,2,10,1449,240,570
2017,4,53,"Onikisubat",37.5999,36.8403,21.5,2.35714285714286,3.88571428571429,65.1,64.1616666666667,NA,639,361,515,82,77,889,278,374
2017,5,53,"Onikisubat",37.5999,36.8403,27.2571428571429,2.72857142857143,0.0428571428571429,48.9571428571429,65.715,NA,588,243,566,232,408,1163,345,597
2017,6,53,"Onikisubat",37.5999,36.8403,16.6,8.05714285714286,0.157142857142857,66.2857142857143,78.03,NA,736,451,915,163,293,1519,285,604
2017,7,53,"Onikisubat",37.5999,36.8403,25.5285714285714,3.02857142857143,0,42.6,45.0071428571429,NA,492,122,102,140,346,717,370,615
2017,8,53,"Onikisubat",37.5999,36.8403,17.6142857142857,8.22857142857143,0,52.3571428571429,78.1714285714286,NA,739,319,666,230,625,1747,420,1081
2017,9,53,"Onikisubat",37.5999,36.8403,25.7428571428571,11.4714285714286,1.08571428571429,54.6428571428571,71.3885714285714,NA,574,428,696,81,88,866,146,170
2017,10,53,"Onikisubat",37.5999,36.8403,25.2714285714286,12.5428571428571,2.32857142857143,57.0857142857143,70.86,NA,712,655,899,0,0,1043,57,144
2017,11,53,"Onikisubat",37.5999,36.8403,26.2428571428571,8.55714285714286,8.11428571428571,73.3285714285714,31.4457142857143,NA,525,133,152,290,395,725,392,573
2017,12,53,"Onikisubat",37.5999,36.8403,24.7571428571429,12.3142857142857,0.0142857142857143,54.4142857142857,31.9371428571429,NA,589,240,416,337,644,1077,349,661
2017,13,53,"Onikisubat",37.5999,36.8403,26.3428571428571,12.9857142857143,0.957142857142857,67.2142857142857,43.1771428571429,NA,574,303,479,244,354,887,271,408
2017,14,53,"Onikisubat",37.5999,36.8403,28.6571428571429,14.1,3.71428571428571,55.8142857142857,24.93,NA,639,291,703,243,461,1336,348,633
2017,15,53,"Onikisubat",37.5999,36.8403,22.4571428571429,12.6714285714286,14.7428571428571,68.7142857142857,34.3514285714286,NA,587,94,129,313,697,1187,493,1058
2017,16,53,"Onikisubat",37.5999,36.8403,28.4857142857143,16.6571428571429,0,60.2285714285714,42.76,NA,717,136,160,453,575,920,581,760
2017,17,53,"Onikisubat",37.5999,36.8403,23.3714285714286,17.1571428571429,0,40.2571428571429,50.8866666666667,NA,731,309,648,291,426,1478,422,830
2017,18,53,"Onikisubat",37.5999,36.8403,25.4142857142857,17.5571428571429,0.414285714285714,68.3571428571429,38.4685714285714,NA,506,46,149,312,561,923,460,774
2017,19,53,"Onikisubat",37.5999,36.8403,28.5,20.4142857142857,0,59.6142857142857,48.7014285714286,NA,471,4,11,358,725,966,467,955
2017,20,53,"Onikisubat",37.5999,36.8403,29.7,19.3714285714286,18.7714285714286,56.4857142857143,28.9357142857143,NA,472,0,0,425,1036,1205,472,1205
2017,21,53,"Onikisubat",37.5999,36.8403,25.3142857142857,17.8857142857143,7.71428571428571,68.0857142857143,28.1185714285714,NA,448,0,0,385,708,849,448,849
2017,22,53,"Onikisubat",37.5999,36.8403,33.2142857142857,22.2571428571429,0.0571428571428571,53.1857142857143,28.3085714285714,NA,522,0,0,516,986,1015,522,1015
2017,23,53,"Onikisubat",37.5999,36.8403,35.5428571428571,26.0285714285714,0,51.1857142857143,40.05,NA,578,0,0,554,1340,1388,578,1388
2017,24,53,"Onikisubat",37.5999,36.8403,37.9142857142857,24.9,0.714285714285714,52.5285714285714,29.4342857142857,NA,552,0,0,532,1054,1139,552,1139
2017,25,53,"Onikisubat",37.5999,36.8403,33.5285714285714,25.2714285714286,1.71428571428571,48.2428571428571,23.768,NA,584,0,0,574,1015,1041,584,1041
2017,26,53,"Onikisubat",37.5999,36.8403,35.5571428571429,30.8571428571429,0,36.8,36.1425,NA,564,0,0,433,833,971,564,971
2017,27,53,"Onikisubat",37.5999,36.8403,38.4857142857143,30.3571428571429,0,37.2285714285714,38.8866666666667,NA,511,0,0,501,592,642,511,642
2017,28,53,"Onikisubat",37.5999,36.8403,37.4,30.6571428571429,0,39.4857142857143,37.0942857142857,NA,481,0,0,469,837,864,481,864
2017,29,53,"Onikisubat",37.5999,36.8403,39.0571428571429,30.2285714285714,0,49.0428571428571,45.2157142857143,NA,532,0,0,496,1141,1272,532,1272
2017,30,53,"Onikisubat",37.5999,36.8403,38.1857142857143,30.0714285714286,0.0142857142857143,43.6285714285714,41.2571428571429,NA,531,0,0,509,870,928,531,928
2017,31,53,"Onikisubat",37.5999,36.8403,33.9714285714286,30.2714285714286,0,48.9714285714286,44.9716666666667,NA,559,0,0,542,1029,1047,559,1047
2017,32,53,"Onikisubat",37.5999,36.8403,33.2,30.5857142857143,0.0142857142857143,48.4428571428571,NA,NA,567,65,43,451,805,1092,502,1049
2017,33,53,"Onikisubat",37.5999,36.8403,38.4285714285714,29.2571428571429,0,54.9142857142857,49.164,NA,596,0,0,587,1158,1199,596,1199
2017,34,53,"Onikisubat",37.5999,36.8403,37.3714285714286,29.4571428571429,0,50.4571428571429,78.5257142857143,NA,601,0,0,587,1264,1280,601,1280
2017,35,53,"Onikisubat",37.5999,36.8403,36.1714285714286,28.5428571428571,0,51.2857142857143,49.4428571428571,NA,493,0,0,486,1013,1014,493,1014
2017,36,53,"Onikisubat",37.5999,36.8403,27.7571428571429,27.1571428571429,0.428571428571429,33.1571428571429,43.4614285714286,NA,507,48,46,347,983,1321,459,1275
2017,37,53,"Onikisubat",37.5999,36.8403,26.0857142857143,29.3714285714286,0,40.1428571428571,72.3014285714286,NA,589,49,60,484,909,1138,540,1078
2017,38,53,"Onikisubat",37.5999,36.8403,31.6857142857143,26.9,0,49,55.3028571428571,NA,671,23,107,542,929,1312,648,1205
2017,39,53,"Onikisubat",37.5999,36.8403,32.3857142857143,24.0142857142857,0.442857142857143,49.6,44.7142857142857,NA,782,147,286,565,1127,1630,635,1344
2017,40,53,"Onikisubat",37.5999,36.8403,21.5,19.6714285714286,1.42857142857143,33.7142857142857,40.5971428571429,NA,543,225,319,125,398,1137,318,818
2017,41,53,"Onikisubat",37.5999,36.8403,20.5285714285714,18.7285714285714,3.7,42.3571428571429,38.47,NA,487,91,170,215,406,843,396,673
2017,42,53,"Onikisubat",37.5999,36.8403,22.6714285714286,18.6142857142857,0,31.5285714285714,47.48,NA,530,151,256,185,293,815,379,559
2017,43,53,"Onikisubat",37.5999,36.8403,22.9428571428571,18.3714285714286,6.71428571428571,53.8571428571429,110.957142857143,NA,506,351,611,118,213,919,155,308
2017,44,53,"Onikisubat",37.5999,36.8403,17.4571428571429,13.8428571428571,6.71428571428571,76.1142857142857,52.7828571428571,NA,561,414,777,43,33,1102,147,325
2017,45,53,"Onikisubat",37.5999,36.8403,13.1714285714286,13.0571428571429,0.285714285714286,71.1571428571429,81.4928571428571,NA,577,359,357,58,37,829,218,472
2017,46,53,"Onikisubat",37.5999,36.8403,17.1571428571429,13.6571428571429,0.0857142857142857,60.0428571428571,95.9085714285714,NA,587,518,872,0,0,1085,69,213
2017,47,53,"Onikisubat",37.5999,36.8403,22.7,9.28571428571428,4.54285714285714,60.9285714285714,51.8157142857143,NA,418,145,344,160,263,804,273,460
2017,48,53,"Onikisubat",37.5999,36.8403,12.9571428571429,9.11428571428571,4.55714285714286,80.7857142857143,100.665714285714,NA,386,245,398,80,115,619,141,221
2017,49,53,"Onikisubat",37.5999,36.8403,20.1285714285714,6.5,2.42857142857143,67.1857142857143,85.75,NA,407,227,303,39,64,645,180,342
2017,50,53,"Onikisubat",37.5999,36.8403,13.2,7.85714285714286,0.128571428571429,73.3,125.095,NA,346,263,233,0,0,442,83,209
2017,51,53,"Onikisubat",37.5999,36.8403,15.3142857142857,10.0285714285714,5.51428571428572,82.4142857142857,227.541666666667,NA,386,308,197,48,76,349,78,152
2017,52,53,"Onikisubat",37.5999,36.8403,17.2625,7.85,2.85,73.7,97.035,NA,528,306,286,68,53,507,222,221
2018,1,53,"Onikisubat",37.5999,36.8403,23.3125,6.8625,4.65,78.875,45.88,NA,618,341,447,171,221,914,277,467
2018,2,53,"Onikisubat",37.5999,36.8403,16.6142857142857,7.8,0.2,66.6285714285714,100.904,NA,624,492,1231,97,41,1309,132,78
2018,3,53,"Onikisubat",37.5999,36.8403,19.8,5.7,12.1428571428571,79.6285714285714,67.1714285714286,NA,639,362,318,16,41,655,277,337
2018,4,53,"Onikisubat",37.5999,36.8403,20.5857142857143,7.32857142857143,2.31428571428571,78.4857142857143,75.4414285714286,NA,604,235,334,255,271,764,369,430
2018,5,53,"Onikisubat",37.5999,36.8403,14.7285714285714,6.78571428571429,0.0571428571428571,70.1857142857143,91.9528571428571,NA,670,558,668,0,0,819,112,151
2018,6,53,"Onikisubat",37.5999,36.8403,14.7285714285714,9.75714285714286,0.0428571428571429,69.7714285714286,152.361666666667,NA,704,664,917,0,0,1022,40,105
2018,7,53,"Onikisubat",37.5999,36.8403,23.4142857142857,9.74285714285714,2.12857142857143,73.7142857142857,58.1885714285714,NA,478,183,214,125,150,557,295,343
2018,8,53,"Onikisubat",37.5999,36.8403,16.3,8.82857142857143,5.12857142857143,76.1142857142857,53.4857142857143,NA,711,594,1070,0,0,1321,117,251
2018,9,53,"Onikisubat",37.5999,36.8403,15.7714285714286,9.97142857142857,4.92857142857143,83.4285714285714,64.0585714285714,NA,621,419,645,0,0,956,202,311
2018,10,53,"Onikisubat",37.5999,36.8403,23.6428571428571,12.9857142857143,0.757142857142857,69.5285714285714,80.4342857142857,NA,556,244,522,237,631,1330,312,808
2018,11,53,"Onikisubat",37.5999,36.8403,22.7,12.5,2.47142857142857,73.2,38.7914285714286,NA,551,62,121,470,1287,1426,489,1305
2018,12,53,"Onikisubat",37.5999,36.8403,28.1714285714286,15.6142857142857,1.38571428571429,57.5571428571429,66.1771428571429,NA,425,174,626,159,329,1187,251,561
2018,13,53,"Onikisubat",37.5999,36.8403,23.7,14.5285714285714,1.44285714285714,63.4857142857143,54.5728571428571,NA,356,223,245,103,94,428,133,183
2018,14,53,"Onikisubat",37.5999,36.8403,21.0857142857143,15.4428571428571,0,48.0714285714286,42.66,NA,407,281,388,52,37,486,126,98
2018,15,53,"Onikisubat",37.5999,36.8403,29.3285714285714,17.1714285714286,5.3,63.7428571428571,38.0857142857143,NA,374,10,28,162,161,450,364,422
2018,16,53,"Onikisubat",37.5999,36.8403,27.0857142857143,16.7714285714286,0.285714285714286,51.1428571428571,34.6914285714286,NA,411,107,167,218,361,648,304,481
2018,17,53,"Onikisubat",37.5999,36.8403,23.7285714285714,19.3571428571429,0.128571428571429,53.8285714285714,46.7114285714286,NA,419,191,294,163,264,652,228,358
2018,18,53,"Onikisubat",37.5999,36.8403,22.5857142857143,19.7857142857143,2.57142857142857,66.1,47.8485714285714,NA,303,173,257,0,0,474,130,217
2018,19,53,"Onikisubat",37.5999,36.8403,24.2714285714286,16.5428571428571,3.84285714285714,77.6571428571429,34.0242857142857,NA,275,68,167,107,159,467,207,300
2018,20,53,"Onikisubat",37.5999,36.8403,26.6428571428571,22.6428571428571,0.142857142857143,47.6428571428571,30.9557142857143,NA,204,51,108,108,120,306,153,198
2018,21,53,"Onikisubat",37.5999,36.8403,29.8714285714286,23.7857142857143,0,48.1714285714286,51.8828571428571,NA,252,37,55,147,195,281,215,226
2018,22,53,"Onikisubat",37.5999,36.8403,31.5714285714286,21.7,5.18571428571429,60.6571428571429,45.044,NA,249,25,91,156,218,427,224,336
2018,23,53,"Onikisubat",37.5999,36.8403,30.3857142857143,26.2571428571429,0.0142857142857143,45.3428571428571,32.9283333333333,NA,267,0,0,248,686,812,267,812
2018,24,53,"Onikisubat",37.5999,36.8403,38.5571428571429,24.1714285714286,9.15714285714286,59.9142857142857,39.2571428571429,NA,267,1,2,198,321,448,266,446
2018,25,53,"Onikisubat",37.5999,36.8403,45.3428571428571,24.9285714285714,3.8,57.0428571428571,26.3471428571429,NA,358,0,0,351,508,518,358,518
2018,26,53,"Onikisubat",37.5999,36.8403,43.2285714285714,26.7857142857143,0,53.7142857142857,35.6442857142857,NA,355,0,0,347,575,587,355,587
2018,27,53,"Onikisubat",37.5999,36.8403,42.4142857142857,29.0714285714286,0,49.8,37.9285714285714,NA,342,0,0,328,400,418,342,418
2018,28,53,"Onikisubat",37.5999,36.8403,43.4285714285714,28.7,0,54.2142857142857,38.5714285714286,NA,286,0,0,274,576,585,286,585
2018,29,53,"Onikisubat",37.5999,36.8403,41.3428571428571,28.7571428571429,0.0857142857142857,46.2857142857143,33.944,NA,260,0,0,253,734,756,260,756
2018,30,53,"Onikisubat",37.5999,36.8403,43.2857142857143,28.1,0.171428571428571,53.4428571428571,37.6216666666667,NA,265,0,0,259,819,822,265,822
2018,31,53,"Onikisubat",37.5999,36.8403,44.6142857142857,29.1714285714286,0,54.9428571428571,32.91,NA,267,0,0,262,454,499,267,499
2018,32,53,"Onikisubat",37.5999,36.8403,40.4,29.1428571428571,0,43.9571428571429,33.7,NA,297,0,0,227,318,403,297,403
2018,33,53,"Onikisubat",37.5999,36.8403,44.5285714285714,28.7,0,49.5142857142857,60.1085714285714,NA,216,0,0,204,315,332,216,332
2018,34,53,"Onikisubat",37.5999,36.8403,40.3714285714286,29.1428571428571,0,51.4571428571429,46.2728571428571,NA,144,0,0,141,226,227,144,227
2018,35,53,"Onikisubat",37.5999,36.8403,34.9428571428571,29.0142857142857,0,48.2285714285714,49.1828571428571,NA,201,0,0,177,297,314,201,314
2018,36,53,"Onikisubat",37.5999,36.8403,37.3857142857143,27.2,0,48.7142857142857,35.3085714285714,NA,341,0,0,332,334,370,341,370
2018,37,53,"Onikisubat",37.5999,36.8403,29.2428571428571,25.5142857142857,0.0857142857142857,45.4571428571429,39.34,NA,241,55,110,178,297,419,186,309
2018,38,53,"Onikisubat",37.5999,36.8403,26.1142857142857,26.6142857142857,0,41.2,37.025,NA,189,28,36,134,248,344,161,308
2018,39,53,"Onikisubat",37.5999,36.8403,31.1,25.4428571428571,0.0428571428571429,43.4142857142857,40.5814285714286,NA,180,5,2,150,296,353,175,351
2018,40,53,"Onikisubat",37.5999,36.8403,24.7714285714286,22.7571428571429,0,36.5428571428571,38.69,NA,191,42,70,89,170,341,149,271
2018,41,53,"Onikisubat",37.5999,36.8403,20.7,21.3714285714286,0.214285714285714,51.2428571428571,99.3928571428571,NA,187,72,130,42,77,422,115,292
2018,42,53,"Onikisubat",37.5999,36.8403,18.7428571428571,19.5714285714286,1.31428571428571,62.0142857142857,139.114,NA,168,129,165,0,0,381,39,216
2018,43,53,"Onikisubat",37.5999,36.8403,20.3857142857143,15.3,11.4571428571429,70.5285714285714,59.4728571428571,NA,187,129,203,16,115,402,58,199
2018,44,53,"Onikisubat",37.5999,36.8403,17.4142857142857,15.2,0,55.0857142857143,73.6142857142857,NA,196,128,121,0,0,264,68,143
2018,45,53,"Onikisubat",37.5999,36.8403,14.7428571428571,13.9428571428571,1.07142857142857,71.4714285714286,85.0214285714286,NA,231,155,342,0,0,473,76,131
2018,46,53,"Onikisubat",37.5999,36.8403,16.0285714285714,9.35714285714286,1.6,71.4571428571429,97.8928571428571,NA,230,174,326,27,65,465,56,139
2018,47,53,"Onikisubat",37.5999,36.8403,13.4857142857143,11.1142857142857,5.68571428571429,80.2428571428571,145.858571428571,NA,270,128,98,66,137,499,142,401
2018,48,53,"Onikisubat",37.5999,36.8403,20.8571428571429,12.1285714285714,0.414285714285714,81.5714285714286,61.5242857142857,NA,245,206,176,0,0,201,39,25
2018,49,53,"Onikisubat",37.5999,36.8403,15.6,10.6571428571429,1.84285714285714,85.1857142857143,73.2557142857143,NA,257,103,104,70,203,420,154,316
2018,50,53,"Onikisubat",37.5999,36.8403,17.1428571428571,9.07142857142857,12.0857142857143,79.3714285714286,68.1514285714286,NA,256,122,149,0,0,305,134,156
2018,51,53,"Onikisubat",37.5999,36.8403,18.4857142857143,8.14285714285714,3.9,85.9142857142857,83.6828571428571,NA,250,209,178,0,0,248,41,70
2018,52,53,"Onikisubat",37.5999,36.8403,21.0857142857143,5.14285714285714,5.87142857142857,80.7142857142857,29.28,NA,244,92,58,82,81,273,152,215
2019,1,53,"Onikisubat",37.5999,36.8403,20.1375,6.2875,23.775,88.2625,64.545,NA,343,179,317,86,286,784,164,467
2019,2,53,"Onikisubat",37.5999,36.8403,19.5571428571429,3.02857142857143,4.42857142857143,76.6714285714286,NA,NA,255,121,145,98,32,208,134,63
2019,3,53,"Onikisubat",37.5999,36.8403,28.4,4.01428571428571,9.88571428571429,70.1714285714286,92.975,NA,192,128,108,44,34,198,64,90
2019,4,53,"Onikisubat",37.5999,36.8403,19.0285714285714,6.98571428571429,0.757142857142857,74.6285714285714,111.94,NA,308,225,262,29,7,314,83,52
2019,5,53,"Onikisubat",37.5999,36.8403,26.0142857142857,7.34285714285714,5.07142857142857,76.4285714285714,82.5885714285714,NA,253,92,25,94,40,143,161,118
2019,6,53,"Onikisubat",37.5999,36.8403,16.0857142857143,6.22857142857143,2.98571428571429,82.8285714285714,59.63,NA,276,148,47,97,51,127,128,80
2019,7,53,"Onikisubat",37.5999,36.8403,22.1,7.61428571428571,0.457142857142857,78.4571428571429,66.1828571428571,NA,325,192,70,119,123,234,133,164
2019,8,53,"Onikisubat",37.5999,36.8403,20.8714285714286,8.72857142857143,1.15714285714286,70.4,70.5385714285714,NA,305,140,100,93,62,219,165,119
2019,9,53,"Onikisubat",37.5999,36.8403,21.8571428571429,7.62857142857143,4.58571428571429,72.1428571428571,56.5883333333333,NA,331,111,116,120,49,310,220,194
2019,10,53,"Onikisubat",37.5999,36.8403,29.4142857142857,9.48571428571429,0.5,63.7142857142857,50.2457142857143,NA,359,10,6,183,151,252,349,246
2019,11,53,"Onikisubat",37.5999,36.8403,26.8714285714286,10.4857142857143,7.25714285714286,77.2142857142857,49.9183333333333,NA,373,158,218,184,93,400,215,182
2019,12,53,"Onikisubat",37.5999,36.8403,19.7714285714286,11.9571428571429,0,56.6,51.1185714285714,NA,343,167,333,49,49,416,176,83
2019,13,53,"Onikisubat",37.5999,36.8403,27.0714285714286,11.0571428571429,8.24285714285714,69.3571428571429,33.61,NA,256,50,13,148,139,194,206,181
2019,14,53,"Onikisubat",37.5999,36.8403,19.7571428571429,12.1,1.48571428571429,80.5142857142857,49.7483333333333,NA,365,39,57,171,74,208,326,151
2019,15,53,"Onikisubat",37.5999,36.8403,25.0285714285714,14.9714285714286,0.985714285714286,70.3714285714286,51.2228571428571,NA,359,169,90,151,67,183,190,93
2019,16,53,"Onikisubat",37.5999,36.8403,26.3571428571429,10.7571428571429,3.65714285714286,77.6571428571429,37.3985714285714,NA,318,27,24,263,135,208,291,184
2019,17,53,"Onikisubat",37.5999,36.8403,22.3571428571429,14.9142857142857,0.0142857142857143,54.3714285714286,46.4185714285714,NA,412,182,139,59,100,313,230,174
2019,18,53,"Onikisubat",37.5999,36.8403,25.6428571428571,19.3142857142857,0,56.2857142857143,56.2885714285714,NA,523,117,160,303,127,353,406,193
2019,19,53,"Onikisubat",37.5999,36.8403,32.1857142857143,18,0.342857142857143,57.2,37.66,NA,452,80,54,359,301,386,372,332
2019,20,53,"Onikisubat",37.5999,36.8403,24.6857142857143,23.8857142857143,0,45.2428571428571,63.32,NA,454,334,274,96,90,389,120,115
2019,21,53,"Onikisubat",37.5999,36.8403,32.6285714285714,24.1571428571429,0.0428571428571429,48.9714285714286,55.055,NA,457,0,0,431,388,413,457,413
2019,22,53,"Onikisubat",37.5999,36.8403,27.9285714285714,27.6142857142857,0,39.7857142857143,67.4071428571429,NA,453,0,0,248,209,323,453,323
2019,23,53,"Onikisubat",37.5999,36.8403,29.9857142857143,26.3428571428571,0.285714285714286,40.4571428571429,56.09,NA,378,0,0,261,285,532,378,532
2019,24,53,"Onikisubat",37.5999,36.8403,37.6714285714286,24.9714285714286,0.0285714285714286,58.2428571428571,52.692,NA,378,0,0,321,180,244,378,244
2019,25,53,"Onikisubat",37.5999,36.8403,42.4142857142857,25.5714285714286,8.14285714285714,59.0142857142857,38.8628571428571,NA,306,0,0,299,312,325,306,325
2019,26,53,"Onikisubat",37.5999,36.8403,37.4714285714286,29.6428571428571,2.22857142857143,49.6571428571429,51.22,NA,377,0,0,358,329,342,377,342
2019,27,53,"Onikisubat",37.5999,36.8403,37.1571428571429,27.7428571428571,0,45.9,45.5157142857143,NA,456,0,0,395,188,222,456,222
2019,28,53,"Onikisubat",37.5999,36.8403,43.2428571428571,27.9571428571429,0.171428571428571,52.6,45.1985714285714,NA,398,0,0,381,379,421,398,421
2019,29,53,"Onikisubat",37.5999,36.8403,38.4571428571429,26.7857142857143,7.57142857142857,54.9857142857143,37.4485714285714,NA,453,0,0,449,203,203,453,203
2019,30,53,"Onikisubat",37.5999,36.8403,41.3285714285714,29.0142857142857,0,49.9142857142857,46.5971428571429,NA,456,0,0,446,332,335,456,335
2019,31,53,"Onikisubat",37.5999,36.8403,42.1714285714286,29.3142857142857,0,55.9428571428571,53.3471428571429,NA,334,0,0,316,365,375,334,375
2019,32,53,"Onikisubat",37.5999,36.8403,38.0571428571429,28.8857142857143,0,46.4142857142857,43.7714285714286,NA,346,0,0,334,379,395,346,395
2019,33,53,"Onikisubat",37.5999,36.8403,36.7428571428571,29.4428571428571,2.31428571428571,55.7571428571429,57.4483333333333,NA,337,0,0,326,516,531,337,531
2019,34,53,"Onikisubat",37.5999,36.8403,29.3142857142857,28.1571428571429,0,50.9142857142857,55.1671428571429,NA,299,0,0,283,311,345,299,345
2019,35,53,"Onikisubat",37.5999,36.8403,30.9142857142857,29.3571428571429,0,52.2,85.74,NA,307,0,0,298,402,415,307,415
2019,36,53,"Onikisubat",37.5999,36.8403,37.1857142857143,27.9571428571429,1.71428571428571,48.5857142857143,53.9957142857143,NA,171,0,0,162,60,67,171,67
2019,37,53,"Onikisubat",37.5999,36.8403,28.8571428571429,26.4285714285714,0.157142857142857,43.8571428571429,57.765,NA,218,30,1,156,46,55,188,54
2019,38,53,"Onikisubat",37.5999,36.8403,30.8142857142857,24.2,0.171428571428571,41.6857142857143,53.41,NA,266,31,7,165,67,91,235,84
2019,39,53,"Onikisubat",37.5999,36.8403,30.8285714285714,23.6714285714286,0,46.0857142857143,56.19,NA,237,0,0,224,74,79,237,79
2019,40,53,"Onikisubat",37.5999,36.8403,32.3428571428571,23.7857142857143,1.47142857142857,51.5142857142857,59.1514285714286,NA,241,37,4,190,103,111,204,107
2019,41,53,"Onikisubat",37.5999,36.8403,22.3571428571429,22.6285714285714,0.142857142857143,43.7857142857143,59.1357142857143,NA,416,51,18,195,290,448,365,430
2019,42,53,"Onikisubat",37.5999,36.8403,23.6428571428571,21.6,0.457142857142857,51.0571428571429,75.3657142857143,NA,356,83,25,104,151,408,273,383
2019,43,53,"Onikisubat",37.5999,36.8403,16.4571428571429,17.9428571428571,0.857142857142857,67.0428571428571,67.6683333333333,NA,306,171,135,13,3,300,135,165
2019,44,53,"Onikisubat",37.5999,36.8403,17.5714285714286,15.1,4.14285714285714,73.0142857142857,51.8657142857143,NA,350,94,62,71,54,250,256,188
2019,45,53,"Onikisubat",37.5999,36.8403,14.4,14.9,0,60.5285714285714,93.17,NA,417,303,133,0,0,328,114,195
2019,46,53,"Onikisubat",37.5999,36.8403,16.2571428571429,14.5,0,45.8,100.162857142857,NA,401,312,216,0,0,337,89,121
2019,47,53,"Onikisubat",37.5999,36.8403,14.2428571428571,9.94285714285714,0,44.1428571428571,109.732857142857,NA,391,327,247,0,0,339,64,92
2019,48,53,"Onikisubat",37.5999,36.8403,19.0428571428571,11.4428571428571,5.78571428571429,75.4,109.991428571429,NA,320,255,184,0,0,251,65,67
2019,49,53,"Onikisubat",37.5999,36.8403,16.8714285714286,7.95714285714286,4.11428571428571,78.4571428571429,86.5028571428571,NA,393,258,177,19,27,274,135,97
2019,50,53,"Onikisubat",37.5999,36.8403,15.3714285714286,8.02857142857143,3.3,88.7571428571429,62.8785714285714,NA,218,90,59,65,27,119,128,60
2019,51,53,"Onikisubat",37.5999,36.8403,13.7142857142857,8.42857142857143,0,75.3142857142857,138.638571428571,NA,361,324,444,0,0,488,37,44
2019,52,53,"Onikisubat",37.5999,36.8403,27.4,7.61428571428571,8.74285714285714,84,69.4428571428572,NA,279,196,191,4,0,281,83,90
2020,1,53,"Onikisubat",37.5999,36.8403,12.56,5.76,2.04,89.4,69.842,NA,160,42,31,75,73,126,118,95
2020,2,53,"Onikisubat",37.5999,36.8403,24.3428571428571,6.54285714285714,0.885714285714286,75.0714285714286,60.0014285714286,NA,240,123,92,40,4,173,117,81
2020,3,53,"Onikisubat",37.5999,36.8403,18.4428571428571,5.05714285714286,0.2,70.6714285714286,78.7528571428571,NA,270,133,155,31,21,382,137,227
2020,4,53,"Onikisubat",37.5999,36.8403,26.9428571428571,4.55714285714286,0.0285714285714286,58.7,46.1575,NA,358,125,107,67,77,295,233,188
2020,5,53,"Onikisubat",37.5999,36.8403,22.6285714285714,6.62857142857143,10.1285714285714,68.3714285714286,81.5885714285714,NA,331,175,165,121,70,272,156,107
2020,6,53,"Onikisubat",37.5999,36.8403,23.7,5.47142857142857,6.44285714285714,71.4,55.64,NA,343,178,177,107,42,267,165,90
2020,7,53,"Onikisubat",37.5999,36.8403,15.8857142857143,0.442857142857143,0.357142857142857,70.0142857142857,100.2,NA,341,143,150,70,64,338,198,188
2020,8,53,"Onikisubat",37.5999,36.8403,20,8.1,2.7,76.2142857142857,105.417142857143,NA,283,148,51,86,99,187,135,136
2020,9,53,"Onikisubat",37.5999,36.8403,21.8428571428571,9.85714285714286,3.35714285714286,69.5,77.2514285714286,NA,393,105,204,108,85,528,288,324
2020,10,53,"Onikisubat",37.5999,36.8403,24.7714285714286,12.8714285714286,0.1,57.7428571428571,60.2571428571429,NA,205,143,124,51,81,210,62,86
2020,11,53,"Onikisubat",37.5999,36.8403,28.7571428571429,15.0857142857143,0.242857142857143,63.5571428571429,82.8914285714286,NA,115,50,45,22,16,94,65,49
2020,12,53,"Onikisubat",37.5999,36.8403,25.1571428571429,8.28571428571429,5.01428571428571,80.0571428571429,40.504,NA,117,10,15,70,73,118,107,103
2020,13,53,"Onikisubat",37.5999,36.8403,23.7571428571429,12.3285714285714,8.48571428571429,76.6857142857143,44.7457142857143,NA,136,62,28,43,46,92,74,64
2020,14,53,"Onikisubat",37.5999,36.8403,21.6571428571429,10.9714285714286,10.6857142857143,78.2571428571429,39.3971428571429,NA,155,65,17,30,15,121,90,104
2020,15,53,"Onikisubat",37.5999,36.8403,27.3857142857143,14.0714285714286,2.91428571428571,69.5571428571428,40.74,NA,133,0,0,107,49,118,133,118
2020,16,53,"Onikisubat",37.5999,36.8403,22.6428571428571,16.3714285714286,0.0428571428571429,55.8142857142857,43.8914285714286,NA,141,15,6,83,64,106,126,100
2020,17,53,"Onikisubat",37.5999,36.8403,25.0142857142857,16.0714285714286,2.31428571428571,58.4,44.3157142857143,NA,137,6,1,108,95,123,131,122
2020,18,53,"Onikisubat",37.5999,36.8403,25.0428571428571,15.7714285714286,6.45714285714286,69.3428571428571,37.6671428571429,NA,146,13,6,83,51,164,133,158
2020,19,53,"Onikisubat",37.5999,36.8403,27.6857142857143,16.8857142857143,1.51428571428571,63.0571428571429,34.2785714285714,NA,137,0,0,116,153,157,137,157
2020,20,53,"Onikisubat",37.5999,36.8403,23.9285714285714,23.9714285714286,0,46.4428571428571,42.335,NA,164,35,15,77,118,164,129,149
2020,21,53,"Onikisubat",37.5999,36.8403,31.3857142857143,24.8,7.57142857142857,39.4,NA,NA,146,0,0,92,60,96,146,96
2020,22,53,"Onikisubat",37.5999,36.8403,34.5285714285714,20.3285714285714,0,50.7285714285714,NA,NA,118,25,21,75,71,100,93,79
2020,23,53,"Onikisubat",37.5999,36.8403,26.6,22.7142857142857,0,46.8714285714286,NA,NA,112,9,1,78,58,70,103,69
2020,24,53,"Onikisubat",37.5999,36.8403,37.7857142857143,24.0142857142857,0.0142857142857143,53.1571428571429,39.16,NA,140,0,0,132,147,150,140,150
2020,25,53,"Onikisubat",37.5999,36.8403,42.7285714285714,24.5857142857143,0.614285714285714,55.5285714285714,45.6242857142857,NA,137,0,0,127,106,108,137,108
2020,26,53,"Onikisubat",37.5999,36.8403,42.7285714285714,26.6285714285714,0.0142857142857143,53.0428571428571,49.7675,NA,173,0,0,159,115,133,173,133
2020,27,53,"Onikisubat",37.5999,36.8403,34.8571428571429,29.1285714285714,0,43.6857142857143,NA,NA,113,0,0,100,100,113,113,113
2020,28,53,"Onikisubat",37.5999,36.8403,42.4857142857143,29.2714285714286,0,54.3428571428571,NA,NA,164,0,0,157,122,122,164,122
2020,29,53,"Onikisubat",37.5999,36.8403,37.6428571428571,29.7285714285714,0,51.5428571428571,NA,NA,186,0,0,175,105,111,186,111
2020,30,53,"Onikisubat",37.5999,36.8403,39.3428571428571,30.7285714285714,0,48.8142857142857,NA,NA,190,0,0,177,129,142,190,142
2020,31,53,"Onikisubat",37.5999,36.8403,34.0428571428571,31.0857142857143,0,46.0857142857143,NA,NA,150,18,7,104,81,127,132,120
2020,32,53,"Onikisubat",37.5999,36.8403,43.6571428571429,29.7428571428571,0,49.7285714285714,NA,NA,146,0,0,132,96,107,146,107
2020,33,53,"Onikisubat",37.5999,36.8403,38.7857142857143,28.6428571428571,1.14285714285714,41.9285714285714,NA,NA,183,0,0,139,69,83,183,83
2020,34,53,"Onikisubat",37.5999,36.8403,40.6285714285714,28.2571428571429,0.714285714285714,44.1857142857143,NA,NA,197,0,0,166,84,97,197,97
2020,35,53,"Onikisubat",37.5999,36.8403,28.9571428571429,28.8428571428571,0,40.0428571428571,NA,NA,164,16,3,114,113,157,148,154
2020,36,53,"Onikisubat",37.5999,36.8403,25.5571428571429,30.5428571428571,0,32.5428571428571,NA,NA,179,32,5,95,73,112,147,107
2020,37,53,"Onikisubat",37.5999,36.8403,25.2714285714286,29.4571428571429,0,38.5,NA,NA,193,57,26,82,40,91,136,65
2020,38,53,"Onikisubat",37.5999,36.8403,30.6428571428571,28.1571428571429,0,52.8714285714286,NA,NA,235,0,0,202,144,157,235,157
2020,39,53,"Onikisubat",37.5999,36.8403,37.2857142857143,26.1571428571429,0,55.1,NA,NA,220,0,0,186,110,129,220,129
2020,40,53,"Onikisubat",37.5999,36.8403,30.9142857142857,25.0571428571429,0.342857142857143,48.1714285714286,NA,NA,187,0,0,167,150,154,187,154
2020,41,53,"Onikisubat",37.5999,36.8403,21.4285714285714,23.4428571428571,0,26.3285714285714,NA,NA,182,88,56,23,16,127,94,71
2020,42,53,"Onikisubat",37.5999,36.8403,25.5285714285714,22.7571428571429,0,47.9571428571429,81.24,49.005,177,29,11,79,45,111,148,100
2020,43,53,"Onikisubat",37.5999,36.8403,19.5285714285714,21.3714285714286,1.85714285714286,41.8142857142857,97.96,71.54,194,57,26,31,15,161,137,135
2020,44,53,"Onikisubat",37.5999,36.8403,17.3714285714286,20.6428571428571,0.128571428571429,34.2857142857143,NA,72.1985714285714,255,195,181,0,0,233,60,52
2020,45,53,"Onikisubat",37.5999,36.8403,19,14.8857142857143,3.47142857142857,72.4714285714286,NA,53.7957142857143,156,105,72,0,0,103,51,31
2020,46,53,"Onikisubat",37.5999,36.8403,13.1857142857143,13,0,61.3428571428571,NA,79.7471428571429,208,130,41,0,0,109,78,68
2020,47,53,"Onikisubat",37.5999,36.8403,16.2857142857143,10.8428571428571,0.428571428571429,67.5857142857143,64.7366666666667,69.14,173,121,55,0,0,83,52,28
2020,48,53,"Onikisubat",37.5999,36.8403,14.4428571428571,8.35714285714286,0.542857142857143,67.7428571428571,92.67,76.37,199,127,157,0,0,262,72,105
2020,49,53,"Onikisubat",37.5999,36.8403,16.1,8.94285714285714,0.871428571428571,80.7142857142857,98.9585714285714,67.5257142857143,207,110,40,13,0,116,97,76
2020,50,53,"Onikisubat",37.5999,36.8403,14.5142857142857,8.82857142857143,0.214285714285714,76.1857142857143,88.1457142857143,61.9342857142857,181,93,40,25,5,98,88,58
2020,51,53,"Onikisubat",37.5999,36.8403,19.5142857142857,8.54285714285714,3.72857142857143,86.6285714285714,106.022857142857,60.1357142857143,171,66,29,12,8,90,105,61
2020,52,53,"Onikisubat",37.5999,36.8403,14.9714285714286,5.57142857142857,0.185714285714286,69.2,89.7285714285714,59.5142857142857,203,78,49,18,25,113,125,64
2020,53,53,"Onikisubat",37.5999,36.8403,13.375,6.325,0,65.2,113.59,93.07,122,58,32,0,0,111,64,79
2017,1,54,"Kardemir",41.2061,32.6204,11.4285714285714,4.38571428571429,3.995,76.1,59.74,50.7471428571429,563,308,412,11,16,847,255,435
2017,2,54,"Kardemir",41.2061,32.6204,14.1428571428571,4.42857142857143,1.71514285714286,68.4857142857143,79.8771428571429,55.3171428571429,757,345,580,133,296,1214,412,634
2017,3,54,"Kardemir",41.2061,32.6204,8.65714285714286,5.04285714285714,1.31428571428571,87.6571428571429,76.7985714285714,47.8314285714286,762,225,332,246,513,1449,537,1117
2017,4,54,"Kardemir",41.2061,32.6204,8.55714285714286,1.01428571428571,5.61271428571429,89.5714285714286,110.938,43.646,639,91,51,269,360,889,548,838
2017,5,54,"Kardemir",41.2061,32.6204,9.34285714285714,2.81428571428571,1.12757142857143,70.1571428571429,NA,NA,588,353,633,0,0,1163,235,530
2017,6,54,"Kardemir",41.2061,32.6204,13.6285714285714,6.95714285714286,0.88,74.4857142857143,82.24,42.415,736,238,370,54,164,1519,498,1149
2017,7,54,"Kardemir",41.2061,32.6204,8.57142857142857,2.3,2.34,74.7428571428571,69.025,45.255,492,0,0,301,445,717,492,717
2017,8,54,"Kardemir",41.2061,32.6204,11.7142857142857,9.27142857142857,2.19571428571429,66.4142857142857,110.138333333333,50.9516666666667,739,0,0,120,309,1747,739,1747
2017,9,54,"Kardemir",41.2061,32.6204,11.5571428571429,8.67142857142857,0.208571428571429,78.8,106.587142857143,48.9528571428571,574,0,0,568,866,866,574,866
2017,10,54,"Kardemir",41.2061,32.6204,12.4428571428571,10.4142857142857,0.0285714285714286,66.8142857142857,110.941666666667,59.2816666666667,712,1,1,564,880,1043,711,1042
2017,11,54,"Kardemir",41.2061,32.6204,11.1285714285714,5.77142857142857,7.25914285714286,85.4714285714286,43.6371428571429,35.425,525,0,0,204,284,725,525,725
2017,12,54,"Kardemir",41.2061,32.6204,14.0428571428571,7.62857142857143,2.06228571428571,77.9142857142857,118.325,53.6875,589,0,0,527,1000,1077,589,1077
2017,13,54,"Kardemir",41.2061,32.6204,16.1571428571429,7.78571428571429,2.226,76.6857142857143,76.634,41.7042857142857,574,0,0,504,824,887,574,887
2017,14,54,"Kardemir",41.2061,32.6204,15.3142857142857,8.7,1.52128571428571,81.2428571428571,85.79,47.1042857142857,639,0,0,415,938,1336,639,1336
2017,15,54,"Kardemir",41.2061,32.6204,12.6857142857143,10.7857142857143,0.343428571428571,69.6428571428571,85.29,47.462,587,0,0,255,628,1187,587,1187
2017,16,54,"Kardemir",41.2061,32.6204,14.5571428571429,10.7142857142857,7.119,74.1571428571429,49.01,36.0057142857143,717,0,0,280,386,920,717,920
2017,17,54,"Kardemir",41.2061,32.6204,14.0428571428571,13.7571428571429,1.46228571428571,56.7571428571429,73.65,49.795,731,0,0,426,1019,1478,731,1478
2017,18,54,"Kardemir",41.2061,32.6204,13.3,13.6142857142857,3.53914285714286,88.1285714285714,62.2683333333333,44.18,506,69,113,427,773,923,437,810
2017,19,54,"Kardemir",41.2061,32.6204,11.6142857142857,17.1,2.39828571428571,72.6571428571429,47.2175,38.535,471,86,156,175,367,966,385,810
2017,20,54,"Kardemir",41.2061,32.6204,15.7142857142857,14.2428571428571,3.48514285714286,79.9571428571429,30.73,31.0166666666667,472,23,104,261,696,1205,449,1101
2017,21,54,"Kardemir",41.2061,32.6204,14.6857142857143,14.8857142857143,2.40285714285714,79.7428571428571,36.66,20.9933333333333,448,0,0,382,767,849,448,849
2017,22,54,"Kardemir",41.2061,32.6204,14.7857142857143,18.7142857142857,0.628142857142857,76.5857142857143,37.7428571428571,25.2514285714286,522,0,0,292,629,1015,522,1015
2017,23,54,"Kardemir",41.2061,32.6204,12.0428571428571,19.6857142857143,3.61014285714286,83.5857142857143,25.6566666666667,19.0866666666667,578,0,0,464,1077,1388,578,1388
2017,24,54,"Kardemir",41.2061,32.6204,12.6142857142857,18.5,0.175428571428571,74.6714285714286,23.9,20.01,552,0,0,325,735,1139,552,1139
2017,25,54,"Kardemir",41.2061,32.6204,12.2,19.3428571428571,9.87985714285714,78.8571428571429,41.76,25.29,584,0,0,147,268,1041,584,1041
2017,26,54,"Kardemir",41.2061,32.6204,12.7285714285714,24.5714285714286,0,71.5857142857143,28.13,25.56,564,101,110,298,547,971,463,861
2017,27,54,"Kardemir",41.2061,32.6204,14.1571428571429,20.9571428571429,1.76671428571429,74.7857142857143,22.2816666666667,17.9683333333333,511,0,0,404,582,642,511,642
2017,28,54,"Kardemir",41.2061,32.6204,15.1571428571429,21.5857142857143,0.128571428571429,76.6142857142857,26.35,20.2742857142857,481,0,0,381,789,864,481,864
2017,29,54,"Kardemir",41.2061,32.6204,15.1571428571429,22.6857142857143,0.522571428571428,80.9714285714286,28.7633333333333,16.0183333333333,532,0,0,394,1019,1272,532,1272
2017,30,54,"Kardemir",41.2061,32.6204,15.3714285714286,24.2571428571429,0.953714285714286,66.3142857142857,72.73,25.14,531,0,0,289,597,928,531,928
2017,31,54,"Kardemir",41.2061,32.6204,15.6,23.4142857142857,0,76.8428571428571,61.0214285714286,19.1857142857143,559,0,0,494,963,1047,559,1047
2017,32,54,"Kardemir",41.2061,32.6204,15.4571428571429,24.7,0,78.4285714285714,75.6971428571429,18.7971428571429,567,0,0,566,1090,1092,567,1092
2017,33,54,"Kardemir",41.2061,32.6204,14.7285714285714,23.3857142857143,0.364714285714286,77.5428571428571,46.2383333333333,19.5166666666667,596,0,0,352,557,1199,596,1199
2017,34,54,"Kardemir",41.2061,32.6204,16.6857142857143,20.5,12.0438571428571,76.9,69.0333333333333,19.6133333333333,601,6,0,139,312,1280,595,1280
2017,35,54,"Kardemir",41.2061,32.6204,14.0571428571429,19.2428571428571,0,70.4857142857143,31.3285714285714,19.2342857142857,493,0,0,162,271,1014,493,1014
2017,36,54,"Kardemir",41.2061,32.6204,13.9714285714286,20.0857142857143,1.88385714285714,74.0142857142857,47.4957142857143,26.3571428571429,507,17,60,271,762,1321,490,1261
2017,37,54,"Kardemir",41.2061,32.6204,13.0571428571429,22.6714285714286,0,75.6714285714286,68.08,32.2242857142857,589,0,0,337,546,1138,589,1138
2017,38,54,"Kardemir",41.2061,32.6204,12,20.6714285714286,1.64214285714286,79.5857142857143,70.676,35.062,671,110,223,309,466,1312,561,1089
2017,39,54,"Kardemir",41.2061,32.6204,12.4142857142857,16.6285714285714,1.091,85.8285714285714,40.5271428571429,28.9071428571429,782,0,0,26,176,1630,782,1630
2017,40,54,"Kardemir",41.2061,32.6204,11.5285714285714,13.6571428571429,2.721,79.2,57.922,37.938,543,75,141,132,278,1137,468,996
2017,41,54,"Kardemir",41.2061,32.6204,10.4428571428571,11.6714285714286,1.431,85.8142857142857,32.6,27.476,487,228,248,113,164,843,259,595
2017,42,54,"Kardemir",41.2061,32.6204,9.68571428571429,13.5571428571429,0.320571428571429,81.3714285714286,53.012,32.102,530,85,115,0,0,815,445,700
2017,43,54,"Kardemir",41.2061,32.6204,10.7857142857143,14.8285714285714,7.31885714285714,85.0142857142857,62.53,31.928,506,77,67,0,0,919,429,852
2017,44,54,"Kardemir",41.2061,32.6204,10.4571428571429,8.15714285714286,5.80442857142857,82.5285714285714,72.1433333333333,33.065,561,386,840,0,0,1102,175,262
2017,45,54,"Kardemir",41.2061,32.6204,8.84285714285714,9.62857142857143,2.19185714285714,89.9571428571429,61.3657142857143,33.2385714285714,577,245,484,34,49,829,332,345
2017,46,54,"Kardemir",41.2061,32.6204,10.8714285714286,12.4,0.0284285714285714,82.9428571428572,78.7171428571429,39.12,587,184,372,195,351,1085,403,713
2017,47,54,"Kardemir",41.2061,32.6204,9.85714285714286,8.34285714285714,13.681,86.4714285714286,42.9228571428571,31.4185714285714,418,202,481,119,159,804,216,323
2017,48,54,"Kardemir",41.2061,32.6204,8.71428571428571,11.8285714285714,2.00014285714286,70.1571428571429,86.7642857142857,40.6828571428571,386,287,443,0,0,619,99,176
2017,49,54,"Kardemir",41.2061,32.6204,11.8142857142857,6.92857142857143,11.7095714285714,83.9,51.3114285714286,30.2285714285714,407,135,218,24,31,645,272,427
2017,50,54,"Kardemir",41.2061,32.6204,9.75714285714286,9.01428571428571,0.113857142857143,74.1714285714286,98.048,41.306,346,346,442,0,0,442,0,0
2017,51,54,"Kardemir",41.2061,32.6204,14.8,6.05714285714286,12.3351428571429,91.1857142857143,26.9057142857143,30.6114285714286,386,207,160,94,73,349,179,189
2017,52,54,"Kardemir",41.2061,32.6204,17.3875,8.9,2.201625,69.8,55.324,40.62125,528,215,192,0,0,507,313,315
2018,1,54,"Kardemir",41.2061,32.6204,9.4625,7.8375,1.94075,82.5625,49.3228571428571,35.9925,618,208,333,72,61,914,410,581
2018,2,54,"Kardemir",41.2061,32.6204,13.5714285714286,7.25714285714286,1.96,87.9428571428572,46.5157142857143,27.1028571428571,624,171,242,1,4,1309,453,1067
2018,3,54,"Kardemir",41.2061,32.6204,22.2857142857143,6.57142857142857,4.721,73.6,38.3671428571429,34.2471428571429,639,349,419,0,0,655,290,236
2018,4,54,"Kardemir",41.2061,32.6204,17.3428571428571,3.97142857142857,2.23142857142857,77.4142857142857,37.16,39.16,604,222,291,70,72,764,382,473
2018,5,54,"Kardemir",41.2061,32.6204,10.7,9.38571428571429,0.0518571428571429,66.9428571428571,98.868,42.158,670,187,280,155,137,819,483,539
2018,6,54,"Kardemir",41.2061,32.6204,9.77142857142857,8.32857142857143,2.03814285714286,85.5857142857143,49.8157142857143,34.4585714285714,704,125,193,92,152,1022,579,829
2018,7,54,"Kardemir",41.2061,32.6204,10.4,6.85714285714286,1.16157142857143,86.2428571428571,35.4214285714286,28.1885714285714,478,135,178,136,123,557,343,379
2018,8,54,"Kardemir",41.2061,32.6204,14.9,6.64285714285714,3.81728571428571,91.3,38.2014285714286,27.6071428571429,711,0,0,102,190,1321,711,1321
2018,9,54,"Kardemir",41.2061,32.6204,14.5714285714286,5.88571428571429,9.05414285714286,87.1142857142857,53.5585714285714,29.1928571428571,621,97,158,237,332,956,524,798
2018,10,54,"Kardemir",41.2061,32.6204,10.7285714285714,10.2,5.37485714285714,83.8571428571429,34.8971428571429,33.78,556,207,404,149,284,1330,349,926
2018,11,54,"Kardemir",41.2061,32.6204,14.5714285714286,14.2714285714286,4.21671428571429,64.6714285714286,37.0442857142857,32.1442857142857,551,93,138,0,0,1426,458,1288
2018,12,54,"Kardemir",41.2061,32.6204,12.6857142857143,9.74285714285714,0.426142857142857,86.8,78.1685714285714,28.7157142857143,425,0,0,173,436,1187,425,1187
2018,13,54,"Kardemir",41.2061,32.6204,13.2142857142857,12.5714285714286,5.28585714285714,71.8,48.9614285714286,23.45,356,57,70,123,207,428,299,358
2018,14,54,"Kardemir",41.2061,32.6204,13.8428571428571,11.8428571428571,0.362857142857143,70.4714285714286,53.0485714285714,28.3857142857143,407,0,0,185,289,486,407,486
2018,15,54,"Kardemir",41.2061,32.6204,17.3857142857143,11.2285714285714,0.0294285714285714,87.2714285714286,66.8157142857143,27.7442857142857,374,0,0,264,387,450,374,450
2018,16,54,"Kardemir",41.2061,32.6204,11.8142857142857,11.6428571428571,1.34514285714286,75.6428571428571,70.1242857142857,30.4414285714286,411,71,91,325,530,648,340,557
2018,17,54,"Kardemir",41.2061,32.6204,13.2285714285714,17.2428571428571,0,59.1428571428571,66.6357142857143,33.7642857142857,419,44,81,87,94,652,375,571
2018,18,54,"Kardemir",41.2061,32.6204,12.3714285714286,13.7714285714286,0.522714285714286,91.6428571428571,55.5714285714286,29.9785714285714,303,0,0,298,474,474,303,474
2018,19,54,"Kardemir",41.2061,32.6204,12.3714285714286,15.5571428571429,5.47328571428571,86.9285714285714,29.42,19.2,275,0,0,96,250,467,275,467
2018,20,54,"Kardemir",41.2061,32.6204,12.4,19.3571428571429,1.48385714285714,69.0857142857143,43.9214285714286,26.06,204,26,78,80,108,306,178,228
2018,21,54,"Kardemir",41.2061,32.6204,14.9285714285714,19.3285714285714,0.168571428571429,86.4142857142857,109.195,15.3916666666667,252,0,0,126,185,281,252,281
2018,22,54,"Kardemir",41.2061,32.6204,14.4857142857143,18.9142857142857,0.586285714285714,79.9857142857143,38.4971428571429,17.7871428571429,249,0,0,70,184,427,249,427
2018,23,54,"Kardemir",41.2061,32.6204,15.8285714285714,21.2857142857143,0,69.2857142857143,34.29,28.0528571428571,267,0,0,71,367,812,267,812
2018,24,54,"Kardemir",41.2061,32.6204,17.5285714285714,21.4142857142857,0.550285714285714,69.0714285714286,31.6071428571429,23.5114285714286,267,35,41,80,159,448,232,407
2018,25,54,"Kardemir",41.2061,32.6204,15.4714285714286,22.3428571428571,10.3914285714286,77.1571428571429,27.24,18.5514285714286,358,0,0,229,269,518,358,518
2018,26,54,"Kardemir",41.2061,32.6204,13.4857142857143,22.9571428571429,0.405285714285714,77.3857142857143,43.53,19.4142857142857,355,0,0,128,208,587,355,587
2018,27,54,"Kardemir",41.2061,32.6204,15.5571428571429,22.1714285714286,0,71.2571428571429,32.1671428571429,23.3585714285714,342,0,0,52,117,418,342,418
2018,28,54,"Kardemir",41.2061,32.6204,12.9571428571429,24.1,1.46271428571429,78.2857142857143,32.99,21.9014285714286,286,0,0,73,149,585,286,585
2018,29,54,"Kardemir",41.2061,32.6204,16.4428571428571,23.8428571428571,1.70057142857143,72.1,55.3528571428571,27.5814285714286,260,9,7,35,173,756,251,749
2018,30,54,"Kardemir",41.2061,32.6204,13.8142857142857,24.1,2.99085714285714,75.5,36.63,23.025,265,0,0,15,22,822,265,822
2018,31,54,"Kardemir",41.2061,32.6204,15.7428571428571,25.6857142857143,0,73.6428571428571,32.7528571428571,24.9085714285714,267,0,0,7,8,499,267,499
2018,32,54,"Kardemir",41.2061,32.6204,18.1,22.9857142857143,0.667428571428571,72.3285714285714,37.1814285714286,26.8514285714286,297,0,0,36,22,403,297,403
2018,33,54,"Kardemir",41.2061,32.6204,16.7285714285714,23.1857142857143,0,71.5857142857143,41.6614285714286,31.6142857142857,216,0,0,36,80,332,216,332
2018,34,54,"Kardemir",41.2061,32.6204,16.0857142857143,22.8571428571429,0,69.5571428571429,26.465,25.3271428571429,144,0,0,33,40,227,144,227
2018,35,54,"Kardemir",41.2061,32.6204,15.2428571428571,23.3571428571429,0.603285714285714,76.0714285714286,17.7166666666667,28.4414285714286,201,0,0,87,156,314,201,314
2018,36,54,"Kardemir",41.2061,32.6204,16,21.4285714285714,6.56285714285714,78.7571428571429,20.1771428571429,29.26,341,22,30,128,153,370,319,340
2018,37,54,"Kardemir",41.2061,32.6204,16.1285714285714,18.8285714285714,8.39842857142857,80.2428571428571,15.1766666666667,28.0028571428571,241,42,123,0,0,419,199,296
2018,38,54,"Kardemir",41.2061,32.6204,17.5714285714286,18.3714285714286,0.310285714285714,79.4428571428572,15.7785714285714,30.2142857142857,189,0,0,55,98,344,189,344
2018,39,54,"Kardemir",41.2061,32.6204,14.8571428571429,16.4285714285714,2.48485714285714,78.7142857142857,14.6942857142857,29.1542857142857,180,27,53,32,66,353,153,300
2018,40,54,"Kardemir",41.2061,32.6204,12.0428571428571,16.5285714285714,3.05585714285714,80.3428571428571,13.1128571428571,28.4542857142857,191,82,163,14,10,341,109,178
2018,41,54,"Kardemir",41.2061,32.6204,12.4142857142857,16.5714285714286,0.0378571428571429,87,16.1514285714286,26.1585714285714,187,0,0,16,60,422,187,422
2018,42,54,"Kardemir",41.2061,32.6204,8.8,17.5857142857143,2.83085714285714,91.0142857142857,17.6571428571429,23.3485714285714,168,0,0,111,311,381,168,381
2018,43,54,"Kardemir",41.2061,32.6204,11.0142857142857,11.7285714285714,8.56785714285714,82.7428571428571,19.5228571428571,27.0642857142857,187,56,87,12,5,402,131,315
2018,44,54,"Kardemir",41.2061,32.6204,9.88571428571429,14,0,73.7285714285714,15.3971428571429,39.7342857142857,196,109,142,0,0,264,87,122
2018,45,54,"Kardemir",41.2061,32.6204,11.3857142857143,13.2,0.0685714285714286,84.4285714285714,14.5214285714286,35.9185714285714,231,26,63,1,0,473,205,410
2018,46,54,"Kardemir",41.2061,32.6204,13.2285714285714,9.01428571428571,4.01371428571429,85.4428571428571,11.5733333333333,31.835,230,145,245,0,0,465,85,220
2018,47,54,"Kardemir",41.2061,32.6204,9.62857142857143,10,2.81314285714286,89.2142857142857,29.6457142857143,26.3785714285714,270,129,56,37,55,499,141,443
2018,48,54,"Kardemir",41.2061,32.6204,10.5571428571429,9.18571428571429,7.95042857142857,89.5285714285714,12.5228571428571,30.1457142857143,245,117,89,25,29,201,128,112
2018,49,54,"Kardemir",41.2061,32.6204,8.42857142857143,6.91428571428571,3.24571428571429,85.4714285714286,10.0885714285714,35.7914285714286,257,120,187,1,1,420,137,233
2018,50,54,"Kardemir",41.2061,32.6204,10.7857142857143,7,12.0355714285714,86.7857142857143,12.8057142857143,41.6357142857143,256,127,146,33,20,305,129,159
2018,51,54,"Kardemir",41.2061,32.6204,11.3142857142857,8.07142857142857,2.46114285714286,89.7285714285714,13.35,34.4771428571429,250,34,54,0,0,248,216,194
2018,52,54,"Kardemir",41.2061,32.6204,9.3,4.12857142857143,7.83171428571429,90.1142857142857,11.3085714285714,42.1785714285714,244,157,207,40,47,273,87,66
2019,1,54,"Kardemir",41.2061,32.6204,13.85,4.4375,5.60025,89.7625,28.34875,35.6225,343,196,530,17,64,784,147,254
2019,2,54,"Kardemir",41.2061,32.6204,10.1,4.25714285714286,6.558,82.4,14.188,41.58,255,131,103,1,0,208,124,105
2019,3,54,"Kardemir",41.2061,32.6204,12.2428571428571,5.57142857142857,6.09985714285714,78.5428571428571,11.1042857142857,42.9014285714286,192,138,153,45,44,198,54,45
2019,4,54,"Kardemir",41.2061,32.6204,22.0714285714286,10.6142857142857,0.892857142857143,65.1857142857143,13.8914285714286,53.54,308,131,172,48,43,314,177,142
2019,5,54,"Kardemir",41.2061,32.6204,13.0714285714286,8.98571428571429,1.90742857142857,68.3428571428571,20.33,50.5657142857143,253,190,113,0,0,143,63,30
2019,6,54,"Kardemir",41.2061,32.6204,9.81428571428571,6.87142857142857,2.46957142857143,89.3714285714286,15.0214285714286,41.13,276,43,13,146,82,127,233,114
2019,7,54,"Kardemir",41.2061,32.6204,14.0428571428571,7.05714285714286,1.148,78.3714285714286,13.18,35.8275,325,14,6,59,10,234,311,228
2019,8,54,"Kardemir",41.2061,32.6204,12.6,5.24285714285714,2.00142857142857,86.0142857142857,16.2842857142857,45.824,305,6,0,195,161,219,299,219
2019,9,54,"Kardemir",41.2061,32.6204,14.2714285714286,5.41428571428571,2.83271428571429,81.5857142857143,14.7857142857143,33.1533333333333,331,1,1,128,112,310,330,309
2019,10,54,"Kardemir",41.2061,32.6204,12.4714285714286,9.37142857142857,1.098,68.3428571428571,15.9442857142857,44.4785714285714,359,2,1,187,105,252,357,251
2019,11,54,"Kardemir",41.2061,32.6204,15.5285714285714,9.77142857142857,3.206,74.2428571428571,13.4542857142857,34.0942857142857,373,68,36,168,142,400,305,364
2019,12,54,"Kardemir",41.2061,32.6204,13.8285714285714,8.1,0,72.9142857142857,16.1385714285714,37.9485714285714,343,37,22,200,87,416,306,394
2019,13,54,"Kardemir",41.2061,32.6204,20.0714285714286,6.02857142857143,0,71.7571428571429,22.8985714285714,30.5185714285714,256,0,0,80,60,194,256,194
2019,14,54,"Kardemir",41.2061,32.6204,14.1857142857143,8.62857142857143,0.00985714285714286,82.7285714285714,8.79142857142857,32.3928571428571,365,0,0,304,192,208,365,208
2019,15,54,"Kardemir",41.2061,32.6204,11.4285714285714,13.9571428571429,3.67742857142857,78.5428571428571,9.02571428571428,37.6285714285714,359,112,37,197,113,183,247,146
2019,16,54,"Kardemir",41.2061,32.6204,11.3285714285714,8.28571428571428,5.32685714285714,87.6428571428571,9.21142857142857,26.6028571428571,318,0,0,243,179,208,318,208
2019,17,54,"Kardemir",41.2061,32.6204,14.0428571428571,10.8714285714286,0,77.7,10.1771428571429,41.4757142857143,412,9,6,225,185,313,403,307
2019,18,54,"Kardemir",41.2061,32.6204,14.1428571428571,16.7428571428571,0.748,65.1,9.41142857142857,39.7271428571429,523,0,0,290,162,353,523,353
2019,19,54,"Kardemir",41.2061,32.6204,11.9571428571429,14.7714285714286,4.13942857142857,78.9,6.01,41.3142857142857,452,8,17,226,190,386,444,369
2019,20,54,"Kardemir",41.2061,32.6204,14.0142857142857,17.9,6.07328571428571,79.9428571428571,6.70571428571429,44.3014285714286,454,6,2,204,150,389,448,387
2019,21,54,"Kardemir",41.2061,32.6204,14.7714285714286,20.8285714285714,1.86585714285714,68.3,6.45,32.0085714285714,457,185,164,0,0,413,272,249
2019,22,54,"Kardemir",41.2061,32.6204,17.5,22.2857142857143,0.219285714285714,64.1,8.82,35.1433333333333,453,0,0,126,125,323,453,323
2019,23,54,"Kardemir",41.2061,32.6204,14.5571428571429,21.7142857142857,0,81.1857142857143,7.99285714285714,25.65,378,0,0,211,204,532,378,532
2019,24,54,"Kardemir",41.2061,32.6204,14.4714285714286,23.1142857142857,1.14657142857143,81.4714285714286,9.15714285714286,34.6585714285714,378,0,0,112,78,244,378,244
2019,25,54,"Kardemir",41.2061,32.6204,12.8142857142857,22.9571428571429,5.65371428571429,86.8714285714286,21.8128571428571,36.8214285714286,306,0,0,106,62,325,306,325
2019,26,54,"Kardemir",41.2061,32.6204,14.2714285714286,22.6,1.699,77.8857142857143,14.0585714285714,32.3228571428571,377,0,0,42,137,342,377,342
2019,27,54,"Kardemir",41.2061,32.6204,15.4285714285714,22.3857142857143,0.00942857142857143,76.6714285714286,55.0814285714286,26.8285714285714,456,0,0,62,9,222,456,222
2019,28,54,"Kardemir",41.2061,32.6204,12.2571428571429,20.1714285714286,9.80928571428571,78.6571428571429,42.8157142857143,23.2071428571429,398,2,3,217,264,421,396,418
2019,29,54,"Kardemir",41.2061,32.6204,15.2571428571429,21.1285714285714,3.35257142857143,79.6285714285714,39.0642857142857,23.8428571428571,453,0,0,7,16,203,453,203
2019,30,54,"Kardemir",41.2061,32.6204,15.7285714285714,21.7571428571429,0.726285714285714,76.1285714285714,50.2828571428571,23.1,456,0,0,184,145,335,456,335
2019,31,54,"Kardemir",41.2061,32.6204,13.8714285714286,23.4428571428571,1.21914285714286,81.9285714285714,60.0414285714286,21.1785714285714,334,0,0,273,284,375,334,375
2019,32,54,"Kardemir",41.2061,32.6204,16.6142857142857,21.1,0.704428571428572,75.6714285714286,49.14,20.9014285714286,346,0,0,77,60,395,346,395
2019,33,54,"Kardemir",41.2061,32.6204,13.5285714285714,22.2142857142857,2.19585714285714,79.4428571428571,48.6885714285714,18.5514285714286,337,55,131,102,158,531,282,400
2019,34,54,"Kardemir",41.2061,32.6204,13.5857142857143,21.6857142857143,7.21657142857143,85.4142857142857,58.1185714285714,20.7714285714286,299,1,0,69,60,345,298,345
2019,35,54,"Kardemir",41.2061,32.6204,16.9714285714286,21.4571428571429,0.0285714285714286,78.7571428571429,58.4142857142857,37.2342857142857,307,0,0,12,4,415,307,415
2019,36,54,"Kardemir",41.2061,32.6204,17.6142857142857,21.3857142857143,0,75.7714285714286,52.9642857142857,31.4514285714286,171,0,0,0,0,67,171,67
2019,37,54,"Kardemir",41.2061,32.6204,17.4428571428571,20.9428571428571,0,75.6285714285714,57.3842857142857,28.4685714285714,218,0,0,1,0,55,218,55
2019,38,54,"Kardemir",41.2061,32.6204,14.4285714285714,17.5857142857143,2.49257142857143,74.4,67.9842857142857,37.4771428571429,266,87,52,36,4,91,179,39
2019,39,54,"Kardemir",41.2061,32.6204,9.5,16.2428571428571,2.36871428571429,86.0857142857143,64.0328571428571,41.53,237,31,19,93,34,79,206,60
2019,40,54,"Kardemir",41.2061,32.6204,12.0285714285714,17.6857142857143,11.0061428571429,82.1285714285714,75.4114285714286,46.0942857142857,241,0,0,108,43,111,241,111
2019,41,54,"Kardemir",41.2061,32.6204,12.8571428571429,14.7285714285714,1.81042857142857,85.5857142857143,66.8128571428571,33.8385714285714,416,29,3,0,0,448,387,445
2019,42,54,"Kardemir",41.2061,32.6204,11.3714285714286,17.5714285714286,0.0187142857142857,88.8571428571429,102.87,46.8042857142857,356,87,142,76,98,408,269,266
2019,43,54,"Kardemir",41.2061,32.6204,12.4857142857143,15.4857142857143,0,88.3142857142857,80.4642857142857,35.4757142857143,306,5,3,0,0,300,301,297
2019,44,54,"Kardemir",41.2061,32.6204,9.44285714285714,12.4428571428571,0.370285714285714,85.7285714285714,84.9371428571429,37.9785714285714,350,134,106,0,0,250,216,144
2019,45,54,"Kardemir",41.2061,32.6204,7.51428571428571,15.3714285714286,0,69.0857142857143,154.625714285714,45.4228571428571,417,384,301,0,0,328,33,27
2019,46,54,"Kardemir",41.2061,32.6204,6.98571428571429,14.2285714285714,0,72.2142857142857,161.537142857143,42.7785714285714,401,164,113,19,49,337,237,224
2019,47,54,"Kardemir",41.2061,32.6204,7.11428571428571,9.81428571428571,0,78.8571428571429,158.084285714286,36.2471428571429,391,102,105,18,12,339,289,234
2019,48,54,"Kardemir",41.2061,32.6204,9.85714285714286,11.6857142857143,8.24414285714286,85.4571428571429,104.214285714286,34.84,320,101,36,0,0,251,219,215
2019,49,54,"Kardemir",41.2061,32.6204,9.7,5.11428571428571,2.12685714285714,85.9428571428572,77.1085714285714,20.5,393,251,156,0,0,274,142,118
2019,50,54,"Kardemir",41.2061,32.6204,6.6,7.61428571428571,1.21257142857143,85.6571428571429,135.728571428571,30.6971428571429,218,101,64,0,0,119,117,55
2019,51,54,"Kardemir",41.2061,32.6204,7.81428571428571,8.64285714285714,0.00942857142857143,72.4714285714286,171.574285714286,36.5285714285714,361,358,485,0,0,488,3,3
2019,52,54,"Kardemir",41.2061,32.6204,14.3285714285714,8.52857142857143,15.2461428571429,86.3714285714286,53.93,36.2533333333333,279,87,76,38,27,281,192,205
2020,1,54,"Kardemir",41.2061,32.6204,8.04,4.72,6.34,88.08,79.73,37.982,160,63,38,0,0,126,97,88
2020,2,54,"Kardemir",41.2061,32.6204,8.6,4.57142857142857,5.23028571428571,92.4142857142857,99.9642857142857,45.0842857142857,240,206,136,0,0,173,34,37
2020,3,54,"Kardemir",41.2061,32.6204,10.7714285714286,4.71428571428571,0.785285714285714,88.4571428571429,113.508333333333,46.345,270,109,175,0,0,382,161,207
2020,4,54,"Kardemir",41.2061,32.6204,17.4571428571429,4.65714285714286,3.21214285714286,77.6428571428571,70.69,51.6375,358,14,5,51,15,295,344,290
2020,5,54,"Kardemir",41.2061,32.6204,17.7571428571429,8.68571428571429,3.88257142857143,75.4142857142857,85.5157142857143,13.1528571428571,331,64,57,0,0,272,267,215
2020,6,54,"Kardemir",41.2061,32.6204,20.9714285714286,7.92857142857143,10.2348571428571,75.5285714285714,43.5314285714286,4.84166666666667,343,28,18,87,65,267,315,249
2020,7,54,"Kardemir",41.2061,32.6204,16.6428571428571,7.1,5.29785714285714,72.9142857142857,67.5942857142857,8.1625,341,124,75,0,0,338,217,263
2020,8,54,"Kardemir",41.2061,32.6204,10.5714285714286,6.5,1.63928571428571,85.5285714285714,81.3957142857143,3.9,283,95,54,3,0,187,188,133
2020,9,54,"Kardemir",41.2061,32.6204,16.2857142857143,10.3142857142857,3.03914285714286,68.5857142857143,82.3685714285714,2.032,393,46,15,52,78,528,347,513
2020,10,54,"Kardemir",41.2061,32.6204,16.2428571428571,14.7142857142857,0,52.1428571428571,98.05,3.32166666666667,205,159,160,4,1,210,46,50
2020,11,54,"Kardemir",41.2061,32.6204,14.1571428571429,11.2857142857143,1.433,79,76.1733333333333,12.6983333333333,115,0,0,45,52,94,115,94
2020,12,54,"Kardemir",41.2061,32.6204,12.8571428571429,4.58571428571429,3.681,82.2285714285714,56.6371428571429,8.05857142857143,117,0,0,61,57,118,117,118
2020,13,54,"Kardemir",41.2061,32.6204,13.2,8.21428571428571,0.469571428571429,90.6857142857143,73.5957142857143,7.67666666666667,136,0,0,43,50,92,136,92
2020,14,54,"Kardemir",41.2061,32.6204,10.9428571428571,8.78571428571429,3.11542857142857,85.8571428571429,45.4114285714286,3.352,155,32,21,44,27,121,123,100
2020,15,54,"Kardemir",41.2061,32.6204,15.8142857142857,8.28571428571429,0.571428571428572,68.0714285714286,70.94,2.94714285714286,133,0,0,57,82,118,133,118
2020,16,54,"Kardemir",41.2061,32.6204,9.55714285714286,10.9285714285714,0.588428571428571,67.3285714285714,57.9442857142857,2.78285714285714,141,21,9,56,59,106,120,97
2020,17,54,"Kardemir",41.2061,32.6204,13.8285714285714,9.4,0.185714285714286,73.7571428571429,53.065,2.73714285714286,137,0,0,60,69,123,137,123
2020,18,54,"Kardemir",41.2061,32.6204,9.35714285714286,12.8571428571429,0.633428571428571,70.2142857142857,62.3216666666667,5.024,146,37,27,101,125,164,109,137
2020,19,54,"Kardemir",41.2061,32.6204,9.1,11.5571428571429,4.28685714285714,81.6142857142857,49.2414285714286,7.26428571428571,137,0,0,94,126,157,137,157
2020,20,54,"Kardemir",41.2061,32.6204,8.95714285714286,19.5714285714286,0.0428571428571429,63.9428571428571,85.324,8.89142857142857,164,19,35,43,24,164,145,129
2020,21,54,"Kardemir",41.2061,32.6204,11.1571428571429,16.3,2.24885714285714,76.6285714285714,65.59,7.41285714285714,146,0,0,110,81,96,146,96
2020,22,54,"Kardemir",41.2061,32.6204,10.9,12.6,6.31328571428571,84.8571428571429,36.0414285714286,6.86,118,18,14,63,55,100,100,86
2020,23,54,"Kardemir",41.2061,32.6204,8.48571428571429,17.3285714285714,2.527,75.7142857142857,47.1385714285714,4.70142857142857,112,17,14,62,34,70,95,56
2020,24,54,"Kardemir",41.2061,32.6204,8.87142857142857,20.7285714285714,1.13757142857143,78.9857142857143,68.6857142857143,6.21142857142857,140,0,0,87,115,150,140,150
2020,25,54,"Kardemir",41.2061,32.6204,11.6142857142857,21.5142857142857,3.37185714285714,81.0285714285714,52.0371428571429,8.68,137,8,4,54,45,108,129,104
2020,26,54,"Kardemir",41.2061,32.6204,14.2857142857143,22.1285714285714,1.41428571428571,79.0571428571428,47.4357142857143,7.67428571428571,173,0,0,37,14,133,173,133
2020,27,54,"Kardemir",41.2061,32.6204,13.0571428571429,22.9142857142857,0,75.4,49.8242857142857,NA,113,0,0,43,70,113,113,113
2020,28,54,"Kardemir",41.2061,32.6204,15.2,23.0285714285714,5.91114285714286,78.4285714285714,48.4428571428571,NA,164,0,0,69,83,122,164,122
2020,29,54,"Kardemir",41.2061,32.6204,12,22.0428571428571,0.409857142857143,79.5,46.8128571428571,NA,186,0,0,80,60,111,186,111
2020,30,54,"Kardemir",41.2061,32.6204,14.8285714285714,22.6571428571429,0.033,75.2428571428571,58.3057142857143,NA,190,0,0,84,69,142,190,142
2020,31,54,"Kardemir",41.2061,32.6204,15.6571428571429,23.5714285714286,0.0571428571428571,76.8857142857143,46.4957142857143,NA,150,0,0,83,85,127,150,127
2020,32,54,"Kardemir",41.2061,32.6204,15.9714285714286,22.9428571428571,0,67.5714285714286,57.9942857142857,NA,146,0,0,74,31,107,146,107
2020,33,54,"Kardemir",41.2061,32.6204,15.2571428571429,22.1142857142857,0,69.4428571428571,73.0742857142857,NA,183,0,0,62,19,83,183,83
2020,34,54,"Kardemir",41.2061,32.6204,14.1,21.6428571428571,0.540857142857143,70.6142857142857,70.5114285714286,NA,197,0,0,127,77,97,197,97
2020,35,54,"Kardemir",41.2061,32.6204,13.9714285714286,22.4571428571429,0,65.6714285714286,74.8414285714286,NA,164,18,11,74,62,157,146,146
2020,36,54,"Kardemir",41.2061,32.6204,13.7428571428571,22,7.85071428571429,80.0142857142857,96.4957142857143,NA,179,0,0,85,64,112,179,112
2020,37,54,"Kardemir",41.2061,32.6204,14.5,21.6285714285714,0.195857142857143,81.8714285714286,66.0428571428571,NA,193,0,0,67,40,91,193,91
2020,38,54,"Kardemir",41.2061,32.6204,15.4285714285714,21.0142857142857,0.0241428571428571,78.1714285714286,78.1214285714286,NA,235,0,0,62,51,157,235,157
2020,39,54,"Kardemir",41.2061,32.6204,11.8428571428571,19.4857142857143,0,73.0714285714286,75.6528571428571,NA,220,21,5,76,29,129,199,124
2020,40,54,"Kardemir",41.2061,32.6204,10.6571428571429,18.9571428571429,4.34771428571429,73.0285714285714,87.17,NA,187,78,72,34,16,154,109,82
2020,41,54,"Kardemir",41.2061,32.6204,13.7571428571429,21.8857142857143,6.558,67.5428571428571,118.895,108.326666666667,182,106,75,0,0,127,76,52
2020,42,54,"Kardemir",41.2061,32.6204,9.4,20.5285714285714,0.804142857142857,67.9857142857143,93.9328571428571,152.241428571429,177,152,105,0,0,111,25,6
2020,43,54,"Kardemir",41.2061,32.6204,9.78571428571428,17.4285714285714,6.991,82.1142857142857,86.5442857142857,143.285714285714,194,84,56,0,0,161,110,105
2020,44,54,"Kardemir",41.2061,32.6204,12.8,16.6,15.7835714285714,83.0428571428571,86.4642857142857,133.476,255,56,27,0,0,233,199,206
2020,45,54,"Kardemir",41.2061,32.6204,9.84285714285714,13.1428571428571,3.07142857142857,85.9428571428571,81.37,62.2783333333333,156,93,70,0,0,103,63,33
2020,46,54,"Kardemir",41.2061,32.6204,12.7714285714286,12.2857142857143,1.35557142857143,86.8714285714286,107.162857142857,59.7428571428571,208,129,88,0,0,109,79,21
2020,47,54,"Kardemir",41.2061,32.6204,12.0285714285714,9.58571428571429,0.476571428571429,81.9714285714286,83.1628571428571,59.7685714285714,173,114,45,0,0,83,59,38
2020,48,54,"Kardemir",41.2061,32.6204,6.95714285714286,5.38571428571429,0.379571428571429,78.6285714285714,93.4314285714286,69.03,199,180,253,0,0,262,19,9
2020,49,54,"Kardemir",41.2061,32.6204,8.34285714285714,10.5571428571429,0.681285714285714,79.3857142857143,134.76,81.49,207,86,24,0,0,116,121,92
2020,50,54,"Kardemir",41.2061,32.6204,15.2571428571429,10.2571428571429,0.833142857142857,75.7428571428571,120.907142857143,60.03,181,175,95,0,0,98,6,3
2020,51,54,"Kardemir",41.2061,32.6204,9.35714285714286,9.61428571428571,4.032,89.0285714285714,92.5757142857143,43.6671428571429,171,43,31,36,16,90,128,59
2020,52,54,"Kardemir",41.2061,32.6204,10.9571428571429,8.42857142857143,1.79085714285714,77.1857142857143,122.104285714286,50.8557142857143,203,140,83,13,7,113,63,30
2020,53,54,"Kardemir",41.2061,32.6204,18.475,13.1,0,55.225,180.185,66.63,122,101,100,0,0,111,21,11
2017,1,55,"Karaman",37.1817,33.215,19.2857142857143,-1.15714285714286,1.3,81.1571428571429,43.798,NA,563,347,547,66,99,847,216,300
2017,2,55,"Karaman",37.1817,33.215,15.6714285714286,-1.82857142857143,4.62857142857143,78.6142857142857,66.0771428571429,NA,757,439,834,155,169,1214,318,380
2017,3,55,"Karaman",37.1817,33.215,11.3857142857143,0.642857142857143,0.0285714285714286,83.4142857142857,96.9828571428571,NA,762,165,220,320,566,1449,597,1229
2017,4,55,"Karaman",37.1817,33.215,14.4,-3.88571428571429,0.928571428571428,79.2142857142857,77.7,NA,639,167,240,360,442,889,472,649
2017,5,55,"Karaman",37.1817,33.215,8.7,-6.04285714285714,0.185714285714286,66.2142857142857,165.471428571429,NA,588,189,276,157,306,1163,399,887
2017,6,55,"Karaman",37.1817,33.215,11.3428571428571,3.52857142857143,0,78.9857142857143,95.8214285714286,NA,736,295,579,244,570,1519,441,940
2017,7,55,"Karaman",37.1817,33.215,15.9142857142857,-1.57142857142857,0.1,62.5571428571429,84.3,NA,492,52,51,327,559,717,440,666
2017,8,55,"Karaman",37.1817,33.215,10.8857142857143,6.4,0,59.1857142857143,138.445714285714,NA,739,346,779,0,0,1747,393,968
2017,9,55,"Karaman",37.1817,33.215,14.1571428571429,7.64285714285714,1.61428571428571,63.9857142857143,125.251428571429,NA,574,282,406,198,260,866,292,460
2017,10,55,"Karaman",37.1817,33.215,19.4,8.42857142857143,5.24285714285714,63.6714285714286,93.11,NA,712,605,930,0,0,1043,107,113
2017,11,55,"Karaman",37.1817,33.215,13.4571428571429,3.87142857142857,2.27142857142857,70.2571428571429,73.2314285714286,NA,525,64,111,193,264,725,461,614
2017,12,55,"Karaman",37.1817,33.215,14.3285714285714,8.9,0.0714285714285714,50.7428571428571,108.016,NA,589,188,252,182,319,1077,401,825
2017,13,55,"Karaman",37.1817,33.215,14.8857142857143,9.88571428571429,0.628571428571429,59.2571428571429,73.9228571428571,NA,574,154,256,236,383,887,420,631
2017,14,55,"Karaman",37.1817,33.215,16.4285714285714,10.9857142857143,1.51428571428571,47.8571428571429,81.41,NA,639,230,534,82,153,1336,409,802
2017,15,55,"Karaman",37.1817,33.215,11.0428571428571,9.55714285714286,5.45714285714286,65.6,72.7828571428571,NA,587,111,265,287,678,1187,476,922
2017,16,55,"Karaman",37.1817,33.215,20.5285714285714,13.5285714285714,0.0428571428571429,49.3428571428571,NA,NA,717,492,614,0,0,920,225,306
2017,17,55,"Karaman",37.1817,33.215,10.7285714285714,13.9571428571429,0,33.4428571428571,NA,NA,731,173,421,188,327,1478,558,1057
2017,18,55,"Karaman",37.1817,33.215,16.9428571428571,15.8285714285714,0.5,52.4428571428571,40.5833333333333,NA,506,244,441,43,130,923,262,482
2017,19,55,"Karaman",37.1817,33.215,16.3142857142857,20.1714285714286,0,35.6,65.1014285714286,NA,471,186,427,94,201,966,285,539
2017,20,55,"Karaman",37.1817,33.215,16.0714285714286,15.1571428571429,2.14285714285714,55.4,48.24,NA,472,110,401,178,413,1205,362,804
2017,21,55,"Karaman",37.1817,33.215,14.0142857142857,14.9285714285714,2.11428571428571,59.1857142857143,NA,NA,448,125,283,80,162,849,323,566
2017,22,55,"Karaman",37.1817,33.215,14.8,18.0857142857143,0.285714285714286,51.4285714285714,NA,NA,522,93,203,195,390,1015,429,812
2017,23,55,"Karaman",37.1817,33.215,14.1,20.7,0,48.9,NA,NA,578,73,190,192,426,1388,505,1198
2017,24,55,"Karaman",37.1817,33.215,15.1,20.5428571428571,2,47.2428571428571,43.155,NA,552,181,367,154,496,1139,371,772
2017,25,55,"Karaman",37.1817,33.215,14.1142857142857,19.9571428571429,0.0714285714285714,48.1285714285714,38.226,NA,584,0,0,274,599,1041,584,1041
2017,26,55,"Karaman",37.1817,33.215,14.1,26.5,0,30.1,65.56,NA,564,0,0,398,755,971,564,971
2017,27,55,"Karaman",37.1817,33.215,16.7857142857143,24.6571428571429,0,33.8571428571429,69.9414285714286,NA,511,59,124,287,310,642,452,518
2017,28,55,"Karaman",37.1817,33.215,13.5142857142857,25.8285714285714,0,27.0857142857143,81.4814285714286,NA,481,72,116,220,467,864,409,748
2017,29,55,"Karaman",37.1817,33.215,12.7285714285714,25.8714285714286,0,35.8142857142857,64.67,NA,532,53,195,348,823,1272,479,1077
2017,30,55,"Karaman",37.1817,33.215,15.7571428571429,25.7,0,28.7571428571429,91.9757142857143,NA,531,102,158,192,382,928,429,770
2017,31,55,"Karaman",37.1817,33.215,12.4285714285714,23.6285714285714,1.85714285714286,51.0285714285714,60.6628571428571,NA,559,0,0,360,630,1047,559,1047
2017,32,55,"Karaman",37.1817,33.215,11.4857142857143,26.4142857142857,0,38.0142857142857,72.66,NA,567,96,228,223,435,1092,471,864
2017,33,55,"Karaman",37.1817,33.215,12.6714285714286,25.8428571428571,0,40.0142857142857,54.5014285714286,NA,596,126,335,170,324,1199,470,864
2017,34,55,"Karaman",37.1817,33.215,13.1428571428571,22.3,0,43.8142857142857,52.5742857142857,NA,601,24,283,454,850,1280,577,997
2017,35,55,"Karaman",37.1817,33.215,11.7142857142857,22.6714285714286,0,33.9857142857143,53.7285714285714,NA,493,0,0,387,847,1014,493,1014
2017,36,55,"Karaman",37.1817,33.215,12.2,21.8714285714286,0.0714285714285714,29.0428571428571,73.48,NA,507,162,502,101,246,1321,345,819
2017,37,55,"Karaman",37.1817,33.215,8.92857142857143,25,0,25.9714285714286,105.597142857143,NA,589,297,705,0,0,1138,292,433
2017,38,55,"Karaman",37.1817,33.215,10.5571428571429,23.2,0,31.2428571428571,78.2916666666667,NA,671,123,268,153,425,1312,548,1044
2017,39,55,"Karaman",37.1817,33.215,13.0428571428571,19.3857142857143,0,41.3714285714286,60.4142857142857,NA,782,110,139,302,707,1630,672,1491
2017,40,55,"Karaman",37.1817,33.215,14.8428571428571,14.5,0.0285714285714286,43.0428571428571,53.884,NA,543,160,385,236,576,1137,383,752
2017,41,55,"Karaman",37.1817,33.215,11.5428571428571,12.6428571428571,0.0142857142857143,45.4,67.99,NA,487,0,0,429,748,843,487,843
2017,42,55,"Karaman",37.1817,33.215,10.4571428571429,13.3714285714286,0,37.5,94.5471428571429,NA,530,194,235,144,218,815,336,580
2017,43,55,"Karaman",37.1817,33.215,15.7,13.4714285714286,2.74285714285714,61.2714285714286,44.2385714285714,NA,506,282,624,41,52,919,224,295
2017,44,55,"Karaman",37.1817,33.215,10.6142857142857,7.7,5.98571428571429,64.2857142857143,51.834,NA,561,190,428,171,299,1102,371,674
2017,45,55,"Karaman",37.1817,33.215,7.11428571428571,7.92857142857143,0.542857142857143,70.7857142857143,71.5228571428571,NA,577,235,458,200,225,829,342,371
2017,46,55,"Karaman",37.1817,33.215,9.38571428571429,9.98571428571429,0,63.1571428571429,143.16,NA,587,336,613,0,0,1085,251,472
2017,47,55,"Karaman",37.1817,33.215,12.2857142857143,4.75714285714286,0.685714285714286,69.3142857142857,68.78,NA,418,209,456,93,144,804,209,348
2017,48,55,"Karaman",37.1817,33.215,13.4714285714286,7.88571428571429,0.185714285714286,66.1,58.7485714285714,NA,386,253,434,0,0,619,133,185
2017,49,55,"Karaman",37.1817,33.215,13.7857142857143,3.52857142857143,1.3,65.1428571428571,60.4142857142857,NA,407,184,289,122,203,645,223,356
2017,50,55,"Karaman",37.1817,33.215,11.5285714285714,6.98571428571429,0.1,72.1285714285714,69.3371428571429,NA,346,206,287,0,0,442,140,155
2017,51,55,"Karaman",37.1817,33.215,21.7142857142857,8.67142857142857,2.15714285714286,69.5285714285714,39.5233333333333,NA,386,227,208,49,40,349,159,141
2017,52,55,"Karaman",37.1817,33.215,13.375,2.3875,1.4,73.45,47.00375,NA,528,357,392,64,35,507,171,115
2018,1,55,"Karaman",37.1817,33.215,11.7625,4.225,1.625,78.275,23.62125,NA,618,118,114,318,422,914,500,800
2018,2,55,"Karaman",37.1817,33.215,11.2857142857143,3.9,1.95714285714286,77.1428571428571,34.52,NA,624,290,361,81,563,1309,334,948
2018,3,55,"Karaman",37.1817,33.215,19.7,3.17142857142857,1.3,73.4857142857143,30.7533333333333,NA,639,356,482,194,117,655,283,173
2018,4,55,"Karaman",37.1817,33.215,17.1285714285714,-0.2,3.35714285714286,82.6,13.5814285714286,NA,604,81,166,410,423,764,523,598
2018,5,55,"Karaman",37.1817,33.215,10.1428571428571,1.71428571428571,0,72.8714285714286,52.5485714285714,NA,670,436,594,95,98,819,234,225
2018,6,55,"Karaman",37.1817,33.215,17.0428571428571,10.0571428571429,0.0285714285714286,54.9285714285714,72.5671428571429,NA,704,426,513,0,0,1022,278,509
2018,7,55,"Karaman",37.1817,33.215,16.2571428571429,6.9,0.671428571428571,63.9571428571429,26.2957142857143,NA,478,187,211,201,239,557,291,346
2018,8,55,"Karaman",37.1817,33.215,15.9714285714286,7.67142857142857,1.05714285714286,65.8714285714286,21.1785714285714,NA,711,350,309,0,0,1321,361,1012
2018,9,55,"Karaman",37.1817,33.215,21.6,8.25714285714286,0.6,62.5142857142857,23.2485714285714,NA,621,318,366,0,0,956,303,590
2018,10,55,"Karaman",37.1817,33.215,14.3142857142857,11.2142857142857,1.17142857142857,58.0571428571429,73.1442857142857,NA,556,271,651,73,65,1330,285,679
2018,11,55,"Karaman",37.1817,33.215,16.0142857142857,10.7428571428571,0.257142857142857,57.9428571428571,24.5271428571429,NA,551,279,625,18,70,1426,272,801
2018,12,55,"Karaman",37.1817,33.215,22.6428571428571,13.7285714285714,0,36.9857142857143,49.42,NA,425,210,530,0,0,1187,215,657
2018,13,55,"Karaman",37.1817,33.215,17.8,11.8857142857143,2.42857142857143,50.5857142857143,42.4733333333333,NA,356,167,304,31,44,428,189,124
2018,14,55,"Karaman",37.1817,33.215,17.3428571428571,12.5,0,38.1428571428571,29.7371428571429,NA,407,192,294,103,94,486,215,192
2018,15,55,"Karaman",37.1817,33.215,13.8714285714286,14.2714285714286,0.357142857142857,55.1857142857143,34.6942857142857,NA,374,49,50,176,132,450,325,400
2018,16,55,"Karaman",37.1817,33.215,15.9142857142857,14.0285714285714,0.885714285714286,40.1428571428571,41.9728571428571,NA,411,23,61,148,166,648,388,587
2018,17,55,"Karaman",37.1817,33.215,11.8571428571429,17.2428571428571,0.0285714285714286,34.1142857142857,26.2285714285714,NA,419,200,203,100,88,652,219,449
2018,18,55,"Karaman",37.1817,33.215,14.7285714285714,18.5428571428571,0.542857142857143,44.5857142857143,43.9614285714286,NA,303,264,282,0,0,474,39,192
2018,19,55,"Karaman",37.1817,33.215,15.7,14.3857142857143,3.74285714285714,62.9428571428571,18.0757142857143,NA,275,25,44,157,208,467,250,423
2018,20,55,"Karaman",37.1817,33.215,11.4571428571429,20.0571428571429,0.428571428571429,43.4857142857143,24.1885714285714,NA,204,7,11,100,111,306,197,295
2018,21,55,"Karaman",37.1817,33.215,13.8142857142857,20.1285714285714,1,47.5,33.4042857142857,NA,252,177,229,4,2,281,75,52
2018,22,55,"Karaman",37.1817,33.215,14.1714285714286,18.0714285714286,0.928571428571428,59.2142857142857,23.5271428571429,NA,249,51,113,130,194,427,198,314
2018,23,55,"Karaman",37.1817,33.215,11.8571428571429,22.9428571428571,0,37.6571428571429,29.7342857142857,NA,267,47,163,132,376,812,220,649
2018,24,55,"Karaman",37.1817,33.215,14.9,22.0857142857143,0.0142857142857143,44.9142857142857,26.9925,NA,267,62,72,76,131,448,205,376
2018,25,55,"Karaman",37.1817,33.215,11.9,20.9857142857143,1.68571428571429,54.9142857142857,15.9366666666667,NA,358,0,0,224,370,518,358,518
2018,26,55,"Karaman",37.1817,33.215,14.3285714285714,24.1428571428571,0,40.1142857142857,23.0642857142857,NA,355,79,112,80,147,587,276,475
2018,27,55,"Karaman",37.1817,33.215,14.9714285714286,25.2285714285714,0,30.2571428571429,34.5328571428571,NA,342,46,80,221,232,418,296,338
2018,28,55,"Karaman",37.1817,33.215,15.9428571428571,25.8285714285714,0,36.4714285714286,34.4514285714286,NA,286,36,66,99,192,585,250,519
2018,29,55,"Karaman",37.1817,33.215,13.1857142857143,24.3571428571429,0.428571428571429,36.3142857142857,33.8257142857143,NA,260,16,11,155,235,756,244,745
2018,30,55,"Karaman",37.1817,33.215,14.2,25.4571428571429,0,37.5,30.0057142857143,NA,265,59,99,107,258,822,206,723
2018,31,55,"Karaman",37.1817,33.215,14.0142857142857,26.2857142857143,0.0142857142857143,38.7,31.1314285714286,NA,267,0,0,143,336,499,267,499
2018,32,55,"Karaman",37.1817,33.215,14.7285714285714,23.4714285714286,0,36,32.3814285714286,NA,297,0,0,280,324,403,297,403
2018,33,55,"Karaman",37.1817,33.215,13.0285714285714,24.2571428571429,0,26.6285714285714,34.2528571428571,NA,216,2,9,152,204,332,214,323
2018,34,55,"Karaman",37.1817,33.215,12.8428571428571,25.2,0,26.2285714285714,28.7414285714286,NA,144,23,24,67,66,227,121,203
2018,35,55,"Karaman",37.1817,33.215,14.2285714285714,25.4714285714286,0,35.6714285714286,34.8928571428571,NA,201,53,21,94,166,314,148,293
2018,36,55,"Karaman",37.1817,33.215,13.8,22.8857142857143,1.28571428571429,34.5142857142857,33.0157142857143,NA,341,58,43,86,148,370,283,327
2018,37,55,"Karaman",37.1817,33.215,13.0285714285714,20,0,41.4,27.5285714285714,NA,241,20,30,178,292,419,221,389
2018,38,55,"Karaman",37.1817,33.215,13.5285714285714,20.2142857142857,0,33.9571428571429,33.8785714285714,NA,189,0,0,110,205,344,189,344
2018,39,55,"Karaman",37.1817,33.215,10.9142857142857,18.4,0.0571428571428571,42.0428571428571,44.2985714285714,NA,180,62,121,102,204,353,118,232
2018,40,55,"Karaman",37.1817,33.215,11.3428571428571,17.3857142857143,0,44.1285714285714,28.4928571428571,NA,191,49,85,100,182,341,142,256
2018,41,55,"Karaman",37.1817,33.215,9.62857142857143,15.2142857142857,3.85714285714286,59.8714285714286,31.3314285714286,NA,187,21,40,34,72,422,166,382
2018,42,55,"Karaman",37.1817,33.215,10.6714285714286,15.6285714285714,0.828571428571429,62.6428571428571,75.4485714285714,NA,168,123,329,0,0,381,45,52
2018,43,55,"Karaman",37.1817,33.215,14.1428571428571,10.7285714285714,2.74285714285714,66.8714285714286,26.2133333333333,NA,187,85,191,30,126,402,102,211
2018,44,55,"Karaman",37.1817,33.215,6.8,11.9,0.0142857142857143,53.2285714285714,46.8071428571429,NA,196,49,80,42,84,264,147,184
2018,45,55,"Karaman",37.1817,33.215,7.27142857142857,8.42857142857143,0,62.5714285714286,51.3814285714286,NA,231,0,0,73,144,473,231,473
2018,46,55,"Karaman",37.1817,33.215,8.65714285714286,4.54285714285714,0.757142857142857,69.9571428571429,44.6485714285714,NA,230,42,58,140,288,465,188,407
2018,47,55,"Karaman",37.1817,33.215,10.4714285714286,8.54285714285714,0.885714285714286,74.6142857142857,35.32,NA,270,46,31,60,123,499,224,468
2018,48,55,"Karaman",37.1817,33.215,14.8142857142857,9.01428571428571,5.54285714285714,78.5857142857143,25.2328571428571,NA,245,207,164,11,25,201,38,37
2018,49,55,"Karaman",37.1817,33.215,10.6714285714286,5.57142857142857,2.77142857142857,85.6428571428571,22.7542857142857,NA,257,160,237,81,174,420,97,183
2018,50,55,"Karaman",37.1817,33.215,15.6571428571429,6.35714285714286,1.2,74.5571428571429,21.0557142857143,NA,256,122,159,1,10,305,134,146
2018,51,55,"Karaman",37.1817,33.215,11.3428571428571,5.27142857142857,1.48571428571429,84.1428571428571,18.6071428571429,NA,250,70,89,42,54,248,180,159
2018,52,55,"Karaman",37.1817,33.215,15.5428571428571,-0.228571428571428,2.74285714285714,82.4714285714286,24.8828571428571,NA,244,58,59,140,179,273,186,214
2019,1,55,"Karaman",37.1817,33.215,13.65,3.05,3.075,83.1375,23.05,NA,343,242,582,21,67,784,101,202
2019,2,55,"Karaman",37.1817,33.215,13.6571428571429,-0.414285714285715,0.457142857142857,80.7142857142857,21.4542857142857,NA,255,117,87,62,34,208,138,121
2019,3,55,"Karaman",37.1817,33.215,14.5142857142857,-1.22857142857143,4.14285714285714,80.7571428571429,51.1071428571429,NA,192,51,31,58,64,198,141,167
2019,4,55,"Karaman",37.1817,33.215,18.5714285714286,5.6,2.28571428571429,71.4714285714286,35.5966666666667,NA,308,249,278,0,0,314,59,36
2019,5,55,"Karaman",37.1817,33.215,15.0571428571429,5.38571428571429,0.914285714285714,68.4571428571429,33.8471428571429,NA,253,151,91,1,1,143,102,52
2019,6,55,"Karaman",37.1817,33.215,10.8857142857143,5.54285714285714,4.48571428571429,76.6857142857143,24.0528571428571,NA,276,127,33,0,0,127,149,94
2019,7,55,"Karaman",37.1817,33.215,11.9714285714286,4.62857142857143,0.828571428571429,75.4857142857143,18.1275,NA,325,137,140,135,41,234,188,94
2019,8,55,"Karaman",37.1817,33.215,9.85714285714286,5.88571428571429,0,64.8428571428571,31.2028571428571,NA,305,112,77,66,55,219,193,142
2019,9,55,"Karaman",37.1817,33.215,11.1857142857143,3.24285714285714,2.05714285714286,77.8714285714286,20.6242857142857,NA,331,64,94,145,45,310,267,216
2019,10,55,"Karaman",37.1817,33.215,13.0428571428571,7.42857142857143,0.342857142857143,58.6285714285714,23.6685714285714,NA,359,138,88,113,94,252,221,164
2019,11,55,"Karaman",37.1817,33.215,15.5,8.25714285714286,1.7,66,22.92,NA,373,191,219,11,29,400,182,181
2019,12,55,"Karaman",37.1817,33.215,14.3714285714286,9.05714285714286,0,49.6,NA,NA,343,47,268,197,92,416,296,148
2019,13,55,"Karaman",37.1817,33.215,12.8285714285714,4.82857142857143,3.02857142857143,68.4428571428572,25.175,NA,256,6,8,144,108,194,250,186
2019,14,55,"Karaman",37.1817,33.215,9.6,9.14285714285714,0.314285714285714,67.3857142857143,27.3257142857143,NA,365,117,69,46,26,208,248,139
2019,15,55,"Karaman",37.1817,33.215,17.7285714285714,12.6,1.14285714285714,56.2285714285714,27.5871428571429,NA,359,286,137,35,6,183,73,46
2019,16,55,"Karaman",37.1817,33.215,15.7142857142857,6.12857142857143,6.6,78.9714285714286,19.2085714285714,NA,318,47,45,211,104,208,271,163
2019,17,55,"Karaman",37.1817,33.215,13.5142857142857,11.7857142857143,0.314285714285714,61.2571428571429,37.4171428571429,NA,412,32,47,106,84,313,380,266
2019,18,55,"Karaman",37.1817,33.215,15.0857142857143,15.9142857142857,0.714285714285714,49.6428571428571,31.2057142857143,NA,523,236,105,70,43,353,287,248
2019,19,55,"Karaman",37.1817,33.215,16.4285714285714,14.6,0.0571428571428571,49.1,20.4014285714286,NA,452,285,252,69,65,386,167,134
2019,20,55,"Karaman",37.1817,33.215,13.5,19.9714285714286,0,37.0142857142857,31.3742857142857,NA,454,290,271,49,43,389,164,118
2019,21,55,"Karaman",37.1817,33.215,14.8857142857143,21.8714285714286,0,34.9285714285714,48.7775,NA,457,43,26,147,156,413,414,387
2019,22,55,"Karaman",37.1817,33.215,11.7142857142857,23.7571428571429,0,33.8428571428571,NA,NA,453,44,90,35,23,323,409,233
2019,23,55,"Karaman",37.1817,33.215,12.2285714285714,22.5428571428571,0.0857142857142857,33.5142857142857,NA,NA,378,19,21,66,134,532,359,511
2019,24,55,"Karaman",37.1817,33.215,13.2571428571429,19.3714285714286,7.77142857142857,65.3,21.758,NA,378,0,0,257,115,244,378,244
2019,25,55,"Karaman",37.1817,33.215,11.9714285714286,20.7714285714286,3.08571428571429,66.5714285714286,20.9371428571429,NA,306,0,0,217,185,325,306,325
2019,26,55,"Karaman",37.1817,33.215,13.7571428571429,24.3571428571429,0.114285714285714,42,27.7871428571429,NA,377,0,0,366,319,342,377,342
2019,27,55,"Karaman",37.1817,33.215,14.1142857142857,22.6571428571429,0,37.1285714285714,35.9557142857143,NA,456,0,0,439,217,222,456,222
2019,28,55,"Karaman",37.1817,33.215,13.6428571428571,23.7,0.0142857142857143,40.8,37.5228571428571,NA,398,56,25,326,364,421,342,396
2019,29,55,"Karaman",37.1817,33.215,14.1142857142857,21.4142857142857,0.0285714285714286,53.5714285714286,28.3,NA,453,52,3,266,116,203,401,200
2019,30,55,"Karaman",37.1817,33.215,14.2857142857143,22.9571428571429,0,41.1714285714286,32.9814285714286,NA,456,0,0,395,306,335,456,335
2019,31,55,"Karaman",37.1817,33.215,12.3714285714286,26.7,0,39.4,42.8557142857143,NA,334,65,75,184,204,375,269,300
2019,32,55,"Karaman",37.1817,33.215,14.7428571428571,22.7285714285714,0,34.9285714285714,30.5742857142857,NA,346,0,0,340,387,395,346,395
2019,33,55,"Karaman",37.1817,33.215,13.4571428571429,24.4857142857143,0,44.6285714285714,34.9842857142857,NA,337,54,85,175,277,531,283,446
2019,34,55,"Karaman",37.1817,33.215,11.2428571428571,21.1571428571429,1.74285714285714,60.1714285714286,26.2842857142857,NA,299,0,0,286,336,345,299,345
2019,35,55,"Karaman",37.1817,33.215,11.8142857142857,23.7142857142857,0,38.8571428571429,35.89,NA,307,0,0,263,391,415,307,415
2019,36,55,"Karaman",37.1817,33.215,10.4285714285714,23.4714285714286,0,35.6,39.27,NA,171,0,0,73,23,67,171,67
2019,37,55,"Karaman",37.1817,33.215,13.2,19.8,0.0285714285714286,41.8142857142857,34.0457142857143,NA,218,0,0,116,29,55,218,55
2019,38,55,"Karaman",37.1817,33.215,9.65714285714286,17.5,0,46.9428571428571,29.5657142857143,NA,266,24,4,124,34,91,242,87
2019,39,55,"Karaman",37.1817,33.215,11.1428571428571,18.7,0.0285714285714286,47.3,31.6314285714286,NA,237,47,20,20,8,79,190,59
2019,40,55,"Karaman",37.1817,33.215,11.4,19.5,0,40.6142857142857,36.2557142857143,NA,241,100,40,37,10,111,141,71
2019,41,55,"Karaman",37.1817,33.215,11.7,17.2857142857143,0,50.3857142857143,37.2942857142857,NA,416,70,20,231,346,448,346,428
2019,42,55,"Karaman",37.1817,33.215,9.28571428571429,17.1285714285714,0.0571428571428571,54.4857142857143,43.4385714285714,NA,356,118,126,37,18,408,238,282
2019,43,55,"Karaman",37.1817,33.215,7.42857142857143,13.5428571428571,0.0571428571428571,62.4857142857143,38.0257142857143,NA,306,0,0,171,157,300,306,300
2019,44,55,"Karaman",37.1817,33.215,8.18571428571429,10.9571428571429,1.57142857142857,69.0428571428571,34.5671428571429,NA,350,204,142,41,32,250,146,108
2019,45,55,"Karaman",37.1817,33.215,8.25714285714286,12.8,0,52.1571428571429,45.3271428571429,NA,417,272,183,26,45,328,145,145
2019,46,55,"Karaman",37.1817,33.215,7.31428571428571,11.7714285714286,4.42857142857143,66.4857142857143,54.4871428571429,NA,401,116,86,43,33,337,285,251
2019,47,55,"Karaman",37.1817,33.215,5,4.82857142857143,0,80.4857142857143,82.2542857142857,NA,391,33,46,223,201,339,358,293
2019,48,55,"Karaman",37.1817,33.215,13.8142857142857,10.1571428571429,1.48571428571429,66.3,32.8814285714286,NA,320,266,217,0,0,251,54,34
2019,49,55,"Karaman",37.1817,33.215,9.28571428571429,2.17142857142857,0.0285714285714286,82.7285714285714,36.1642857142857,NA,393,0,0,203,117,274,393,274
2019,50,55,"Karaman",37.1817,33.215,11.8571428571429,5.95714285714286,1.85714285714286,78.9,30.0214285714286,NA,218,135,64,12,4,119,83,55
2019,51,55,"Karaman",37.1817,33.215,6.54285714285714,4.75714285714286,0,81.0571428571429,69.1671428571428,NA,361,51,101,144,102,488,310,387
2019,52,55,"Karaman",37.1817,33.215,12.9285714285714,4.17142857142857,7.82857142857143,88.3,21.82,NA,279,94,150,81,57,281,185,131
2020,1,55,"Karaman",37.1817,33.215,7.16,0.44,1.88,94.82,31.722,NA,160,1,0,111,93,126,159,126
2020,2,55,"Karaman",37.1817,33.215,14.2571428571429,1.41428571428571,6.65714285714286,86.1857142857143,18.3942857142857,NA,240,105,65,56,31,173,135,108
2020,3,55,"Karaman",37.1817,33.215,6.54285714285714,0.542857142857143,0.714285714285714,88.5142857142857,38.1928571428571,NA,270,88,103,160,262,382,182,279
2020,4,55,"Karaman",37.1817,33.215,13.4857142857143,-1.37142857142857,0.0285714285714286,72.4714285714286,25.3985714285714,NA,358,52,83,298,212,295,306,212
2020,5,55,"Karaman",37.1817,33.215,12.7285714285714,3.57142857142857,1.2,73.7285714285714,39.4316666666667,NA,331,221,207,33,24,272,110,65
2020,6,55,"Karaman",37.1817,33.215,18.7428571428571,3.38571428571429,2.68571428571429,74.4571428571429,14.9128571428571,NA,343,219,170,75,44,267,124,97
2020,7,55,"Karaman",37.1817,33.215,13,1.27142857142857,0.0571428571428571,75.5571428571428,20.7214285714286,NA,341,79,59,141,182,338,262,279
2020,8,55,"Karaman",37.1817,33.215,11.1428571428571,3.85714285714286,0.685714285714286,79.2857142857143,33.4071428571429,NA,283,61,65,167,84,187,222,122
2020,9,55,"Karaman",37.1817,33.215,17.4571428571429,7.02857142857143,0.514285714285714,67.4,23.0757142857143,NA,393,218,327,115,135,528,175,201
2020,10,55,"Karaman",37.1817,33.215,13.8142857142857,10.3857142857143,0.457142857142857,53.9142857142857,33.2228571428571,NA,205,154,160,0,0,210,51,50
2020,11,55,"Karaman",37.1817,33.215,13.2857142857143,10.9714285714286,1.6,60.4714285714286,33.2742857142857,NA,115,59,27,0,0,94,56,67
2020,12,55,"Karaman",37.1817,33.215,16.1142857142857,1.42857142857143,0.914285714285714,81.2571428571429,17.71,NA,117,0,0,94,79,118,117,118
2020,13,55,"Karaman",37.1817,33.215,13,9.71428571428572,1.02857142857143,64.9571428571429,25.4971428571429,NA,136,75,22,31,16,92,61,70
2020,14,55,"Karaman",37.1817,33.215,15.1428571428571,9.57142857142857,0.6,67.3714285714286,27.0885714285714,NA,155,46,34,28,23,121,109,87
2020,15,55,"Karaman",37.1817,33.215,11.4571428571429,9.08571428571429,2.88571428571429,67.7,28.7985714285714,NA,133,26,13,62,37,118,107,105
2020,16,55,"Karaman",37.1817,33.215,11.9714285714286,13.0285714285714,0.0571428571428571,47.5857142857143,24.2614285714286,NA,141,40,32,51,43,106,101,74
2020,17,55,"Karaman",37.1817,33.215,13.8142857142857,12.2857142857143,0.428571428571429,53.3285714285714,22.7342857142857,NA,137,30,37,33,36,123,107,86
2020,18,55,"Karaman",37.1817,33.215,14.3285714285714,14.2428571428571,0.714285714285714,57,16.5442857142857,NA,146,68,45,22,16,164,78,119
2020,19,55,"Karaman",37.1817,33.215,15.0571428571429,12.9428571428571,0.8,63.1142857142857,14.5671428571429,NA,137,28,33,44,32,157,109,124
2020,20,55,"Karaman",37.1817,33.215,13.5571428571429,21.7285714285714,0,38.0857142857143,46.2914285714286,NA,164,0,0,70,70,164,164,164
2020,21,55,"Karaman",37.1817,33.215,17.9714285714286,20.3285714285714,0.571428571428572,37.5285714285714,52.1857142857143,NA,146,21,12,40,40,96,125,84
2020,22,55,"Karaman",37.1817,33.215,16.6428571428571,16.3714285714286,0,38.6,15.6842857142857,NA,118,69,59,16,18,100,49,41
2020,23,55,"Karaman",37.1817,33.215,16.4428571428571,19.0428571428571,0.428571428571429,40.7571428571429,20.7785714285714,NA,112,57,33,15,10,70,55,37
2020,24,55,"Karaman",37.1817,33.215,16.6,21.7142857142857,0.8,39.0142857142857,39.6828571428571,NA,140,79,81,22,18,150,61,69
2020,25,55,"Karaman",37.1817,33.215,15.6142857142857,21.1428571428571,2.65714285714286,51.1,31.9042857142857,NA,137,22,30,39,38,108,115,78
2020,26,55,"Karaman",37.1817,33.215,15.1571428571429,22.2428571428571,0,43.9714285714286,31.3228571428571,NA,173,46,40,105,82,133,127,93
2020,27,55,"Karaman",37.1817,33.215,13.5142857142857,24.5285714285714,0,33,36.0128571428571,NA,113,0,0,100,101,113,113,113
2020,28,55,"Karaman",37.1817,33.215,12.6285714285714,24.7142857142857,0,38.6,35.6228571428571,NA,164,20,36,124,81,122,144,86
2020,29,55,"Karaman",37.1817,33.215,12.0714285714286,25.9142857142857,0,39.0285714285714,41.6871428571429,NA,186,29,12,103,42,111,157,99
2020,30,55,"Karaman",37.1817,33.215,13.5428571428571,25.2,0,36.2285714285714,38.5571428571429,NA,190,0,0,139,103,142,190,142
2020,31,55,"Karaman",37.1817,33.215,11.2428571428571,25.8571428571429,0,36.3,41.56,NA,150,0,0,108,93,127,150,127
2020,32,55,"Karaman",37.1817,33.215,13.5,24.9142857142857,0,31.8857142857143,35.13,NA,146,29,11,75,79,107,117,96
2020,33,55,"Karaman",37.1817,33.215,16.3428571428571,23.2285714285714,0,33.8428571428571,38.695,NA,183,0,0,164,72,83,183,83
2020,34,55,"Karaman",37.1817,33.215,13.8571428571429,22.5428571428571,0,35.3571428571429,34.9842857142857,NA,197,0,0,129,67,97,197,97
2020,35,55,"Karaman",37.1817,33.215,8.81428571428571,23.9142857142857,0,28.3428571428571,43.58,NA,164,0,0,132,128,157,164,157
2020,36,55,"Karaman",37.1817,33.215,12.0142857142857,25.4857142857143,0,34.5,51.0371428571429,NA,179,45,12,74,59,112,134,100
2020,37,55,"Karaman",37.1817,33.215,11.2,22.1714285714286,0.0285714285714286,47.3714285714286,47.0542857142857,NA,193,0,0,136,62,91,193,91
2020,38,55,"Karaman",37.1817,33.215,8.05714285714286,22.7428571428571,0,44.2285714285714,47.0928571428571,NA,235,0,0,105,50,157,235,157
2020,39,55,"Karaman",37.1817,33.215,10.4285714285714,21.6428571428571,0,47.3285714285714,39.8171428571429,NA,220,34,16,103,80,129,186,113
2020,40,55,"Karaman",37.1817,33.215,11.9714285714286,19.6,0,42.5428571428571,46.9814285714286,NA,187,50,30,86,64,154,137,124
2020,41,55,"Karaman",37.1817,33.215,14.3285714285714,20.6,0,33.8285714285714,64.1,NA,182,87,56,49,48,127,95,71
2020,42,55,"Karaman",37.1817,33.215,10.5142857142857,18.2142857142857,0,44.5857142857143,51.64,NA,177,118,58,0,0,111,59,53
2020,43,55,"Karaman",37.1817,33.215,6.8,15.7714285714286,0.571428571428572,59.6142857142857,66.0385714285714,NA,194,7,0,115,73,161,187,161
2020,44,55,"Karaman",37.1817,33.215,14.8,15.8428571428571,0,48.0571428571429,42.9285714285714,NA,255,172,160,19,10,233,83,73
2020,45,55,"Karaman",37.1817,33.215,14.4142857142857,9.17142857142857,1.57142857142857,70.7571428571429,33.8014285714286,NA,156,22,17,97,65,103,134,86
2020,46,55,"Karaman",37.1817,33.215,5,7.12857142857143,0,74.7,72.1714285714286,NA,208,0,0,62,16,109,208,109
2020,47,55,"Karaman",37.1817,33.215,5.51428571428571,5.64285714285714,0.371428571428571,74.8,56.23,NA,173,0,0,57,19,83,173,83
2020,48,55,"Karaman",37.1817,33.215,6.74285714285714,2.24285714285714,0,69.6571428571429,60.04,NA,199,0,0,99,146,262,199,262
2020,49,55,"Karaman",37.1817,33.215,6.4,6.44285714285714,0,68.5285714285714,45.6428571428571,NA,207,121,76,24,4,116,86,40
2020,50,55,"Karaman",37.1817,33.215,13.5,8.31428571428571,0.228571428571429,74.0428571428571,36.8442857142857,NA,181,144,79,6,3,98,37,19
2020,51,55,"Karaman",37.1817,33.215,10,5.98571428571429,4.14285714285714,80.9428571428571,26.3714285714286,NA,171,21,12,88,44,90,150,78
2020,52,55,"Karaman",37.1817,33.215,9.12857142857143,2.67142857142857,0,71.9571428571429,48.5928571428571,NA,203,125,48,24,32,113,78,65
2020,53,55,"Karaman",37.1817,33.215,11.1,6.325,0,58.775,34.285,NA,122,90,51,0,0,111,32,60
2017,1,57,"Kastamonu",41.3897,33.7836,21.9571428571429,-1.31428571428571,0.313571428571429,78.2142857142857,83.2614285714286,NA,563,19,32,128,207,847,544,815
2017,2,57,"Kastamonu",41.3897,33.7836,13.4285714285714,-3.22857142857143,0.491,75.8142857142857,63.6042857142857,NA,757,205,469,0,0,1214,552,745
2017,3,57,"Kastamonu",41.3897,33.7836,7.88571428571429,0.342857142857143,0.508857142857143,85.7,76.0985714285714,NA,762,99,111,112,482,1449,663,1338
2017,4,57,"Kastamonu",41.3897,33.7836,18.5714285714286,-2.22857142857143,1.301,77.8,53.6657142857143,NA,639,111,173,390,524,889,528,716
2017,5,57,"Kastamonu",41.3897,33.7836,10.9,-3.12857142857143,0.349142857142857,68.9714285714286,80.48,NA,588,1,1,319,540,1163,587,1162
2017,6,57,"Kastamonu",41.3897,33.7836,10.0428571428571,2.35714285714286,0.0122857142857143,74.5857142857143,59.1285714285714,NA,736,226,351,86,213,1519,510,1168
2017,7,57,"Kastamonu",41.3897,33.7836,12.7714285714286,-2.2,0.0954285714285714,65.3714285714286,41.8957142857143,NA,492,0,0,326,521,717,492,717
2017,8,57,"Kastamonu",41.3897,33.7836,17.4285714285714,5.2,0.216285714285714,65.7857142857143,63.4328571428571,NA,739,0,0,51,84,1747,739,1747
2017,9,57,"Kastamonu",41.3897,33.7836,9.34285714285714,6.54285714285714,0.866428571428571,70.9,84.7585714285714,NA,574,78,82,169,278,866,496,784
2017,10,57,"Kastamonu",41.3897,33.7836,13.1571428571429,8.52857142857143,0.0142857142857143,58.0142857142857,86.8014285714286,NA,712,394,499,0,0,1043,318,544
2017,11,57,"Kastamonu",41.3897,33.7836,11.6857142857143,3.3,2.03271428571429,80.7142857142857,39.78,NA,525,0,0,240,312,725,525,725
2017,12,57,"Kastamonu",41.3897,33.7836,13.8714285714286,6.17142857142857,0.149428571428571,62.6714285714286,47.6657142857143,NA,589,0,0,322,635,1077,589,1077
2017,13,57,"Kastamonu",41.3897,33.7836,16.3,6.82857142857143,0.145142857142857,63.8285714285714,48.89,NA,574,0,0,168,266,887,574,887
2017,14,57,"Kastamonu",41.3897,33.7836,23.8142857142857,8.35714285714286,1.78485714285714,64.3571428571429,50.5628571428571,NA,639,61,111,171,272,1336,578,1225
2017,15,57,"Kastamonu",41.3897,33.7836,11.2571428571429,8.54285714285714,0.187714285714286,62.2,47.4528571428571,NA,587,0,0,158,395,1187,587,1187
2017,16,57,"Kastamonu",41.3897,33.7836,18.4714285714286,7.85714285714286,3.33657142857143,69.8,38.2842857142857,NA,717,0,0,373,338,920,717,920
2017,17,57,"Kastamonu",41.3897,33.7836,13.4285714285714,10.7571428571429,0.0514285714285714,56.7714285714286,53.0885714285714,NA,731,208,465,0,0,1478,523,1013
2017,18,57,"Kastamonu",41.3897,33.7836,14.3571428571429,14.6142857142857,3.06571428571429,59.6142857142857,56.4485714285714,NA,506,131,189,35,35,923,375,734
2017,19,57,"Kastamonu",41.3897,33.7836,21.5,15.0857142857143,1.99814285714286,66.3428571428571,54.1114285714286,NA,471,0,0,88,126,966,471,966
2017,20,57,"Kastamonu",41.3897,33.7836,15,11.0571428571429,0.493285714285714,73.2,29.7157142857143,NA,472,0,0,117,254,1205,472,1205
2017,21,57,"Kastamonu",41.3897,33.7836,13.1285714285714,12.0714285714286,0.575571428571429,72.1142857142857,33.0057142857143,NA,448,0,0,262,521,849,448,849
2017,22,57,"Kastamonu",41.3897,33.7836,12.5428571428571,15.5571428571429,2.08471428571429,76.5,36.77,NA,522,74,197,160,253,1015,448,818
2017,23,57,"Kastamonu",41.3897,33.7836,11.8142857142857,17.5,6.40628571428571,78.2285714285714,31.6828571428571,NA,578,65,135,180,475,1388,513,1253
2017,24,57,"Kastamonu",41.3897,33.7836,10.7285714285714,16.3857142857143,0.542,67.5571428571428,30.7357142857143,NA,552,0,0,257,533,1139,552,1139
2017,25,57,"Kastamonu",41.3897,33.7836,18.2714285714286,16.8428571428571,9.83442857142857,77.4714285714286,30.6714285714286,NA,584,0,0,184,335,1041,584,1041
2017,26,57,"Kastamonu",41.3897,33.7836,11.0857142857143,22.9571428571429,1.054,61.4142857142857,41.3014285714286,NA,564,33,33,195,296,971,531,938
2017,27,57,"Kastamonu",41.3897,33.7836,13.3,19.9857142857143,0.0431428571428571,62.0857142857143,33.43,NA,511,0,0,130,141,642,511,642
2017,28,57,"Kastamonu",41.3897,33.7836,12.5,21.2,0.579,55,38.7833333333333,NA,481,0,0,46,39,864,481,864
2017,29,57,"Kastamonu",41.3897,33.7836,13.9285714285714,21,3.83457142857143,66.9428571428572,31.5416666666667,NA,532,0,0,21,31,1272,532,1272
2017,30,57,"Kastamonu",41.3897,33.7836,18.2428571428571,22.4142857142857,0.00228571428571429,55.5857142857143,51.6142857142857,NA,531,108,176,55,28,928,423,752
2017,31,57,"Kastamonu",41.3897,33.7836,18.7714285714286,22.3857142857143,0.285714285714286,63.3714285714286,41.7242857142857,NA,559,0,0,309,575,1047,559,1047
2017,32,57,"Kastamonu",41.3897,33.7836,14.2285714285714,24.1,2.41728571428571,60.3285714285714,53.6542857142857,NA,567,0,0,256,551,1092,567,1092
2017,33,57,"Kastamonu",41.3897,33.7836,16.8714285714286,21.7714285714286,5.03157142857143,71.2714285714286,42.8871428571429,NA,596,0,0,366,802,1199,596,1199
2017,34,57,"Kastamonu",41.3897,33.7836,17.8714285714286,18.4857142857143,1.92157142857143,71.7428571428571,28.13,NA,601,0,0,83,182,1280,601,1280
2017,35,57,"Kastamonu",41.3897,33.7836,8.87142857142857,17.0714285714286,1.097,66.4428571428572,31.6785714285714,NA,493,0,0,27,263,1014,493,1014
2017,36,57,"Kastamonu",41.3897,33.7836,10,18.2285714285714,1.268,63.6142857142857,41.3071428571429,NA,507,0,0,169,436,1321,507,1321
2017,37,57,"Kastamonu",41.3897,33.7836,13.8428571428571,22.0285714285714,0,47.4857142857143,73.14,NA,589,0,0,35,48,1138,589,1138
2017,38,57,"Kastamonu",41.3897,33.7836,13.4714285714286,20.3,0.156,52.7714285714286,71.72,NA,671,0,0,323,734,1312,671,1312
2017,39,57,"Kastamonu",41.3897,33.7836,11.8714285714286,14.0714285714286,1.32471428571429,78.9142857142857,42.6633333333333,NA,782,99,190,68,98,1630,683,1440
2017,40,57,"Kastamonu",41.3897,33.7836,12.2428571428571,11.0142857142857,2.02414285714286,65.8714285714286,48.9285714285714,NA,543,75,141,192,501,1137,468,996
2017,41,57,"Kastamonu",41.3897,33.7836,11.3714285714286,9.32857142857143,1.74728571428571,74.9428571428572,32.9342857142857,NA,487,0,0,330,508,843,487,843
2017,42,57,"Kastamonu",41.3897,33.7836,9.8,10.5714285714286,0.0827142857142857,65.7,48.6042857142857,NA,530,0,0,429,641,815,530,815
2017,43,57,"Kastamonu",41.3897,33.7836,12.3142857142857,10.8,1.465,75.1857142857143,51.7971428571429,NA,506,117,98,0,0,919,389,821
2017,44,57,"Kastamonu",41.3897,33.7836,13.3428571428571,3.14285714285714,0.322857142857143,76.0714285714286,40.3357142857143,NA,561,0,0,157,354,1102,561,1102
2017,45,57,"Kastamonu",41.3897,33.7836,9.41428571428571,6.37142857142857,0.227428571428571,84.1,49.1185714285714,NA,577,80,68,83,116,829,497,761
2017,46,57,"Kastamonu",41.3897,33.7836,8.05714285714286,6.92857142857143,0.014,80.0714285714286,71.8216666666667,NA,587,186,387,0,0,1085,401,698
2017,47,57,"Kastamonu",41.3897,33.7836,13.2285714285714,2.74285714285714,0.958,86.0714285714286,33.1016666666667,NA,418,0,0,219,359,804,418,804
2017,48,57,"Kastamonu",41.3897,33.7836,8.22857142857143,4.02857142857143,0.195571428571429,86.7142857142857,70.5,NA,386,271,419,0,0,619,115,200
2017,49,57,"Kastamonu",41.3897,33.7836,13.5285714285714,2.68571428571429,0.879142857142857,81.7142857142857,43.2257142857143,NA,407,61,160,92,119,645,346,485
2017,50,57,"Kastamonu",41.3897,33.7836,8.5,2.81428571428571,0.127857142857143,87.7857142857143,79.0742857142857,NA,346,158,210,112,119,442,188,232
2017,51,57,"Kastamonu",41.3897,33.7836,8.97142857142857,1.85714285714286,4.42442857142857,92.8571428571429,30.89,NA,386,96,63,85,103,349,290,286
2017,52,57,"Kastamonu",41.3897,33.7836,9.975,0.8875,0.452125,85.6,61.6316666666667,NA,528,193,260,3,0,507,335,247
2018,1,57,"Kastamonu",41.3897,33.7836,7.9625,2.3,0.575875,86.0875,NA,NA,618,129,238,318,468,914,489,676
2018,2,57,"Kastamonu",41.3897,33.7836,10,2.9,0.954,89.3571428571429,52.635,NA,624,26,49,226,836,1309,598,1260
2018,3,57,"Kastamonu",41.3897,33.7836,13.5857142857143,0.728571428571429,0.662857142857143,80.0142857142857,51.0071428571429,NA,639,134,269,101,55,655,505,386
2018,4,57,"Kastamonu",41.3897,33.7836,11.8,-0.485714285714286,0.434571428571428,75.2142857142857,33.81,NA,604,34,82,159,160,764,570,682
2018,5,57,"Kastamonu",41.3897,33.7836,18.1428571428571,4.41428571428571,0.0757142857142857,72.1428571428571,68.8371428571429,NA,670,2,0,106,97,819,668,819
2018,6,57,"Kastamonu",41.3897,33.7836,9.25714285714286,4.72857142857143,1.68457142857143,86.8428571428571,49.6785714285714,NA,704,295,535,91,154,1022,409,487
2018,7,57,"Kastamonu",41.3897,33.7836,10.2571428571429,3.71428571428571,0.400857142857143,78.9,35.1071428571429,NA,478,80,133,163,176,557,398,424
2018,8,57,"Kastamonu",41.3897,33.7836,8.74285714285714,4.37142857142857,2.47057142857143,84.1142857142857,40.6828571428571,NA,711,1,0,100,95,1321,710,1321
2018,9,57,"Kastamonu",41.3897,33.7836,16.7285714285714,2.38571428571429,3.61757142857143,80.6857142857143,39.0457142857143,NA,621,97,158,34,61,956,524,798
2018,10,57,"Kastamonu",41.3897,33.7836,11.6428571428571,6.92857142857143,4.18071428571429,79.8714285714286,38.47,NA,556,66,173,340,800,1330,490,1157
2018,11,57,"Kastamonu",41.3897,33.7836,12.9571428571429,8.87142857142857,1.40471428571429,72.8285714285714,46.9871428571429,NA,551,0,0,160,380,1426,551,1426
2018,12,57,"Kastamonu",41.3897,33.7836,14.8142857142857,9.38571428571429,1.885,72.7142857142857,79.4385714285714,NA,425,0,0,103,243,1187,425,1187
2018,13,57,"Kastamonu",41.3897,33.7836,11.2857142857143,8.61428571428571,2.62685714285714,74.3142857142857,69.4771428571429,NA,356,9,24,87,79,428,347,404
2018,14,57,"Kastamonu",41.3897,33.7836,11.7,10.3285714285714,0.843714285714286,60.3285714285714,49.4042857142857,NA,407,0,0,9,0,486,407,486
2018,15,57,"Kastamonu",41.3897,33.7836,13.6857142857143,14.1714285714286,0.000428571428571429,53.8142857142857,48.394,NA,374,0,0,66,59,450,374,450
2018,16,57,"Kastamonu",41.3897,33.7836,10.8857142857143,10.9142857142857,0.567142857142857,55.5428571428571,43.2885714285714,NA,411,12,10,184,352,648,399,638
2018,17,57,"Kastamonu",41.3897,33.7836,12.6714285714286,15.2714285714286,0.704142857142857,49.9857142857143,42.6328571428571,NA,419,0,0,171,287,652,419,652
2018,18,57,"Kastamonu",41.3897,33.7836,10.6428571428571,16.7857142857143,2.95528571428571,57.4857142857143,30.3428571428571,NA,303,97,214,0,0,474,206,260
2018,19,57,"Kastamonu",41.3897,33.7836,12.6,12.6285714285714,6.34314285714286,81.8428571428571,27.9671428571429,NA,275,5,21,71,65,467,270,446
2018,20,57,"Kastamonu",41.3897,33.7836,10.7285714285714,16.8714285714286,2.82628571428571,66.7571428571429,43.5014285714286,NA,204,35,40,60,92,306,169,266
2018,21,57,"Kastamonu",41.3897,33.7836,10.4142857142857,17.1,5.93928571428571,76.0142857142857,23.4733333333333,18.22,252,18,17,0,0,281,234,264
2018,22,57,"Kastamonu",41.3897,33.7836,11.2142857142857,16.3714285714286,0.505571428571429,71.0857142857143,NA,21.06,249,0,0,56,112,427,249,427
2018,23,57,"Kastamonu",41.3897,33.7836,12.2285714285714,18.1714285714286,2.78542857142857,64.1857142857143,NA,25.98,267,0,0,74,163,812,267,812
2018,24,57,"Kastamonu",41.3897,33.7836,11.0285714285714,19.1,3.92514285714286,62.4428571428571,NA,22.1642857142857,267,29,161,37,29,448,238,287
2018,25,57,"Kastamonu",41.3897,33.7836,12.1285714285714,18.2571428571429,1.41271428571429,73.0428571428571,NA,23.9333333333333,358,0,0,192,255,518,358,518
2018,26,57,"Kastamonu",41.3897,33.7836,18.2857142857143,21,1.11214285714286,71.8285714285714,NA,NA,355,0,0,140,184,587,355,587
2018,27,57,"Kastamonu",41.3897,33.7836,14.9857142857143,20.2,0.0425714285714286,60.5857142857143,NA,NA,342,0,0,67,80,418,342,418
2018,28,57,"Kastamonu",41.3897,33.7836,16.2285714285714,21.5857142857143,5.09542857142857,68.3,NA,4.795,286,0,0,144,304,585,286,585
2018,29,57,"Kastamonu",41.3897,33.7836,13.6857142857143,19.2285714285714,2.63385714285714,68.9142857142857,NA,4.616,260,0,0,202,659,756,260,756
2018,30,57,"Kastamonu",41.3897,33.7836,11.7142857142857,20.1428571428571,3.71457142857143,75.1285714285714,71.83,10.2314285714286,265,34,139,40,264,822,231,683
2018,31,57,"Kastamonu",41.3897,33.7836,12.2,21.1857142857143,0.396285714285714,71.3857142857143,52.8825,18.0471428571429,267,0,0,76,185,499,267,499
2018,32,57,"Kastamonu",41.3897,33.7836,14.9285714285714,19.0428571428571,0.484714285714286,66.7857142857143,52.1728571428571,21.2871428571429,297,0,0,14,3,403,297,403
2018,33,57,"Kastamonu",41.3897,33.7836,14.1,20.5428571428571,0.0285714285714286,55.5285714285714,58.2185714285714,25.7,216,0,0,3,1,332,216,332
2018,34,57,"Kastamonu",41.3897,33.7836,11.1285714285714,21.8428571428571,0,51.6142857142857,48.8385714285714,17.885,144,0,0,1,0,227,144,227
2018,35,57,"Kastamonu",41.3897,33.7836,12.4857142857143,22.2428571428571,0.337571428571429,58.4142857142857,53.0642857142857,23.292,201,0,0,34,60,314,201,314
2018,36,57,"Kastamonu",41.3897,33.7836,15.3428571428571,18.6571428571429,2.26642857142857,72.2,53.9542857142857,22.63,341,0,0,54,74,370,341,370
2018,37,57,"Kastamonu",41.3897,33.7836,15.2,15.8142857142857,8.45085714285714,76.9571428571429,52.5614285714286,23.5128571428571,241,0,0,110,120,419,241,419
2018,38,57,"Kastamonu",41.3897,33.7836,11.4857142857143,15.2428571428571,0.214285714285714,70.8571428571429,53.085,23.9516666666667,189,0,0,37,59,344,189,344
2018,39,57,"Kastamonu",41.3897,33.7836,10.2857142857143,12.7,0.167571428571429,78.0285714285714,55.6928571428571,25.7828571428571,180,0,0,50,104,353,180,353
2018,40,57,"Kastamonu",41.3897,33.7836,9.47142857142857,13,1.88885714285714,80.5285714285714,50.0714285714286,22.2642857142857,191,0,0,62,117,341,191,341
2018,41,57,"Kastamonu",41.3897,33.7836,9.27142857142857,13.4714285714286,0.0432857142857143,80.1714285714286,69.63,28.0642857142857,187,24,17,0,0,422,163,405
2018,42,57,"Kastamonu",41.3897,33.7836,6.11428571428571,14.1428571428571,3.16171428571429,83.8857142857143,NA,25.8,168,0,0,49,76,381,168,381
2018,43,57,"Kastamonu",41.3897,33.7836,12.4857142857143,8.91428571428571,0.981285714285714,83.7285714285714,55.1266666666667,24.17,187,8,24,43,57,402,179,378
2018,44,57,"Kastamonu",41.3897,33.7836,8.47142857142857,9.21428571428571,0,74.3857142857143,83.9357142857143,37.4342857142857,196,17,49,55,44,264,179,215
2018,45,57,"Kastamonu",41.3897,33.7836,5.24285714285714,7.04285714285714,0,80.7714285714286,72.91,33.36,231,1,0,0,0,473,230,473
2018,46,57,"Kastamonu",41.3897,33.7836,9.55714285714286,4.27142857142857,0.0877142857142857,82.4428571428571,NA,27.1733333333333,230,67,95,28,26,465,163,370
2018,47,57,"Kastamonu",41.3897,33.7836,7.87142857142857,6.25714285714286,1.24,92.3,NA,28.8228571428571,270,65,71,0,0,499,205,428
2018,48,57,"Kastamonu",41.3897,33.7836,10.3714285714286,4.52857142857143,2.62442857142857,92.9,NA,31.8483333333333,245,39,49,25,29,201,206,152
2018,49,57,"Kastamonu",41.3897,33.7836,6.35714285714286,2.12857142857143,0.761428571428571,92.2142857142857,NA,NA,257,140,169,4,8,420,117,251
2018,50,57,"Kastamonu",41.3897,33.7836,9.81428571428571,1.8,0.873,90.0571428571428,NA,NA,256,191,207,0,0,305,65,98
2018,51,57,"Kastamonu",41.3897,33.7836,7.58571428571429,2.98571428571429,1.22685714285714,97.3571428571429,47.5,28.29,250,26,53,49,11,248,224,195
2018,52,57,"Kastamonu",41.3897,33.7836,10.5,-1.15714285714286,1.754,89.4285714285714,NA,28.865,244,0,0,3,2,273,244,273
2019,1,57,"Kastamonu",41.3897,33.7836,10.6,0.2125,1.417375,91.9625,63.045,32.98,343,120,243,0,0,784,223,541
2019,2,57,"Kastamonu",41.3897,33.7836,9.8,-1.57142857142857,20.4615714285714,85.6285714285714,59.91,37.2566666666667,255,1,0,29,3,208,254,208
2019,3,57,"Kastamonu",41.3897,33.7836,7.27142857142857,-1.87142857142857,11.5928571428571,95.7571428571429,38.778,32.174,192,5,6,24,24,198,187,192
2019,4,57,"Kastamonu",41.3897,33.7836,9.25714285714286,2.2,0.0902857142857143,87.2,78.1425,42.34,308,157,183,51,44,314,151,131
2019,5,57,"Kastamonu",41.3897,33.7836,17.2142857142857,4.58571428571429,0.087,73.3857142857143,80.8133333333333,35.6371428571429,253,54,25,0,0,143,199,118
2019,6,57,"Kastamonu",41.3897,33.7836,7.14285714285714,3.67142857142857,2.047,89.9,NA,30.9342857142857,276,0,0,37,23,127,276,127
2019,7,57,"Kastamonu",41.3897,33.7836,9.94285714285714,2.8,0.361428571428571,82.5,NA,27.1542857142857,325,7,82,136,54,234,318,152
2019,8,57,"Kastamonu",41.3897,33.7836,12.9285714285714,3.51428571428571,0.364428571428571,74.6571428571429,47.135,27.6033333333333,305,0,0,140,70,219,305,219
2019,9,57,"Kastamonu",41.3897,33.7836,14.5714285714286,1.97142857142857,0.172142857142857,75.9857142857143,41.4933333333333,26.385,331,0,0,102,22,310,331,310
2019,10,57,"Kastamonu",41.3897,33.7836,12.4285714285714,5.21428571428571,0.81,66.9857142857143,79.225,34.2885714285714,359,0,0,44,37,252,359,252
2019,11,57,"Kastamonu",41.3897,33.7836,13.8571428571429,5.55714285714286,2.68485714285714,79.3,44.3142857142857,31.306,373,0,0,72,97,400,373,400
2019,12,57,"Kastamonu",41.3897,33.7836,10.8571428571429,4.85714285714286,0.0464285714285714,62.0142857142857,46.0285714285714,27.6885714285714,343,0,0,300,395,416,343,416
2019,13,57,"Kastamonu",41.3897,33.7836,15.9142857142857,2.84285714285714,0.0455714285714286,59.7571428571429,37.1785714285714,25.0042857142857,256,0,0,49,91,194,256,194
2019,14,57,"Kastamonu",41.3897,33.7836,12.5,8.05714285714286,0.286571428571429,63.2428571428571,53.1014285714286,31.5114285714286,365,104,38,107,71,208,261,170
2019,15,57,"Kastamonu",41.3897,33.7836,14.8714285714286,10.6714285714286,2.71857142857143,74.2,44.4371428571429,28.4414285714286,359,8,26,0,0,183,351,157
2019,16,57,"Kastamonu",41.3897,33.7836,12.4571428571429,4.68571428571429,0.761714285714286,80.4714285714286,20.08,21.585,318,0,0,273,197,208,318,208
2019,17,57,"Kastamonu",41.3897,33.7836,11.2571428571429,9.82857142857143,0.3,65.0857142857143,55.634,29.905,412,0,0,188,184,313,412,313
2019,18,57,"Kastamonu",41.3897,33.7836,15.7857142857143,12.9428571428571,1.95742857142857,70.1,52.552,NA,523,105,42,146,77,353,418,311
2019,19,57,"Kastamonu",41.3897,33.7836,10.2428571428571,10.9,11.7722857142857,83.1285714285714,NA,NA,452,64,73,127,112,386,388,313
2019,20,57,"Kastamonu",41.3897,33.7836,15.7571428571429,16.1714285714286,5.547,71.9285714285714,NA,NA,454,7,9,35,13,389,447,380
2019,21,57,"Kastamonu",41.3897,33.7836,14.3714285714286,16.1142857142857,2.75442857142857,78.4428571428572,43.69,23.336,457,0,0,231,214,413,457,413
2019,22,57,"Kastamonu",41.3897,33.7836,11.1428571428571,20.1285714285714,1.00742857142857,64.5428571428571,72.2871428571429,26.8971428571429,453,145,92,57,16,323,308,231
2019,23,57,"Kastamonu",41.3897,33.7836,11.4571428571429,19.6142857142857,3.66414285714286,77.1571428571429,39.5114285714286,17.6142857142857,378,0,0,96,138,532,378,532
2019,24,57,"Kastamonu",41.3897,33.7836,13.0857142857143,18.9571428571429,1.68571428571429,85.6857142857143,40.6371428571429,21.5414285714286,378,0,0,143,58,244,378,244
2019,25,57,"Kastamonu",41.3897,33.7836,12.7285714285714,19.4571428571429,1.31628571428571,81.7428571428571,46.64,19.9566666666667,306,0,0,177,157,325,306,325
2019,26,57,"Kastamonu",41.3897,33.7836,12.9428571428571,20.1,0.298857142857143,66.0714285714286,41.13,19.6614285714286,377,0,0,203,210,342,377,342
2019,27,57,"Kastamonu",41.3897,33.7836,13.3428571428571,19.9857142857143,0.281142857142857,56.2428571428571,43.8328571428571,20.1528571428571,456,0,0,0,0,222,456,222
2019,28,57,"Kastamonu",41.3897,33.7836,12.7428571428571,18.0285714285714,4.31642857142857,70.6285714285714,31.2314285714286,19.8928571428571,398,0,0,342,396,421,398,421
2019,29,57,"Kastamonu",41.3897,33.7836,12.3285714285714,17.6714285714286,2.22857142857143,72.8,34.8257142857143,20.3228571428571,453,0,0,131,61,203,453,203
2019,30,57,"Kastamonu",41.3897,33.7836,13.5,19.7142857142857,0.071,58.5857142857143,51.1675,21.0514285714286,456,2,4,72,35,335,454,331
2019,31,57,"Kastamonu",41.3897,33.7836,13.5,21.9142857142857,0.433142857142857,61.4285714285714,41.572,21.1285714285714,334,0,0,87,107,375,334,375
2019,32,57,"Kastamonu",41.3897,33.7836,11.5,19.1142857142857,0.0292857142857143,58.5857142857143,47.1457142857143,22.8471428571429,346,0,0,47,34,395,346,395
2019,33,57,"Kastamonu",41.3897,33.7836,12.8714285714286,20.9142857142857,5.19114285714286,60.2,46.3371428571429,24.0342857142857,337,0,0,141,291,531,337,531
2019,34,57,"Kastamonu",41.3897,33.7836,12.6714285714286,19.2714285714286,3.05957142857143,76.1571428571429,49.1542857142857,27.7414285714286,299,0,0,169,162,345,299,345
2019,35,57,"Kastamonu",41.3897,33.7836,12.6,19.2714285714286,0.000428571428571429,64.9285714285714,54.82,25.1914285714286,307,0,0,0,0,415,307,415
2019,36,57,"Kastamonu",41.3897,33.7836,10.7285714285714,17.6285714285714,0.0515714285714286,65.6571428571429,55.5985714285714,26.4942857142857,171,0,0,11,3,67,171,67
2019,37,57,"Kastamonu",41.3897,33.7836,11.1714285714286,16.6428571428571,0.0394285714285714,68.3857142857143,54.7014285714286,26.95,218,0,0,0,0,55,218,55
2019,38,57,"Kastamonu",41.3897,33.7836,12.6142857142857,14.3571428571429,0.213142857142857,66.4571428571429,50.4471428571429,20.4625,266,0,0,109,35,91,266,91
2019,39,57,"Kastamonu",41.3897,33.7836,10.2714285714286,14.2571428571429,0.254714285714286,73.5285714285714,57.23,31.8485714285714,237,0,0,84,32,79,237,79
2019,40,57,"Kastamonu",41.3897,33.7836,11.6571428571429,15.9571428571429,1.98828571428571,62.8,65.05,37.4228571428571,241,32,28,84,21,111,209,83
2019,41,57,"Kastamonu",41.3897,33.7836,8.01428571428571,12.0142857142857,0.921857142857143,82.5857142857143,52.335,29.5671428571429,416,0,0,96,101,448,416,448
2019,42,57,"Kastamonu",41.3897,33.7836,7.38571428571429,14.7,0.0568571428571429,69.6857142857143,65.8157142857143,38.9114285714286,356,51,68,61,139,408,305,340
2019,43,57,"Kastamonu",41.3897,33.7836,8.38571428571429,11.5857142857143,0.00314285714285714,77.9857142857143,52.2542857142857,33.3057142857143,306,0,0,23,48,300,306,300
2019,44,57,"Kastamonu",41.3897,33.7836,7.54285714285714,7.84285714285714,1.596,83.8142857142857,44.8816666666667,29.5557142857143,350,56,56,75,24,250,294,194
2019,45,57,"Kastamonu",41.3897,33.7836,7.1,9.88571428571429,0,71.3714285714286,84.0742857142857,45.4428571428571,417,232,212,0,0,328,185,116
2019,46,57,"Kastamonu",41.3897,33.7836,6.08571428571429,8.8,0,67.7714285714286,95.8742857142857,51.5285714285714,401,117,152,0,0,337,284,185
2019,47,57,"Kastamonu",41.3897,33.7836,6.14285714285714,4.85714285714286,0.000428571428571429,67.2857142857143,82.3928571428571,46.9142857142857,391,0,0,252,235,339,391,339
2019,48,57,"Kastamonu",41.3897,33.7836,12.2857142857143,6.54285714285714,0.576142857142857,85.0285714285714,75.9228571428571,39.8857142857143,320,100,36,29,24,251,220,215
2019,49,57,"Kastamonu",41.3897,33.7836,7.71428571428571,0.0714285714285714,0.300142857142857,80.9,54.6433333333333,36.9971428571429,393,0,0,106,54,274,393,274
2019,50,57,"Kastamonu",41.3897,33.7836,7.48571428571429,2.88571428571429,0.0695714285714286,91.0428571428571,101.626666666667,35.9285714285714,218,154,75,0,0,119,64,44
2019,51,57,"Kastamonu",41.3897,33.7836,6.82857142857143,3.34285714285714,0.00414285714285714,74.3,129.07,49.5685714285714,361,10,25,209,242,488,351,463
2019,52,57,"Kastamonu",41.3897,33.7836,13.4428571428571,3.87142857142857,1.85557142857143,88.5857142857143,51.8014285714286,30.5671428571429,279,81,103,19,4,281,198,178
2020,1,57,"Kastamonu",41.3897,33.7836,9.44,0.78,0.2522,87,47.08,27.17,160,28,6,8,10,126,132,120
2020,2,57,"Kastamonu",41.3897,33.7836,9.84285714285714,0.614285714285714,0.620285714285714,90.9857142857143,67.84,32.84,240,2,2,97,59,173,238,171
2020,3,57,"Kastamonu",41.3897,33.7836,7.9,-0.342857142857143,0.0701428571428571,83.5142857142857,77.5257142857143,35.0371428571429,270,36,79,17,28,382,234,303
2020,4,57,"Kastamonu",41.3897,33.7836,13.8571428571429,-0.942857142857143,0.237428571428571,79.4571428571429,53.73,27.3285714285714,358,0,0,177,105,295,358,295
2020,5,57,"Kastamonu",41.3897,33.7836,11.4714285714286,2.54285714285714,0.460142857142857,86.2285714285714,80.0557142857143,38.72,331,36,65,181,128,272,295,207
2020,6,57,"Kastamonu",41.3897,33.7836,20.7,2.35714285714286,3.701,80.1571428571429,46.2214285714286,23.0228571428571,343,0,0,82,47,267,343,267
2020,7,57,"Kastamonu",41.3897,33.7836,11.8714285714286,-1.02857142857143,1.51842857142857,82,61.9028571428571,35.3485714285714,341,31,9,88,138,338,310,329
2020,8,57,"Kastamonu",41.3897,33.7836,7.61428571428571,2.31428571428571,1.17957142857143,77.8857142857143,110.34,37.8742857142857,283,0,0,81,36,187,283,187
2020,9,57,"Kastamonu",41.3897,33.7836,13.2,4.8,2.36057142857143,71.4714285714286,92.1214285714286,30.7028571428571,393,46,15,62,120,528,347,513
2020,10,57,"Kastamonu",41.3897,33.7836,12.0285714285714,8.65714285714286,0,61.9,78.17,40.624,205,85,100,0,0,210,120,110
2020,11,57,"Kastamonu",41.3897,33.7836,13.4428571428571,9.85714285714286,0.245714285714286,69.1714285714286,73.14,29.0028571428571,115,12,7,18,13,94,103,87
2020,12,57,"Kastamonu",41.3897,33.7836,10.3142857142857,1.28571428571429,1.30171428571429,82.1285714285714,35.0028571428571,20.6971428571429,117,0,0,74,57,118,117,118
2020,13,57,"Kastamonu",41.3897,33.7836,10.7428571428571,7.64285714285714,0.983,77.1714285714286,58.15,20.5571428571429,136,0,0,8,3,92,136,92
2020,14,57,"Kastamonu",41.3897,33.7836,13.0857142857143,6.98571428571429,2.46857142857143,79.4142857142857,50.3266666666667,20.5914285714286,155,28,10,24,20,121,127,111
2020,15,57,"Kastamonu",41.3897,33.7836,19.9571428571429,5.87142857142857,0.613428571428571,60.8714285714286,47.3957142857143,16.9885714285714,133,0,0,17,18,118,133,118
2020,16,57,"Kastamonu",41.3897,33.7836,14.4714285714286,9.9,1.72357142857143,57.9571428571429,52.2914285714286,21.0385714285714,141,0,0,98,59,106,141,106
2020,17,57,"Kastamonu",41.3897,33.7836,13.2857142857143,7.9,1.19171428571429,64.9285714285714,34.0871428571429,17.5866666666667,137,7,1,59,59,123,130,122
2020,18,57,"Kastamonu",41.3897,33.7836,14.2428571428571,11.2142857142857,0.550571428571429,66.8428571428571,52.14,22.148,146,40,36,60,30,164,106,128
2020,19,57,"Kastamonu",41.3897,33.7836,14.1,9.88571428571429,2.11385714285714,74.6,36.7214285714286,18.7442857142857,137,0,0,43,49,157,137,157
2020,20,57,"Kastamonu",41.3897,33.7836,18.5142857142857,18.9571428571429,0,50.2142857142857,80.8657142857143,24.6271428571429,164,0,0,93,93,164,164,164
2020,21,57,"Kastamonu",41.3897,33.7836,18.1142857142857,16.1428571428571,3.206,58.7857142857143,61.07,16.41,146,0,0,85,73,96,146,96
2020,22,57,"Kastamonu",41.3897,33.7836,15.6285714285714,11.5142857142857,2.20057142857143,76.6857142857143,22.8342857142857,13.2071428571429,118,0,0,35,48,100,118,100
2020,23,57,"Kastamonu",41.3897,33.7836,11.5142857142857,15.5142857142857,4.48714285714286,79.2714285714286,29.2671428571429,21.115,112,10,7,42,17,70,102,63
2020,24,57,"Kastamonu",41.3897,33.7836,9.81428571428571,18.2428571428571,8.17771428571428,77.6142857142857,28.8116666666667,23.9416666666667,140,44,57,0,0,150,96,93
2020,25,57,"Kastamonu",41.3897,33.7836,10.3,17.0714285714286,8.859,85.0714285714286,18.92,20.9742857142857,137,19,6,1,0,108,118,102
2020,26,57,"Kastamonu",41.3897,33.7836,10.1285714285714,19.0714285714286,2.16857142857143,75,21.632,19.5371428571429,173,12,0,40,43,133,161,133
2020,27,57,"Kastamonu",41.3897,33.7836,10.8428571428571,21.9714285714286,0,58.1428571428571,20.6985714285714,21.3971428571429,113,0,0,6,2,113,113,113
2020,28,57,"Kastamonu",41.3897,33.7836,13.1714285714286,21.2714285714286,0.00828571428571429,63.4142857142857,18.16,19.93,164,0,0,37,20,122,164,122
2020,29,57,"Kastamonu",41.3897,33.7836,12.8428571428571,20.5571428571429,1.13114285714286,69.8428571428571,15.6142857142857,18.2185714285714,186,0,0,26,16,111,186,111
2020,30,57,"Kastamonu",41.3897,33.7836,13.1285714285714,21.3571428571429,0.000857142857142857,59.9571428571429,24.7614285714286,20.0842857142857,190,0,0,59,63,142,190,142
2020,31,57,"Kastamonu",41.3897,33.7836,12.4857142857143,21.8285714285714,0.156428571428571,62.4428571428571,21.5157142857143,17.6828571428571,150,0,0,86,79,127,150,127
2020,32,57,"Kastamonu",41.3897,33.7836,11.9857142857143,21.6428571428571,0,53.9142857142857,21.3857142857143,22.4514285714286,146,0,0,0,0,107,146,107
2020,33,57,"Kastamonu",41.3897,33.7836,13.5142857142857,19.5,0,61.7285714285714,24.4585714285714,21.0428571428571,183,0,0,21,8,83,183,83
2020,34,57,"Kastamonu",41.3897,33.7836,12.3714285714286,19.5428571428571,0.162,62.9428571428571,22.5628571428571,22.7742857142857,197,0,0,43,16,97,197,97
2020,35,57,"Kastamonu",41.3897,33.7836,12.2285714285714,21.4285714285714,0,47.5285714285714,25.72,18.2728571428571,164,1,0,10,15,157,163,157
2020,36,57,"Kastamonu",41.3897,33.7836,15.6285714285714,22.3,0.0225714285714286,48.0428571428571,30.3942857142857,19.5242857142857,179,0,0,44,32,112,179,112
2020,37,57,"Kastamonu",41.3897,33.7836,12.1,20.0285714285714,0.0421428571428571,68.6,26.0714285714286,21.12,193,0,0,1,0,91,193,91
2020,38,57,"Kastamonu",41.3897,33.7836,15.0428571428571,19.0285714285714,0.000428571428571429,64.5285714285714,27.96,22.4357142857143,235,0,0,29,23,157,235,157
2020,39,57,"Kastamonu",41.3897,33.7836,10.8428571428571,17.7,0.240571428571429,68.5571428571428,31.5042857142857,30.2185714285714,220,2,2,0,0,129,218,127
2020,40,57,"Kastamonu",41.3897,33.7836,11.5142857142857,16.3714285714286,1.19314285714286,72.5285714285714,26.8042857142857,27.02,187,55,44,44,47,154,132,110
2020,41,57,"Kastamonu",41.3897,33.7836,10.0142857142857,17.4428571428571,0.609,66.1857142857143,27.7071428571429,36.5783333333333,182,49,33,63,53,127,133,94
2020,42,57,"Kastamonu",41.3897,33.7836,11.0142857142857,15.1857142857143,0.707285714285714,75.5714285714286,30.435,37.8025,177,40,24,18,17,111,137,87
2020,43,57,"Kastamonu",41.3897,33.7836,9.55714285714286,11.9857142857143,0.356428571428571,82.7857142857143,27.0185714285714,36.3128571428571,194,39,80,14,9,161,155,81
2020,44,57,"Kastamonu",41.3897,33.7836,13.4714285714286,12.0142857142857,0.181142857142857,75.2857142857143,30.68,37.1785714285714,255,72,82,0,0,233,183,151
2020,45,57,"Kastamonu",41.3897,33.7836,8.7,8.04285714285714,0.157714285714286,82.2571428571429,21.4666666666667,30.46,156,0,0,58,36,103,156,103
2020,46,57,"Kastamonu",41.3897,33.7836,7.37142857142857,5.64285714285714,0.0324285714285714,84.3,30.08,38.8285714285714,208,0,0,19,8,109,208,109
2020,47,57,"Kastamonu",41.3897,33.7836,10.0857142857143,3.9,0.0544285714285714,82.6714285714286,23.2285714285714,31.6657142857143,173,36,35,42,10,83,137,48
2020,48,57,"Kastamonu",41.3897,33.7836,7.98571428571429,1.8,0.00828571428571429,72.5857142857143,30.57,41.4666666666667,199,43,18,81,144,262,156,244
2020,49,57,"Kastamonu",41.3897,33.7836,7.77142857142857,2.65714285714286,0.00185714285714286,74.3428571428571,41.4357142857143,49.1057142857143,207,51,26,40,12,116,156,90
2020,50,57,"Kastamonu",41.3897,33.7836,8.44285714285714,3.07142857142857,0.392285714285714,92.8714285714286,38.6,36.4628571428571,181,138,82,0,0,98,43,16
2020,51,57,"Kastamonu",41.3897,33.7836,7.62857142857143,4.97142857142857,0.508857142857143,94.3285714285714,29.3914285714286,32.4416666666667,171,20,11,65,41,90,151,79
2020,52,57,"Kastamonu",41.3897,33.7836,8,2,0.109571428571429,85.8285714285714,24.1442857142857,28.2416666666667,203,60,45,64,35,113,143,68
2020,53,57,"Kastamonu",41.3897,33.7836,7.45,3.85,0.175,84.05,42.615,44.36,122,122,111,0,0,111,0,0
2017,1,58,"Hurriyet",38.7312,35.4787,27.3,0.942857142857143,1.009,72.9857142857143,110.895714285714,80.4828571428571,563,169,249,255,367,847,394,598
2017,2,58,"Hurriyet",38.7312,35.4787,24.6,-3.24285714285714,1.05814285714286,76.3142857142857,110.77,119.448571428571,757,213,383,129,138,1214,544,831
2017,3,58,"Hurriyet",38.7312,35.4787,16.0857142857143,-1.68571428571429,0.0284285714285714,76.3428571428571,132.161428571429,151.955714285714,762,0,0,134,496,1449,762,1449
2017,4,58,"Hurriyet",38.7312,35.4787,16.3285714285714,-5.07142857142857,1.74857142857143,80.5285714285714,79.0614285714286,125.498571428571,639,0,0,103,57,889,639,889
2017,5,58,"Hurriyet",38.7312,35.4787,16.4,-10.0142857142857,0.484428571428571,77.0714285714286,132.53,155.452857142857,588,0,0,164,348,1163,588,1163
2017,6,58,"Hurriyet",38.7312,35.4787,16.1142857142857,1.85714285714286,0.170857142857143,79.6857142857143,122.348571428571,183.281428571429,736,154,195,1,0,1519,582,1324
2017,7,58,"Hurriyet",38.7312,35.4787,20.3571428571429,-3.5,0.0291428571428571,64.9285714285714,52.86,83.9185714285714,492,18,29,91,207,717,474,688
2017,8,58,"Hurriyet",38.7312,35.4787,19.2714285714286,3.62857142857143,0,62.0285714285714,116.914285714286,163.802857142857,739,61,216,410,968,1747,678,1531
2017,9,58,"Hurriyet",38.7312,35.4787,20.8285714285714,7.24285714285714,0.571571428571429,59.3714285714286,93.1714285714286,129.455714285714,574,205,314,7,1,866,369,552
2017,10,58,"Hurriyet",38.7312,35.4787,23.8285714285714,8.42857142857143,0.232285714285714,55.0142857142857,93.1333333333333,152.835714285714,712,447,700,0,0,1043,265,343
2017,11,58,"Hurriyet",38.7312,35.4787,21.6857142857143,2.85714285714286,4.11214285714286,79.1571428571429,49.2485714285714,133.185714285714,525,60,61,299,375,725,465,664
2017,12,58,"Hurriyet",38.7312,35.4787,20.8571428571429,7.25714285714286,0.0587142857142857,51.8285714285714,45.6514285714286,109.238571428571,589,2,0,343,653,1077,587,1077
2017,13,58,"Hurriyet",38.7312,35.4787,21.7,8.38571428571429,0.749,60.7,47.7057142857143,117.607142857143,574,37,28,148,225,887,537,859
2017,14,58,"Hurriyet",38.7312,35.4787,24.6,9.35714285714286,2.14028571428571,50.3714285714286,47.6714285714286,111.371428571429,639,168,367,303,553,1336,471,969
2017,15,58,"Hurriyet",38.7312,35.4787,16.6428571428571,8.47142857142857,0.380142857142857,67.6142857142857,47.2071428571429,124.557142857143,587,36,22,255,526,1187,551,1165
2017,16,58,"Hurriyet",38.7312,35.4787,28.5,13.6285714285714,0.000142857142857143,46.1142857142857,67.4214285714286,74.6871428571429,717,137,160,228,306,920,580,760
2017,17,58,"Hurriyet",38.7312,35.4787,14.2571428571429,12.0857142857143,0.0284285714285714,35.7,46.3357142857143,100.597142857143,731,55,138,219,406,1478,676,1340
2017,18,58,"Hurriyet",38.7312,35.4787,22.7857142857143,13.2142857142857,1.94042857142857,62.2571428571429,52.3457142857143,98.2771428571428,506,153,191,111,185,923,353,732
2017,19,58,"Hurriyet",38.7312,35.4787,27.5,17.4857142857143,0.114,45.3,74.2757142857143,86.6128571428571,471,0,0,296,541,966,471,966
2017,20,58,"Hurriyet",38.7312,35.4787,21.1857142857143,13.6857142857143,2.20628571428571,59.6714285714286,31.9271428571429,90.42,472,4,8,222,551,1205,468,1197
2017,21,58,"Hurriyet",38.7312,35.4787,19.5714285714286,13.2857142857143,2.904,63.5142857142857,37.27,100.381428571429,448,71,176,212,396,849,377,673
2017,22,58,"Hurriyet",38.7312,35.4787,18.7571428571429,16.4857142857143,2.16942857142857,60.4285714285714,36.6157142857143,95.3228571428571,522,0,0,207,259,1015,522,1015
2017,23,58,"Hurriyet",38.7312,35.4787,23.5142857142857,19.4285714285714,0.0285714285714286,52.5714285714286,44.5528571428571,102.22,578,0,0,278,770,1388,578,1388
2017,24,58,"Hurriyet",38.7312,35.4787,23.5571428571429,18.7857142857143,1.03314285714286,55.4714285714286,32.3485714285714,79.8471428571429,552,0,0,261,491,1139,552,1139
2017,25,58,"Hurriyet",38.7312,35.4787,18.6714285714286,18.4428571428571,2.23671428571429,58.6857142857143,33.2,65.45,584,0,0,246,467,1041,584,1041
2017,26,58,"Hurriyet",38.7312,35.4787,20.5714285714286,24.0857142857143,0,39.8714285714286,38.7671428571429,72.5285714285714,564,6,5,89,257,971,558,966
2017,27,58,"Hurriyet",38.7312,35.4787,23.2285714285714,22.8285714285714,0,44.3857142857143,43.1871428571429,69.4785714285714,511,0,0,273,446,642,511,642
2017,28,58,"Hurriyet",38.7312,35.4787,20.0714285714286,23.4142857142857,0,32.8,41.3528571428571,75.7671428571429,481,0,0,65,145,864,481,864
2017,29,58,"Hurriyet",38.7312,35.4787,20.6428571428571,25.2571428571429,0,38.7714285714286,50.3214285714286,71.3614285714286,532,0,0,223,561,1272,532,1272
2017,30,58,"Hurriyet",38.7312,35.4787,23,24.0142857142857,0,37.7571428571429,63.1542857142857,75.1942857142857,531,28,64,245,433,928,503,864
2017,31,58,"Hurriyet",38.7312,35.4787,23.0857142857143,23.6428571428571,0.289285714285714,50.4714285714286,51.4042857142857,59.4728571428571,559,47,75,374,653,1047,512,972
2017,32,58,"Hurriyet",38.7312,35.4787,22.1857142857143,25.9714285714286,0,37.5857142857143,58.0471428571429,65.9442857142857,567,0,0,269,545,1092,567,1092
2017,33,58,"Hurriyet",38.7312,35.4787,17.9285714285714,25.0714285714286,0.995571428571429,44.8285714285714,54.8828571428571,65.11,596,32,63,194,400,1199,564,1136
2017,34,58,"Hurriyet",38.7312,35.4787,19.4571428571429,22.3142857142857,0.000571428571428571,46.2714285714286,39.59,31.28,601,0,0,300,867,1280,601,1280
2017,35,58,"Hurriyet",38.7312,35.4787,16.6285714285714,20.7857142857143,0,43.5428571428571,41.0271428571429,40.0742857142857,493,0,0,206,280,1014,493,1014
2017,36,58,"Hurriyet",38.7312,35.4787,17.4,19.8857142857143,0.0284285714285714,35.3285714285714,72.9,83.8114285714286,507,0,0,227,742,1321,507,1321
2017,37,58,"Hurriyet",38.7312,35.4787,16.6428571428571,23.9714285714286,0,27.1428571428571,117.995714285714,128.582857142857,589,18,10,23,51,1138,571,1128
2017,38,58,"Hurriyet",38.7312,35.4787,18.7428571428571,22.0142857142857,0,30.4285714285714,92.8485714285714,114.735714285714,671,0,0,380,787,1312,671,1312
2017,39,58,"Hurriyet",38.7312,35.4787,19.8142857142857,17.0571428571429,0.0588571428571429,50.5,63.5714285714286,102.111428571429,782,76,137,183,331,1630,706,1493
2017,40,58,"Hurriyet",38.7312,35.4787,18.0285714285714,11.8428571428571,0.603142857142857,52.1857142857143,57.2671428571429,115.997142857143,543,66,139,187,462,1137,477,998
2017,41,58,"Hurriyet",38.7312,35.4787,14.7142857142857,10.8285714285714,0.142285714285714,55.8,51.0485714285714,114.981428571429,487,0,0,143,145,843,487,843
2017,42,58,"Hurriyet",38.7312,35.4787,14.2428571428571,10.1714285714286,0,47.9857142857143,97.1614285714286,170.64,530,24,37,104,190,815,506,778
2017,43,58,"Hurriyet",38.7312,35.4787,27.7142857142857,12.9142857142857,0.460142857142857,49.1714285714286,135.004285714286,144.497142857143,506,188,265,112,181,919,318,654
2017,44,58,"Hurriyet",38.7312,35.4787,20.2714285714286,5.94285714285714,0.0904285714285714,59.5142857142857,39.35,82.098,561,131,307,235,381,1102,430,795
2017,45,58,"Hurriyet",38.7312,35.4787,12.4142857142857,5.22857142857143,0.0291428571428571,67.7,105.482,80.334,577,24,18,233,354,829,553,811
2017,46,58,"Hurriyet",38.7312,35.4787,15.1857142857143,7.75714285714286,0,55.2857142857143,197.473333333333,50.836,587,101,170,0,0,1085,486,915
2017,47,58,"Hurriyet",38.7312,35.4787,20.9142857142857,3.58571428571429,1.32385714285714,76.9285714285714,61.9871428571429,33.3585714285714,418,39,53,137,257,804,379,751
2017,48,58,"Hurriyet",38.7312,35.4787,13.7714285714286,4.68571428571429,0.601714285714286,76.7571428571429,146.255714285714,44.6214285714286,386,105,163,52,109,619,281,456
2017,49,58,"Hurriyet",38.7312,35.4787,14.3714285714286,0.785714285714286,1.40157142857143,80.2142857142857,151.591428571429,78.5566666666667,407,151,151,115,233,645,256,494
2017,50,58,"Hurriyet",38.7312,35.4787,13.2428571428571,3.28571428571429,0.113714285714286,74.8857142857143,244.89,82.2657142857143,346,46,101,0,0,442,300,341
2017,51,58,"Hurriyet",38.7312,35.4787,15.6428571428571,6.58571428571429,0.669,79.6571428571429,112.567142857143,68.324,386,48,27,23,7,349,338,322
2017,52,58,"Hurriyet",38.7312,35.4787,19.4,1.4,0.402625,79.15,120.06625,69.6471428571429,528,205,278,105,64,507,323,229
2018,1,58,"Hurriyet",38.7312,35.4787,17.3875,3.025,0.590625,79.8875,85.6871428571429,56.5814285714286,618,199,290,324,419,914,419,624
2018,2,58,"Hurriyet",38.7312,35.4787,15.6857142857143,1.95714285714286,0.547857142857143,84.1285714285714,107.282857142857,62.7371428571429,624,88,104,0,0,1309,536,1205
2018,3,58,"Hurriyet",38.7312,35.4787,18.2428571428571,0.314285714285715,2.20128571428571,85.5428571428571,73.9357142857143,61.1328571428571,639,0,0,98,44,655,639,655
2018,4,58,"Hurriyet",38.7312,35.4787,27.2571428571429,0.642857142857143,1.53957142857143,80.1142857142857,48.3428571428571,44.66,604,253,375,131,122,764,351,389
2018,5,58,"Hurriyet",38.7312,35.4787,12.4428571428571,1.24285714285714,0,75.3285714285714,148.017142857143,81.7442857142857,670,146,215,297,192,819,524,604
2018,6,58,"Hurriyet",38.7312,35.4787,16.6714285714286,6.77142857142857,0.057,63.5857142857143,171.545714285714,69.6671428571429,704,18,19,4,3,1022,686,1003
2018,7,58,"Hurriyet",38.7312,35.4787,23.2857142857143,5.92857142857143,0.0571428571428571,61.1571428571429,65.9457142857143,55.2414285714286,478,122,140,144,141,557,356,417
2018,8,58,"Hurriyet",38.7312,35.4787,16.9285714285714,5.48571428571429,0.887714285714286,66.9285714285714,70.1842857142857,61.726,711,69,92,207,529,1321,642,1229
2018,9,58,"Hurriyet",38.7312,35.4787,29.3571428571429,6.5,1.197,65.3857142857143,71.63,57.2257142857143,621,219,357,169,321,956,402,599
2018,10,58,"Hurriyet",38.7312,35.4787,20.9,8.4,3.65242857142857,72.7,90.4142857142857,66.1828571428571,556,0,0,355,788,1330,556,1330
2018,11,58,"Hurriyet",38.7312,35.4787,18.1714285714286,8.57142857142857,4.96028571428571,69.1571428571429,64.12,67.8857142857143,551,16,44,399,1170,1426,535,1382
2018,12,58,"Hurriyet",38.7312,35.4787,31.7571428571429,13.5714285714286,0.0291428571428571,44.5857142857143,99.1385714285714,58.2085714285714,425,26,250,121,283,1187,399,937
2018,13,58,"Hurriyet",38.7312,35.4787,25.6142857142857,11.0714285714286,1.68542857142857,57.6142857142857,70.1614285714286,59.0742857142857,356,59,119,120,142,428,297,309
2018,14,58,"Hurriyet",38.7312,35.4787,24.1,10.3857142857143,0.428571428571429,52.3857142857143,58.42,76.7885714285714,407,111,245,96,54,486,296,241
2018,15,58,"Hurriyet",38.7312,35.4787,21.7285714285714,12.7428571428571,0.501857142857143,60.0142857142857,51.5757142857143,66.3383333333333,374,53,168,154,136,450,321,282
2018,16,58,"Hurriyet",38.7312,35.4787,20.9142857142857,10.7571428571429,0.826714285714286,46.9285714285714,53.7028571428571,73.3342857142857,411,0,0,119,186,648,411,648
2018,17,58,"Hurriyet",38.7312,35.4787,20.1428571428571,15.2,0,42,51.3657142857143,95.3657142857143,419,0,0,62,96,652,419,652
2018,18,58,"Hurriyet",38.7312,35.4787,24.8428571428571,16.9714285714286,0.573428571428572,51.6714285714286,52.46,76.985,303,114,96,104,152,474,189,378
2018,19,58,"Hurriyet",38.7312,35.4787,21.3857142857143,13.0142857142857,5.465,72.8142857142857,39.6957142857143,69.29,275,0,0,200,233,467,275,467
2018,20,58,"Hurriyet",38.7312,35.4787,20.5857142857143,17.1428571428571,0.145142857142857,55.8714285714286,41.3628571428571,77.9842857142857,204,30,31,5,4,306,174,275
2018,21,58,"Hurriyet",38.7312,35.4787,24.1428571428571,18.9,0.120714285714286,52.2428571428571,40.4342857142857,64.7342857142857,252,52,64,6,2,281,200,217
2018,22,58,"Hurriyet",38.7312,35.4787,20.3428571428571,16.5428571428571,2.11942857142857,66.5428571428571,43.9614285714286,77.306,249,30,44,55,102,427,219,383
2018,23,58,"Hurriyet",38.7312,35.4787,18.1142857142857,20.4428571428571,0.0284285714285714,46.6857142857143,34.3085714285714,73.2416666666667,267,0,0,54,207,812,267,812
2018,24,58,"Hurriyet",38.7312,35.4787,22.7571428571429,20.5428571428571,2.10571428571429,52.5428571428571,29.9571428571429,64.43,267,75,49,61,49,448,192,399
2018,25,58,"Hurriyet",38.7312,35.4787,21.1714285714286,19.8,0.323857142857143,60.4,30.345,106.413333333333,358,35,41,170,208,518,323,477
2018,26,58,"Hurriyet",38.7312,35.4787,18,23.6142857142857,1.28257142857143,48.4714285714286,50.5528571428571,104.808571428571,355,31,59,235,412,587,324,528
2018,27,58,"Hurriyet",38.7312,35.4787,20.1,22.6428571428571,0,46.5857142857143,34.2157142857143,79.1442857142857,342,0,0,12,26,418,342,418
2018,28,58,"Hurriyet",38.7312,35.4787,20.6,24.7571428571429,0,43.3285714285714,55.6857142857143,89.2257142857143,286,6,5,116,269,585,280,580
2018,29,58,"Hurriyet",38.7312,35.4787,21.1142857142857,22.7142857142857,0.000571428571428571,39.9857142857143,44.8271428571429,88.5371428571429,260,0,0,162,437,756,260,756
2018,30,58,"Hurriyet",38.7312,35.4787,19.5285714285714,25,0,42.6142857142857,62.8557142857143,90.5757142857143,265,0,0,165,618,822,265,822
2018,31,58,"Hurriyet",38.7312,35.4787,20.6428571428571,24.7285714285714,0,42.6571428571429,39.0414285714286,64.4128571428571,267,10,37,4,4,499,257,462
2018,32,58,"Hurriyet",38.7312,35.4787,19.5142857142857,21.3857142857143,0,46.2714285714286,36.0585714285714,68.3785714285714,297,0,0,9,12,403,297,403
2018,33,58,"Hurriyet",38.7312,35.4787,16.6142857142857,21.8714285714286,0,39.7857142857143,48.1728571428571,63.02,216,28,33,33,49,332,188,299
2018,34,58,"Hurriyet",38.7312,35.4787,14.2428571428571,22.6857142857143,0,39.5428571428571,40.0414285714286,50.2171428571429,144,13,1,31,46,227,131,226
2018,35,58,"Hurriyet",38.7312,35.4787,18.1571428571429,24.4571428571429,0.00257142857142857,35.4428571428571,63.5314285714286,61.5371428571429,201,6,2,45,66,314,195,312
2018,36,58,"Hurriyet",38.7312,35.4787,19.3285714285714,20.6428571428571,0.142285714285714,42.9714285714286,62.8171428571429,64.0657142857143,341,0,0,155,180,370,341,370
2018,37,58,"Hurriyet",38.7312,35.4787,21.9571428571429,19.8714285714286,0.000571428571428571,41.9857142857143,62.7128571428571,56.9157142857143,241,12,25,115,214,419,229,394
2018,38,58,"Hurriyet",38.7312,35.4787,14.8,17.1285714285714,0.0284285714285714,44.3428571428571,48.9685714285714,58.45,189,22,46,70,134,344,167,298
2018,39,58,"Hurriyet",38.7312,35.4787,16.6571428571429,17.2571428571429,0.000142857142857143,43.6,61.0128571428571,55.86,180,15,25,81,168,353,165,328
2018,40,58,"Hurriyet",38.7312,35.4787,16.4142857142857,15.1857142857143,0.772857142857143,50.8571428571429,47.7185714285714,57.0714285714286,191,40,61,65,119,341,151,280
2018,41,58,"Hurriyet",38.7312,35.4787,17.7142857142857,15.1428571428571,0.264857142857143,59.6142857142857,79.69,60.0228571428571,187,72,105,48,30,422,115,317
2018,42,58,"Hurriyet",38.7312,35.4787,21.3428571428571,15.7428571428571,0.607142857142857,57.8571428571429,118.55,64.3585714285714,168,76,221,11,6,381,92,160
2018,43,58,"Hurriyet",38.7312,35.4787,16.7,9.7,1.63757142857143,67.9571428571429,66.3885714285714,57.7071428571429,187,1,0,66,191,402,186,402
2018,44,58,"Hurriyet",38.7312,35.4787,10.0142857142857,9.27142857142857,0,57.8142857142857,128.954285714286,81.55,196,25,12,32,32,264,171,252
2018,45,58,"Hurriyet",38.7312,35.4787,12.2142857142857,7.45714285714286,0.000428571428571429,62.4857142857143,91.2185714285714,72.3257142857143,231,11,11,63,157,473,220,462
2018,46,58,"Hurriyet",38.7312,35.4787,15.0714285714286,3.71428571428571,0.285,68.1285714285714,73.3671428571429,61.6585714285714,230,29,28,56,125,465,201,437
2018,47,58,"Hurriyet",38.7312,35.4787,11.6857142857143,6.64285714285714,0.313571428571429,75.1142857142857,127.797142857143,71.57,270,16,7,76,77,499,254,492
2018,48,58,"Hurriyet",38.7312,35.4787,16.9714285714286,7.57142857142857,0.290571428571429,74.9,119.146666666667,69.8866666666667,245,115,129,24,16,201,130,72
2018,49,58,"Hurriyet",38.7312,35.4787,19.0714285714286,4.71428571428571,0.360142857142857,75.5714285714286,70.902,61.3142857142857,257,95,48,80,78,420,162,372
2018,50,58,"Hurriyet",38.7312,35.4787,24.8714285714286,3.37142857142857,1.95071428571429,75.6285714285714,105.878,62.99,256,76,38,77,88,305,180,267
2018,51,58,"Hurriyet",38.7312,35.4787,19.0285714285714,5.2,0.663571428571429,79.8714285714286,87.57,56.7814285714286,250,41,59,124,22,248,209,189
2018,52,58,"Hurriyet",38.7312,35.4787,17.2571428571429,-1.15714285714286,2.36528571428571,78.9714285714286,39.68,58.7575,244,57,60,125,141,273,187,213
2019,1,58,"Hurriyet",38.7312,35.4787,28.1875,2.5625,1.305625,75.9,36.625,NA,343,168,401,55,104,784,175,383
2019,2,58,"Hurriyet",38.7312,35.4787,17.4714285714286,-5.37142857142857,1.552,78.8142857142857,2.62666666666667,96.1616666666667,255,2,1,128,118,208,253,207
2019,3,58,"Hurriyet",38.7312,35.4787,20.1,-3.78571428571429,2.539,79.1428571428571,2.34714285714286,105.237142857143,192,14,10,39,34,198,178,188
2019,4,58,"Hurriyet",38.7312,35.4787,24.6,1.85714285714286,0.06,71.1571428571429,65.506,114.622,308,129,205,0,0,314,179,109
2019,5,58,"Hurriyet",38.7312,35.4787,22.2285714285714,3.05714285714286,0.374285714285714,69.0857142857143,114.757142857143,134.925714285714,253,44,23,60,24,143,209,120
2019,6,58,"Hurriyet",38.7312,35.4787,21.7142857142857,4.82857142857143,1.75571428571429,65.1142857142857,109.427142857143,137.18,276,206,79,1,0,127,70,48
2019,7,58,"Hurriyet",38.7312,35.4787,18.1571428571429,3.51428571428571,0,63.7571428571429,87.62,127.764285714286,325,162,61,15,96,234,163,173
2019,8,58,"Hurriyet",38.7312,35.4787,14.3142857142857,3.11428571428571,0.000142857142857143,59.3285714285714,89.5142857142857,154.027142857143,305,36,23,153,127,219,269,196
2019,9,58,"Hurriyet",38.7312,35.4787,18.9571428571429,2.9,0.317714285714286,66.7142857142857,56.6357142857143,122.84,331,0,0,197,140,310,331,310
2019,10,58,"Hurriyet",38.7312,35.4787,18.4,4.51428571428571,0.314857142857143,59.9857142857143,91.2157142857143,139.501428571429,359,2,1,220,172,252,357,251
2019,11,58,"Hurriyet",38.7312,35.4787,24.7142857142857,7.6,0.343,59.6857142857143,61.4385714285714,104.357142857143,373,106,104,175,149,400,267,296
2019,12,58,"Hurriyet",38.7312,35.4787,18.3571428571429,5.75714285714286,0.113714285714286,51.5285714285714,58.3928571428571,109.18,343,43,10,97,319,416,300,406
2019,13,58,"Hurriyet",38.7312,35.4787,22.2142857142857,4.55714285714286,0.523,60.3285714285714,42.4871428571429,87.7028571428571,256,68,13,142,144,194,188,181
2019,14,58,"Hurriyet",38.7312,35.4787,15.5571428571429,8.21428571428572,0.200142857142857,64.6571428571429,49.18,112.047142857143,365,174,70,41,31,208,191,138
2019,15,58,"Hurriyet",38.7312,35.4787,21.3857142857143,11.5142857142857,0.642571428571429,57.5142857142857,41.5357142857143,120.274285714286,359,45,42,122,73,183,314,141
2019,16,58,"Hurriyet",38.7312,35.4787,21.3428571428571,6.5,1.44042857142857,70.3,24.6,94.6914285714286,318,0,0,198,145,208,318,208
2019,17,58,"Hurriyet",38.7312,35.4787,15.5428571428571,9.62857142857143,0.455428571428571,63.8285714285714,59.6228571428571,138.238333333333,412,0,0,148,194,313,412,313
2019,18,58,"Hurriyet",38.7312,35.4787,21.3285714285714,13.4142857142857,1.28757142857143,61.8571428571429,54.5328571428571,131.404285714286,523,0,0,198,94,353,523,353
2019,19,58,"Hurriyet",38.7312,35.4787,24.0714285714286,13.3,1.43371428571429,59.1428571428571,42.6571428571429,94.1085714285714,452,36,28,172,138,386,416,358
2019,20,58,"Hurriyet",38.7312,35.4787,23.9714285714286,19.1857142857143,0.000142857142857143,45.9571428571429,52.7914285714286,96.96,454,186,138,51,44,389,268,251
2019,21,58,"Hurriyet",38.7312,35.4787,27.0142857142857,19.3285714285714,1.366,49.2857142857143,53.564,83.742,457,1,0,379,381,413,456,413
2019,22,58,"Hurriyet",38.7312,35.4787,20.8857142857143,21.7142857142857,0.247142857142857,47.0428571428571,58.8042857142857,92.3657142857143,453,0,0,89,73,323,453,323
2019,23,58,"Hurriyet",38.7312,35.4787,20.5857142857143,22.8,0.286285714285714,42.3857142857143,49.7242857142857,69.9585714285714,378,0,0,216,205,532,378,532
2019,24,58,"Hurriyet",38.7312,35.4787,21.4428571428571,19.2,1.92414285714286,67.8857142857143,44.1114285714286,91.2957142857143,378,0,0,179,99,244,378,244
2019,25,58,"Hurriyet",38.7312,35.4787,21.0571428571429,19.8428571428571,0.668428571428571,67.9571428571429,46.745,83.37,306,3,10,120,219,325,303,315
2019,26,58,"Hurriyet",38.7312,35.4787,19.0857142857143,23.1,0,48.8428571428571,NA,NA,377,0,0,6,17,342,377,342
2019,27,58,"Hurriyet",38.7312,35.4787,23.0428571428571,21.2714285714286,0,46.7142857142857,22.6875,24.26,456,51,28,74,18,222,405,194
2019,28,58,"Hurriyet",38.7312,35.4787,23.3428571428571,22,0.284714285714286,49.2285714285714,26.0557142857143,38.9171428571429,398,0,0,229,257,421,398,421
2019,29,58,"Hurriyet",38.7312,35.4787,19.9571428571429,19.8857142857143,1.15614285714286,61.9,21.1314285714286,32.2157142857143,453,0,0,199,102,203,453,203
2019,30,58,"Hurriyet",38.7312,35.4787,21.1714285714286,21.4285714285714,0,50.1857142857143,20.0728571428571,33.722,456,54,84,49,41,335,402,251
2019,31,58,"Hurriyet",38.7312,35.4787,20.9714285714286,24.7,0.00128571428571429,42.2,41.8933333333333,48.58,334,0,0,151,167,375,334,375
2019,32,58,"Hurriyet",38.7312,35.4787,21.9571428571429,20.8571428571429,0.0902857142857143,48.6,22.01,28.135,346,49,80,66,69,395,297,315
2019,33,58,"Hurriyet",38.7312,35.4787,19.4,24.4857142857143,0.00257142857142857,44.7428571428571,43.0085714285714,42.5771428571429,337,137,171,53,94,531,200,360
2019,34,58,"Hurriyet",38.7312,35.4787,18.7285714285714,20.1428571428571,1.71314285714286,65.6285714285714,26.7642857142857,36.3228571428571,299,42,58,88,132,345,257,287
2019,35,58,"Hurriyet",38.7312,35.4787,19.0857142857143,21.9571428571429,0.000142857142857143,55.3714285714286,30.1471428571429,36.1242857142857,307,2,0,66,38,415,305,415
2019,36,58,"Hurriyet",38.7312,35.4787,17.2,20.4,0,42.4571428571429,37.04,53.4071428571429,171,0,0,1,1,67,171,67
2019,37,58,"Hurriyet",38.7312,35.4787,17.9142857142857,18.0142857142857,0.230285714285714,56.2714285714286,27.5314285714286,46.8071428571429,218,55,7,11,9,55,163,48
2019,38,58,"Hurriyet",38.7312,35.4787,15.2857142857143,15.4285714285714,0.000142857142857143,57.2428571428571,37.5557142857143,57.6171428571429,266,34,6,156,66,91,232,85
2019,39,58,"Hurriyet",38.7312,35.4787,13.5857142857143,15.6714285714286,0.343285714285714,55.0428571428571,45.6416666666667,65.0883333333333,237,0,0,151,53,79,237,79
2019,40,58,"Hurriyet",38.7312,35.4787,20.8142857142857,17.3285714285714,0.0284285714285714,45.7714285714286,66.204,73.402,241,15,2,104,43,111,226,109
2019,41,58,"Hurriyet",38.7312,35.4787,14.2,15.7571428571429,0,52.6,45.5814285714286,63.2016666666667,416,36,5,208,224,448,380,443
2019,42,58,"Hurriyet",38.7312,35.4787,13.4285714285714,15.1285714285714,0.172,56.4428571428571,67.9257142857143,81.485,356,93,62,65,82,408,263,346
2019,43,58,"Hurriyet",38.7312,35.4787,14.1285714285714,12.3857142857143,0.967285714285714,71.4857142857143,47.4185714285714,NA,306,92,35,98,106,300,214,265
2019,44,58,"Hurriyet",38.7312,35.4787,12.7,8.58571428571429,0.401428571428571,69.6142857142857,65.4585714285714,69.628,350,0,0,187,146,250,350,250
2019,45,58,"Hurriyet",38.7312,35.4787,0.914285714285714,8.62857142857143,0,58.4142857142857,119.847142857143,NA,417,79,113,0,0,328,338,215
2019,46,58,"Hurriyet",38.7312,35.4787,12.6428571428571,8.77142857142857,0.00128571428571429,54.6,119.198571428571,NA,401,144,123,0,0,337,257,214
2019,47,58,"Hurriyet",38.7312,35.4787,7.67142857142857,2.58571428571429,0,53.8857142857143,170.35,NA,391,40,15,0,0,339,351,324
2019,48,58,"Hurriyet",38.7312,35.4787,22.4857142857143,7.98571428571429,2.34171428571429,69.2571428571429,89.1228571428571,64.334,320,50,44,126,141,251,270,207
2019,49,58,"Hurriyet",38.7312,35.4787,14.6714285714286,1.12857142857143,0.973142857142857,81.8,47.0642857142857,56.2314285714286,393,241,150,17,11,274,152,124
2019,50,58,"Hurriyet",38.7312,35.4787,14.7,4,0.119142857142857,81.0428571428571,78.5542857142857,76.2914285714286,218,128,66,63,42,119,90,53
2019,51,58,"Hurriyet",38.7312,35.4787,8.41428571428571,2.62857142857143,0,75.4142857142857,160.727142857143,104.435714285714,361,37,26,116,126,488,324,462
2019,52,58,"Hurriyet",38.7312,35.4787,25.3714285714286,4.01428571428571,1.544,79.0285714285714,41.8557142857143,NA,279,84,118,28,14,281,195,163
2020,1,58,"Hurriyet",38.7312,35.4787,19.72,0.94,1.2388,87.1,25.868,NA,160,52,54,63,22,126,108,72
2020,2,58,"Hurriyet",38.7312,35.4787,24.9285714285714,1.94285714285714,0.036,70.1571428571429,35.8828571428571,NA,240,81,77,42,4,173,159,96
2020,3,58,"Hurriyet",38.7312,35.4787,19.4,0.0714285714285714,0.0571428571428571,73.1857142857143,57.4585714285714,NA,270,93,143,27,23,382,177,239
2020,4,58,"Hurriyet",38.7312,35.4787,17.3142857142857,-2.58571428571429,0.386857142857143,72.5142857142857,58.8985714285714,NA,358,1,0,88,42,295,357,295
2020,5,58,"Hurriyet",38.7312,35.4787,15.7285714285714,1.11428571428571,2.38071428571429,78.6571428571429,81.0885714285714,NA,331,4,1,177,117,272,327,271
2020,6,58,"Hurriyet",38.7312,35.4787,32.0428571428571,1.08571428571429,4.60042857142857,80.6,45.2085714285714,NA,343,73,76,158,98,267,270,191
2020,7,58,"Hurriyet",38.7312,35.4787,22.6857142857143,-4.7,3.42685714285714,79.1285714285714,59.3042857142857,NA,341,49,20,78,55,338,292,318
2020,8,58,"Hurriyet",38.7312,35.4787,18.7,-0.0857142857142859,0.0288571428571429,82.3714285714286,72.7585714285714,NA,283,55,15,0,0,187,228,172
2020,9,58,"Hurriyet",38.7312,35.4787,21.0142857142857,5.42857142857143,0.858285714285714,68.5857142857143,43.3214285714286,NA,393,26,10,88,71,528,367,518
2020,10,58,"Hurriyet",38.7312,35.4787,21.5857142857143,8.44285714285714,0,57.2,62.16,NA,205,49,53,0,0,210,156,157
2020,11,58,"Hurriyet",38.7312,35.4787,27.8857142857143,11.5571428571429,0.170571428571429,56.2285714285714,52.2271428571429,NA,115,72,37,0,0,94,43,57
2020,12,58,"Hurriyet",38.7312,35.4787,17.6714285714286,0.814285714285714,4.203,84.6,22.94,NA,117,21,22,61,57,118,96,96
2020,13,58,"Hurriyet",38.7312,35.4787,18.3571428571429,8.45714285714286,4.61442857142857,73.0142857142857,38.125,NA,136,47,34,24,19,92,89,58
2020,14,58,"Hurriyet",38.7312,35.4787,25.5285714285714,7.9,1.51471428571429,72.8285714285714,28.41,NA,155,51,39,50,42,121,104,82
2020,15,58,"Hurriyet",38.7312,35.4787,21.8714285714286,8.81428571428571,0.801428571428571,63.6428571428571,29.9257142857143,NA,133,44,8,26,14,118,89,110
2020,16,58,"Hurriyet",38.7312,35.4787,18.0285714285714,10.7714285714286,0.0284285714285714,57.5714285714286,36.7942857142857,NA,141,0,0,98,85,106,141,106
2020,17,58,"Hurriyet",38.7312,35.4787,19.7142857142857,10.0857142857143,0.857428571428571,61.9142857142857,27.7128571428571,NA,137,1,1,103,103,123,136,122
2020,18,58,"Hurriyet",38.7312,35.4787,20.4,12.3714285714286,2.76828571428571,65.4,23.0185714285714,NA,146,17,9,93,66,164,129,155
2020,19,58,"Hurriyet",38.7312,35.4787,19.6,11.1142857142857,3.85242857142857,75.3571428571429,15.9528571428571,NA,137,0,0,65,58,157,137,157
2020,20,58,"Hurriyet",38.7312,35.4787,19.6428571428571,18.4714285714286,0,53.8571428571429,50.7771428571429,NA,164,0,0,93,133,164,164,164
2020,21,58,"Hurriyet",38.7312,35.4787,25.0142857142857,17.5714285714286,1.70671428571429,52.6,50.3314285714286,NA,146,0,0,41,34,96,146,96
2020,22,58,"Hurriyet",38.7312,35.4787,26.0714285714286,15.1714285714286,0.0284285714285714,52.8428571428571,22.7028571428571,NA,118,13,6,43,29,100,105,94
2020,23,58,"Hurriyet",38.7312,35.4787,20.2714285714286,17.4857142857143,0.174285714285714,52.2142857142857,29.6342857142857,NA,112,1,0,75,49,70,111,70
2020,24,58,"Hurriyet",38.7312,35.4787,23.2142857142857,18.6,2.74157142857143,59.2857142857143,39.7285714285714,NA,140,54,73,35,14,150,86,77
2020,25,58,"Hurriyet",38.7312,35.4787,21.7142857142857,18.9571428571429,2.17171428571429,64.3571428571429,30.1871428571429,NA,137,0,0,77,81,108,137,108
2020,26,58,"Hurriyet",38.7312,35.4787,22.0571428571429,21,0.430428571428571,57.5,27.9657142857143,NA,173,0,0,73,84,133,173,133
2020,27,58,"Hurriyet",38.7312,35.4787,17.9857142857143,22.5714285714286,0.284571428571429,51.2428571428571,27.2271428571429,NA,113,1,0,6,7,113,112,113
2020,28,58,"Hurriyet",38.7312,35.4787,19.6142857142857,23.3571428571429,0.438714285714286,53.3571428571429,28.7871428571429,NA,164,16,2,22,45,122,148,120
2020,29,58,"Hurriyet",38.7312,35.4787,18.7571428571429,24.7428571428571,0,47.1428571428571,39.5328571428571,NA,186,7,10,32,11,111,179,101
2020,30,58,"Hurriyet",38.7312,35.4787,19.2142857142857,23.9285714285714,0,47.6428571428571,38.73,NA,190,20,28,74,66,142,170,114
2020,31,58,"Hurriyet",38.7312,35.4787,18.4428571428571,23.9285714285714,0,46.5857142857143,40.3785714285714,NA,150,0,0,36,40,127,150,127
2020,32,58,"Hurriyet",38.7312,35.4787,18.0285714285714,22.0571428571429,0,43.8857142857143,34.8414285714286,NA,146,9,20,69,31,107,137,87
2020,33,58,"Hurriyet",38.7312,35.4787,21.7714285714286,20.8857142857143,0,50.7285714285714,27.9928571428571,NA,183,13,6,8,2,83,170,77
2020,34,58,"Hurriyet",38.7312,35.4787,16.6285714285714,20.1571428571429,0,49.3428571428571,37.2185714285714,NA,197,4,1,52,47,97,193,96
2020,35,58,"Hurriyet",38.7312,35.4787,15.5142857142857,21.9571428571429,0,36.7571428571429,55.5842857142857,NA,164,2,2,3,1,157,162,155
2020,36,58,"Hurriyet",38.7312,35.4787,19.2428571428571,24.3571428571429,0,37.1571428571429,72.9442857142857,61.0716666666667,179,0,0,84,65,112,179,112
2020,37,58,"Hurriyet",38.7312,35.4787,21.5857142857143,22.0285714285714,0.0287142857142857,47.7571428571429,58.6328571428571,49.6942857142857,193,49,13,27,13,91,144,78
2020,38,58,"Hurriyet",38.7312,35.4787,14.9714285714286,21.2857142857143,0,47.9142857142857,51.66,50.0385714285714,235,2,1,64,67,157,233,156
2020,39,58,"Hurriyet",38.7312,35.4787,14.0285714285714,18.0571428571429,0.426714285714286,57.4142857142857,54.5228571428571,53.0414285714286,220,2,1,121,103,129,218,128
2020,40,58,"Hurriyet",38.7312,35.4787,19.4285714285714,16.7,1.28314285714286,58.2142857142857,52.2928571428571,52.9928571428571,187,0,0,114,115,154,187,154
2020,41,58,"Hurriyet",38.7312,35.4787,18.8142857142857,17.1857142857143,0,39.8428571428571,75.3871428571429,76.3628571428571,182,36,20,22,18,127,146,107
2020,42,58,"Hurriyet",38.7312,35.4787,11.0714285714286,15.6142857142857,0,45.8571428571429,88.8714285714286,83.9942857142857,177,35,15,38,19,111,142,96
2020,43,58,"Hurriyet",38.7312,35.4787,18,14.9857142857143,0.0852857142857143,53.8857142857143,83.27,61.5957142857143,194,26,8,20,16,161,168,153
2020,44,58,"Hurriyet",38.7312,35.4787,16.3,14.3857142857143,0,48.1,74.82,55.5614285714286,255,108,137,91,70,233,147,96
2020,45,58,"Hurriyet",38.7312,35.4787,20.4428571428571,9.44285714285714,0.923142857142857,69.0428571428571,36.2428571428571,43.7014285714286,156,60,32,36,29,103,96,71
2020,46,58,"Hurriyet",38.7312,35.4787,10.9714285714286,4.95714285714286,0,68.3571428571429,90.61,62.2942857142857,208,17,5,47,15,109,191,104
2020,47,58,"Hurriyet",38.7312,35.4787,11.6714285714286,3.41428571428571,0,70.7857142857143,90.2885714285714,59.8485714285714,173,28,16,54,33,83,145,67
2020,48,58,"Hurriyet",38.7312,35.4787,15.4,0.685714285714286,0,61.4428571428571,118.267142857143,64.79,199,39,41,0,0,262,160,221
2020,49,58,"Hurriyet",38.7312,35.4787,15.3142857142857,3.94285714285714,0.0861428571428571,68.5571428571429,98.5457142857143,60.4142857142857,207,13,0,17,24,116,194,116
2020,50,58,"Hurriyet",38.7312,35.4787,14.9285714285714,3.32857142857143,2.99771428571429,78.6285714285714,106.354285714286,69.9371428571429,181,94,39,9,4,98,87,59
2020,51,58,"Hurriyet",38.7312,35.4787,18.9428571428571,4.11428571428571,0.0872857142857143,77.7428571428571,45.5385714285714,47.5914285714286,171,54,27,33,12,90,117,63
2020,52,58,"Hurriyet",38.7312,35.4787,12.3142857142857,-0.557142857142857,0.000142857142857143,75.3571428571429,94.3942857142857,61.5185714285714,203,29,7,47,42,113,174,106
2020,53,58,"Hurriyet",38.7312,35.4787,10.125,1.975,0.04975,67.625,129.7825,86.6275,122,4,7,0,0,111,118,104
2017,1,59,"Kilis",36.7161,37.115,13.5142857142857,4.71428571428571,2.17142857142857,83.0142857142857,37.3442857142857,NA,563,390,567,54,41,847,173,280
2017,2,59,"Kilis",36.7161,37.115,13.3,3.9,2.02857142857143,69.9714285714286,40.6766666666667,NA,757,436,518,25,48,1214,321,696
2017,3,59,"Kilis",36.7161,37.115,10.8857142857143,5.32857142857143,0,59.6142857142857,54.6633333333333,NA,762,169,251,207,526,1449,593,1198
2017,4,59,"Kilis",36.7161,37.115,17.7571428571429,3.25714285714286,2.42857142857143,57.0285714285714,43.86,NA,639,279,186,95,150,889,360,703
2017,5,59,"Kilis",36.7161,37.115,19.3571428571429,2.25714285714286,0.171428571428571,49.3285714285714,36.2357142857143,NA,588,189,394,197,387,1163,399,769
2017,6,59,"Kilis",36.7161,37.115,11.7,7.05714285714286,0,63.5428571428571,48.8828571428571,NA,736,433,671,49,67,1519,303,848
2017,7,59,"Kilis",36.7161,37.115,19.8714285714286,3.24285714285714,0.142857142857143,38.1571428571429,35.4885714285714,NA,492,50,46,134,279,717,442,671
2017,8,59,"Kilis",36.7161,37.115,10.6857142857143,7.6,0,48.3428571428571,62.4014285714286,NA,739,104,210,511,1316,1747,635,1537
2017,9,59,"Kilis",36.7161,37.115,15.6142857142857,10.7571428571429,1.4,54.3428571428571,46.2485714285714,NA,574,279,441,92,91,866,295,425
2017,10,59,"Kilis",36.7161,37.115,17.5428571428571,12.3857142857143,2.17142857142857,54.4571428571429,90.1128571428571,NA,712,525,697,0,0,1043,187,346
2017,11,59,"Kilis",36.7161,37.115,15.9142857142857,8.55714285714286,3.62885714285714,70.3142857142857,18.44,NA,525,0,0,342,469,725,525,725
2017,12,59,"Kilis",36.7161,37.115,15.8714285714286,11.7428571428571,1.14285714285714,56.3571428571429,24.3357142857143,NA,589,195,325,296,526,1077,394,752
2017,13,59,"Kilis",36.7161,37.115,13.8142857142857,12.2285714285714,5.22857142857143,65.9,29.6071428571429,NA,574,206,262,150,205,887,368,625
2017,14,59,"Kilis",36.7161,37.115,17.7142857142857,13.2428571428571,0.657142857142857,57.2285714285714,25.8371428571429,NA,639,183,291,252,382,1336,456,1045
2017,15,59,"Kilis",36.7161,37.115,15.6142857142857,12.7285714285714,3.37142857142857,60.9285714285714,27.1742857142857,NA,587,181,172,227,585,1187,406,1015
2017,16,59,"Kilis",36.7161,37.115,15.6142857142857,15.9428571428571,0,55.3285714285714,29.3166666666667,NA,717,106,72,459,488,920,611,848
2017,17,59,"Kilis",36.7161,37.115,16.7857142857143,17.4428571428571,0,36.1857142857143,33.4285714285714,NA,731,55,186,431,878,1478,676,1292
2017,18,59,"Kilis",36.7161,37.115,14.5857142857143,17.7285714285714,4.28571428571429,61.1857142857143,35.1885714285714,NA,506,41,40,279,451,923,465,883
2017,19,59,"Kilis",36.7161,37.115,17.4571428571429,21.8571428571429,0,39.6285714285714,35.85,NA,471,0,0,333,632,966,471,966
2017,20,59,"Kilis",36.7161,37.115,19.5142857142857,20.1714285714286,1.64285714285714,46.3285714285714,20.73,NA,472,0,0,303,798,1205,472,1205
2017,21,59,"Kilis",36.7161,37.115,17.7571428571429,18.6571428571429,0.8,53.1571428571429,21.0057142857143,NA,448,0,0,278,337,849,448,849
2017,22,59,"Kilis",36.7161,37.115,18.0142857142857,22.6285714285714,0.0571428571428571,39.4,20.5642857142857,NA,522,0,0,370,707,1015,522,1015
2017,23,59,"Kilis",36.7161,37.115,21.1857142857143,26.0857142857143,0,39.4571428571429,31.3628571428571,NA,578,0,0,382,880,1388,578,1388
2017,24,59,"Kilis",36.7161,37.115,19.8571428571429,24.9428571428571,0.0142857142857143,43.8,27.7542857142857,NA,552,0,0,370,648,1139,552,1139
2017,25,59,"Kilis",36.7161,37.115,21.1428571428571,25.3,0.571428571428572,40.9,22.1185714285714,NA,584,0,0,353,518,1041,584,1041
2017,26,59,"Kilis",36.7161,37.115,24.0857142857143,30.9714285714286,0,26.6714285714286,26.1285714285714,NA,564,10,3,290,548,971,554,968
2017,27,59,"Kilis",36.7161,37.115,19.8571428571429,30.5,0,28.5428571428571,32.2457142857143,NA,511,0,0,413,334,642,511,642
2017,28,59,"Kilis",36.7161,37.115,20.6428571428571,31.2285714285714,0,27.2571428571429,30.44,NA,481,0,0,377,575,864,481,864
2017,29,59,"Kilis",36.7161,37.115,19.0857142857143,29.6857142857143,0,40,35.8357142857143,NA,532,0,0,388,872,1272,532,1272
2017,30,59,"Kilis",36.7161,37.115,24.4142857142857,30.3142857142857,0,31.2428571428571,33.1414285714286,NA,531,0,0,404,663,928,531,928
2017,31,59,"Kilis",36.7161,37.115,15.9142857142857,29.3142857142857,0,39.2428571428571,30.54,NA,559,0,0,412,556,1047,559,1047
2017,32,59,"Kilis",36.7161,37.115,14.5428571428571,29.4,0,40.0428571428571,38.5028571428571,NA,567,67,60,354,526,1092,500,1032
2017,33,59,"Kilis",36.7161,37.115,17.4571428571429,28.0571428571429,0,49.3,35.1614285714286,NA,596,0,0,467,536,1199,596,1199
2017,34,59,"Kilis",36.7161,37.115,15.8714285714286,28.2714285714286,0,45.6571428571429,37.86,NA,601,0,0,466,547,1280,601,1280
2017,35,59,"Kilis",36.7161,37.115,12.7428571428571,26.9285714285714,0,47.6285714285714,31.69,NA,493,0,0,342,386,1014,493,1014
2017,36,59,"Kilis",36.7161,37.115,13.8142857142857,26.3571428571429,0,31.5142857142857,29.5942857142857,NA,507,0,0,360,668,1321,507,1321
2017,37,59,"Kilis",36.7161,37.115,11.2,29.0428571428571,0,29.1857142857143,49.1085714285714,NA,589,49,60,294,542,1138,540,1078
2017,38,59,"Kilis",36.7161,37.115,15.1428571428571,25.3714285714286,0,49.3,41.0985714285714,NA,671,0,0,502,757,1312,671,1312
2017,39,59,"Kilis",36.7161,37.115,15.3,23.0142857142857,0,47.5571428571429,35.2342857142857,NA,782,130,206,466,643,1630,652,1424
2017,40,59,"Kilis",36.7161,37.115,10.8857142857143,18.9,0,33.1571428571429,35.9114285714286,NA,543,69,142,240,606,1137,474,995
2017,41,59,"Kilis",36.7161,37.115,13.3,19.0285714285714,0.285714285714286,41.9285714285714,26.4971428571429,NA,487,30,37,281,511,843,457,806
2017,42,59,"Kilis",36.7161,37.115,11.4571428571429,18.7714285714286,0,28.5714285714286,34.86,NA,530,51,52,230,422,815,479,763
2017,43,59,"Kilis",36.7161,37.115,11.4571428571429,17.4857142857143,0.685714285714286,48.3428571428571,115.96,NA,506,143,230,156,266,919,363,689
2017,44,59,"Kilis",36.7161,37.115,12.9857142857143,14,2.74285714285714,69.9142857142857,27.7414285714286,NA,561,207,498,183,272,1102,354,604
2017,45,59,"Kilis",36.7161,37.115,7.68571428571429,13.8,0.285714285714286,58.1285714285714,50.5528571428571,NA,577,57,52,364,402,829,520,777
2017,46,59,"Kilis",36.7161,37.115,14.3142857142857,14.5428571428571,0,46,83.8042857142857,NA,587,217,297,118,224,1085,370,788
2017,47,59,"Kilis",36.7161,37.115,18.2714285714286,8.72857142857143,2.02857142857143,56.1285714285714,58.7185714285714,NA,418,140,278,203,332,804,278,526
2017,48,59,"Kilis",36.7161,37.115,8.25714285714286,9.37142857142857,2.22857142857143,75.3,50.1785714285714,NA,386,127,191,156,235,619,259,428
2017,49,59,"Kilis",36.7161,37.115,10.9285714285714,6.9,1.02857142857143,59.6,37.01,NA,407,103,100,143,288,645,304,545
2017,50,59,"Kilis",36.7161,37.115,9.08571428571429,9.11428571428571,0.114285714285714,63.0428571428571,53.6728571428571,NA,346,69,56,205,262,442,277,386
2017,51,59,"Kilis",36.7161,37.115,13,10.3857142857143,1.6,68.6,160.563333333333,NA,386,255,195,39,20,349,131,154
2017,52,59,"Kilis",36.7161,37.115,15.55,8.3875,0.5,63.2875,54.8025,NA,528,244,179,174,97,507,284,328
2018,1,59,"Kilis",36.7161,37.115,22.95,7.0625,2.225,73.475,53.635,NA,618,195,290,175,266,914,423,624
2018,2,59,"Kilis",36.7161,37.115,14.8571428571429,7.65714285714286,0.0285714285714286,57.8857142857143,88.342,NA,624,187,302,164,755,1309,437,1007
2018,3,59,"Kilis",36.7161,37.115,17.2714285714286,6.31428571428571,11.5714285714286,77.0714285714286,33.9385714285714,NA,639,161,149,265,314,655,478,506
2018,4,59,"Kilis",36.7161,37.115,18.2571428571429,6.8,7.32857142857143,81.4,86.8028571428571,NA,604,320,428,19,22,764,284,336
2018,5,59,"Kilis",36.7161,37.115,8.74285714285714,6.4,0.0285714285714286,66.7714285714286,41.6657142857143,NA,670,238,331,209,203,819,432,488
2018,6,59,"Kilis",36.7161,37.115,9.6,9.8,0,61.6857142857143,57.4185714285714,NA,704,353,445,105,233,1022,351,577
2018,7,59,"Kilis",36.7161,37.115,21.0428571428571,9.1,11.3428571428571,72.7571428571429,29.1914285714286,NA,478,139,188,186,166,557,339,369
2018,8,59,"Kilis",36.7161,37.115,14.5714285714286,8.35714285714286,3.28571428571429,77.3,29.7385714285714,NA,711,278,403,147,334,1321,433,918
2018,9,59,"Kilis",36.7161,37.115,12.1428571428571,9.7,3.51428571428571,81.5857142857143,34.0114285714286,NA,621,389,585,141,232,956,232,371
2018,10,59,"Kilis",36.7161,37.115,17.7571428571429,12.6285714285714,2.17142857142857,67.0285714285714,64.1085714285714,NA,556,111,285,261,721,1330,445,1045
2018,11,59,"Kilis",36.7161,37.115,14.8142857142857,12.1,0.571428571428572,68.2142857142857,23.3614285714286,NA,551,56,107,421,1046,1426,495,1319
2018,12,59,"Kilis",36.7161,37.115,17.7428571428571,14.6428571428571,0,53.7714285714286,56.9233333333333,NA,425,100,289,269,757,1187,325,898
2018,13,59,"Kilis",36.7161,37.115,15.8857142857143,14.1142857142857,2.22857142857143,56.7142857142857,NA,NA,356,79,79,148,166,428,277,349
2018,14,59,"Kilis",36.7161,37.115,14.4571428571429,16.9428571428571,0.8,34.0857142857143,22.75,NA,407,124,106,96,74,486,283,380
2018,15,59,"Kilis",36.7161,37.115,15.7428571428571,16.7571428571429,4.343,59.8714285714286,22.79,NA,374,90,197,118,151,450,284,253
2018,16,59,"Kilis",36.7161,37.115,15.7428571428571,17.1,1.11428571428571,46.2428571428571,25.1885714285714,NA,411,16,6,312,467,648,395,642
2018,17,59,"Kilis",36.7161,37.115,14.7571428571429,18.8428571428571,1.34285714285714,50.8428571428571,32.5242857142857,NA,419,260,458,87,70,652,159,194
2018,18,59,"Kilis",36.7161,37.115,14.7428571428571,20.4571428571429,2.71428571428571,55.8714285714286,35.5657142857143,NA,303,149,201,8,6,474,154,273
2018,19,59,"Kilis",36.7161,37.115,11.3714285714286,16.3714285714286,3.57142857142857,73.6857142857143,20.2933333333333,NA,275,53,168,147,180,467,222,299
2018,20,59,"Kilis",36.7161,37.115,12.2285714285714,23.0428571428571,0,41.9571428571429,22.9128571428571,NA,204,34,92,65,78,306,170,214
2018,21,59,"Kilis",36.7161,37.115,15.4,24.4,0,40,47.78,NA,252,27,17,152,194,281,225,264
2018,22,59,"Kilis",36.7161,37.115,16.6,21.9285714285714,0.228571428571429,52.5,44.5271428571429,NA,249,20,29,129,174,427,229,398
2018,23,59,"Kilis",36.7161,37.115,14.5,25.8857142857143,0.285714285714286,40.9857142857143,28.7571428571429,NA,267,0,0,198,426,812,267,812
2018,24,59,"Kilis",36.7161,37.115,16.8,23.8571428571429,4.31428571428571,55.3714285714286,29.44,NA,267,0,0,194,144,448,267,448
2018,25,59,"Kilis",36.7161,37.115,21.3285714285714,24.8285714285714,1.25714285714286,50.8428571428571,22.0671428571429,NA,358,0,0,303,340,518,358,518
2018,26,59,"Kilis",36.7161,37.115,18.7571428571429,26.4142857142857,1.37142857142857,46.4857142857143,29.1814285714286,NA,355,0,0,308,485,587,355,587
2018,27,59,"Kilis",36.7161,37.115,17.8428571428571,29.2428571428571,0,40.4428571428571,26.5342857142857,NA,342,0,0,279,260,418,342,418
2018,28,59,"Kilis",36.7161,37.115,20.0714285714286,28.7571428571429,0,43.8571428571429,33.3,NA,286,0,0,229,428,585,286,585
2018,29,59,"Kilis",36.7161,37.115,23.5142857142857,28.7142857142857,0,37.5714285714286,31.8371428571429,NA,260,0,0,181,632,756,260,756
2018,30,59,"Kilis",36.7161,37.115,20.9142857142857,27.8714285714286,0,44.2428571428571,40.8414285714286,NA,265,0,0,222,723,822,265,822
2018,31,59,"Kilis",36.7161,37.115,19.2,29,0,47.7571428571429,32.3285714285714,NA,267,0,0,231,431,499,267,499
2018,32,59,"Kilis",36.7161,37.115,24.2,29.2571428571429,1.14285714285714,37.6142857142857,29.366,NA,297,0,0,184,241,403,297,403
2018,33,59,"Kilis",36.7161,37.115,21.6142857142857,29.1,0,37.4714285714286,33.875,NA,216,0,0,145,211,332,216,332
2018,34,59,"Kilis",36.7161,37.115,16.7714285714286,29.0285714285714,0,42.5,30.8514285714286,NA,144,0,0,105,181,227,144,227
2018,35,59,"Kilis",36.7161,37.115,13.4285714285714,28.5,0,41.3428571428571,33.24,NA,201,0,0,129,206,314,201,314
2018,36,59,"Kilis",36.7161,37.115,15.8714285714286,26.9142857142857,0,41.6285714285714,30.7814285714286,NA,341,0,0,254,217,370,341,370
2018,37,59,"Kilis",36.7161,37.115,18.4,25.3857142857143,0.0857142857142857,40.0285714285714,39.4914285714286,NA,241,40,46,146,137,419,201,373
2018,38,59,"Kilis",36.7161,37.115,14.4285714285714,26.6571428571429,1.42857142857143,35.0142857142857,32.0066666666667,NA,189,19,29,93,194,344,170,315
2018,39,59,"Kilis",36.7161,37.115,11.4571428571429,24.9428571428571,0,39.0857142857143,36.9928571428571,NA,180,0,0,108,189,353,180,353
2018,40,59,"Kilis",36.7161,37.115,12.7571428571429,23.1285714285714,0,33.4571428571429,34.4528571428571,NA,191,17,18,81,121,341,174,323
2018,41,59,"Kilis",36.7161,37.115,13.8857142857143,22,0.0571428571428571,42.3428571428571,151.204285714286,NA,187,89,89,33,71,422,98,333
2018,42,59,"Kilis",36.7161,37.115,16.4428571428571,20.6142857142857,1.57142857142857,49.7285714285714,148.782,NA,168,98,67,0,0,381,70,314
2018,43,59,"Kilis",36.7161,37.115,13.8857142857143,15.1571428571429,5,67.7,68.3428571428571,NA,187,69,35,35,59,402,118,367
2018,44,59,"Kilis",36.7161,37.115,14.0571428571429,15.8285714285714,0.371428571428571,46.8428571428571,74.2185714285714,NA,196,83,61,44,70,264,113,203
2018,45,59,"Kilis",36.7161,37.115,13.9428571428571,12.7857142857143,0.128571428571429,76.2142857142857,35.7516666666667,NA,231,153,227,3,3,473,78,246
2018,46,59,"Kilis",36.7161,37.115,10.6,10.0857142857143,2.14285714285714,66.0285714285714,49.6285714285714,NA,230,112,183,18,41,465,118,282
2018,47,59,"Kilis",36.7161,37.115,10.4714285714286,10.9714285714286,6.25714285714286,78.7,59.6071428571429,NA,270,97,49,104,86,499,173,450
2018,48,59,"Kilis",36.7161,37.115,15.2428571428571,10.5285714285714,2.57142857142857,89.1428571428571,48.9857142857143,NA,245,144,64,21,18,201,101,137
2018,49,59,"Kilis",36.7161,37.115,14.7142857142857,9.81428571428571,3.91428571428571,88.4285714285714,36.7642857142857,NA,257,169,186,25,26,420,88,234
2018,50,59,"Kilis",36.7161,37.115,17.6571428571429,8.78571428571429,7.2,80.7428571428571,44.9875,NA,256,96,106,50,66,305,160,199
2018,51,59,"Kilis",36.7161,37.115,16.1714285714286,8.07142857142857,6.91428571428571,87.8428571428571,44.75,NA,250,91,79,79,62,248,159,169
2018,52,59,"Kilis",36.7161,37.115,14.4428571428571,5.61428571428571,8.18571428571429,80.1285714285714,45.1485714285714,NA,244,127,53,22,45,273,117,220
2019,1,59,"Kilis",36.7161,37.115,18.8375,6.2625,9.708125,90.7625,48.38,NA,343,176,246,27,23,784,167,538
2019,2,59,"Kilis",36.7161,37.115,20.0285714285714,3.24285714285714,4,77.3571428571429,38.5028571428571,NA,255,111,92,45,19,208,144,116
2019,3,59,"Kilis",36.7161,37.115,15.9,3.94285714285714,3.45714285714286,71.8285714285714,49.38,NA,192,89,77,23,40,198,103,121
2019,4,59,"Kilis",36.7161,37.115,16.1428571428571,5.98571428571429,0.2,72.5857142857143,89.9883333333333,NA,308,258,103,1,1,314,50,211
2019,5,59,"Kilis",36.7161,37.115,17.4714285714286,7.27142857142857,4.77142857142857,75.3142857142857,69.9157142857143,NA,253,33,2,91,58,143,220,141
2019,6,59,"Kilis",36.7161,37.115,20.6142857142857,5.98571428571429,6.8,79.7714285714286,33.86,NA,276,226,79,0,0,127,50,48
2019,7,59,"Kilis",36.7161,37.115,12.2857142857143,6.6,2.8,82.7714285714286,49.28,NA,325,76,26,197,138,234,249,208
2019,8,59,"Kilis",36.7161,37.115,11.1571428571429,7.92857142857143,0.428571428571429,77.2,49.815,NA,305,107,42,125,50,219,198,177
2019,9,59,"Kilis",36.7161,37.115,15.0571428571429,7.3,5.68571428571429,71.7285714285714,40.234,NA,331,82,60,183,112,310,249,250
2019,10,59,"Kilis",36.7161,37.115,17.5142857142857,9.08571428571429,1.65714285714286,63.5142857142857,34.6842857142857,NA,359,81,8,167,128,252,278,244
2019,11,59,"Kilis",36.7161,37.115,17.5,10.0142857142857,4.77142857142857,76.5142857142857,44.644,NA,373,105,95,166,131,400,268,305
2019,12,59,"Kilis",36.7161,37.115,11.3142857142857,11.8285714285714,0,56.5142857142857,45.165,NA,343,56,22,132,306,416,287,394
2019,13,59,"Kilis",36.7161,37.115,17.1142857142857,10,8.68571428571429,73.4142857142857,33.9428571428571,NA,256,63,6,117,69,194,193,188
2019,14,59,"Kilis",36.7161,37.115,14.2,11.5142857142857,8.28557142857143,80.3142857142857,29.2457142857143,NA,365,138,74,127,45,208,227,134
2019,15,59,"Kilis",36.7161,37.115,13.5571428571429,14.5714285714286,0.142857142857143,66.3,44.7985714285714,NA,359,128,46,135,43,183,231,137
2019,16,59,"Kilis",36.7161,37.115,14.8285714285714,10.2,3.92857142857143,77.5857142857143,25.0885714285714,NA,318,0,0,249,119,208,318,208
2019,17,59,"Kilis",36.7161,37.115,13.6428571428571,14.6857142857143,0.142857142857143,48.6428571428571,35.8914285714286,NA,412,128,116,69,75,313,284,197
2019,18,59,"Kilis",36.7161,37.115,14.1714285714286,18.5571428571429,0,52.7428571428571,39.3,NA,523,211,197,258,130,353,312,156
2019,19,59,"Kilis",36.7161,37.115,15.7714285714286,17.2857142857143,0.1,53.1,36.3528571428571,NA,452,74,50,337,247,386,378,336
2019,20,59,"Kilis",36.7161,37.115,14.7142857142857,23.5428571428571,0,39.5285714285714,53.52,NA,454,264,198,82,71,389,190,191
2019,21,59,"Kilis",36.7161,37.115,17.0857142857143,24.3714285714286,0,30.9714285714286,50.034,NA,457,0,0,426,359,413,457,413
2019,22,59,"Kilis",36.7161,37.115,14.8714285714286,28.1428571428571,0,23,60.1557142857143,NA,453,9,0,197,190,323,444,323
2019,23,59,"Kilis",36.7161,37.115,15.5285714285714,26.7142857142857,0,24.0714285714286,61.6828571428571,NA,378,60,130,241,253,532,318,402
2019,24,59,"Kilis",36.7161,37.115,17.0571428571429,25.1142857142857,0,37.9,58.44,NA,378,49,39,302,185,244,329,205
2019,25,59,"Kilis",36.7161,37.115,17.0142857142857,24.9857142857143,0,45.6428571428571,43.66,NA,306,0,0,272,258,325,306,325
2019,26,59,"Kilis",36.7161,37.115,19.9285714285714,29.6,0,34.7428571428571,46.2728571428571,NA,377,0,0,279,262,342,377,342
2019,27,59,"Kilis",36.7161,37.115,17.1857142857143,28.0285714285714,0,30.3142857142857,44.2516666666667,NA,456,2,0,366,162,222,454,222
2019,28,59,"Kilis",36.7161,37.115,22.0142857142857,28.2142857142857,0,34.6857142857143,49.9185714285714,NA,398,0,0,303,319,421,398,421
2019,29,59,"Kilis",36.7161,37.115,17.8285714285714,26.9142857142857,0,36.3714285714286,42.9428571428571,NA,453,0,0,407,151,203,453,203
2019,30,59,"Kilis",36.7161,37.115,19.7142857142857,29.3857142857143,0,32.0142857142857,47.1871428571429,NA,456,0,0,322,284,335,456,335
2019,31,59,"Kilis",36.7161,37.115,21.7285714285714,28.8142857142857,0,35.4,55.2457142857143,NA,334,0,0,274,327,375,334,375
2019,32,59,"Kilis",36.7161,37.115,23.1285714285714,29.9571428571429,0,30.1857142857143,51.1371428571429,NA,346,0,0,180,187,395,346,395
2019,33,59,"Kilis",36.7161,37.115,16.5,29.1857142857143,0,34.2142857142857,52.4314285714286,NA,337,0,0,280,444,531,337,531
2019,34,59,"Kilis",36.7161,37.115,12.2285714285714,27.4571428571429,0,33.5285714285714,45.89,NA,299,0,0,261,314,345,299,345
2019,35,59,"Kilis",36.7161,37.115,12.7428571428571,28.4571428571429,0,33.1857142857143,58.2628571428571,NA,307,0,0,225,347,415,307,415
2019,36,59,"Kilis",36.7161,37.115,17.4428571428571,27.3428571428571,0,35.0142857142857,53.7683333333333,NA,171,0,0,120,46,67,171,67
2019,37,59,"Kilis",36.7161,37.115,16.2857142857143,26.4857142857143,0.114285714285714,28.9142857142857,56.8666666666667,NA,218,30,1,140,38,55,188,54
2019,38,59,"Kilis",36.7161,37.115,16.1857142857143,23.2571428571429,0.171428571428571,31.5,49.6257142857143,NA,266,30,4,150,42,91,236,87
2019,39,59,"Kilis",36.7161,37.115,10.6857142857143,22.2428571428571,0,33.6428571428571,47.07,NA,237,0,0,190,45,79,237,79
2019,40,59,"Kilis",36.7161,37.115,13.3142857142857,22.5142857142857,0,36.7,60.0871428571429,NA,241,28,4,158,80,111,213,107
2019,41,59,"Kilis",36.7161,37.115,11.1285714285714,22.2,0,33.6285714285714,60.5042857142857,NA,416,63,17,114,129,448,353,431
2019,42,59,"Kilis",36.7161,37.115,11.1857142857143,21,0.628571428571429,36.2428571428571,68.6771428571429,NA,356,62,13,109,120,408,294,395
2019,43,59,"Kilis",36.7161,37.115,12.4714285714286,17.5714285714286,0.257142857142857,49.8428571428571,39.0875,NA,306,99,59,54,26,300,207,241
2019,44,59,"Kilis",36.7161,37.115,9.02857142857143,14.2,2.94285714285714,61.9142857142857,41.0171428571429,NA,350,70,41,122,92,250,280,209
2019,45,59,"Kilis",36.7161,37.115,10.2714285714286,14.0428571428571,0,45.3142857142857,73.0114285714286,NA,417,237,115,42,72,328,180,213
2019,46,59,"Kilis",36.7161,37.115,13.8142857142857,13.9,0,32.5857142857143,73.5871428571429,NA,401,236,174,32,19,337,165,163
2019,47,59,"Kilis",36.7161,37.115,10.8,9.74285714285714,0,30.8571428571429,86.4828571428571,NA,391,124,76,145,112,339,267,263
2019,48,59,"Kilis",36.7161,37.115,10.6857142857143,10.9571428571429,1.296,63.9,85.2485714285714,NA,320,174,95,8,4,251,146,156
2019,49,59,"Kilis",36.7161,37.115,16.3142857142857,8.1,1.44014285714286,72.2714285714286,49.8928571428571,NA,393,110,77,90,90,274,283,197
2019,50,59,"Kilis",36.7161,37.115,17.9571428571429,7.57142857142857,7.06785714285714,90.9428571428572,30.9742857142857,NA,218,183,108,0,0,119,35,11
2019,51,59,"Kilis",36.7161,37.115,8.17142857142857,9.05714285714286,0,65.8714285714286,91.7628571428571,NA,361,86,169,68,157,488,275,319
2019,52,59,"Kilis",36.7161,37.115,17.3714285714286,6.58571428571429,10.6845714285714,87.0571428571429,42.6771428571429,NA,279,168,178,7,2,281,111,103
2020,1,59,"Kilis",36.7161,37.115,13.54,5.66,6.0712,86.18,32.848,NA,160,49,51,53,39,126,111,75
2020,2,59,"Kilis",36.7161,37.115,17.1,5.94285714285714,0.318857142857143,75.4142857142857,45.7257142857143,NA,240,63,38,59,9,173,177,135
2020,3,59,"Kilis",36.7161,37.115,14.1857142857143,4.85714285714286,0.766714285714286,68.3571428571429,55.13,NA,270,143,268,44,27,382,127,114
2020,4,59,"Kilis",36.7161,37.115,21.9142857142857,4.84285714285714,1.05714285714286,52.6571428571429,46.6442857142857,NA,358,2,4,164,183,295,356,291
2020,5,59,"Kilis",36.7161,37.115,19.1571428571429,6.2,2.575,68.5142857142857,61.33,NA,331,146,150,113,59,272,185,122
2020,6,59,"Kilis",36.7161,37.115,18.3857142857143,4.97142857142857,6.55442857142857,72.5,34.17,NA,343,220,200,35,4,267,123,67
2020,7,59,"Kilis",36.7161,37.115,15.7857142857143,0.2,0.771428571428571,61.6142857142857,38.2328571428571,NA,341,169,129,53,68,338,172,209
2020,8,59,"Kilis",36.7161,37.115,15.9571428571429,8.5,0.257142857142857,73.4571428571429,46.875,NA,283,195,82,28,57,187,88,105
2020,9,59,"Kilis",36.7161,37.115,11.2714285714286,9.74285714285714,2.71428571428571,65.9857142857143,14.22,NA,393,41,38,206,273,528,352,490
2020,10,59,"Kilis",36.7161,37.115,17.2285714285714,12.2714285714286,0,57.4285714285714,70.25,NA,205,87,60,47,74,210,118,150
2020,11,59,"Kilis",36.7161,37.115,22.0571428571429,14.2,0.771428571428571,62.7,91.7,NA,115,33,34,15,2,94,82,60
2020,12,59,"Kilis",36.7161,37.115,14.5571428571429,8.61428571428571,5.63871428571429,75.1285714285714,NA,NA,117,30,33,34,41,118,87,85
2020,13,59,"Kilis",36.7161,37.115,19.9857142857143,12.2285714285714,1.39085714285714,71.1,NA,NA,136,61,43,14,7,92,75,49
2020,14,59,"Kilis",36.7161,37.115,19.5571428571429,10.9428571428571,5.91428571428571,74.2142857142857,38.878,NA,155,42,12,35,11,121,113,109
2020,15,59,"Kilis",36.7161,37.115,13.1285714285714,13.9142857142857,0.414285714285714,63.5428571428571,41.69,NA,133,0,0,92,86,118,133,118
2020,16,59,"Kilis",36.7161,37.115,13.9285714285714,16.3571428571429,0.143428571428571,49.2571428571429,60.56,NA,141,13,6,70,42,106,128,100
2020,17,59,"Kilis",36.7161,37.115,14.5857142857143,15.4,3.8,60.3857142857143,56.21,NA,137,6,1,91,46,123,131,122
2020,18,59,"Kilis",36.7161,37.115,12.6142857142857,15.5285714285714,1.51428571428571,65.8714285714286,39.3575,NA,146,9,18,75,46,164,137,146
2020,19,59,"Kilis",36.7161,37.115,16.6857142857143,16.4,0.352,59.9285714285714,34.4233333333333,NA,137,0,0,71,111,157,137,157
2020,20,59,"Kilis",36.7161,37.115,13.5428571428571,24.1428571428571,0,37.1428571428571,NA,NA,164,34,15,63,103,164,130,149
2020,21,59,"Kilis",36.7161,37.115,17.8428571428571,24.4,0.828571428571429,39.4142857142857,40.26,NA,146,4,0,72,42,96,142,96
2020,22,59,"Kilis",36.7161,37.115,17.7428571428571,19.5857142857143,0.0571428571428571,44.1857142857143,40.72,NA,118,20,20,44,32,100,98,80
2020,23,59,"Kilis",36.7161,37.115,14.2857142857143,21.8714285714286,0.0285714285714286,41.3714285714286,59.8216666666667,NA,112,26,23,46,25,70,86,47
2020,24,59,"Kilis",36.7161,37.115,16.9142857142857,23.7142857142857,0,44.0571428571429,81.565,NA,140,0,0,88,91,150,140,150
2020,25,59,"Kilis",36.7161,37.115,19.8142857142857,24.4,0,44.8428571428571,75.025,NA,137,0,0,92,68,108,137,108
2020,26,59,"Kilis",36.7161,37.115,18.4,26.6285714285714,0,41.7285714285714,NA,NA,173,0,0,117,85,133,173,133
2020,27,59,"Kilis",36.7161,37.115,16.4714285714286,29.9,0,30.8285714285714,58.406,NA,113,0,0,54,58,113,113,113
2020,28,59,"Kilis",36.7161,37.115,18.1142857142857,29.1571428571429,0,43.8857142857143,68.7414285714286,NA,164,0,0,114,77,122,164,122
2020,29,59,"Kilis",36.7161,37.115,18.2714285714286,29.3857142857143,0,40.5142857142857,64.4071428571429,NA,186,0,0,112,81,111,186,111
2020,30,59,"Kilis",36.7161,37.115,20.6142857142857,30.5857142857143,0,36.3857142857143,71.974,NA,190,0,0,124,107,142,190,142
2020,31,59,"Kilis",36.7161,37.115,18.7857142857143,31.7142857142857,0,31.2428571428571,86.2233333333333,NA,150,10,13,58,34,127,140,114
2020,32,59,"Kilis",36.7161,37.115,17.4714285714286,29.8285714285714,0,38.0714285714286,NA,NA,146,0,0,89,45,107,146,107
2020,33,59,"Kilis",36.7161,37.115,22.4714285714286,29,0,33.8285714285714,NA,NA,183,0,0,89,48,83,183,83
2020,34,59,"Kilis",36.7161,37.115,19.5571428571429,28.1285714285714,0,35.4428571428571,63.81,NA,197,1,0,116,41,97,196,97
2020,35,59,"Kilis",36.7161,37.115,12.2285714285714,28.5428571428571,0,33.0142857142857,NA,NA,164,4,10,95,62,157,160,147
2020,36,59,"Kilis",36.7161,37.115,15.3571428571429,31.0285714285714,0,22.9428571428571,117.5325,NA,179,31,4,71,42,112,148,108
2020,37,59,"Kilis",36.7161,37.115,13.1,29,0,31.5,82.8366666666667,NA,193,51,14,64,35,91,142,77
2020,38,59,"Kilis",36.7161,37.115,11.0714285714286,25.9285714285714,0,52.9714285714286,82.2628571428571,NA,235,0,0,137,65,157,235,157
2020,39,59,"Kilis",36.7161,37.115,13.6428571428571,24.4428571428571,0,54.7,71.75,NA,220,0,0,141,62,129,220,129
2020,40,59,"Kilis",36.7161,37.115,12.3571428571429,24.4428571428571,0,47.4428571428571,81.6771428571429,NA,187,0,0,114,93,154,187,154
2020,41,59,"Kilis",36.7161,37.115,14.0428571428571,22.0428571428571,0,30.2428571428571,91.0985714285714,NA,182,71,41,25,38,127,111,86
2020,42,59,"Kilis",36.7161,37.115,9.08571428571429,20.9714285714286,0,51.3571428571429,99.1671428571429,NA,177,35,24,56,39,111,142,87
2020,43,59,"Kilis",36.7161,37.115,8.72857142857143,20.9428571428571,0,43.2571428571429,120.674285714286,NA,194,25,11,74,104,161,169,150
2020,44,59,"Kilis",36.7161,37.115,9.8,19.7285714285714,0,37.5285714285714,159.064285714286,95.3025,255,134,117,18,4,233,121,116
2020,45,59,"Kilis",36.7161,37.115,15.4714285714286,14.0714285714286,11.0575714285714,73.3571428571429,55.98,50.1342857142857,156,88,51,6,14,103,68,52
2020,46,59,"Kilis",36.7161,37.115,9.48571428571429,13.1428571428571,0,58.4571428571429,99.3385714285714,34.9571428571429,208,104,59,1,10,109,104,50
2020,47,59,"Kilis",36.7161,37.115,9.58571428571429,10.0428571428571,0.634571428571429,73.1,105.62,27.78,173,61,29,15,6,83,112,54
2020,48,59,"Kilis",36.7161,37.115,12.8142857142857,8.87142857142857,0.342857142857143,62,81.7828571428571,24.6828571428571,199,62,24,38,42,262,137,238
2020,49,59,"Kilis",36.7161,37.115,12.5857142857143,9.28571428571429,2.18942857142857,72.4428571428571,80.3242857142857,19.4714285714286,207,88,32,9,8,116,119,84
2020,50,59,"Kilis",36.7161,37.115,13.9285714285714,8.12857142857143,1.05714285714286,73.3571428571429,97.7357142857143,21.6842857142857,181,91,26,4,3,98,90,72
2020,51,59,"Kilis",36.7161,37.115,14.9714285714286,8.85714285714286,0.876,82.7142857142857,116.321428571429,18.7528571428571,171,92,44,0,0,90,79,46
2020,52,59,"Kilis",36.7161,37.115,12.2,5.7,0.771428571428572,61.7857142857143,88.7028571428571,23.01,203,77,18,24,27,113,126,95
2020,53,59,"Kilis",36.7161,37.115,10.525,6.8,0.05,56.8,97.3475,27.1525,122,52,28,0,0,111,70,83
2017,1,60,"Kirikkale",39.8468,33.5153,10.1142857142857,-1.94285714285714,2.11428571428571,86.3,19.85,NA,563,64,74,49,34,847,499,773
2017,2,60,"Kirikkale",39.8468,33.5153,9.8,-3.22857142857143,0.471428571428571,83.7714285714286,30.3242857142857,NA,757,243,296,0,0,1214,514,918
2017,3,60,"Kirikkale",39.8468,33.5153,7.68571428571429,0.514285714285714,0.243,89.3,41.5842857142857,NA,762,107,217,90,131,1449,655,1232
2017,4,60,"Kirikkale",39.8468,33.5153,13.7428571428571,-2.21428571428571,0.171428571428571,73.1571428571429,23.1985714285714,NA,639,79,36,89,125,889,560,853
2017,5,60,"Kirikkale",39.8468,33.5153,11.9714285714286,-3.62857142857143,0.128571428571429,67.6285714285714,26.54,NA,588,63,77,76,118,1163,525,1086
2017,6,60,"Kirikkale",39.8468,33.5153,10.5714285714286,3.75714285714286,0.0142857142857143,76.9,33.83,NA,736,121,247,0,0,1519,615,1272
2017,7,60,"Kirikkale",39.8468,33.5153,13.2,-1.01428571428571,0,56.9285714285714,27.6142857142857,NA,492,138,160,103,190,717,354,557
2017,8,60,"Kirikkale",39.8468,33.5153,13.2571428571429,6.85714285714286,0.228571428571429,63.5857142857143,26.7285714285714,NA,739,96,195,0,0,1747,643,1552
2017,9,60,"Kirikkale",39.8468,33.5153,10.5714285714286,8.67142857142857,2.14257142857143,61.3714285714286,36.4057142857143,NA,574,340,594,0,0,866,234,272
2017,10,60,"Kirikkale",39.8468,33.5153,13.5571428571429,8.47142857142857,1.51428571428571,63.4714285714286,31.0171428571429,NA,712,420,569,94,125,1043,292,474
2017,11,60,"Kirikkale",39.8468,33.5153,15.4142857142857,4.75714285714286,1.52857142857143,74.6,11.8728571428571,NA,525,0,0,56,124,725,525,725
2017,12,60,"Kirikkale",39.8468,33.5153,16.1285714285714,9.75714285714286,0,44.8285714285714,20.08,NA,589,60,66,236,455,1077,529,1011
2017,13,60,"Kirikkale",39.8468,33.5153,17.2428571428571,10.3285714285714,0.0714285714285714,44.4142857142857,19.21,NA,574,150,271,6,30,887,424,616
2017,14,60,"Kirikkale",39.8468,33.5153,12.2142857142857,10.8142857142857,1.82842857142857,48.4857142857143,22.0928571428571,NA,639,187,468,194,323,1336,452,868
2017,15,60,"Kirikkale",39.8468,33.5153,11.9714285714286,9.85714285714286,1.92842857142857,60.2,17.8757142857143,NA,587,155,315,0,0,1187,432,872
2017,16,60,"Kirikkale",39.8468,33.5153,19.3142857142857,11.0428571428571,0.128714285714286,55.7571428571429,13.0971428571429,NA,717,0,0,53,31,920,717,920
2017,17,60,"Kirikkale",39.8468,33.5153,9.85714285714286,13.0142857142857,0,40.1428571428571,21.1342857142857,NA,731,269,706,87,79,1478,462,772
2017,18,60,"Kirikkale",39.8468,33.5153,15.8714285714286,15.9857142857143,2.9,55.9142857142857,19.5142857142857,NA,506,104,214,0,0,923,402,709
2017,19,60,"Kirikkale",39.8468,33.5153,15.1428571428571,18.9142857142857,0.0285714285714286,43.8,24.6614285714286,NA,471,0,0,185,364,966,471,966
2017,20,60,"Kirikkale",39.8468,33.5153,19.3,14.5428571428571,3.28528571428571,55.9428571428571,9.61,NA,472,6,9,22,266,1205,466,1196
2017,21,60,"Kirikkale",39.8468,33.5153,11.7142857142857,14.4857142857143,1.31471428571429,58.7,9.64857142857143,NA,448,111,215,35,78,849,337,634
2017,22,60,"Kirikkale",39.8468,33.5153,14.3285714285714,17.1714285714286,3.01385714285714,68.7,14.9842857142857,NA,522,83,184,117,209,1015,439,831
2017,23,60,"Kirikkale",39.8468,33.5153,11.9714285714286,20.5142857142857,1.08571428571429,56.6142857142857,14.9571428571429,NA,578,32,81,218,650,1388,546,1307
2017,24,60,"Kirikkale",39.8468,33.5153,14.8,20.8857142857143,0.428571428571429,48.2142857142857,13.88,NA,552,72,113,92,144,1139,480,1026
2017,25,60,"Kirikkale",39.8468,33.5153,11.6571428571429,19.3857142857143,1.51457142857143,59.5,12.44,NA,584,143,202,118,243,1041,441,839
2017,26,60,"Kirikkale",39.8468,33.5153,15.3142857142857,27.1714285714286,0,34.1142857142857,19.6757142857143,NA,564,139,234,105,212,971,425,737
2017,27,60,"Kirikkale",39.8468,33.5153,18.0142857142857,24.2285714285714,0,38.3285714285714,25.6185714285714,NA,511,80,148,62,98,642,431,494
2017,28,60,"Kirikkale",39.8468,33.5153,15.8285714285714,26.3142857142857,0.657142857142857,31.9714285714286,25.0571428571429,NA,481,62,62,0,0,864,419,802
2017,29,60,"Kirikkale",39.8468,33.5153,19.7714285714286,26.3,0.571285714285714,40.8,20.9628571428571,NA,532,0,0,66,180,1272,532,1272
2017,30,60,"Kirikkale",39.8468,33.5153,18.3142857142857,26.4571428571429,0,29.9857142857143,31.3314285714286,NA,531,43,42,89,102,928,488,886
2017,31,60,"Kirikkale",39.8468,33.5153,19.2571428571429,24.8571428571429,2.52842857142857,48.4714285714286,22.0328571428571,NA,559,0,0,0,0,1047,559,1047
2017,32,60,"Kirikkale",39.8468,33.5153,17.8,28.1285714285714,0,37.4428571428571,28.2,NA,567,0,0,77,158,1092,567,1092
2017,33,60,"Kirikkale",39.8468,33.5153,16.7714285714286,25.6,0.0287142857142857,45.7857142857143,23.3014285714286,NA,596,0,0,65,198,1199,596,1199
2017,34,60,"Kirikkale",39.8468,33.5153,18.8,22.3571428571429,0,45.5428571428571,22.9228571428571,NA,601,0,0,223,591,1280,601,1280
2017,35,60,"Kirikkale",39.8468,33.5153,15,21.5285714285714,0.314285714285714,42.2857142857143,19.6342857142857,NA,493,0,0,0,0,1014,493,1014
2017,36,60,"Kirikkale",39.8468,33.5153,9.4,21.0714285714286,2.42814285714286,36.4285714285714,26.5814285714286,NA,507,120,242,131,349,1321,387,1079
2017,37,60,"Kirikkale",39.8468,33.5153,12.9857142857143,25.9,0,26.3285714285714,46.82,NA,589,55,121,0,0,1138,534,1017
2017,38,60,"Kirikkale",39.8468,33.5153,13.2571428571429,23.3285714285714,0,30.2571428571429,44.12,NA,671,3,0,114,284,1312,668,1312
2017,39,60,"Kirikkale",39.8468,33.5153,14.3428571428571,17.8857142857143,1.28585714285714,50.3428571428571,21.6985714285714,NA,782,0,0,56,146,1630,782,1630
2017,40,60,"Kirikkale",39.8468,33.5153,11.7142857142857,13.7,0.0574285714285714,48.0285714285714,24.0757142857143,NA,543,195,340,0,0,1137,348,797
2017,41,60,"Kirikkale",39.8468,33.5153,9.85714285714286,12.5428571428571,0.428571428571429,54.0285714285714,20.2142857142857,NA,487,39,54,88,70,843,448,789
2017,42,60,"Kirikkale",39.8468,33.5153,9.17142857142857,12.7428571428571,0,45.5285714285714,37.5342857142857,NA,530,144,189,51,82,815,386,626
2017,43,60,"Kirikkale",39.8468,33.5153,11.6571428571429,12.7571428571429,1.02857142857143,62.5714285714286,38.4714285714286,NA,506,185,302,144,290,919,321,617
2017,44,60,"Kirikkale",39.8468,33.5153,10.8857142857143,6.04285714285714,1.21428571428571,56.0714285714286,42.3785714285714,NA,561,128,233,56,47,1102,433,869
2017,45,60,"Kirikkale",39.8468,33.5153,7.94285714285714,7.08571428571429,0.285714285714286,79.8714285714286,42.7442857142857,NA,577,301,480,0,0,829,276,349
2017,46,60,"Kirikkale",39.8468,33.5153,5.14285714285714,8.92857142857143,0,68.3285714285714,61.8028571428571,NA,587,348,572,0,0,1085,239,513
2017,47,60,"Kirikkale",39.8468,33.5153,10.3714285714286,4.88571428571429,4.75685714285714,74.8428571428571,27.8342857142857,NA,418,49,170,86,72,804,369,634
2017,48,60,"Kirikkale",39.8468,33.5153,8.65714285714286,5.51428571428571,0.243,81.8285714285714,37.26,NA,386,172,238,0,0,619,214,381
2017,49,60,"Kirikkale",39.8468,33.5153,11.9857142857143,3.71428571428571,1.18571428571429,73.1571428571429,25.15,NA,407,71,115,74,109,645,336,530
2017,50,60,"Kirikkale",39.8468,33.5153,7.42857142857143,4.51428571428571,0.228571428571429,85.9857142857143,43.62,NA,346,161,111,0,0,442,185,331
2017,51,60,"Kirikkale",39.8468,33.5153,9.08571428571429,5.38571428571429,3.32857142857143,85.8142857142857,26.255,NA,386,58,49,70,69,349,328,300
2017,52,60,"Kirikkale",39.8468,33.5153,6.85,-0.7625,0.5,91.8375,32.46,NA,528,278,303,0,0,507,250,204
2018,1,60,"Kirikkale",39.8468,33.5153,7.95,3.8625,1.113125,85.5,38.84375,NA,618,307,527,0,0,914,311,387
2018,2,60,"Kirikkale",39.8468,33.5153,8.14285714285714,3.74285714285714,0.828857142857143,89.3142857142857,29.1871428571429,NA,624,278,471,0,0,1309,346,838
2018,3,60,"Kirikkale",39.8468,33.5153,13.0428571428571,3.21428571428571,1.25714285714286,76.4,23.0571428571429,NA,639,40,84,84,35,655,599,571
2018,4,60,"Kirikkale",39.8468,33.5153,15.6,1.01428571428571,3.04271428571429,75.6714285714286,21.1414285714286,NA,604,86,169,4,0,764,518,595
2018,5,60,"Kirikkale",39.8468,33.5153,11.9714285714286,3.97142857142857,0,72.1,27.5814285714286,NA,670,11,24,0,0,819,659,795
2018,6,60,"Kirikkale",39.8468,33.5153,9.88571428571429,6.94285714285714,0.657142857142857,75.6428571428571,50.345,NA,704,293,461,82,122,1022,411,561
2018,7,60,"Kirikkale",39.8468,33.5153,13.0285714285714,5.3,0.628714285714286,72.7428571428571,30.0466666666667,NA,478,33,55,44,23,557,445,502
2018,8,60,"Kirikkale",39.8468,33.5153,9.41428571428571,6.74285714285714,0.343,75.0285714285714,30.0233333333333,NA,711,1,10,94,320,1321,710,1311
2018,9,60,"Kirikkale",39.8468,33.5153,15.9142857142857,6.14285714285714,2.90014285714286,70.8571428571429,24.6433333333333,NA,621,103,165,87,145,956,518,791
2018,10,60,"Kirikkale",39.8468,33.5153,10.4285714285714,9.68571428571429,1.857,70.6285714285714,39.7216666666667,NA,556,30,82,62,126,1330,526,1248
2018,11,60,"Kirikkale",39.8468,33.5153,11.4571428571429,10.7857142857143,0.271428571428571,63.3142857142857,24.8233333333333,NA,551,67,215,0,0,1426,484,1211
2018,12,60,"Kirikkale",39.8468,33.5153,15.6142857142857,12.7857142857143,0.0857142857142857,49.9142857142857,44.694,NA,425,0,0,6,5,1187,425,1187
2018,13,60,"Kirikkale",39.8468,33.5153,13.5142857142857,11.6142857142857,3.64257142857143,59.3428571428571,21.88,NA,356,75,41,11,7,428,281,387
2018,14,60,"Kirikkale",39.8468,33.5153,9.34285714285714,12.5285714285714,0.1,51.5571428571429,29.8385714285714,NA,407,207,203,0,0,486,200,283
2018,15,60,"Kirikkale",39.8468,33.5153,13.8571428571429,15.3285714285714,1.88542857142857,58.4857142857143,24.435,NA,374,158,117,0,0,450,216,333
2018,16,60,"Kirikkale",39.8468,33.5153,12.2142857142857,13.2142857142857,0,42.7857142857143,NA,NA,411,212,218,0,0,648,199,430
2018,17,60,"Kirikkale",39.8468,33.5153,14.0714285714286,18.2857142857143,0,33.5,NA,NA,419,87,125,14,51,652,332,527
2018,18,60,"Kirikkale",39.8468,33.5153,16.4714285714286,19.1714285714286,2.17114285714286,48.7714285714286,NA,NA,303,81,188,0,0,474,222,286
2018,19,60,"Kirikkale",39.8468,33.5153,13.5,14.5857142857143,9.799,74.0285714285714,NA,NA,275,42,38,53,99,467,233,429
2018,20,60,"Kirikkale",39.8468,33.5153,10.3714285714286,19.3857142857143,2.98557142857143,57.5571428571429,NA,NA,204,59,101,1,0,306,145,205
2018,21,60,"Kirikkale",39.8468,33.5153,17.7142857142857,19.1714285714286,2.61442857142857,62.7142857142857,18.2133333333333,21.33,252,0,0,0,0,281,252,281
2018,22,60,"Kirikkale",39.8468,33.5153,19.0428571428571,19.1285714285714,6.75657142857143,60.1428571428571,23.3814285714286,32.1825,249,31,26,0,0,427,218,401
2018,23,60,"Kirikkale",39.8468,33.5153,15.3571428571429,21.8142857142857,0.0714285714285714,45.6571428571429,27.392,34.974,267,46,143,70,280,812,221,669
2018,24,60,"Kirikkale",39.8468,33.5153,15.1428571428571,22.3714285714286,1.48585714285714,44.2142857142857,NA,34.4166666666667,267,27,22,34,31,448,240,426
2018,25,60,"Kirikkale",39.8468,33.5153,15.6142857142857,21.4571428571429,2.65728571428571,59.4,16.6816666666667,22.836,358,0,0,64,73,518,358,518
2018,26,60,"Kirikkale",39.8468,33.5153,13.5571428571429,25.4142857142857,0.000142857142857143,38.9571428571429,12.55,24.298,355,38,50,89,183,587,317,537
2018,27,60,"Kirikkale",39.8468,33.5153,15.8714285714286,25.0142857142857,0,38.8714285714286,NA,3.158,342,38,64,0,0,418,304,354
2018,28,60,"Kirikkale",39.8468,33.5153,17.2857142857143,27.0428571428571,0,37.0142857142857,NA,2.77666666666667,286,43,90,0,0,585,243,495
2018,29,60,"Kirikkale",39.8468,33.5153,15.3142857142857,24.3857142857143,0.228571428571429,40.1285714285714,NA,NA,260,0,0,66,147,756,260,756
2018,30,60,"Kirikkale",39.8468,33.5153,15.1428571428571,26.0285714285714,0.0144285714285714,40.5857142857143,26.718,26.468,265,9,20,107,481,822,256,802
2018,31,60,"Kirikkale",39.8468,33.5153,20.3714285714286,26.1857142857143,0.129,42.7857142857143,25.5628571428571,17.4716666666667,267,7,9,0,0,499,260,490
2018,32,60,"Kirikkale",39.8468,33.5153,20.0857142857143,23.2857142857143,0.00514285714285714,41.1714285714286,23.3814285714286,17.5128571428571,297,0,0,0,0,403,297,403
2018,33,60,"Kirikkale",39.8468,33.5153,18.3571428571429,24.4571428571429,0,32.5428571428571,26.66,29.312,216,0,0,0,0,332,216,332
2018,34,60,"Kirikkale",39.8468,33.5153,14.5857142857143,25.4142857142857,0,31.6142857142857,29.1542857142857,NA,144,0,0,1,0,227,144,227
2018,35,60,"Kirikkale",39.8468,33.5153,17.5285714285714,26.6428571428571,0.137857142857143,35.3428571428571,31.4785714285714,18.9666666666667,201,0,0,0,0,314,201,314
2018,36,60,"Kirikkale",39.8468,33.5153,15.4,22.4285714285714,1.07414285714286,44.9285714285714,38.1766666666667,33.385,341,0,0,146,153,370,341,370
2018,37,60,"Kirikkale",39.8468,33.5153,19.1285714285714,19.3285714285714,0.285714285714286,50.1857142857143,24.53,23.7466666666667,241,0,0,29,33,419,241,419
2018,38,60,"Kirikkale",39.8468,33.5153,17.9714285714286,18.2142857142857,0,42.9571428571429,20.7175,28.23,189,31,48,0,0,344,158,296
2018,39,60,"Kirikkale",39.8468,33.5153,19.8857142857143,16.9857142857143,0.0571428571428571,46.9285714285714,NA,33.43,180,29,64,18,40,353,151,289
2018,40,60,"Kirikkale",39.8468,33.5153,14.6428571428571,15.8714285714286,0.166714285714286,52.8285714285714,NA,31.5575,191,0,0,6,17,341,191,341
2018,41,60,"Kirikkale",39.8468,33.5153,13.9142857142857,16.0857142857143,0.757,54.7285714285714,NA,41.6142857142857,187,0,0,0,0,422,187,422
2018,42,60,"Kirikkale",39.8468,33.5153,9.61428571428571,16.6428571428571,2.21185714285714,62.5285714285714,NA,63.424,168,3,10,19,64,381,165,371
2018,43,60,"Kirikkale",39.8468,33.5153,12.0571428571429,9.97142857142857,2.143,71.4714285714286,NA,83.935,187,31,39,62,169,402,156,363
2018,44,60,"Kirikkale",39.8468,33.5153,8.68571428571429,11.0714285714286,0,57.9,NA,101.685714285714,196,5,0,0,0,264,191,264
2018,45,60,"Kirikkale",39.8468,33.5153,10.4285714285714,9.14285714285714,0,60.9571428571429,NA,69.4783333333333,231,29,45,0,0,473,202,428
2018,46,60,"Kirikkale",39.8468,33.5153,11.2285714285714,5.9,0,62.0142857142857,NA,59.6933333333333,230,65,61,28,67,465,165,404
2018,47,60,"Kirikkale",39.8468,33.5153,12.3142857142857,8.45714285714286,1.02857142857143,71.5428571428571,NA,55.1183333333333,270,43,20,22,13,499,227,479
2018,48,60,"Kirikkale",39.8468,33.5153,12.7857142857143,7.92857142857143,3.48557142857143,82.7142857142857,NA,56.505,245,55,23,3,3,201,190,178
2018,49,60,"Kirikkale",39.8468,33.5153,11.1142857142857,4.41428571428571,1.17128571428571,80.7714285714286,NA,52.374,257,2,2,30,31,420,255,418
2018,50,60,"Kirikkale",39.8468,33.5153,13.7714285714286,3.61428571428571,1.97142857142857,83.6857142857143,54.0866666666667,54.926,256,44,4,41,53,305,212,301
2018,51,60,"Kirikkale",39.8468,33.5153,11.4285714285714,6.11428571428571,2.39985714285714,82.1571428571429,48.1914285714286,56.2525,250,59,76,39,31,248,191,172
2018,52,60,"Kirikkale",39.8468,33.5153,9.34285714285714,-0.585714285714286,3.48642857142857,79.0714285714286,41.34,42.18,244,26,17,33,31,273,218,256
2019,1,60,"Kirikkale",39.8468,33.5153,18.3375,1.9625,3.987375,83.4875,40.7275,38.43,343,3,0,66,165,784,340,784
2019,2,60,"Kirikkale",39.8468,33.5153,11.3142857142857,-2,0.785714285714286,80.8142857142857,52.1114285714286,77.01,255,23,2,53,62,208,232,206
2019,3,60,"Kirikkale",39.8468,33.5153,15.6857142857143,1.12857142857143,1.2,77.5,52.3985714285714,46.3066666666667,192,35,30,32,26,198,157,168
2019,4,60,"Kirikkale",39.8468,33.5153,11.8142857142857,4.38571428571429,2.99971428571429,81.8857142857143,72.7442857142857,40.852,308,101,102,0,0,314,207,212
2019,5,60,"Kirikkale",39.8468,33.5153,11.2285714285714,5.2,0.571428571428572,73.4714285714286,60.6671428571429,56.932,253,72,48,0,0,143,181,95
2019,6,60,"Kirikkale",39.8468,33.5153,11.8857142857143,5.67142857142857,4.28571428571429,79.0571428571428,61.1128571428571,68.615,276,5,6,41,32,127,271,121
2019,7,60,"Kirikkale",39.8468,33.5153,15.6,5.02857142857143,0.0285714285714286,70.1142857142857,50.0133333333333,48.2633333333333,325,28,2,0,0,234,297,232
2019,8,60,"Kirikkale",39.8468,33.5153,11.8857142857143,5.31428571428571,0.757,66.0571428571429,68.0816666666667,61.0814285714286,305,48,13,7,23,219,257,206
2019,9,60,"Kirikkale",39.8468,33.5153,14.6142857142857,3.58571428571429,0.0285714285714286,64.7142857142857,42.9871428571429,41.855,331,0,0,60,52,310,331,310
2019,10,60,"Kirikkale",39.8468,33.5153,11.8714285714286,7.08571428571429,0.0714285714285714,55.4142857142857,47.6757142857143,NA,359,68,67,65,71,252,291,185
2019,11,60,"Kirikkale",39.8468,33.5153,16.3714285714286,8.44285714285714,2.04342857142857,66.4,36.7985714285714,32.456,373,0,0,59,139,400,373,400
2019,12,60,"Kirikkale",39.8468,33.5153,14.2142857142857,8.24285714285714,0,50.8142857142857,47.7785714285714,47.0128571428571,343,0,0,2,2,416,343,416
2019,13,60,"Kirikkale",39.8468,33.5153,21.6714285714286,5.88571428571429,0,49.0571428571429,36.3257142857143,28.8714285714286,256,42,4,0,0,194,214,190
2019,14,60,"Kirikkale",39.8468,33.5153,10.6285714285714,10.7285714285714,0,47.7285714285714,46.12,41.3142857142857,365,112,56,29,13,208,253,152
2019,15,60,"Kirikkale",39.8468,33.5153,15.9571428571429,11.9428571428571,2.22857142857143,66.7571428571429,34.7566666666667,34.37,359,5,2,0,0,183,354,181
2019,16,60,"Kirikkale",39.8468,33.5153,16.0142857142857,7.2,1.47128571428571,63.9857142857143,21.1142857142857,26.9371428571429,318,0,0,18,24,208,318,208
2019,17,60,"Kirikkale",39.8468,33.5153,12.9142857142857,11.9285714285714,0.0428571428571429,55.1,21.81,43.1414285714286,412,22,67,4,2,313,390,246
2019,18,60,"Kirikkale",39.8468,33.5153,16.2142857142857,16.2,0.143,47.4142857142857,26.7966666666667,34.96,523,76,23,74,45,353,447,330
2019,19,60,"Kirikkale",39.8468,33.5153,11.6714285714286,13.6714285714286,0.769857142857143,62.3428571428571,35.895,30.9642857142857,452,7,4,168,113,386,445,382
2019,20,60,"Kirikkale",39.8468,33.5153,13.7142857142857,19.5285714285714,0.285714285714286,48.5857142857143,37.47,33.9328571428571,454,0,0,89,73,389,454,389
2019,21,60,"Kirikkale",39.8468,33.5153,15.3142857142857,19.7571428571429,1.06571428571429,53.7428571428571,43.1985714285714,33.8671428571429,457,0,0,119,178,413,457,413
2019,22,60,"Kirikkale",39.8468,33.5153,13.2571428571429,23.1428571428571,2.15685714285714,46.7142857142857,51.6414285714286,37.2357142857143,453,0,0,116,76,323,453,323
2019,23,60,"Kirikkale",39.8468,33.5153,13.8857142857143,23.2714285714286,4.771,46.6285714285714,41.9957142857143,30.7128571428571,378,62,66,0,0,532,316,466
2019,24,60,"Kirikkale",39.8468,33.5153,19.6,20.1,10.8065714285714,67.7857142857143,27.8,35.24,378,0,0,55,16,244,378,244
2019,25,60,"Kirikkale",39.8468,33.5153,15.6142857142857,21.5857142857143,2.49928571428571,63.9857142857143,23.8225,29.516,306,0,0,20,26,325,306,325
2019,26,60,"Kirikkale",39.8468,33.5153,15.4142857142857,23.5857142857143,0,47.6428571428571,31.8271428571429,26.8885714285714,377,0,0,6,2,342,377,342
2019,27,60,"Kirikkale",39.8468,33.5153,18.5285714285714,23.1571428571429,0.000142857142857143,40.7,38.2871428571429,25.5542857142857,456,0,0,0,0,222,456,222
2019,28,60,"Kirikkale",39.8468,33.5153,13.8,22.3857142857143,1.08571428571429,47.1714285714286,40.21,30.6314285714286,398,0,0,71,85,421,398,421
2019,29,60,"Kirikkale",39.8468,33.5153,17.8,20.8857142857143,1.05714285714286,56.1857142857143,28.55,27.25,453,0,0,36,4,203,453,203
2019,30,60,"Kirikkale",39.8468,33.5153,16.9285714285714,23.6,0,40.6857142857143,39.7971428571429,25.6557142857143,456,0,0,0,0,335,456,335
2019,31,60,"Kirikkale",39.8468,33.5153,14.8428571428571,26.7571428571429,0,39.6428571428571,57.48,33.0357142857143,334,54,55,81,122,375,280,320
2019,32,60,"Kirikkale",39.8468,33.5153,19.6714285714286,23.1857142857143,0,37.5857142857143,37.83,25.7385714285714,346,0,0,0,0,395,346,395
2019,33,60,"Kirikkale",39.8468,33.5153,17.0714285714286,25.2142857142857,3.08557142857143,41.5142857142857,38.5628571428571,31.25,337,0,0,5,21,531,337,531
2019,34,60,"Kirikkale",39.8468,33.5153,19.6,22.1857142857143,1.91414285714286,57.8142857142857,37.5728571428571,34.4085714285714,299,0,0,21,10,345,299,345
2019,35,60,"Kirikkale",39.8468,33.5153,18.3428571428571,23.9142857142857,0,43.3714285714286,41.3071428571429,30.8242857142857,307,0,0,0,0,415,307,415
2019,36,60,"Kirikkale",39.8468,33.5153,15.3571428571429,22.6857142857143,0,41.4714285714286,39.6685714285714,37.88,171,0,0,3,2,67,171,67
2019,37,60,"Kirikkale",39.8468,33.5153,17.7142857142857,20.9428571428571,0,43.0714285714286,33.6028571428571,29.9916666666667,218,0,0,0,0,55,218,55
2019,38,60,"Kirikkale",39.8468,33.5153,13.8571428571429,18.3285714285714,0,41.9714285714286,53.705,52.4266666666667,266,37,15,38,6,91,229,76
2019,39,60,"Kirikkale",39.8468,33.5153,10.5714285714286,17.8714285714286,0.0428571428571429,47.1857142857143,NA,63.772,237,63,11,78,32,79,174,68
2019,40,60,"Kirikkale",39.8468,33.5153,9.71428571428572,18.8428571428571,0,39.3857142857143,64.96,76.79,241,63,54,74,20,111,178,57
2019,41,60,"Kirikkale",39.8468,33.5153,10.3285714285714,16.3571428571429,0,52.9,42.3457142857143,55.7928571428571,416,0,0,118,98,448,416,448
2019,42,60,"Kirikkale",39.8468,33.5153,7.54285714285714,16.5571428571429,0.0285714285714286,49.7714285714286,71.9228571428571,101.597142857143,356,83,95,0,0,408,273,313
2019,43,60,"Kirikkale",39.8468,33.5153,12.9428571428571,14.2857142857143,0.285714285714286,60.6571428571429,37.9214285714286,51.5442857142857,306,0,0,0,0,300,306,300
2019,44,60,"Kirikkale",39.8468,33.5153,7.97142857142857,10.3285714285714,1.28571428571429,62.3285714285714,61.1242857142857,92.71,350,117,87,107,106,250,233,163
2019,45,60,"Kirikkale",39.8468,33.5153,5.77142857142857,10.9285714285714,0,60.5428571428571,82.8542857142857,118.15,417,181,173,0,0,328,236,155
2019,46,60,"Kirikkale",39.8468,33.5153,6.78571428571429,10.6857142857143,0.0142857142857143,56.3285714285714,113.895714285714,146.447142857143,401,0,0,0,0,337,401,337
2019,47,60,"Kirikkale",39.8468,33.5153,5.44285714285714,3.74285714285714,0,73.4428571428572,117.608571428571,148.394285714286,391,123,73,48,50,339,268,266
2019,48,60,"Kirikkale",39.8468,33.5153,9.05714285714286,8.07142857142857,3.61571428571429,79.5142857142857,76.7842857142857,89.016,320,0,0,28,65,251,320,251
2019,49,60,"Kirikkale",39.8468,33.5153,10.2142857142857,1.17142857142857,1.29314285714286,80.9857142857143,48.48,51.15,393,10,5,48,37,274,383,269
2019,50,60,"Kirikkale",39.8468,33.5153,8.45714285714286,5.12857142857143,0.582285714285714,81.6428571428571,60.8866666666667,39.3485714285714,218,105,81,0,0,119,113,38
2019,51,60,"Kirikkale",39.8468,33.5153,5.01428571428571,1.95714285714286,0,90.6571428571429,74.0071428571429,32.4771428571429,361,169,139,4,3,488,192,349
2019,52,60,"Kirikkale",39.8468,33.5153,12.9571428571429,5.28571428571429,6.92028571428571,80.3714285714286,37.8985714285714,32.2642857142857,279,41,88,45,22,281,238,193
2020,1,60,"Kirikkale",39.8468,33.5153,13.04,2.06,0.9398,77.18,43.33,31.64,160,2,1,28,14,126,158,125
2020,2,60,"Kirikkale",39.8468,33.5153,12.1428571428571,1.42857142857143,0.958714285714286,77.9142857142857,53.6157142857143,36.0828571428571,240,0,0,16,19,173,240,173
2020,3,60,"Kirikkale",39.8468,33.5153,9.22857142857143,0.714285714285714,0,73.0857142857143,74.1742857142857,41.5342857142857,270,11,3,1,0,382,259,379
2020,4,60,"Kirikkale",39.8468,33.5153,11.5285714285714,-0.771428571428571,0.157142857142857,67.5714285714286,43.8514285714286,31.7,358,0,0,98,57,295,358,295
2020,5,60,"Kirikkale",39.8468,33.5153,12.7,3.8,2.03142857142857,74.7428571428571,45.1885714285714,28.55,331,41,37,33,24,272,290,235
2020,6,60,"Kirikkale",39.8468,33.5153,23.2,3.72857142857143,2.89842857142857,69.6142857142857,21.8442857142857,23.5871428571429,343,0,0,83,64,267,343,267
2020,7,60,"Kirikkale",39.8468,33.5153,11.7285714285714,1.42857142857143,0.965142857142857,70.9428571428571,27.564,30.2257142857143,341,16,10,28,14,338,325,328
2020,8,60,"Kirikkale",39.8468,33.5153,11.1857142857143,3.77142857142857,1.601,69.4571428571429,44.1114285714286,40.2142857142857,283,3,11,0,0,187,280,176
2020,9,60,"Kirikkale",39.8468,33.5153,17.5285714285714,6.54285714285714,1.44242857142857,61.7428571428571,34.7957142857143,31.1571428571429,393,0,0,52,41,528,393,528
2020,10,60,"Kirikkale",39.8468,33.5153,12.5142857142857,9.64285714285714,0.0857142857142857,56.9,52.6628571428571,39.3128571428571,205,58,32,0,0,210,147,178
2020,11,60,"Kirikkale",39.8468,33.5153,14.6857142857143,12.9857142857143,0.228571428571429,50.6142857142857,49.6957142857143,34.5614285714286,115,8,3,34,34,94,107,91
2020,12,60,"Kirikkale",39.8468,33.5153,16.9714285714286,2.98571428571429,1.93014285714286,67.9285714285714,18.085,21.0014285714286,117,1,0,12,7,118,116,118
2020,13,60,"Kirikkale",39.8468,33.5153,15.5428571428571,10.2714285714286,2.24942857142857,63.9285714285714,29.684,28.1542857142857,136,0,0,3,8,92,136,92
2020,14,60,"Kirikkale",39.8468,33.5153,18.2714285714286,8.52857142857143,3.45614285714286,69.6857142857143,29.7828571428571,26,155,0,0,10,1,121,155,121
2020,15,60,"Kirikkale",39.8468,33.5153,28.1142857142857,9.31428571428571,0.063,46.4857142857143,26.8442857142857,21.7028571428571,133,0,0,8,3,118,133,118
2020,16,60,"Kirikkale",39.8468,33.5153,18.5285714285714,11.5571428571429,1.54614285714286,53.5142857142857,34.1885714285714,26.4357142857143,141,12,9,37,20,106,129,97
2020,17,60,"Kirikkale",39.8468,33.5153,17.8714285714286,10.4714285714286,0.502571428571429,52.9142857142857,26.6,22.3283333333333,137,0,0,60,65,123,137,123
2020,18,60,"Kirikkale",39.8468,33.5153,21.3142857142857,12.4,2.42857142857143,61.4571428571429,30.0185714285714,27.1471428571429,146,17,16,41,78,164,129,148
2020,19,60,"Kirikkale",39.8468,33.5153,20.1428571428571,12.0857142857143,1.06871428571429,61.5285714285714,21.4671428571429,20.1657142857143,137,0,0,32,17,157,137,157
2020,20,60,"Kirikkale",39.8468,33.5153,18.4571428571429,20.7285714285714,0,44.5285714285714,68.5971428571429,27.5357142857143,164,0,0,94,91,164,164,164
2020,21,60,"Kirikkale",39.8468,33.5153,25.9142857142857,18.2571428571429,0.285714285714286,47.1428571428571,58.3542857142857,17.5057142857143,146,0,0,47,35,96,146,96
2020,22,60,"Kirikkale",39.8468,33.5153,21.6285714285714,14.3142857142857,0.654142857142857,58.9857142857143,19.9628571428571,18.0128571428571,118,0,0,57,65,100,118,100
2020,23,60,"Kirikkale",39.8468,33.5153,15.2428571428571,18.5,0.840142857142857,49.4,29.8285714285714,26.4871428571429,112,17,14,38,29,70,95,56
2020,24,60,"Kirikkale",39.8468,33.5153,16.7428571428571,21.1142857142857,4.55014285714286,53.0285714285714,45.5257142857143,25.1633333333333,140,7,42,74,45,150,133,108
2020,25,60,"Kirikkale",39.8468,33.5153,13.6714285714286,19.5142857142857,3.73985714285714,67.0714285714286,28.3171428571429,24.13,137,17,4,65,74,108,120,104
2020,26,60,"Kirikkale",39.8468,33.5153,14.3571428571429,22.4857142857143,0.789857142857143,54.5142857142857,31.3528571428571,16.7928571428571,173,0,0,36,32,133,173,133
2020,27,60,"Kirikkale",39.8468,33.5153,15.6142857142857,25.6571428571429,0,40.8571428571429,35.4071428571429,18.2328571428571,113,0,0,4,2,113,113,113
2020,28,60,"Kirikkale",39.8468,33.5153,18.9857142857143,25.1428571428571,0.175571428571429,44.7571428571429,35.4725,15.1728571428571,164,0,0,6,6,122,164,122
2020,29,60,"Kirikkale",39.8468,33.5153,17.5571428571429,25.6,0,45.7,33.4716666666667,13.5471428571429,186,0,0,11,4,111,186,111
2020,30,60,"Kirikkale",39.8468,33.5153,17.7857142857143,25.4142857142857,0,38.9714285714286,39.1428571428571,17.1385714285714,190,0,0,26,19,142,190,142
2020,31,60,"Kirikkale",39.8468,33.5153,17.6142857142857,26.4285714285714,0,40.3714285714286,35.2071428571429,15.8685714285714,150,0,0,27,24,127,150,127
2020,32,60,"Kirikkale",39.8468,33.5153,16.4571428571429,26.0571428571429,0,31.5428571428571,30.4585714285714,18.1528571428571,146,0,0,0,0,107,146,107
2020,33,60,"Kirikkale",39.8468,33.5153,17.5142857142857,23.8285714285714,0,39.4285714285714,35.3614285714286,17.344,183,0,0,0,0,83,183,83
2020,34,60,"Kirikkale",39.8468,33.5153,16.2571428571429,23.1428571428571,0,39.0142857142857,40.3385714285714,25.2366666666667,197,21,2,10,5,97,176,95
2020,35,60,"Kirikkale",39.8468,33.5153,12.1428571428571,25.2857142857143,0,31.4714285714286,45.7957142857143,32.0785714285714,164,0,0,8,9,157,164,157
2020,36,60,"Kirikkale",39.8468,33.5153,11.3285714285714,26.2714285714286,0,30.0428571428571,72.21,23.41,179,0,0,41,47,112,179,112
2020,37,60,"Kirikkale",39.8468,33.5153,14.7142857142857,23.6,0.719285714285714,46.5142857142857,61.4128571428571,22.51,193,0,0,7,6,91,193,91
2020,38,60,"Kirikkale",39.8468,33.5153,18.0428571428571,22.7857142857143,0.0142857142857143,42.4,45.32,18.1957142857143,235,0,0,27,23,157,235,157
2020,39,60,"Kirikkale",39.8468,33.5153,12.7285714285714,19.7571428571429,0.232428571428571,54.8571428571429,44.784,28.4233333333333,220,7,4,99,49,129,213,125
2020,40,60,"Kirikkale",39.8468,33.5153,10.9857142857143,18.8,0.0357142857142857,43.5428571428571,72.405,36.4828571428571,187,0,0,79,66,154,187,154
2020,41,60,"Kirikkale",39.8468,33.5153,10.5857142857143,20.5142857142857,0.125857142857143,40.9,90.66,36.0157142857143,182,12,6,69,64,127,170,121
2020,42,60,"Kirikkale",39.8468,33.5153,9.55714285714286,18.0142857142857,0.714285714285714,45.2285714285714,93.4442857142857,40.3657142857143,177,0,0,0,0,111,177,111
2020,43,60,"Kirikkale",39.8468,33.5153,10.8714285714286,15.5142857142857,0.879571428571429,59.7428571428571,49.4542857142857,31.4285714285714,194,1,3,0,0,161,193,158
2020,44,60,"Kirikkale",39.8468,33.5153,8.81428571428571,13.5714285714286,2.24042857142857,59.6571428571429,65.4071428571429,38.4642857142857,255,48,30,29,44,233,207,203
2020,45,60,"Kirikkale",39.8468,33.5153,13.3,9.22857142857143,1.22857142857143,69.4,43.4257142857143,30.09,156,0,0,0,0,103,156,103
2020,46,60,"Kirikkale",39.8468,33.5153,9.05714285714286,7.04285714285714,0,71.9285714285714,65.1128571428571,39.5728571428571,208,0,0,2,0,109,208,109
2020,47,60,"Kirikkale",39.8468,33.5153,11.8285714285714,4.71428571428571,0,67.0142857142857,58.4485714285714,33.6042857142857,173,19,2,0,0,83,154,81
2020,48,60,"Kirikkale",39.8468,33.5153,8.25714285714286,1.77142857142857,0,66.1428571428571,82.3114285714286,41.1414285714286,199,1,1,0,0,262,198,261
2020,49,60,"Kirikkale",39.8468,33.5153,4.71428571428571,4.41428571428571,0.133714285714286,68.5714285714286,117.247142857143,50.4714285714286,207,4,4,14,1,116,203,112
2020,50,60,"Kirikkale",39.8468,33.5153,8.54285714285714,5.3,1.56785714285714,84.9857142857143,81.1042857142857,40.2557142857143,181,53,17,0,0,98,128,81
2020,51,60,"Kirikkale",39.8468,33.5153,9.15714285714286,6.2,1.624,80.4857142857143,71.185,37.682,171,59,29,25,24,90,112,61
2020,52,60,"Kirikkale",39.8468,33.5153,8.95714285714286,2.37142857142857,0,75.5714285714286,66.735,33.4542857142857,203,0,0,12,24,113,203,113
2020,53,60,"Kirikkale",39.8468,33.5153,6.05,5.225,0.3475,77.75,98.415,40.1525,122,28,6,0,0,111,94,105
2017,1,61,"Kirklareli",41.7333,27.2167,11.7571428571429,-1.32857142857143,6.62642857142857,89.1571428571429,89.1328571428571,NA,563,285,394,163,295,847,278,453
2017,2,61,"Kirklareli",41.7333,27.2167,13,-2,4.52885714285714,85.0428571428571,78.0071428571429,NA,757,219,313,265,437,1214,538,901
2017,3,61,"Kirklareli",41.7333,27.2167,14.3714285714286,0.7,2.28628571428571,84.0428571428571,54.9028571428571,NA,762,0,0,97,119,1449,762,1449
2017,4,61,"Kirklareli",41.7333,27.2167,16.5571428571429,-0.0857142857142856,0,74.4142857142857,69.1357142857143,NA,639,0,0,52,75,889,639,889
2017,5,61,"Kirklareli",41.7333,27.2167,12.0285714285714,4.1,0.171428571428571,80.3285714285714,81.96,NA,588,143,272,0,0,1163,445,891
2017,6,61,"Kirklareli",41.7333,27.2167,19.7571428571429,4.14285714285714,1.41371428571429,84,63.1866666666667,NA,736,180,329,0,0,1519,556,1190
2017,7,61,"Kirklareli",41.7333,27.2167,15.1714285714286,2.65714285714286,2.043,68.8857142857143,84.285,NA,492,156,181,0,0,717,336,536
2017,8,61,"Kirklareli",41.7333,27.2167,15.4428571428571,8.74285714285714,4.31271428571429,81.3,58.2571428571429,NA,739,19,47,251,557,1747,720,1700
2017,9,61,"Kirklareli",41.7333,27.2167,12.1142857142857,9.64285714285714,1.44242857142857,77.5,78.4971428571428,NA,574,182,250,157,271,866,392,616
2017,10,61,"Kirklareli",41.7333,27.2167,19.5857142857143,9.87142857142857,0.787142857142857,78.3142857142857,63.7328571428571,NA,712,100,158,0,0,1043,612,885
2017,11,61,"Kirklareli",41.7333,27.2167,14.3571428571429,6.31428571428571,1.31485714285714,81.0571428571428,63.3571428571429,NA,525,0,0,149,184,725,525,725
2017,12,61,"Kirklareli",41.7333,27.2167,15.6428571428571,12.1571428571429,0.143285714285714,58.8428571428571,64.9628571428571,NA,589,0,0,39,65,1077,589,1077
2017,13,61,"Kirklareli",41.7333,27.2167,15.4857142857143,10.4428571428571,0.571285714285714,56.5571428571429,65.3685714285714,NA,574,5,1,89,150,887,569,886
2017,14,61,"Kirklareli",41.7333,27.2167,11.2857142857143,11.0428571428571,1.74214285714286,66,57.7685714285714,NA,639,100,289,248,480,1336,539,1047
2017,15,61,"Kirklareli",41.7333,27.2167,12.1571428571429,13.9285714285714,0,54.3142857142857,61.4928571428571,NA,587,208,267,78,215,1187,379,920
2017,16,61,"Kirklareli",41.7333,27.2167,15.4285714285714,8.62857142857143,8.85657142857143,77.1428571428571,42.6925,NA,717,305,361,241,244,920,412,559
2017,17,61,"Kirklareli",41.7333,27.2167,11.5857142857143,15.6571428571429,0.428571428571429,52.2428571428571,70.44,NA,731,533,1038,97,111,1478,198,440
2017,18,61,"Kirklareli",41.7333,27.2167,13.8,17.9428571428571,1.77042857142857,58.7714285714286,80.1114285714286,NA,506,73,104,1,0,923,433,819
2017,19,61,"Kirklareli",41.7333,27.2167,11.4857142857143,16.9714285714286,2.02928571428571,73.1714285714286,51.1614285714286,NA,471,63,109,61,100,966,408,857
2017,20,61,"Kirklareli",41.7333,27.2167,17.2285714285714,16.6428571428571,0.828142857142857,59.3142857142857,52.6785714285714,NA,472,0,0,53,42,1205,472,1205
2017,21,61,"Kirklareli",41.7333,27.2167,13.4285714285714,17.0285714285714,1.13114285714286,67.4,43.6571428571429,NA,448,118,216,44,69,849,330,633
2017,22,61,"Kirklareli",41.7333,27.2167,13.8,21.1571428571429,2.17542857142857,66.9,56.2271428571429,NA,522,0,0,109,132,1015,522,1015
2017,23,61,"Kirklareli",41.7333,27.2167,14.3,20.8714285714286,0.115428571428571,66.9571428571429,48.5414285714286,NA,578,86,230,97,335,1388,492,1158
2017,24,61,"Kirklareli",41.7333,27.2167,12.3,21.3428571428571,1.07128571428571,61.2428571428571,49.8028571428571,NA,552,106,177,106,265,1139,446,962
2017,25,61,"Kirklareli",41.7333,27.2167,12.9285714285714,23.8142857142857,0.487285714285714,62.3142857142857,48.6642857142857,NA,584,68,167,176,331,1041,516,874
2017,26,61,"Kirklareli",41.7333,27.2167,11.7857142857143,28.2714285714286,0.285571428571429,53.6142857142857,53.8885714285714,NA,564,360,674,0,0,971,204,297
2017,27,61,"Kirklareli",41.7333,27.2167,15.9,23.2428571428571,4.08414285714286,61.0857142857143,50.3485714285714,NA,511,25,20,4,32,642,486,622
2017,28,61,"Kirklareli",41.7333,27.2167,15.9571428571429,25.2,0.002,58.9571428571429,55.0857142857143,NA,481,67,96,1,3,864,414,768
2017,29,61,"Kirklareli",41.7333,27.2167,16.2142857142857,23.5857142857143,5.20085714285714,56.5285714285714,68.3785714285714,NA,532,47,104,0,0,1272,485,1168
2017,30,61,"Kirklareli",41.7333,27.2167,14.5142857142857,25.2428571428571,0.128571428571429,58.2285714285714,64.8471428571429,NA,531,206,458,150,173,928,325,470
2017,31,61,"Kirklareli",41.7333,27.2167,17.5428571428571,27.5428571428571,0,53.6714285714286,75.6342857142857,NA,559,0,0,0,0,1047,559,1047
2017,32,61,"Kirklareli",41.7333,27.2167,19.5857142857143,27.8142857142857,0,56.9285714285714,65.6942857142857,NA,567,0,0,0,0,1092,567,1092
2017,33,61,"Kirklareli",41.7333,27.2167,18.4428571428571,26.0571428571429,0,51.6857142857143,74.6571428571429,NA,596,0,0,73,170,1199,596,1199
2017,34,61,"Kirklareli",41.7333,27.2167,12.2,21.8571428571429,1.17128571428571,61.6,51.4857142857143,NA,601,0,0,112,252,1280,601,1280
2017,35,61,"Kirklareli",41.7333,27.2167,13.2714285714286,22.0428571428571,0.143,57.5142857142857,47.5928571428571,NA,493,177,390,0,0,1014,316,624
2017,36,61,"Kirklareli",41.7333,27.2167,12.3571428571429,22.5857142857143,0.342857142857143,47.2857142857143,56.7771428571429,NA,507,149,457,92,229,1321,358,864
2017,37,61,"Kirklareli",41.7333,27.2167,12.5571428571429,24.9,0,53.9142857142857,71.36,NA,589,127,225,0,0,1138,462,913
2017,38,61,"Kirklareli",41.7333,27.2167,12.5571428571429,20.9571428571429,0.457285714285714,61.5142857142857,66.2671428571429,NA,671,170,240,183,413,1312,501,1072
2017,39,61,"Kirklareli",41.7333,27.2167,21.9714285714286,15.6142857142857,4.08814285714286,79.3857142857143,51.4942857142857,NA,782,0,0,0,0,1630,782,1630
2017,40,61,"Kirklareli",41.7333,27.2167,12.9142857142857,14.4857142857143,3.28957142857143,74.7714285714286,61.1585714285714,NA,543,9,3,74,128,1137,534,1134
2017,41,61,"Kirklareli",41.7333,27.2167,8.61428571428571,13.9571428571429,0.0571428571428571,69.6714285714286,48.6916666666667,NA,487,0,0,187,252,843,487,843
2017,42,61,"Kirklareli",41.7333,27.2167,9.9,17.0285714285714,0,59.3428571428571,65.2942857142857,NA,530,0,0,147,163,815,530,815
2017,43,61,"Kirklareli",41.7333,27.2167,17.5428571428571,11.4714285714286,8.78785714285714,82.9285714285714,38.0328571428571,NA,506,154,125,126,285,919,352,794
2017,44,61,"Kirklareli",41.7333,27.2167,12.5428571428571,8.15714285714286,0.0285714285714286,65.1428571428571,22.6,NA,561,69,129,133,176,1102,492,973
2017,45,61,"Kirklareli",41.7333,27.2167,11.8285714285714,11.2857142857143,3.59857142857143,84.6857142857143,NA,NA,577,291,460,44,104,829,286,369
2017,46,61,"Kirklareli",41.7333,27.2167,14.4428571428571,12.5285714285714,4.22771428571429,85.9857142857143,NA,NA,587,36,148,0,0,1085,551,937
2017,47,61,"Kirklareli",41.7333,27.2167,11.6571428571429,7.45714285714286,1.657,84.1714285714286,NA,NA,418,74,183,79,91,804,344,621
2017,48,61,"Kirklareli",41.7333,27.2167,21.3285714285714,11.3285714285714,2.83028571428571,82.3,49.0333333333333,NA,386,55,97,68,118,619,331,522
2017,49,61,"Kirklareli",41.7333,27.2167,18.3285714285714,7.14285714285714,5.22628571428571,76.7428571428571,60.4971428571429,NA,407,0,0,169,271,645,407,645
2017,50,61,"Kirklareli",41.7333,27.2167,18.8142857142857,10.4,6.401,86.9285714285714,46.49,NA,346,0,0,0,0,442,346,442
2017,51,61,"Kirklareli",41.7333,27.2167,17.8285714285714,1.3,1.04357142857143,78.1285714285714,47.2128571428571,NA,386,0,0,51,41,349,386,349
2017,52,61,"Kirklareli",41.7333,27.2167,15.7875,6.5,5.46275,86.9125,60.14,NA,528,123,66,113,85,507,405,441
2018,1,61,"Kirklareli",41.7333,27.2167,10.2125,5.95,0.624625,86.8875,68.4871428571429,25.71,618,261,410,72,61,914,357,504
2018,2,61,"Kirklareli",41.7333,27.2167,17.7428571428571,6.28571428571429,1.14342857142857,88.9285714285714,53.36,NA,624,109,249,0,0,1309,515,1060
2018,3,61,"Kirklareli",41.7333,27.2167,19.5428571428571,4.82857142857143,6.741,83.4,40.52,NA,639,133,267,83,33,655,506,388
2018,4,61,"Kirklareli",41.7333,27.2167,16.3142857142857,1.24285714285714,3.91257142857143,73.0142857142857,52.4871428571429,NA,604,0,0,38,69,764,604,764
2018,5,61,"Kirklareli",41.7333,27.2167,19.7428571428571,8.15714285714286,0.901714285714286,81.9714285714286,86.6342857142857,NA,670,70,18,87,80,819,600,801
2018,6,61,"Kirklareli",41.7333,27.2167,16.8142857142857,6.41428571428571,5.486,82.7285714285714,63.6842857142857,NA,704,225,393,0,0,1022,479,629
2018,7,61,"Kirklareli",41.7333,27.2167,15.3285714285714,5.32857142857143,1.75814285714286,79.5,43.9457142857143,NA,478,192,223,0,0,557,286,334
2018,8,61,"Kirklareli",41.7333,27.2167,19.1857142857143,4.75714285714286,1.31514285714286,85.0428571428571,32.74,NA,711,0,0,0,0,1321,711,1321
2018,9,61,"Kirklareli",41.7333,27.2167,20.7714285714286,2.92857142857143,5.08571428571429,82.7571428571429,55.36,NA,621,222,352,0,0,956,399,604
2018,10,61,"Kirklareli",41.7333,27.2167,14.9142857142857,9.6,2.41428571428571,80.6714285714286,65.4385714285714,NA,556,68,102,63,126,1330,488,1228
2018,11,61,"Kirklareli",41.7333,27.2167,18.2142857142857,12.2,2.71514285714286,80.3428571428571,58.0214285714286,NA,551,67,99,0,0,1426,484,1327
2018,12,61,"Kirklareli",41.7333,27.2167,21.0285714285714,5.9,11.425,87.1,33.5828571428571,NA,425,0,0,0,0,1187,425,1187
2018,13,61,"Kirklareli",41.7333,27.2167,15.5857142857143,9.94285714285714,7.32871428571429,81.0571428571428,67.8285714285714,NA,356,118,165,0,0,428,238,263
2018,14,61,"Kirklareli",41.7333,27.2167,17.8285714285714,13.8714285714286,0.0571428571428571,54.5142857142857,57.0342857142857,NA,407,115,82,61,49,486,292,404
2018,15,61,"Kirklareli",41.7333,27.2167,13.7428571428571,16.4285714285714,0,61.4142857142857,83.6171428571429,NA,374,158,147,0,0,450,216,303
2018,16,61,"Kirklareli",41.7333,27.2167,16.7285714285714,15.6857142857143,0.0571428571428571,53.8,67.1614285714286,NA,411,0,0,70,90,648,411,648
2018,17,61,"Kirklareli",41.7333,27.2167,13.2857142857143,20.0714285714286,0.000285714285714286,54.1714285714286,68.2257142857143,NA,419,120,290,1,0,652,299,362
2018,18,61,"Kirklareli",41.7333,27.2167,12.5428571428571,19.0428571428571,0.0142857142857143,62.4142857142857,60.3928571428571,NA,303,55,97,0,0,474,248,377
2018,19,61,"Kirklareli",41.7333,27.2167,13.5285714285714,17.3857142857143,5.883,70.6714285714286,56.0957142857143,NA,275,0,0,77,106,467,275,467
2018,20,61,"Kirklareli",41.7333,27.2167,13.6571428571429,20.3857142857143,1.58571428571429,62.3428571428571,54.2857142857143,NA,204,84,139,35,40,306,120,167
2018,21,61,"Kirklareli",41.7333,27.2167,18.1142857142857,20.1285714285714,0.000142857142857143,67.8571428571429,53.1457142857143,NA,252,0,0,0,0,281,252,281
2018,22,61,"Kirklareli",41.7333,27.2167,17.8,20.4,0.271428571428571,55.8,63.7742857142857,NA,249,0,0,0,0,427,249,427
2018,23,61,"Kirklareli",41.7333,27.2167,13.3714285714286,22.1857142857143,10.5111428571429,67.7142857142857,49.5057142857143,NA,267,58,68,36,134,812,209,744
2018,24,61,"Kirklareli",41.7333,27.2167,12.5,22.6857142857143,5.48328571428571,61.2428571428571,42.7442857142857,NA,267,46,14,29,161,448,221,434
2018,25,61,"Kirklareli",41.7333,27.2167,13.8857142857143,22.3142857142857,1.08542857142857,62.5142857142857,50.5185714285714,NA,358,0,0,24,27,518,358,518
2018,26,61,"Kirklareli",41.7333,27.2167,14.9857142857143,20.7428571428571,5.02942857142857,76.2571428571429,30.5828571428571,NA,355,93,168,37,65,587,262,419
2018,27,61,"Kirklareli",41.7333,27.2167,9.65714285714286,24.1428571428571,3.62871428571429,66,48.7442857142857,NA,342,152,171,0,0,418,190,247
2018,28,61,"Kirklareli",41.7333,27.2167,10.5571428571429,24.4857142857143,0.03,65.5,42.092,NA,286,0,0,41,107,585,286,585
2018,29,61,"Kirklareli",41.7333,27.2167,12.3714285714286,24.6285714285714,0.658285714285714,62.9571428571429,42.8566666666667,NA,260,0,0,241,749,756,260,756
2018,30,61,"Kirklareli",41.7333,27.2167,10.7571428571429,22.7857142857143,8.11171428571429,79.4857142857143,42.6014285714286,NA,265,39,59,107,482,822,226,763
2018,31,61,"Kirklareli",41.7333,27.2167,15.0857142857143,25.3857142857143,0.600142857142857,69.7571428571429,51.455,NA,267,0,0,0,0,499,267,499
2018,32,61,"Kirklareli",41.7333,27.2167,15.1714285714286,24.8571428571429,0,58.7714285714286,54.9514285714286,NA,297,0,0,0,0,403,297,403
2018,33,61,"Kirklareli",41.7333,27.2167,15.5285714285714,25.3285714285714,0,59.9857142857143,58.1971428571429,NA,216,0,0,0,0,332,216,332
2018,34,61,"Kirklareli",41.7333,27.2167,15.0571428571429,24.5571428571429,0,61.3,49.7642857142857,NA,144,1,0,0,0,227,143,227
2018,35,61,"Kirklareli",41.7333,27.2167,16.4571428571429,25.7857142857143,0.285571428571429,53.0571428571429,65.9285714285714,NA,201,0,0,0,0,314,201,314
2018,36,61,"Kirklareli",41.7333,27.2167,11.0714285714286,22.9285714285714,0.785285714285714,66.2857142857143,60.6,NA,341,0,0,90,94,370,341,370
2018,37,61,"Kirklareli",41.7333,27.2167,12.9571428571429,21.0428571428571,0.429285714285714,64.8857142857143,45.5242857142857,NA,241,0,0,69,134,419,241,419
2018,38,61,"Kirklareli",41.7333,27.2167,16.8142857142857,20.6857142857143,0.0142857142857143,63.8714285714286,42.7,NA,189,0,0,0,0,344,189,344
2018,39,61,"Kirklareli",41.7333,27.2167,23.2428571428571,15.6571428571429,1.743,64.6428571428571,40.3271428571429,NA,180,27,53,19,40,353,153,300
2018,40,61,"Kirklareli",41.7333,27.2167,13.1714285714286,16.5142857142857,3.47214285714286,72.8428571428571,35.98,NA,191,28,38,2,3,341,163,303
2018,41,61,"Kirklareli",41.7333,27.2167,18.5142857142857,15.8285714285714,0.4,74.5142857142857,54.37,NA,187,0,0,0,0,422,187,422
2018,42,61,"Kirklareli",41.7333,27.2167,12.5857142857143,15.6857142857143,0.257285714285714,80.6714285714286,69.4414285714286,NA,168,0,0,1,0,381,168,381
2018,43,61,"Kirklareli",41.7333,27.2167,17.8857142857143,12.5428571428571,0,67.9857142857143,72.2,20.052,187,0,0,65,112,402,187,402
2018,44,61,"Kirklareli",41.7333,27.2167,14.7571428571429,15.6714285714286,0,75.4714285714286,59.9128571428571,17.7257142857143,196,55,74,0,0,264,141,190
2018,45,61,"Kirklareli",41.7333,27.2167,13.2142857142857,12.6571428571429,0.0572857142857143,74.1714285714286,36.8142857142857,14.3185714285714,231,0,0,0,0,473,231,473
2018,46,61,"Kirklareli",41.7333,27.2167,18.4571428571429,8.02857142857143,0.9,76.4142857142857,35.88,NA,230,0,0,9,31,465,230,465
2018,47,61,"Kirklareli",41.7333,27.2167,17.4857142857143,7.78571428571429,3.74314285714286,82.6142857142857,36.96,NA,270,95,216,0,0,499,175,283
2018,48,61,"Kirklareli",41.7333,27.2167,21.2428571428571,4.34285714285714,24.6251428571429,82.6714285714286,40.8371428571429,17.7783333333333,245,27,3,0,0,201,218,198
2018,49,61,"Kirklareli",41.7333,27.2167,15.6,4.3,2.47057142857143,79.1285714285714,50.0428571428571,26.7557142857143,257,69,66,26,106,420,188,354
2018,50,61,"Kirklareli",41.7333,27.2167,13.5857142857143,5.65714285714286,1.67057142857143,80.5428571428571,54.0857142857143,27.1328571428571,256,105,51,70,106,305,151,254
2018,51,61,"Kirklareli",41.7333,27.2167,17.1285714285714,2.77142857142857,1.05771428571429,86.0571428571429,45.8942857142857,17.9942857142857,250,57,42,5,2,248,193,206
2018,52,61,"Kirklareli",41.7333,27.2167,12.6142857142857,3.41428571428571,1.05685714285714,75.7428571428571,59.0466666666667,28.2028571428571,244,0,0,186,227,273,244,273
2019,1,61,"Kirklareli",41.7333,27.2167,24.075,0.7625,0.774625,76.1625,37.2485714285714,17.8575,343,0,0,109,136,784,343,784
2019,2,61,"Kirklareli",41.7333,27.2167,19.0285714285714,0.714285714285714,15.522,80.3285714285714,37.35,11.8525,255,92,64,70,62,208,163,144
2019,3,61,"Kirklareli",41.7333,27.2167,13.6428571428571,4.1,0.185714285714286,78.1,48.4425,10.2125,192,74,72,54,45,198,118,126
2019,4,61,"Kirklareli",41.7333,27.2167,18.7571428571429,7.12857142857143,3.41285714285714,84.1,54.7814285714286,8.98142857142857,308,207,227,0,0,314,101,87
2019,5,61,"Kirklareli",41.7333,27.2167,16.8142857142857,9.4,1.91457142857143,81.7428571428571,38.4071428571429,10.76,253,132,69,1,0,143,121,74
2019,6,61,"Kirklareli",41.7333,27.2167,19.5285714285714,5.15714285714286,0.900285714285714,78.0714285714286,56.8171428571429,18.0414285714286,276,78,32,0,0,127,198,95
2019,7,61,"Kirklareli",41.7333,27.2167,21.4428571428571,4.78571428571429,2.17071428571429,74.3142857142857,42.1028571428571,16.7771428571429,325,0,0,58,9,234,325,234
2019,8,61,"Kirklareli",41.7333,27.2167,16.7142857142857,4.3,0.6,67.2571428571429,87.3,30.24,305,0,0,82,26,219,305,219
2019,9,61,"Kirklareli",41.7333,27.2167,15.6571428571429,4.77142857142857,1.48485714285714,67.2285714285714,47.8442857142857,22.0528571428571,331,0,0,73,70,310,331,310
2019,10,61,"Kirklareli",41.7333,27.2167,12.2714285714286,10.4142857142857,0,70.4285714285714,61.12,17.8071428571429,359,172,99,52,44,252,187,153
2019,11,61,"Kirklareli",41.7333,27.2167,15.4428571428571,8.68571428571429,1.45642857142857,70.6571428571429,45.6014285714286,16.9614285714286,373,24,29,1,0,400,349,371
2019,12,61,"Kirklareli",41.7333,27.2167,14.7142857142857,10.8857142857143,0,61.2714285714286,52.2185714285714,17.0614285714286,343,42,33,0,0,416,301,383
2019,13,61,"Kirklareli",41.7333,27.2167,18.7714285714286,8.41428571428571,0,53.3285714285714,42.5242857142857,13.7814285714286,256,46,35,0,0,194,210,159
2019,14,61,"Kirklareli",41.7333,27.2167,14,9.81428571428571,0.0857142857142857,59.9714285714286,47.8571428571429,12.7614285714286,365,46,35,0,0,208,319,173
2019,15,61,"Kirklareli",41.7333,27.2167,14.1428571428571,12.2571428571429,6.315,82.6714285714286,32.9971428571429,11.3542857142857,359,206,121,0,0,183,153,62
2019,16,61,"Kirklareli",41.7333,27.2167,14.3571428571429,9.04285714285714,0.685714285714286,66.5714285714286,42.4271428571429,15.1,318,0,0,1,1,208,318,208
2019,17,61,"Kirklareli",41.7333,27.2167,11.1857142857143,14.9571428571429,0.142857142857143,53.3714285714286,60.5957142857143,13.3642857142857,412,344,253,0,0,313,68,60
2019,18,61,"Kirklareli",41.7333,27.2167,15.0428571428571,16.3,0.272571428571429,65.0857142857143,51.1957142857143,7.99142857142857,523,146,52,4,2,353,377,301
2019,19,61,"Kirklareli",41.7333,27.2167,13.4428571428571,14.2,5.89842857142857,71.2714285714286,40.6228571428571,10.3257142857143,452,101,112,226,198,386,351,274
2019,20,61,"Kirklareli",41.7333,27.2167,12.8714285714286,18.1142857142857,2.22742857142857,70.4285714285714,45.5928571428571,12.2671428571429,454,68,37,46,46,389,386,352
2019,21,61,"Kirklareli",41.7333,27.2167,13.1428571428571,19.5,1.45714285714286,64.0714285714286,45.8014285714286,8.50714285714286,457,6,2,67,21,413,451,411
2019,22,61,"Kirklareli",41.7333,27.2167,12.2571428571429,21.8857142857143,5.76957142857143,65,44.8342857142857,8.97428571428572,453,161,108,0,0,323,292,215
2019,23,61,"Kirklareli",41.7333,27.2167,9.48571428571429,21.8142857142857,0.400428571428571,66.9285714285714,36.474,7.854,378,166,160,0,0,532,212,372
2019,24,61,"Kirklareli",41.7333,27.2167,15.9857142857143,24.4571428571429,0.343428571428571,63.4285714285714,49.5666666666667,8.11166666666667,378,0,0,60,14,244,378,244
2019,25,61,"Kirklareli",41.7333,27.2167,12.4857142857143,25.0714285714286,2.58414285714286,59.6142857142857,52.1042857142857,8.82333333333333,306,0,0,7,13,325,306,325
2019,26,61,"Kirklareli",41.7333,27.2167,18.2285714285714,25.1142857142857,0,59.3142857142857,45.8033333333333,6.99,377,30,21,0,0,342,347,321
2019,27,61,"Kirklareli",41.7333,27.2167,11.7428571428571,25.8285714285714,0,53.3857142857143,43.1028571428571,8.96285714285714,456,79,25,0,0,222,377,197
2019,28,61,"Kirklareli",41.7333,27.2167,12.1571428571429,22.0428571428571,2.71471428571429,65.8857142857143,36.7766666666667,9.005,398,130,115,65,32,421,268,306
2019,29,61,"Kirklareli",41.7333,27.2167,12.8142857142857,23.2857142857143,0.0285714285714286,59.4,35.648,8.152,453,0,0,57,5,203,453,203
2019,30,61,"Kirklareli",41.7333,27.2167,13.3714285714286,24.6857142857143,5.45485714285714,55.6,36.2314285714286,9.37285714285714,456,0,0,0,0,335,456,335
2019,31,61,"Kirklareli",41.7333,27.2167,12.0142857142857,25.4142857142857,5.48242857142857,65.5714285714286,40.4483333333333,9.97,334,4,2,70,84,375,330,373
2019,32,61,"Kirklareli",41.7333,27.2167,12.0285714285714,25.2142857142857,0,53.2857142857143,31.145,9.09,346,34,35,0,0,395,312,360
2019,33,61,"Kirklareli",41.7333,27.2167,16.3142857142857,24.7285714285714,2.37371428571429,62.7285714285714,30.98,7.10142857142857,337,0,0,0,0,531,337,531
2019,34,61,"Kirklareli",41.7333,27.2167,15.4142857142857,25.7285714285714,0,54.9,49.6714285714286,9.64142857142857,299,0,0,0,0,345,299,345
2019,35,61,"Kirklareli",41.7333,27.2167,16.8285714285714,24.4142857142857,0,59.4285714285714,49.87,4.00285714285714,307,0,0,0,0,415,307,415
2019,36,61,"Kirklareli",41.7333,27.2167,15.2714285714286,22.7285714285714,0,61.3428571428571,42.3985714285714,4.13428571428571,171,0,0,0,0,67,171,67
2019,37,61,"Kirklareli",41.7333,27.2167,17.5714285714286,21.8714285714286,0,59.4714285714286,46.1916666666667,3.36333333333333,218,0,0,0,0,55,218,55
2019,38,61,"Kirklareli",41.7333,27.2167,15.0714285714286,18.5714285714286,1.74242857142857,58.3714285714286,44.5657142857143,7.59857142857143,266,36,4,7,0,91,230,87
2019,39,61,"Kirklareli",41.7333,27.2167,10.0571428571429,18.4142857142857,0.571428571428571,67.1285714285714,35.6757142857143,13.0142857142857,237,68,31,41,11,79,169,48
2019,40,61,"Kirklareli",41.7333,27.2167,13.6285714285714,19.4,10.9088571428571,67.3857142857143,52.93,12.696,241,60,40,35,7,111,181,71
2019,41,61,"Kirklareli",41.7333,27.2167,12.3285714285714,15.2142857142857,0.914285714285714,74.6571428571429,33.04,15.264,416,107,98,0,0,448,309,350
2019,42,61,"Kirklareli",41.7333,27.2167,9.1,16.2857142857143,0,78.9142857142857,44.9675,22.3325,356,0,0,0,0,408,356,408
2019,43,61,"Kirklareli",41.7333,27.2167,11.2,15.6285714285714,0,72.5428571428571,44.6366666666667,15.3083333333333,306,0,0,0,0,300,306,300
2019,44,61,"Kirklareli",41.7333,27.2167,14.3285714285714,11.5142857142857,0.0857142857142857,78.9428571428571,43.5971428571429,18.11,350,87,57,0,0,250,263,193
2019,45,61,"Kirklareli",41.7333,27.2167,18.0571428571429,17.5285714285714,0.443,75.6714285714286,59.1442857142857,14.2314285714286,417,168,135,0,0,328,249,193
2019,46,61,"Kirklareli",41.7333,27.2167,12.7,15.7142857142857,2.11328571428571,76.3,68.6114285714286,21.1928571428571,401,248,225,0,0,337,153,112
2019,47,61,"Kirklareli",41.7333,27.2167,15.9285714285714,13.1857142857143,0.171857142857143,81.1857142857143,50.4257142857143,16.8385714285714,391,65,27,0,0,339,326,312
2019,48,61,"Kirklareli",41.7333,27.2167,19.1285714285714,10.1857142857143,3.65728571428571,84.8285714285714,39.0042857142857,17.94,320,32,12,49,66,251,288,239
2019,49,61,"Kirklareli",41.7333,27.2167,12.1428571428571,4.45714285714286,1.30128571428571,79.8571428571429,44.4671428571429,23.8166666666667,393,106,77,2,0,274,287,197
2019,50,61,"Kirklareli",41.7333,27.2167,11.4285714285714,8.77142857142857,0.0857142857142857,81.0285714285714,56.32,23.4025,218,91,21,14,15,119,127,98
2019,51,61,"Kirklareli",41.7333,27.2167,16.4714285714286,11.1571428571429,0.157142857142857,88.4285714285714,66.4142857142857,17.6371428571429,361,161,124,0,0,488,200,364
2019,52,61,"Kirklareli",41.7333,27.2167,16.5571428571429,6.02857142857143,2.28471428571429,75.8714285714286,23.9371428571429,13.64,279,47,64,136,152,281,232,217
2020,1,61,"Kirklareli",41.7333,27.2167,17.78,2.92,0.3198,63.8,51.452,27.386,160,0,0,42,30,126,160,126
2020,2,61,"Kirklareli",41.7333,27.2167,20.5714285714286,2.21428571428571,0.699714285714286,65.8714285714286,48.95,25.0728571428571,240,0,0,36,51,173,240,173
2020,3,61,"Kirklareli",41.7333,27.2167,14.3428571428571,3.52857142857143,0.0571428571428571,79.9714285714286,44.1714285714286,22.9285714285714,270,0,0,4,6,382,270,382
2020,4,61,"Kirklareli",41.7333,27.2167,13.5714285714286,2.6,0,70.1,71.8571428571429,29.5114285714286,358,117,159,144,91,295,241,136
2020,5,61,"Kirklareli",41.7333,27.2167,13.8857142857143,7.8,4.85485714285714,79.6,42.5271428571429,22.4514285714286,331,64,57,45,29,272,267,215
2020,6,61,"Kirklareli",41.7333,27.2167,20.6714285714286,4.35714285714286,2.91485714285714,73.6285714285714,28.2742857142857,15.5528571428571,343,55,69,90,74,267,288,198
2020,7,61,"Kirklareli",41.7333,27.2167,14.7714285714286,6.17142857142857,0.671142857142857,71.9142857142857,39.9985714285714,23.7885714285714,341,88,138,74,47,338,253,200
2020,8,61,"Kirklareli",41.7333,27.2167,12.9714285714286,5.8,0.314142857142857,72.8857142857143,53.8271428571429,26.7,283,0,0,42,36,187,283,187
2020,9,61,"Kirklareli",41.7333,27.2167,19.6428571428571,7.84285714285714,4.29785714285714,72.2,43.1242857142857,16.9014285714286,393,116,136,55,114,528,277,392
2020,10,61,"Kirklareli",41.7333,27.2167,17.5857142857143,12.2285714285714,0.0431428571428571,73.5428571428571,53.3428571428571,15.5957142857143,205,52,28,0,0,210,153,182
2020,11,61,"Kirklareli",41.7333,27.2167,17.1142857142857,11.0571428571429,2.45714285714286,70.7714285714286,70.6933333333333,14.705,115,0,0,3,0,94,115,94
2020,12,61,"Kirklareli",41.7333,27.2167,14.5,7.31428571428571,0.0285714285714286,59.5428571428571,NA,19.5866666666667,117,21,15,0,0,118,96,103
2020,13,61,"Kirklareli",41.7333,27.2167,21.8,7.8,0.815428571428572,76.2571428571429,83.73,8.76571428571429,136,0,0,16,10,92,136,92
2020,14,61,"Kirklareli",41.7333,27.2167,22.9571428571429,7.31428571428571,4.45971428571429,76,22.935,12.475,155,7,3,0,0,121,148,118
2020,15,61,"Kirklareli",41.7333,27.2167,20.5714285714286,11.2714285714286,0.0857142857142857,48.6,25.9216666666667,10.3016666666667,133,0,0,0,0,118,133,118
2020,16,61,"Kirklareli",41.7333,27.2167,13.5,12.6142857142857,2.71385714285714,58.9857142857143,20.4471428571429,13.0185714285714,141,35,11,33,39,106,106,95
2020,17,61,"Kirklareli",41.7333,27.2167,15.9285714285714,11.3,0.773142857142857,55.0571428571429,20.7533333333333,8.88142857142857,137,18,9,0,0,123,119,114
2020,18,61,"Kirklareli",41.7333,27.2167,13.8285714285714,16.0285714285714,1.41585714285714,68.1714285714286,18.01,9.43285714285714,146,41,81,0,0,164,105,83
2020,19,61,"Kirklareli",41.7333,27.2167,12.8714285714286,14.6571428571429,7.14071428571429,67.3714285714286,29.6657142857143,9.29428571428571,137,37,80,75,62,157,100,77
2020,20,61,"Kirklareli",41.7333,27.2167,15.7285714285714,21.3142857142857,0,60.3857142857143,64.9985714285714,10.5657142857143,164,62,34,0,0,164,102,130
2020,21,61,"Kirklareli",41.7333,27.2167,17.1285714285714,18.5857142857143,0.142857142857143,60.0142857142857,45.8442857142857,7.47714285714286,146,6,0,0,0,96,140,96
2020,22,61,"Kirklareli",41.7333,27.2167,14.9714285714286,15.0428571428571,2.60085714285714,73.7714285714286,23.8757142857143,7.76,118,0,0,37,48,100,118,100
2020,23,61,"Kirklareli",41.7333,27.2167,14.3571428571429,18.7,1.34314285714286,66.1571428571429,38.61,9.14428571428572,112,13,5,19,2,70,99,65
2020,24,61,"Kirklareli",41.7333,27.2167,11.0857142857143,21.4428571428571,1.015,66.9571428571429,47.9628571428571,9.30285714285714,140,37,16,43,34,150,103,134
2020,25,61,"Kirklareli",41.7333,27.2167,10.2142857142857,21.3714285714286,12.2084285714286,73.6571428571429,37.5983333333333,9.82714285714286,137,0,0,71,61,108,137,108
2020,26,61,"Kirklareli",41.7333,27.2167,13.2285714285714,21.9142857142857,1.99928571428571,69.4571428571429,37.8571428571429,9.15714285714286,173,22,24,35,40,133,151,109
2020,27,61,"Kirklareli",41.7333,27.2167,11.6285714285714,26.1285714285714,0,59.3142857142857,47.9028571428571,8.83142857142857,113,0,0,5,0,113,113,113
2020,28,61,"Kirklareli",41.7333,27.2167,16.9142857142857,24.1571428571429,0,60.7571428571429,43.5457142857143,7.15428571428571,164,0,0,0,0,122,164,122
2020,29,61,"Kirklareli",41.7333,27.2167,14.0285714285714,22.3285714285714,0,54.2857142857143,37.2442857142857,7.81,186,0,0,0,0,111,186,111
2020,30,61,"Kirklareli",41.7333,27.2167,13.8857142857143,24.9,0,57.0428571428571,42.9514285714286,7.24142857142857,190,0,0,17,5,142,190,142
2020,31,61,"Kirklareli",41.7333,27.2167,13.2571428571429,26.6857142857143,0,50.1714285714286,45.6385714285714,8.86714285714286,150,2,0,0,0,127,148,127
2020,32,61,"Kirklareli",41.7333,27.2167,19.2428571428571,25.1285714285714,0.0285714285714286,60.4571428571429,39.4114285714286,5.75,146,0,0,0,0,107,146,107
2020,33,61,"Kirklareli",41.7333,27.2167,13.4285714285714,24.6857142857143,0.000142857142857143,54.6857142857143,38.85,9.59428571428571,183,11,1,0,0,83,172,82
2020,34,61,"Kirklareli",41.7333,27.2167,12.3428571428571,23.9285714285714,0.799428571428571,57.9,39.4228571428571,10.2414285714286,197,0,0,3,4,97,197,97
2020,35,61,"Kirklareli",41.7333,27.2167,11.6285714285714,25.0285714285714,0,58.7285714285714,36.3542857142857,8.85285714285714,164,0,0,0,0,157,164,157
2020,36,61,"Kirklareli",41.7333,27.2167,13.4571428571429,24.3571428571429,0,53.7285714285714,37.5114285714286,9.55142857142857,179,0,0,34,17,112,179,112
2020,37,61,"Kirklareli",41.7333,27.2167,16.4,23.5142857142857,0,60.2857142857143,47.08,8.09714285714286,193,0,0,0,0,91,193,91
2020,38,61,"Kirklareli",41.7333,27.2167,18.4571428571429,21.6142857142857,0.199857142857143,60.0428571428571,44.0371428571429,8.67285714285714,235,0,0,0,0,157,235,157
2020,39,61,"Kirklareli",41.7333,27.2167,13.4857142857143,20.9857142857143,0.9,61.7,43.3314285714286,11.6857142857143,220,96,32,0,0,129,124,97
2020,40,61,"Kirklareli",41.7333,27.2167,10.7142857142857,18.8714285714286,1.856,61,45.4471428571429,17.1942857142857,187,80,59,20,8,154,107,95
2020,41,61,"Kirklareli",41.7333,27.2167,9.4,20.2,6.315,69.6285714285714,63.7314285714286,16.0942857142857,182,109,81,51,37,127,73,46
2020,42,61,"Kirklareli",41.7333,27.2167,11.9571428571429,17.7857142857143,0.457571428571429,72.5428571428571,50.82,16.2885714285714,177,80,34,0,0,111,97,77
2020,43,61,"Kirklareli",41.7333,27.2167,11.9571428571429,15.4428571428571,0.0857142857142857,66.1,55.3442857142857,21.1571428571429,194,55,19,0,0,161,139,142
2020,44,61,"Kirklareli",41.7333,27.2167,13.7857142857143,13.7571428571429,4.24071428571429,77.8428571428571,49.3028571428571,17.01,255,0,0,131,127,233,255,233
2020,45,61,"Kirklareli",41.7333,27.2167,9.9,11.3714285714286,0,70.9142857142857,41.2514285714286,19.2242857142857,156,0,0,20,14,103,156,103
2020,46,61,"Kirklareli",41.7333,27.2167,9.02857142857143,11.1428571428571,0.0858571428571429,75.3142857142857,31.1085714285714,14.6128571428571,208,0,0,2,2,109,208,109
2020,47,61,"Kirklareli",41.7333,27.2167,15.8,8.14285714285714,0.357,76.2142857142857,40.4757142857143,16.9285714285714,173,0,0,0,0,83,173,83
2020,48,61,"Kirklareli",41.7333,27.2167,10.9142857142857,6.18571428571429,0.000142857142857143,68.7,61.9228571428571,30.3585714285714,199,63,87,22,22,262,136,175
2020,49,61,"Kirklareli",41.7333,27.2167,7.22857142857143,6.21428571428571,0.0858571428571429,77.1571428571429,44.1642857142857,19.2828571428571,207,31,20,0,0,116,176,96
2020,50,61,"Kirklareli",41.7333,27.2167,11.7142857142857,10.0571428571429,3.401,83.8285714285714,33.7028571428571,16.3328571428571,181,82,69,24,8,98,99,29
2020,51,61,"Kirklareli",41.7333,27.2167,9.84285714285714,6.22857142857143,0.345571428571429,83.4857142857143,30.9757142857143,14.9528571428571,171,0,0,5,0,90,171,90
2020,52,61,"Kirklareli",41.7333,27.2167,9.8,8.67142857142857,0.828285714285714,83.4,40.78,15.3871428571429,203,97,43,0,0,113,106,70
2020,53,61,"Kirklareli",41.7333,27.2167,16.15,12.675,5.00025,79.9,35.9275,11.7575,122,110,103,0,0,111,12,8
2017,1,62,"Kirsehir",39.1458,34.1611,21.9714285714286,-1.21428571428571,0.986,80.9,15.8914285714286,NA,563,165,315,46,63,847,398,532
2017,2,62,"Kirsehir",39.1458,34.1611,23.3,-2.61428571428571,0.985857142857143,76.5571428571429,19.26,NA,757,252,465,0,0,1214,505,749
2017,3,62,"Kirsehir",39.1458,34.1611,18.5285714285714,0.685714285714286,0.0714285714285714,78.2142857142857,16.9542857142857,NA,762,343,647,23,33,1449,419,802
2017,4,62,"Kirsehir",39.1458,34.1611,21.9714285714286,-4.34285714285714,1.64271428571429,80.4285714285714,11.9257142857143,NA,639,191,222,140,151,889,448,667
2017,5,62,"Kirsehir",39.1458,34.1611,20.0714285714286,-7.21428571428571,0.157142857142857,71.3857142857143,23.9842857142857,NA,588,269,409,58,157,1163,319,754
2017,6,62,"Kirsehir",39.1458,34.1611,19.1,3.32857142857143,0.457142857142857,77.3,14.2314285714286,NA,736,264,421,117,305,1519,472,1098
2017,7,62,"Kirsehir",39.1458,34.1611,25.7142857142857,-2.2,0.0142857142857143,61.2285714285714,15.5614285714286,NA,492,180,188,59,83,717,312,529
2017,8,62,"Kirsehir",39.1458,34.1611,19.3428571428571,5.02857142857143,0,63.2857142857143,25.3885714285714,NA,739,221,427,0,0,1747,518,1320
2017,9,62,"Kirsehir",39.1458,34.1611,17.7714285714286,8.02857142857143,1.8,61.5714285714286,24.1585714285714,NA,574,336,561,131,198,866,238,305
2017,10,62,"Kirsehir",39.1458,34.1611,18.7857142857143,8.01428571428571,1.6,61.6714285714286,25.8185714285714,NA,712,511,851,0,0,1043,201,192
2017,11,62,"Kirsehir",39.1458,34.1611,18.7857142857143,3.32857142857143,1.92871428571429,78.3,10.72,NA,525,3,5,181,239,725,522,720
2017,12,62,"Kirsehir",39.1458,34.1611,25.4142857142857,8.45714285714286,0.0714285714285714,50.3,33.0642857142857,NA,589,0,0,117,332,1077,589,1077
2017,13,62,"Kirsehir",39.1458,34.1611,24.0571428571429,9.27142857142857,0.657285714285714,55.8285714285714,25.26,NA,574,1,0,69,101,887,573,887
2017,14,62,"Kirsehir",39.1458,34.1611,19.3,10.1428571428571,0.542857142857143,48.2857142857143,33.1528571428571,NA,639,196,530,51,97,1336,443,806
2017,15,62,"Kirsehir",39.1458,34.1611,15.8285714285714,8.74285714285714,2.57142857142857,66.4428571428572,25.5257142857143,NA,587,76,292,148,512,1187,511,895
2017,16,62,"Kirsehir",39.1458,34.1611,26.7,12.1571428571429,0.642857142857143,53.2285714285714,19.7257142857143,NA,717,0,0,33,18,920,717,920
2017,17,62,"Kirsehir",39.1458,34.1611,17.7142857142857,12.6857142857143,0,38.1857142857143,30.1814285714286,NA,731,160,457,81,79,1478,571,1021
2017,18,62,"Kirsehir",39.1458,34.1611,22.4428571428571,14.8,1.35714285714286,59.5142857142857,27.6185714285714,NA,506,71,106,19,17,923,435,817
2017,19,62,"Kirsehir",39.1458,34.1611,20.2857142857143,18.3857142857143,0.2,45.6857142857143,36.0828571428571,NA,471,46,133,18,20,966,425,833
2017,20,62,"Kirsehir",39.1458,34.1611,22.7714285714286,13.8142857142857,2.30014285714286,63.7,11.604,NA,472,165,331,0,0,1205,307,874
2017,21,62,"Kirsehir",39.1458,34.1611,16.9857142857143,14.0285714285714,0.657142857142857,62.9428571428571,8.695,NA,448,116,266,5,2,849,332,583
2017,22,62,"Kirsehir",39.1458,34.1611,18.3142857142857,17.7571428571429,0.0287142857142857,58.9857142857143,9.85285714285714,NA,522,67,159,0,0,1015,455,856
2017,23,62,"Kirsehir",39.1458,34.1611,18.2285714285714,20.2285714285714,0.1,56.1428571428571,13.8228571428571,NA,578,106,237,0,0,1388,472,1151
2017,24,62,"Kirsehir",39.1458,34.1611,18.7857142857143,19.5714285714286,1.5,58.1571428571429,10.7085714285714,NA,552,157,421,0,0,1139,395,718
2017,25,62,"Kirsehir",39.1458,34.1611,17.4571428571429,19.2285714285714,0.785857142857143,59.4285714285714,11.5185714285714,NA,584,37,124,0,0,1041,547,917
2017,26,62,"Kirsehir",39.1458,34.1611,20.6857142857143,26.3285714285714,0,36.2,16.1871428571429,NA,564,140,352,0,0,971,424,619
2017,27,62,"Kirsehir",39.1458,34.1611,27,23.8857142857143,0,41.1857142857143,18.3485714285714,NA,511,249,312,0,0,642,262,330
2017,28,62,"Kirsehir",39.1458,34.1611,28.3285714285714,25.7142857142857,0.0571428571428571,31.3,14.6728571428571,NA,481,332,650,0,0,864,149,214
2017,29,62,"Kirsehir",39.1458,34.1611,29.1857142857143,25.7428571428571,0,41.7428571428571,18.9742857142857,NA,532,439,1111,0,0,1272,93,161
2017,30,62,"Kirsehir",39.1458,34.1611,28.3857142857143,25.5142857142857,0.0285714285714286,34.5714285714286,24.5457142857143,NA,531,292,641,4,3,928,239,287
2017,31,62,"Kirsehir",39.1458,34.1611,20.7857142857143,24.2142857142857,1.34285714285714,51.2571428571429,15.7457142857143,NA,559,222,444,0,0,1047,337,603
2017,32,62,"Kirsehir",39.1458,34.1611,24.7571428571429,27.5857142857143,0,39.4857142857143,22.5442857142857,NA,567,464,895,0,0,1092,103,197
2017,33,62,"Kirsehir",39.1458,34.1611,25.4142857142857,26.2285714285714,0.0714285714285714,44.3142857142857,19.7642857142857,NA,596,420,847,0,0,1199,176,352
2017,34,62,"Kirsehir",39.1458,34.1611,24.2285714285714,22.3714285714286,0.0142857142857143,48.6571428571429,15.2242857142857,NA,601,264,828,0,0,1280,337,452
2017,35,62,"Kirsehir",39.1458,34.1611,19.1857142857143,21.7,0.857142857142857,44.8857142857143,14.9114285714286,NA,493,235,653,0,0,1014,258,361
2017,36,62,"Kirsehir",39.1458,34.1611,15.3571428571429,21.6285714285714,0,32.5571428571429,20.7871428571429,NA,507,177,695,0,0,1321,330,626
2017,37,62,"Kirsehir",39.1458,34.1611,20.8428571428571,25.9428571428571,0,25.4428571428571,39.17,NA,589,491,1044,0,0,1138,98,94
2017,38,62,"Kirsehir",39.1458,34.1611,19.8142857142857,23.8142857142857,0.0428571428571429,28.3571428571429,27.9183333333333,NA,671,209,494,0,0,1312,462,818
2017,39,62,"Kirsehir",39.1458,34.1611,20.6714285714286,18.4,0.114285714285714,48.5571428571429,15.4271428571429,NA,782,351,948,0,0,1630,431,682
2017,40,62,"Kirsehir",39.1458,34.1611,15.6142857142857,12.9714285714286,1.25728571428571,51.3285714285714,15.7985714285714,NA,543,305,769,0,0,1137,238,368
2017,41,62,"Kirsehir",39.1458,34.1611,15.1,11.5428571428571,0.1,56.6571428571429,11.3271428571429,NA,487,100,260,0,0,843,387,583
2017,42,62,"Kirsehir",39.1458,34.1611,15.1,12.3,0,45.0857142857143,26.6057142857143,NA,530,259,377,0,0,815,271,438
2017,43,62,"Kirsehir",39.1458,34.1611,16.4285714285714,12.5857142857143,1.14285714285714,57.0857142857143,34.1366666666667,NA,506,169,393,0,0,919,337,526
2017,44,62,"Kirsehir",39.1458,34.1611,16.1285714285714,5.97142857142857,2.19985714285714,61.3714285714286,8.29,NA,561,183,419,0,0,1102,378,683
2017,45,62,"Kirsehir",39.1458,34.1611,15.6142857142857,6.58571428571429,0.0285714285714286,76.5571428571429,35.6814285714286,NA,577,410,683,0,0,829,167,146
2017,46,62,"Kirsehir",39.1458,34.1611,13.3,9.22857142857143,0.114285714285714,63.9142857142857,56.6585714285714,NA,587,253,538,0,0,1085,334,547
2017,47,62,"Kirsehir",39.1458,34.1611,18.0285714285714,4.6,1.58585714285714,75.9714285714286,25.2233333333333,NA,418,127,346,0,0,804,291,458
2017,48,62,"Kirsehir",39.1458,34.1611,19.0428571428571,5.9,3.22842857142857,79.0571428571428,47.3771428571429,NA,386,323,489,0,0,619,63,130
2017,49,62,"Kirsehir",39.1458,34.1611,20.6714285714286,2.8,1.257,73.4857142857143,39.2885714285714,NA,407,210,321,19,20,645,197,324
2017,50,62,"Kirsehir",39.1458,34.1611,19.3285714285714,5.51428571428571,0.0571428571428571,74.6857142857143,46.2985714285714,NA,346,238,281,0,0,442,108,161
2017,51,62,"Kirsehir",39.1458,34.1611,19.0857142857143,6.95714285714286,3.17142857142857,81.9142857142857,22.66,NA,386,73,67,0,0,349,313,282
2017,52,62,"Kirsehir",39.1458,34.1611,14.6125,1.3625,2.574875,80.6125,44.09,NA,528,80,120,0,0,507,448,387
2018,1,62,"Kirsehir",39.1458,34.1611,16.075,3.15,8.824375,84.175,28.8525,29.85,618,209,312,0,0,914,409,602
2018,2,62,"Kirsehir",39.1458,34.1611,15.7,3.1,1.22857142857143,85.2,31.25,NA,624,468,1142,0,0,1309,156,167
2018,3,62,"Kirsehir",39.1458,34.1611,20.1571428571429,2.27142857142857,0.843,78.3142857142857,20.5042857142857,NA,639,371,502,18,20,655,268,153
2018,4,62,"Kirsehir",39.1458,34.1611,26.2714285714286,0.1,3.8,80.7428571428571,10.9842857142857,NA,604,86,169,140,186,764,518,595
2018,5,62,"Kirsehir",39.1458,34.1611,19.5714285714286,3.45714285714286,0.0142857142857143,71.2428571428571,24.8633333333333,NA,670,549,701,0,0,819,121,118
2018,6,62,"Kirsehir",39.1458,34.1611,19.5142857142857,8,0.171428571428571,64.2714285714286,NA,NA,704,378,518,69,128,1022,326,504
2018,7,62,"Kirsehir",39.1458,34.1611,24.7,6.01428571428571,0.285714285714286,65.7857142857143,NA,NA,478,63,108,42,62,557,415,449
2018,8,62,"Kirsehir",39.1458,34.1611,19.4857142857143,6.5,0.242857142857143,71.5428571428571,NA,NA,711,606,1023,0,0,1321,105,298
2018,9,62,"Kirsehir",39.1458,34.1611,25.6571428571429,6.62857142857143,3.3,68.3428571428571,31.8466666666667,NA,621,108,197,37,63,956,513,759
2018,10,62,"Kirsehir",39.1458,34.1611,18.2142857142857,9,2.02857142857143,74.2428571428571,NA,NA,556,229,488,37,80,1330,327,842
2018,11,62,"Kirsehir",39.1458,34.1611,23.2857142857143,9.57142857142857,2.30014285714286,68.3428571428571,63.035,NA,551,84,196,0,0,1426,467,1230
2018,12,62,"Kirsehir",39.1458,34.1611,23.7714285714286,12.6142857142857,0.657142857142857,51.5,56.9585714285714,NA,425,119,235,0,0,1187,306,952
2018,13,62,"Kirsehir",39.1458,34.1611,18.0142857142857,11.2285714285714,0.857142857142857,61.2,67.402,NA,356,151,189,37,45,428,205,239
2018,14,62,"Kirsehir",39.1458,34.1611,16.8571428571429,11.1285714285714,0.1,53.6142857142857,42.37,41.69,407,224,202,52,39,486,183,284
2018,15,62,"Kirsehir",39.1458,34.1611,21.1428571428571,13.9142857142857,0.342857142857143,62.4714285714286,27.8642857142857,37.745,374,70,66,55,170,450,304,384
2018,16,62,"Kirsehir",39.1458,34.1611,23.7142857142857,12.3714285714286,0.171428571428571,46.1142857142857,25.0142857142857,42.32,411,126,204,150,191,648,285,444
2018,17,62,"Kirsehir",39.1458,34.1611,20.5285714285714,17.0428571428571,0,39.0714285714286,19.8914285714286,33.662,419,20,53,12,29,652,399,599
2018,18,62,"Kirsehir",39.1458,34.1611,17.5428571428571,18.1285714285714,1.39985714285714,53.8428571428571,27.8742857142857,26.8433333333333,303,267,310,0,0,474,36,164
2018,19,62,"Kirsehir",39.1458,34.1611,15.8714285714286,13.6,5.04271428571429,74.8714285714286,12.43,NA,275,55,72,9,14,467,220,395
2018,20,62,"Kirsehir",39.1458,34.1611,17.9,18.1,0.2,58.6857142857143,17.3385714285714,35.55,204,127,165,11,16,306,77,141
2018,21,62,"Kirsehir",39.1458,34.1611,17.9714285714286,19.2285714285714,1.20014285714286,62.1857142857143,19.5771428571429,NA,252,45,41,119,82,281,207,240
2018,22,62,"Kirsehir",39.1458,34.1611,23.7571428571429,17.7428571428571,1.71442857142857,66.5,14.6642857142857,NA,249,0,0,44,112,427,249,427
2018,23,62,"Kirsehir",39.1458,34.1611,20.4142857142857,21.6285714285714,0.228571428571429,47.4857142857143,14.8571428571429,26.545,267,5,47,52,186,812,262,765
2018,24,62,"Kirsehir",39.1458,34.1611,25.3714285714286,21.8857142857143,1.68571428571429,49.8714285714286,13.4885714285714,17.4366666666667,267,66,42,11,31,448,201,406
2018,25,62,"Kirsehir",39.1458,34.1611,19.2571428571429,20.5142857142857,1.343,63.6,7.42428571428571,NA,358,42,83,154,256,518,316,435
2018,26,62,"Kirsehir",39.1458,34.1611,18.0142857142857,24.5142857142857,0.0857142857142857,44.2571428571429,22.0614285714286,NA,355,22,39,40,84,587,333,548
2018,27,62,"Kirsehir",39.1458,34.1611,29.4142857142857,24.2857142857143,0,44.1428571428571,10.7425,9.33,342,46,80,99,142,418,296,338
2018,28,62,"Kirsehir",39.1458,34.1611,29.3857142857143,26.3571428571429,0.142857142857143,39.9571428571429,NA,NA,286,11,28,63,127,585,275,557
2018,29,62,"Kirsehir",39.1458,34.1611,25.4571428571429,23.8285714285714,0.485714285714286,40.8428571428571,12.6333333333333,30.56,260,0,0,114,349,756,260,756
2018,30,62,"Kirsehir",39.1458,34.1611,21.6142857142857,25.7,0,42.2,24.2685714285714,21.674,265,27,54,90,228,822,238,768
2018,31,62,"Kirsehir",39.1458,34.1611,32.8714285714286,26.2142857142857,0.428571428571429,44.2285714285714,10.1342857142857,9.08,267,0,0,46,131,499,267,499
2018,32,62,"Kirsehir",39.1458,34.1611,34.6,23.1857142857143,0,43.7142857142857,8.65714285714286,8.77714285714286,297,0,0,36,56,403,297,403
2018,33,62,"Kirsehir",39.1458,34.1611,23.5714285714286,23.9857142857143,0,37.1,10.4142857142857,14.9542857142857,216,0,0,57,105,332,216,332
2018,34,62,"Kirsehir",39.1458,34.1611,21.1571428571429,24.7857142857143,0,35.1857142857143,11.9214285714286,14.3857142857143,144,33,59,35,75,227,111,168
2018,35,62,"Kirsehir",39.1458,34.1611,28.8142857142857,26.3142857142857,0.1,35.1571428571429,14.6571428571429,11.5885714285714,201,44,31,22,105,314,157,283
2018,36,62,"Kirsehir",39.1458,34.1611,20.6428571428571,22.0285714285714,0.0857142857142857,42.6428571428571,23.27,25.97,341,102,85,132,153,370,239,285
2018,37,62,"Kirsehir",39.1458,34.1611,20.3857142857143,20.0285714285714,0.128571428571429,48,11.8385714285714,16.7971428571429,241,1,1,39,89,419,240,418
2018,38,62,"Kirsehir",39.1458,34.1611,21.1714285714286,18.7714285714286,0,41.9857142857143,11.5685714285714,22.7957142857143,189,17,42,72,146,344,172,302
2018,39,62,"Kirsehir",39.1458,34.1611,23.5142857142857,17.7571428571429,0.528571428571429,48.4428571428571,21.0457142857143,26.7342857142857,180,52,112,74,141,353,128,241
2018,40,62,"Kirsehir",39.1458,34.1611,22.5428571428571,16.3714285714286,0.0285714285714286,48.9428571428571,18.2371428571429,26.1357142857143,191,64,92,42,130,341,127,249
2018,41,62,"Kirsehir",39.1458,34.1611,18.7857142857143,16.1285714285714,1.57157142857143,63.9,23.87,21.3971428571429,187,8,11,83,302,422,179,411
2018,42,62,"Kirsehir",39.1458,34.1611,16.9,15.9142857142857,0.943,65.0285714285714,98.4528571428571,38.6642857142857,168,104,296,49,76,381,64,85
2018,43,62,"Kirsehir",39.1458,34.1611,18.7857142857143,9.57142857142857,2.58585714285714,73.2285714285714,29.97,37.0757142857143,187,112,231,62,169,402,75,171
2018,44,62,"Kirsehir",39.1458,34.1611,16.6428571428571,11.1142857142857,0,57.2571428571429,41.66,47.8528571428571,196,95,139,40,81,264,101,125
2018,45,62,"Kirsehir",39.1458,34.1611,14.5857142857143,8.21428571428572,0,65.0714285714286,37.3385714285714,40.0914285714286,231,138,285,81,135,473,93,188
2018,46,62,"Kirsehir",39.1458,34.1611,15.5714285714286,4.91428571428571,0.2,67.7571428571429,25.9885714285714,36.5357142857143,230,169,337,23,52,465,61,128
2018,47,62,"Kirsehir",39.1458,34.1611,19.3142857142857,7.95714285714286,0.614285714285714,73.7714285714286,50.1757142857143,43.2742857142857,270,208,249,50,195,499,62,250
2018,48,62,"Kirsehir",39.1458,34.1611,17.5,8.15714285714286,3.4,81.3571428571429,32.3028571428571,37.9357142857143,245,139,107,23,17,201,106,94
2018,49,62,"Kirsehir",39.1458,34.1611,19.0428571428571,4.34285714285714,3.64285714285714,84.5285714285714,29.9542857142857,38.1928571428571,257,193,257,0,0,420,64,163
2018,50,62,"Kirsehir",39.1458,34.1611,21.7,4.01428571428571,5.98557142857143,80.9,26.6314285714286,39.3985714285714,256,169,213,59,66,305,87,92
2018,51,62,"Kirsehir",39.1458,34.1611,18.4857142857143,6.01428571428571,3.15714285714286,82.9285714285714,20.5042857142857,33.0928571428571,250,155,152,0,0,248,95,96
2018,52,62,"Kirsehir",39.1458,34.1611,19.3571428571429,-0.957142857142857,2.42842857142857,77.2,18.2014285714286,30.3214285714286,244,34,32,18,2,273,210,241
2019,1,62,"Kirsehir",39.1458,34.1611,20.65,2.05,1.412625,82.4,21.98,39.49,343,27,152,32,13,784,316,632
2019,2,62,"Kirsehir",39.1458,34.1611,25.7571428571429,-2.25714285714286,0.628714285714286,78.8428571428571,35.5714285714286,49.7885714285714,255,110,79,56,62,208,145,129
2019,3,62,"Kirsehir",39.1458,34.1611,20.8,-1.9,1.22885714285714,80.8142857142857,33.5857142857143,41.9085714285714,192,117,152,3,6,198,75,46
2019,4,62,"Kirsehir",39.1458,34.1611,20.4714285714286,3.71428571428571,2.11428571428571,77.1142857142857,45.9328571428571,46.98,308,214,261,0,0,314,94,53
2019,5,62,"Kirsehir",39.1458,34.1611,18.3714285714286,4.25714285714286,1.04285714285714,73.2285714285714,43.9814285714286,43.11,253,174,96,0,0,143,79,47
2019,6,62,"Kirsehir",39.1458,34.1611,16.9571428571429,5.18571428571429,4.44314285714286,77.8571428571429,26.9428571428571,43.6885714285714,276,150,40,5,0,127,126,87
2019,7,62,"Kirsehir",39.1458,34.1611,21.3571428571429,4.04285714285714,0.128571428571429,70.5714285714286,22.3671428571429,30.8128571428571,325,42,36,0,0,234,283,198
2019,8,62,"Kirsehir",39.1458,34.1611,15.4428571428571,4.62857142857143,0.0428571428571429,64.0857142857143,35.0128571428571,40.7314285714286,305,154,115,1,0,219,151,104
2019,9,62,"Kirsehir",39.1458,34.1611,20.9285714285714,3.15714285714286,0.342857142857143,70.1571428571429,11.3671428571429,24.215,331,0,0,29,57,310,331,310
2019,10,62,"Kirsehir",39.1458,34.1611,16.1571428571429,5.75714285714286,0.642857142857143,59.7428571428571,25.6328571428571,41.4357142857143,359,113,127,25,16,252,246,125
2019,11,62,"Kirsehir",39.1458,34.1611,20.8571428571429,8.37142857142857,0.857142857142857,61.8285714285714,18.4985714285714,24.7885714285714,373,78,158,23,39,400,295,242
2019,12,62,"Kirsehir",39.1458,34.1611,23.1428571428571,7.04285714285714,0,51.2857142857143,17.8171428571429,30.3033333333333,343,88,301,159,88,416,255,115
2019,13,62,"Kirsehir",39.1458,34.1611,32.3857142857143,4.88571428571429,0.128714285714286,54.8142857142857,12.1785714285714,20.3428571428571,256,69,65,103,109,194,187,129
2019,14,62,"Kirsehir",39.1458,34.1611,15.6285714285714,9.22857142857143,0.0285714285714286,57.3142857142857,14.97,29.7028571428571,365,210,131,2,1,208,155,77
2019,15,62,"Kirsehir",39.1458,34.1611,19.7142857142857,11.4285714285714,2.05728571428571,67,16.9742857142857,27.8957142857143,359,142,66,54,27,183,217,117
2019,16,62,"Kirsehir",39.1458,34.1611,18.4,6.25714285714286,2.52857142857143,77.0285714285714,3.73571428571429,17.5028571428571,318,0,0,139,93,208,318,208
2019,17,62,"Kirsehir",39.1458,34.1611,16.2571428571429,11.1571428571429,0.328571428571429,63.1857142857143,32.5857142857143,32.3033333333333,412,149,160,1,0,313,263,153
2019,18,62,"Kirsehir",39.1458,34.1611,20.2571428571429,14.8,1.01442857142857,55.7142857142857,23.6942857142857,25.2157142857143,523,31,7,0,0,353,492,346
2019,19,62,"Kirsehir",39.1458,34.1611,19.1285714285714,13.2571428571429,1.04285714285714,62.1,26.61,16.5,452,202,154,0,0,386,250,232
2019,20,62,"Kirsehir",39.1458,34.1611,18.0142857142857,19.1,0,48.5857142857143,28.3071428571429,22.8233333333333,454,76,54,6,5,389,378,335
2019,21,62,"Kirsehir",39.1458,34.1611,17.7142857142857,19.7857142857143,0.342857142857143,50.2714285714286,35.8933333333333,20.412,457,71,31,138,153,413,386,382
2019,22,62,"Kirsehir",39.1458,34.1611,17.4142857142857,22.6857142857143,0.286,44.8857142857143,34.18,25.2457142857143,453,1,0,148,126,323,452,323
2019,23,62,"Kirsehir",39.1458,34.1611,20.8285714285714,22.9571428571429,0.242857142857143,39.8285714285714,31.1442857142857,18.24,378,64,128,2,1,532,314,404
2019,24,62,"Kirsehir",39.1458,34.1611,18.5142857142857,19.3571428571429,3.10057142857143,70.2142857142857,14.13,15.0285714285714,378,1,0,179,93,244,377,244
2019,25,62,"Kirsehir",39.1458,34.1611,17.1571428571429,20.3428571428571,8.47114285714286,71.9571428571429,12.5757142857143,15.6985714285714,306,0,0,95,79,325,306,325
2019,26,62,"Kirsehir",39.1458,34.1611,25.3142857142857,23.7,0,48.6571428571429,14.3657142857143,10.47,377,0,0,37,23,342,377,342
2019,27,62,"Kirsehir",39.1458,34.1611,29.3857142857143,22.6,0,42.7,13.3728571428571,8.89142857142857,456,0,0,70,84,222,456,222
2019,28,62,"Kirsehir",39.1458,34.1611,16.1,22.4571428571429,0.314285714285714,47.7714285714286,16.2271428571429,14.2757142857143,398,56,25,193,147,421,342,396
2019,29,62,"Kirsehir",39.1458,34.1611,25.4142857142857,20.4285714285714,0.885857142857143,59.3,14.8157142857143,11.9971428571429,453,0,0,59,21,203,453,203
2019,30,62,"Kirsehir",39.1458,34.1611,28.1,22.6571428571429,0,45.3,21.94,12.7071428571429,456,0,0,86,68,335,456,335
2019,31,62,"Kirsehir",39.1458,34.1611,18.3714285714286,26.1428571428571,0,38.2857142857143,38.8185714285714,22.9371428571429,334,17,13,89,86,375,317,362
2019,32,62,"Kirsehir",39.1458,34.1611,31.2714285714286,22.0857142857143,0.657142857142857,43.9714285714286,17.5142857142857,10.4671428571429,346,0,0,12,19,395,346,395
2019,33,62,"Kirsehir",39.1458,34.1611,25.1142857142857,24.8,5.77114285714286,44.6714285714286,29.7014285714286,16.0357142857143,337,50,85,169,332,531,287,446
2019,34,62,"Kirsehir",39.1458,34.1611,27.7142857142857,20.9571428571429,3.04271428571429,65.5714285714286,21.0328571428571,17.1942857142857,299,0,0,62,73,345,299,345
2019,35,62,"Kirsehir",39.1458,34.1611,26.5857142857143,23.4285714285714,0,49.5142857142857,21.1614285714286,11.8571428571429,307,0,0,90,91,415,307,415
2019,36,62,"Kirsehir",39.1458,34.1611,21.7857142857143,22.1285714285714,0,38.8571428571429,23.6885714285714,13.564,171,0,0,46,35,67,171,67
2019,37,62,"Kirsehir",39.1458,34.1611,28.4142857142857,19.5857142857143,2.58557142857143,51.2142857142857,17.5642857142857,14.876,218,0,0,37,12,55,218,55
2019,38,62,"Kirsehir",39.1458,34.1611,20.1142857142857,16.9142857142857,0,51.4,32.2214285714286,34.7916666666667,266,125,54,48,11,91,141,37
2019,39,62,"Kirsehir",39.1458,34.1611,15.5857142857143,17.0428571428571,0.514285714285714,52.6142857142857,29.7414285714286,37.3216666666667,237,61,30,70,12,79,176,49
2019,40,62,"Kirsehir",39.1458,34.1611,17.0285714285714,18.4714285714286,0,40.8714285714286,47.5585714285714,43.5228571428571,241,46,50,33,7,111,195,61
2019,41,62,"Kirsehir",39.1458,34.1611,14.6142857142857,16.3428571428571,0.0142857142857143,50.8142857142857,33.1628571428571,33.95,416,24,48,139,237,448,392,400
2019,42,62,"Kirsehir",39.1458,34.1611,12.6857142857143,16.8285714285714,0.0571428571428571,49.3285714285714,46.7871428571429,47.112,356,111,143,151,207,408,245,265
2019,43,62,"Kirsehir",39.1458,34.1611,20.9285714285714,13.9142857142857,0,63.8714285714286,19.6742857142857,20.5725,306,0,0,170,193,300,306,300
2019,44,62,"Kirsehir",39.1458,34.1611,14.9714285714286,9.78571428571429,0.714285714285714,65.1714285714286,39.7514285714286,59.0516666666667,350,122,100,70,46,250,228,150
2019,45,62,"Kirsehir",39.1458,34.1611,16.4,11.2142857142857,0,52.8571428571429,63.6942857142857,82.2957142857143,417,378,321,0,0,328,39,7
2019,46,62,"Kirsehir",39.1458,34.1611,14.3428571428571,10.7428571428571,0,52.1428571428571,68.2185714285714,79.5442857142857,401,137,93,67,69,337,264,244
2019,47,62,"Kirsehir",39.1458,34.1611,9.3,3.75714285714286,0,64.7285714285714,102.695714285714,72.7057142857143,391,296,301,0,0,339,95,38
2019,48,62,"Kirsehir",39.1458,34.1611,19.9428571428571,8.12857142857143,4.39971428571429,76.3,63.73,65.61,320,157,84,54,75,251,163,167
2019,49,62,"Kirsehir",39.1458,34.1611,16,1.37142857142857,0.2,79.8714285714286,28.95,32.6285714285714,393,75,68,67,50,274,318,206
2019,50,62,"Kirsehir",39.1458,34.1611,14.2714285714286,5.08571428571429,0.557285714285714,80.3285714285714,43.4428571428571,56.5242857142857,218,124,83,0,0,119,94,36
2019,51,62,"Kirsehir",39.1458,34.1611,9.18571428571429,3.88571428571429,0,75.8428571428571,87.5957142857143,58.3542857142857,361,118,222,1,0,488,243,266
2019,52,62,"Kirsehir",39.1458,34.1611,18.2142857142857,4.15714285714286,5.78557142857143,83.7428571428571,18.5657142857143,33.1914285714286,279,162,198,90,62,281,117,83
2020,1,62,"Kirsehir",39.1458,34.1611,17.94,1.34,0.38,81.7,31.7366666666667,46.906,160,31,24,78,32,126,129,102
2020,2,62,"Kirsehir",39.1458,34.1611,22.9714285714286,1.97142857142857,0.485857142857143,73.4571428571429,31.6342857142857,59.1971428571429,240,94,62,34,46,173,146,111
2020,3,62,"Kirsehir",39.1458,34.1611,13.5428571428571,0.9,0,69.8428571428571,36.5657142857143,61.2942857142857,270,29,31,67,79,382,241,351
2020,4,62,"Kirsehir",39.1458,34.1611,18.9285714285714,-1.38571428571429,0.385714285714286,66.7571428571429,34.7957142857143,51.102,358,118,159,100,45,295,240,136
2020,5,62,"Kirsehir",39.1458,34.1611,19.2428571428571,2.45714285714286,6.39985714285714,77.9,52.3857142857143,NA,331,223,206,33,24,272,108,66
2020,6,62,"Kirsehir",39.1458,34.1611,25.2714285714286,2.27142857142857,3.943,76.2285714285714,26.9885714285714,NA,343,84,58,85,64,267,259,209
2020,7,62,"Kirsehir",39.1458,34.1611,18.9,-1.31428571428571,2.72857142857143,75.8428571428571,44.0242857142857,NA,341,143,198,15,6,338,198,140
2020,8,62,"Kirsehir",39.1458,34.1611,16.4,2.97142857142857,1.52857142857143,76.8285714285714,45.5585714285714,NA,283,156,120,87,46,187,127,67
2020,9,62,"Kirsehir",39.1458,34.1611,22.5571428571429,6.75714285714286,0.4,62.7857142857143,28.8233333333333,NA,393,73,21,99,130,528,320,507
2020,10,62,"Kirsehir",39.1458,34.1611,18.3857142857143,9.55714285714286,0,52.4285714285714,56.3571428571429,43.3866666666667,205,148,133,0,0,210,57,77
2020,11,62,"Kirsehir",39.1458,34.1611,23.9571428571429,12.6142857142857,0.571428571428572,50.7142857142857,42.7342857142857,31.2728571428571,115,47,49,0,0,94,68,45
2020,12,62,"Kirsehir",39.1458,34.1611,28.3285714285714,1.44285714285714,2.243,75.5,13.9928571428571,19.152,117,11,10,64,47,118,106,108
2020,13,62,"Kirsehir",39.1458,34.1611,18.0142857142857,9.57142857142857,0.885714285714286,65.9857142857143,27.5485714285714,24.69,136,29,9,8,1,92,107,83
2020,14,62,"Kirsehir",39.1458,34.1611,14.9857142857143,8.58571428571429,1.84285714285714,68.0285714285714,19.6085714285714,19.31,155,55,56,5,1,121,100,65
2020,15,62,"Kirsehir",39.1458,34.1611,22.8,9.24285714285714,0.614285714285714,55.0714285714286,22.8585714285714,11.7371428571429,133,0,0,5,2,118,133,118
2020,16,62,"Kirsehir",39.1458,34.1611,14.8428571428571,11.8857142857143,0.414285714285714,50.4,30.2928571428571,24.9285714285714,141,49,21,15,23,106,92,85
2020,17,62,"Kirsehir",39.1458,34.1611,17.5428571428571,10.6142857142857,0.842857142857143,56.5285714285714,20.5814285714286,15.725,137,1,0,42,25,123,136,123
2020,18,62,"Kirsehir",39.1458,34.1611,14.0285714285714,12.7857142857143,3.74328571428571,62.8142857142857,23.7857142857143,22.7171428571429,146,16,15,8,47,164,130,149
2020,19,62,"Kirsehir",39.1458,34.1611,13.4,11.7142857142857,4.37128571428571,68.9571428571429,14.4785714285714,20.6042857142857,137,25,58,53,26,157,112,99
2020,20,62,"Kirsehir",39.1458,34.1611,12.4142857142857,20.8,0,43.9428571428571,53.1257142857143,29.6442857142857,164,0,0,37,28,164,164,164
2020,21,62,"Kirsehir",39.1458,34.1611,18.5428571428571,19.2,0.328571428571429,43.8142857142857,60.6014285714286,17.0571428571429,146,10,0,55,53,96,136,96
2020,22,62,"Kirsehir",39.1458,34.1611,17.0714285714286,15.7285714285714,0.442857142857143,44.7142857142857,21.9185714285714,18.0916666666667,118,19,7,7,3,100,99,93
2020,23,62,"Kirsehir",39.1458,34.1611,15.7428571428571,18.6428571428571,0.471428571428571,46.4,25.1028571428571,24.6628571428571,112,34,24,0,0,70,78,46
2020,24,62,"Kirsehir",39.1458,34.1611,18.8285714285714,21.0857142857143,0.100142857142857,47.2571428571429,44.8985714285714,20.7557142857143,140,90,113,0,0,150,50,37
2020,25,62,"Kirsehir",39.1458,34.1611,16.4571428571429,19.7142857142857,4.257,58.5714285714286,27.7614285714286,21.6016666666667,137,26,5,48,47,108,111,103
2020,26,62,"Kirsehir",39.1458,34.1611,20.7571428571429,22.0571428571429,0.428571428571429,51.2142857142857,28.9628571428571,15.275,173,20,3,3,1,133,153,130
2020,27,62,"Kirsehir",39.1458,34.1611,22.3571428571429,24.7,0.114285714285714,37.2571428571429,25.1928571428571,16.7328571428571,113,0,0,15,38,113,113,113
2020,28,62,"Kirsehir",39.1458,34.1611,26.6,24.7,1.38585714285714,47.5285714285714,25.8114285714286,12.8928571428571,164,0,0,13,2,122,164,122
2020,29,62,"Kirsehir",39.1458,34.1611,22.9,25.9142857142857,0,40.3571428571429,32.9328571428571,14.7014285714286,186,25,8,4,1,111,161,103
2020,30,62,"Kirsehir",39.1458,34.1611,30.5857142857143,24.9857142857143,0,41.5714285714286,34.3928571428571,16.5628571428571,190,0,0,37,33,142,190,142
2020,31,62,"Kirsehir",39.1458,34.1611,23.1285714285714,25.7714285714286,0,38.3,26.5185714285714,17.1142857142857,150,13,23,31,21,127,137,104
2020,32,62,"Kirsehir",39.1458,34.1611,27.3571428571429,24.5857142857143,0,34.5571428571429,15.2685714285714,14.8314285714286,146,0,0,27,19,107,146,107
2020,33,62,"Kirsehir",39.1458,34.1611,30.2857142857143,23.1571428571429,0,38.0142857142857,18.592,10.1933333333333,183,0,0,7,1,83,183,83
2020,34,62,"Kirsehir",39.1458,34.1611,19.0571428571429,22.1142857142857,0,39.7857142857143,20.3371428571429,18.3928571428571,197,50,21,69,53,97,147,76
2020,35,62,"Kirsehir",39.1458,34.1611,17.3285714285714,24.1,0,29.3857142857143,22.4957142857143,25.0585714285714,164,32,36,66,68,157,132,121
2020,36,62,"Kirsehir",39.1458,34.1611,16.9428571428571,25.9285714285714,0,28.9714285714286,42.0557142857143,37.6657142857143,179,46,21,56,41,112,133,91
2020,37,62,"Kirsehir",39.1458,34.1611,28.4857142857143,23.1857142857143,0.114285714285714,45.1714285714286,29.0266666666667,17.6383333333333,193,4,2,26,15,91,189,89
2020,38,62,"Kirsehir",39.1458,34.1611,18.3571428571429,22.2285714285714,0,42.9714285714286,20.085,10.16,235,44,29,57,37,157,191,128
2020,39,62,"Kirsehir",39.1458,34.1611,18.5142857142857,19.5428571428571,0.871428571428571,52.5,27.54,34.21,220,46,23,96,59,129,174,106
2020,40,62,"Kirsehir",39.1458,34.1611,16.2571428571429,18.2142857142857,0.928571428571428,48.0571428571429,30.152,39.982,187,94,59,0,0,154,93,95
2020,41,62,"Kirsehir",39.1458,34.1611,16,19.6,0,33.9428571428571,43.64,42.7414285714286,182,156,105,0,0,127,26,22
2020,42,62,"Kirsehir",39.1458,34.1611,15.3714285714286,17.3285714285714,0,41.1428571428571,36.4657142857143,50.0014285714286,177,136,69,0,0,111,41,42
2020,43,62,"Kirsehir",39.1458,34.1611,18.4,15.4428571428571,0.414285714285714,55.0714285714286,22.6766666666667,29.595,194,73,90,15,9,161,121,71
2020,44,62,"Kirsehir",39.1458,34.1611,18,14.3428571428571,0.0714285714285714,46.6571428571429,38.8242857142857,46.585,255,126,145,0,0,233,129,88
2020,45,62,"Kirsehir",39.1458,34.1611,29.6714285714286,9.34285714285714,2.34285714285714,65.7857142857143,15.33,27.6114285714286,156,0,0,46,35,103,156,103
2020,46,62,"Kirsehir",39.1458,34.1611,15.4,7.64285714285714,0.0142857142857143,65.9142857142857,26.2428571428571,40.5328571428571,208,15,3,92,54,109,193,106
2020,47,62,"Kirsehir",39.1458,34.1611,17.2428571428571,5.2,0.285714285714286,67.8571428571429,21.4928571428571,40.7557142857143,173,0,0,67,25,83,173,83
2020,48,62,"Kirsehir",39.1458,34.1611,20.5285714285714,1.55714285714286,0,66.9571428571429,29.3914285714286,49.1716666666667,199,94,157,5,0,262,105,105
2020,49,62,"Kirsehir",39.1458,34.1611,11.2,4.68571428571429,0,67.4,44.11,63.3314285714286,207,94,84,35,9,116,113,32
2020,50,62,"Kirsehir",39.1458,34.1611,20.9285714285714,5.85714285714286,1.55728571428571,79.4857142857143,37.6028571428571,65.8371428571429,181,181,98,0,0,98,0,0
2020,51,62,"Kirsehir",39.1458,34.1611,15.8571428571429,5.54285714285714,0.557142857142857,76.9571428571429,18.8028571428571,28.664,171,81,44,27,4,90,90,46
2020,52,62,"Kirsehir",39.1458,34.1611,16.5142857142857,1.84285714285714,0,73.7,32.6642857142857,53.1228571428571,203,155,73,33,36,113,48,40
2020,53,62,"Kirsehir",39.1458,34.1611,13.925,4.175,0.025,68.325,48.5075,69.395,122,109,73,0,0,111,13,38
2017,1,63,"Izmit",40.8533,29.8815,11.9714285714286,3.44285714285714,5.23585714285714,79.0857142857143,73.25,60.2614285714286,563,191,257,72,119,847,372,590
2017,2,63,"Izmit",40.8533,29.8815,17,4.55714285714286,1.76157142857143,73.6571428571429,49.6414285714286,58.5557142857143,757,219,346,222,355,1214,538,868
2017,3,63,"Izmit",40.8533,29.8815,9.84285714285714,4.57142857142857,3.027,90.3571428571429,47.9328571428571,48.1142857142857,762,81,82,116,193,1449,681,1367
2017,4,63,"Izmit",40.8533,29.8815,11.2142857142857,1.72857142857143,1.22014285714286,85.9285714285714,58.3157142857143,52.67,639,34,30,139,138,889,605,859
2017,5,63,"Izmit",40.8533,29.8815,14.2714285714286,3.31428571428571,0.346285714285714,73.0142857142857,96.8628571428571,68.4328571428571,588,0,0,100,114,1163,588,1163
2017,6,63,"Izmit",40.8533,29.8815,14.3714285714286,7.57142857142857,0.349571428571429,88.5428571428571,71.1128571428571,49.4057142857143,736,0,0,252,577,1519,736,1519
2017,7,63,"Izmit",40.8533,29.8815,14.5285714285714,3.08571428571429,0.284142857142857,88.2285714285714,69.0614285714286,59.4614285714286,492,0,0,169,181,717,492,717
2017,8,63,"Izmit",40.8533,29.8815,16.7428571428571,9.54285714285714,0.449857142857143,87.2571428571429,112.498571428571,68.89,739,0,0,376,985,1747,739,1747
2017,9,63,"Izmit",40.8533,29.8815,15.1142857142857,9.17142857142857,0.0605714285714286,90.0714285714286,112.474285714286,65.5157142857143,574,0,0,151,252,866,574,866
2017,10,63,"Izmit",40.8533,29.8815,13.6142857142857,11.1857142857143,0.345285714285714,86.8571428571429,88.6514285714286,60.66,712,0,0,27,52,1043,712,1043
2017,11,63,"Izmit",40.8533,29.8815,16.6428571428571,6.64285714285714,3.69285714285714,93.1714285714286,66.6685714285714,59.0514285714286,525,0,0,409,592,725,525,725
2017,12,63,"Izmit",40.8533,29.8815,14.7571428571429,10.2142857142857,0.117857142857143,87.2428571428571,93.3371428571429,62.0428571428571,589,0,0,113,167,1077,589,1077
2017,13,63,"Izmit",40.8533,29.8815,19.5,8.94285714285714,0.908142857142857,87.3571428571429,52.5357142857143,46.5071428571429,574,0,0,0,0,887,574,887
2017,14,63,"Izmit",40.8533,29.8815,14.7714285714286,10.9857142857143,1.30114285714286,88.9142857142857,80.4657142857143,66.0357142857143,639,0,0,16,62,1336,639,1336
2017,15,63,"Izmit",40.8533,29.8815,13.8,12.1571428571429,0.277428571428571,69.9,65.7185714285714,61.67,587,113,264,150,395,1187,474,923
2017,16,63,"Izmit",40.8533,29.8815,17.4571428571429,10.8571428571429,6.05985714285714,78.3857142857143,39.5942857142857,45.5871428571429,717,81,38,447,669,920,636,882
2017,17,63,"Izmit",40.8533,29.8815,16.6,14.5714285714286,1.30571428571429,63.6285714285714,69.2985714285714,72.1771428571429,731,270,531,189,322,1478,461,947
2017,18,63,"Izmit",40.8533,29.8815,14.4142857142857,16.3142857142857,2.00271428571429,77.3,63.4328571428571,55.0714285714286,506,91,139,110,204,923,415,784
2017,19,63,"Izmit",40.8533,29.8815,13.4857142857143,18.2714285714286,2.61814285714286,75.8,63.8785714285714,56.7885714285714,471,139,310,241,527,966,332,656
2017,20,63,"Izmit",40.8533,29.8815,16.7285714285714,15.3714285714286,0.606,79.4714285714286,35.31,37.1728571428571,472,12,29,166,575,1205,460,1176
2017,21,63,"Izmit",40.8533,29.8815,15.8714285714286,16.4571428571429,0.882571428571429,77.9571428571429,40.4685714285714,45.0785714285714,448,165,258,66,82,849,283,591
2017,22,63,"Izmit",40.8533,29.8815,16.1142857142857,20.1571428571429,1.62685714285714,77.7285714285714,49.3283333333333,66.8783333333333,522,27,68,251,344,1015,495,947
2017,23,63,"Izmit",40.8533,29.8815,12.9857142857143,20.5285714285714,5.19857142857143,84.0285714285714,58.2685714285714,63.6171428571429,578,45,89,257,683,1388,533,1299
2017,24,63,"Izmit",40.8533,29.8815,15.4714285714286,20.1571428571429,1.04642857142857,76.3857142857143,41.9014285714286,52.1814285714286,552,59,112,190,361,1139,493,1027
2017,25,63,"Izmit",40.8533,29.8815,13.4142857142857,21.3714285714286,13.2222857142857,78.7142857142857,52.8328571428571,74.1642857142857,584,26,59,441,747,1041,558,982
2017,26,63,"Izmit",40.8533,29.8815,12.8428571428571,26.0428571428571,0,69.4428571428572,45.0485714285714,62.46,564,200,278,229,419,971,364,693
2017,27,63,"Izmit",40.8533,29.8815,16.7285714285714,22.4857142857143,4.38957142857143,75.9714285714286,31.2,42.0257142857143,511,56,72,149,182,642,455,570
2017,28,63,"Izmit",40.8533,29.8815,17.4285714285714,23.9857142857143,0.000142857142857143,73.4428571428571,36.698,40.62,481,103,220,0,0,864,378,644
2017,29,63,"Izmit",40.8533,29.8815,16.6857142857143,23.4,8.46657142857143,80.6857142857143,39.3614285714286,38.2842857142857,532,0,0,162,358,1272,532,1272
2017,30,63,"Izmit",40.8533,29.8815,16.1857142857143,24.9142857142857,2.24985714285714,71.2857142857143,59.4314285714286,66.7771428571428,531,54,48,237,312,928,477,880
2017,31,63,"Izmit",40.8533,29.8815,14.2714285714286,25.1285714285714,0.306142857142857,77.3714285714286,44.8971428571429,46.1371428571429,559,27,44,146,331,1047,532,1003
2017,32,63,"Izmit",40.8533,29.8815,16.1428571428571,26.3,0,78.5,53.1714285714286,39.3285714285714,567,0,0,258,394,1092,567,1092
2017,33,63,"Izmit",40.8533,29.8815,14.4714285714286,23.9428571428571,0.281571428571429,81.9714285714286,48.0683333333333,48.535,596,0,0,413,838,1199,596,1199
2017,34,63,"Izmit",40.8533,29.8815,16.6714285714286,21.7285714285714,6.945,77.5285714285714,42.1742857142857,45.2057142857143,601,121,187,85,116,1280,480,1093
2017,35,63,"Izmit",40.8533,29.8815,15.9,21.0571428571429,0.000142857142857143,71.6285714285714,32.8671428571429,44.7857142857143,493,90,132,0,0,1014,403,882
2017,36,63,"Izmit",40.8533,29.8815,11.5857142857143,21.1,0.531857142857143,72.1714285714286,46.9214285714286,66.4957142857143,507,301,821,114,279,1321,206,500
2017,37,63,"Izmit",40.8533,29.8815,15.5714285714286,23.9857142857143,0,74.0142857142857,72.4242857142857,71.6371428571429,589,182,314,139,220,1138,407,824
2017,38,63,"Izmit",40.8533,29.8815,13.5714285714286,21.7714285714286,1.10042857142857,72.7428571428571,101.166666666667,64.7333333333333,671,304,478,288,563,1312,367,834
2017,39,63,"Izmit",40.8533,29.8815,12.0428571428571,17.7,4.79057142857143,87.1,65.8385714285714,46.3028571428571,782,316,601,161,252,1630,466,1029
2017,40,63,"Izmit",40.8533,29.8815,12.5857142857143,15.5857142857143,0.893428571428571,77.6285714285714,151.178571428571,58.3914285714286,543,125,155,267,646,1137,418,982
2017,41,63,"Izmit",40.8533,29.8815,9.64285714285714,13.1142857142857,1.826,77.9428571428571,194.598571428571,58.9728571428571,487,197,474,153,149,843,290,369
2017,42,63,"Izmit",40.8533,29.8815,10.8857142857143,15.5857142857143,0.0138571428571429,78.1857142857143,175.93,68.4742857142857,530,125,213,332,493,815,405,602
2017,43,63,"Izmit",40.8533,29.8815,10.8428571428571,14.7,7.985,86.8857142857143,71.5557142857143,52.6842857142857,506,106,97,205,524,919,400,822
2017,44,63,"Izmit",40.8533,29.8815,11.6571428571429,8.87142857142857,2.18171428571429,79.4428571428571,88.2371428571429,57.0514285714286,561,65,99,227,372,1102,496,1003
2017,45,63,"Izmit",40.8533,29.8815,8.68571428571429,11.8714285714286,0.873428571428571,84.9714285714286,116.603333333333,56.8671428571429,577,286,460,286,369,829,291,369
2017,46,63,"Izmit",40.8533,29.8815,14.1857142857143,14.1428571428571,0.00242857142857143,81.1428571428571,115.575714285714,54.69,587,218,365,78,136,1085,369,720
2017,47,63,"Izmit",40.8533,29.8815,11.1714285714286,9.12857142857143,3.05042857142857,83.3285714285714,95.3685714285714,52.7628571428571,418,66,117,272,551,804,352,687
2017,48,63,"Izmit",40.8533,29.8815,11.6142857142857,13.4571428571429,3.52585714285714,69.4714285714286,90.3557142857143,56.4757142857143,386,149,237,184,320,619,237,382
2017,49,63,"Izmit",40.8533,29.8815,15.2428571428571,8.48571428571429,7.054,77.1,85.86,55.42,407,56,42,243,406,645,351,603
2017,50,63,"Izmit",40.8533,29.8815,12.0285714285714,12.0428571428571,0.00171428571428571,71.3428571428571,143.074285714286,68.5557142857143,346,0,0,82,103,442,346,442
2017,51,63,"Izmit",40.8533,29.8815,13.9142857142857,5.72857142857143,11.6138571428571,92.5857142857143,30.2414285714286,40.7914285714286,386,146,131,156,131,349,240,218
2017,52,63,"Izmit",40.8533,29.8815,14.975,8.8375,0.87975,74.5625,87.2325,58.04375,528,181,164,242,243,507,347,343
2018,1,63,"Izmit",40.8533,29.8815,8.325,7.0125,0.4485,84.8875,101.04125,53.66,618,92,119,240,362,914,526,795
2018,2,63,"Izmit",40.8533,29.8815,10.6,7.95714285714286,2.517,88.2285714285714,101.497142857143,48.0885714285714,624,101,203,81,181,1309,523,1106
2018,3,63,"Izmit",40.8533,29.8815,15.8142857142857,7.31428571428571,3.108,74.4571428571429,70.3371428571429,50.31,639,18,20,538,600,655,621,635
2018,4,63,"Izmit",40.8533,29.8815,11.3714285714286,3.55714285714286,4.26428571428571,84.8857142857143,44.3014285714286,44.5257142857143,604,135,144,156,241,764,469,620
2018,5,63,"Izmit",40.8533,29.8815,12.8857142857143,9.1,0.294571428571429,72.0428571428571,127.075714285714,70.2285714285714,670,0,0,670,819,819,670,819
2018,6,63,"Izmit",40.8533,29.8815,12.4285714285714,9.35714285714286,2.32842857142857,83.5571428571429,90.128,54.348,704,169,226,296,471,1022,535,796
2018,7,63,"Izmit",40.8533,29.8815,13.2857142857143,7.27142857142857,0.312285714285714,85.1,55.275,40.5475,478,206,235,17,5,557,272,322
2018,8,63,"Izmit",40.8533,29.8815,12.0142857142857,7.15714285714286,4.02385714285714,90.5857142857143,40.556,37.308,711,141,268,0,0,1321,570,1053
2018,9,63,"Izmit",40.8533,29.8815,19.1,7.21428571428571,5.23942857142857,84.0428571428571,65.7875,47.1625,621,132,206,345,493,956,489,750
2018,10,63,"Izmit",40.8533,29.8815,15.8857142857143,11.1,3.40071428571429,84.0285714285714,120.72,66.1983333333333,556,0,0,392,1010,1330,556,1330
2018,11,63,"Izmit",40.8533,29.8815,14.9571428571429,14.0142857142857,1.86042857142857,69.2571428571429,128.525714285714,67.4514285714286,551,0,0,497,1024,1426,551,1426
2018,12,63,"Izmit",40.8533,29.8815,16.6428571428571,10.1857142857143,1.05728571428571,86.0142857142857,64.62,40.3571428571429,425,7,4,214,763,1187,418,1183
2018,13,63,"Izmit",40.8533,29.8815,13.2428571428571,13.0571428571429,4.55342857142857,72.1,110.795714285714,55.2442857142857,356,60,54,120,152,428,296,374
2018,14,63,"Izmit",40.8533,29.8815,13.9428571428571,12.8,1.31242857142857,71.1,97.4414285714286,60.2957142857143,407,1,0,290,391,486,406,486
2018,15,63,"Izmit",40.8533,29.8815,13.2857142857143,14.7,0.0287142857142857,79.4285714285714,104.388571428571,54.6157142857143,374,117,83,55,170,450,257,367
2018,16,63,"Izmit",40.8533,29.8815,14.5714285714286,13.0857142857143,1.03671428571429,75.2571428571429,75.2314285714286,50.4457142857143,411,8,20,233,357,648,403,628
2018,17,63,"Izmit",40.8533,29.8815,14.5571428571429,17.7857142857143,0,66.6857142857143,73.6914285714286,54.9257142857143,419,53,220,121,141,652,366,432
2018,18,63,"Izmit",40.8533,29.8815,13.3714285714286,16.3142857142857,2.50785714285714,85.9285714285714,56.3057142857143,31.4657142857143,303,64,41,61,30,474,239,433
2018,19,63,"Izmit",40.8533,29.8815,15.2428571428571,16.1571428571429,9.77414285714286,88,47.3514285714286,40.8171428571429,275,6,12,151,310,467,269,455
2018,20,63,"Izmit",40.8533,29.8815,11.2714285714286,21.0857142857143,0.000428571428571429,68.1285714285714,81.2333333333333,50.9914285714286,204,8,32,96,156,306,196,274
2018,21,63,"Izmit",40.8533,29.8815,12.4142857142857,19.9142857142857,8.91985714285714,86.6714285714286,38.87,34.2671428571429,252,23,5,36,41,281,229,276
2018,22,63,"Izmit",40.8533,29.8815,14.3285714285714,19.5,1.28414285714286,80.4428571428571,54.1985714285714,41.0228571428571,249,54,55,35,79,427,195,372
2018,23,63,"Izmit",40.8533,29.8815,13.7714285714286,22.5428571428571,1.08642857142857,73.5571428571429,60.5257142857143,54.0585714285714,267,41,87,57,150,812,226,725
2018,24,63,"Izmit",40.8533,29.8815,18.5142857142857,22.7428571428571,0.472714285714286,73.5857142857143,39.2642857142857,42.1214285714286,267,5,0,71,182,448,262,448
2018,25,63,"Izmit",40.8533,29.8815,14.7,21.9571428571429,1.77042857142857,83.5285714285714,46.8628571428571,43.1228571428571,358,93,139,146,148,518,265,379
2018,26,63,"Izmit",40.8533,29.8815,14.0142857142857,22.6571428571429,1.07114285714286,80.3857142857143,50.4385714285714,46.43,355,90,177,179,259,587,265,410
2018,27,63,"Izmit",40.8533,29.8815,17.3857142857143,23.8428571428571,0,68.5857142857143,58.7233333333333,48.706,342,79,124,0,0,418,263,294
2018,28,63,"Izmit",40.8533,29.8815,15.0142857142857,24.0142857142857,1.543,81.3,57.1457142857143,40.44,286,0,0,58,116,585,286,585
2018,29,63,"Izmit",40.8533,29.8815,14.0571428571429,23.6,1.82685714285714,78.2142857142857,53.9328571428571,55.0514285714286,260,32,158,228,598,756,228,598
2018,30,63,"Izmit",40.8533,29.8815,16.0857142857143,23.6714285714286,7.70685714285714,81.0714285714286,45.6357142857143,48.23,265,23,44,94,471,822,242,778
2018,31,63,"Izmit",40.8533,29.8815,16.9142857142857,25.8857142857143,3.47842857142857,80.0428571428571,41.85,33.5485714285714,267,10,57,0,0,499,257,442
2018,32,63,"Izmit",40.8533,29.8815,19.0571428571429,24.7142857142857,0.116857142857143,73.9857142857143,40.9342857142857,35.6828571428571,297,0,0,0,0,403,297,403
2018,33,63,"Izmit",40.8533,29.8815,15.3142857142857,24.3714285714286,0.000142857142857143,75.2285714285714,45.3257142857143,36.37,216,1,0,32,49,332,215,332
2018,34,63,"Izmit",40.8533,29.8815,16.9428571428571,24.2285714285714,0,75.3142857142857,33.45,25.8585714285714,144,0,0,0,0,227,144,227
2018,35,63,"Izmit",40.8533,29.8815,14.8428571428571,24.8285714285714,0.338428571428571,78.5428571428571,33.04,34.1542857142857,201,2,1,0,0,314,199,313
2018,36,63,"Izmit",40.8533,29.8815,16.3714285714286,22.0857142857143,1.46928571428571,81.9714285714286,12.3342857142857,41.4957142857143,341,52,72,92,104,370,289,298
2018,37,63,"Izmit",40.8533,29.8815,15.0285714285714,19.0428571428571,0.991571428571428,83.6285714285714,11.83,47.1242857142857,241,2,15,128,241,419,239,404
2018,38,63,"Izmit",40.8533,29.8815,19,19.8857142857143,0.2,79.4428571428572,11.2642857142857,35.2014285714286,189,0,0,0,0,344,189,344
2018,39,63,"Izmit",40.8533,29.8815,15.8285714285714,17.2428571428571,4.06728571428571,82.6142857142857,10.09,34.3771428571429,180,0,0,25,50,353,180,353
2018,40,63,"Izmit",40.8533,29.8815,13.8571428571429,17.5,0.791,78.9,13.2628571428571,37.3357142857143,191,0,0,54,103,341,191,341
2018,41,63,"Izmit",40.8533,29.8815,11.7714285714286,17.3857142857143,0.514428571428571,84.9285714285714,12.5742857142857,34.3528571428571,187,0,0,25,92,422,187,422
2018,42,63,"Izmit",40.8533,29.8815,9.64285714285714,18.3285714285714,1.66028571428571,88.0857142857143,15.8642857142857,31.2957142857143,168,0,0,17,7,381,168,381
2018,43,63,"Izmit",40.8533,29.8815,13.1857142857143,13.5571428571429,3.09828571428571,77.0714285714286,29.5657142857143,35.7042857142857,187,25,30,112,283,402,162,372
2018,44,63,"Izmit",40.8533,29.8815,8.65714285714286,15.1,0,77.2857142857143,33.03,41.1571428571429,196,76,129,63,57,264,120,135
2018,45,63,"Izmit",40.8533,29.8815,12.2857142857143,14.2714285714286,0.00242857142857143,84.9285714285714,28.8842857142857,32.3557142857143,231,1,1,0,0,473,230,472
2018,46,63,"Izmit",40.8533,29.8815,11.4857142857143,10.0428571428571,2.17714285714286,86.6,35.8357142857143,34.8814285714286,230,39,85,36,74,465,191,380
2018,47,63,"Izmit",40.8533,29.8815,9.54285714285714,11.3428571428571,3.01328571428571,86.6142857142857,45.4814285714286,31.6585714285714,270,22,9,1,0,499,248,490
2018,48,63,"Izmit",40.8533,29.8815,12.7714285714286,10.1142857142857,7.238,85.1428571428571,49.6371428571429,37.6757142857143,245,28,22,108,68,201,217,179
2018,49,63,"Izmit",40.8533,29.8815,9.9,7.14285714285714,2.91771428571429,82.9428571428572,71.1014285714286,47.2857142857143,257,72,79,25,105,420,185,341
2018,50,63,"Izmit",40.8533,29.8815,10.2,7.91428571428571,4.12128571428571,83.0285714285714,72.1342857142857,57.0828571428571,256,112,102,70,107,305,144,203
2018,51,63,"Izmit",40.8533,29.8815,14.9428571428571,7.14285714285714,7.87857142857143,89.9142857142857,62.1614285714286,40.7316666666667,250,0,0,232,236,248,250,248
2018,52,63,"Izmit",40.8533,29.8815,12.5285714285714,3.98571428571429,8.04528571428571,87.9857142857143,57.83,55.8314285714286,244,37,51,181,203,273,207,222
2019,1,63,"Izmit",40.8533,29.8815,11.75,4.3,12.215625,88.9,42.24625,43.39625,343,71,224,84,212,784,272,560
2019,2,63,"Izmit",40.8533,29.8815,14.9857142857143,4.55714285714286,2.65528571428571,78.9,33.9971428571429,42.8428571428571,255,92,63,54,28,208,163,145
2019,3,63,"Izmit",40.8533,29.8815,10.3285714285714,5.45714285714286,4.31528571428571,76.9428571428571,78.9842857142857,61.2371428571429,192,42,72,119,99,198,150,126
2019,4,63,"Izmit",40.8533,29.8815,17.4142857142857,10.0428571428571,0.598428571428572,69.2428571428571,62.4642857142857,47.6757142857143,308,142,166,0,0,314,166,148
2019,5,63,"Izmit",40.8533,29.8815,13.4714285714286,10.7,0.710142857142857,64.3571428571429,76.8428571428571,54.1785714285714,253,128,81,31,13,143,125,62
2019,6,63,"Izmit",40.8533,29.8815,10.0714285714286,7.44285714285714,3.34657142857143,82.6,55.0542857142857,47.4385714285714,276,65,28,56,14,127,211,99
2019,7,63,"Izmit",40.8533,29.8815,14.1428571428571,6.35714285714286,2.36871428571429,77.7,50.1828571428571,44.0871428571429,325,72,27,91,110,234,253,207
2019,8,63,"Izmit",40.8533,29.8815,13.3,5.35714285714286,2.22328571428571,82.3142857142857,85.0185714285714,59.3014285714286,305,82,72,182,124,219,223,147
2019,9,63,"Izmit",40.8533,29.8815,15.9285714285714,6.12857142857143,2.21957142857143,76.8142857142857,44.6171428571429,45.7314285714286,331,1,0,177,146,310,330,310
2019,10,63,"Izmit",40.8533,29.8815,14.3428571428571,9.9,1.12414285714286,65.4142857142857,92.3557142857143,70.5014285714286,359,50,40,258,171,252,309,212
2019,11,63,"Izmit",40.8533,29.8815,15.6714285714286,9.75714285714286,4.02085714285714,73.4142857142857,52.8671428571429,49.5842857142857,373,38,17,196,167,400,335,383
2019,12,63,"Izmit",40.8533,29.8815,16.6714285714286,9.74285714285714,0,67.1,55.6585714285714,50.0857142857143,343,88,301,0,0,416,255,115
2019,13,63,"Izmit",40.8533,29.8815,21.2857142857143,7.65714285714286,0,64.9714285714286,39.4485714285714,39.3857142857143,256,49,35,0,0,194,207,159
2019,14,63,"Izmit",40.8533,29.8815,15.0714285714286,9.68571428571429,0,74.9142857142857,52.6857142857143,42.2214285714286,365,112,41,41,25,208,253,167
2019,15,63,"Izmit",40.8533,29.8815,15.4428571428571,13.3571428571429,3.98742857142857,81.4857142857143,51.0471428571429,54.5771428571429,359,77,13,208,132,183,282,170
2019,16,63,"Izmit",40.8533,29.8815,10.8571428571429,8.45714285714286,3.628,78.7714285714286,34.3628571428571,41.0771428571429,318,46,15,178,146,208,272,193
2019,17,63,"Izmit",40.8533,29.8815,14.4571428571429,13.5,0,66.7714285714286,52.9071428571429,50.0871428571429,412,236,178,52,18,313,176,135
2019,18,63,"Izmit",40.8533,29.8815,16.0714285714286,17.5571428571429,0.477285714285714,65.2142857142857,64.4642857142857,51.8985714285714,523,105,42,416,311,353,418,311
2019,19,63,"Izmit",40.8533,29.8815,15.3857142857143,15.0571428571429,1.53157142857143,76.1142857142857,44.2428571428571,41.99,452,37,39,276,217,386,415,347
2019,20,63,"Izmit",40.8533,29.8815,15.6571428571429,18.4285714285714,2.39557142857143,76.8571428571428,52.4157142857143,51.5528571428571,454,56,53,171,142,389,398,336
2019,21,63,"Izmit",40.8533,29.8815,13.0142857142857,20.8428571428571,0.360142857142857,68.7,58.138,58.7514285714286,457,0,0,207,222,413,457,413
2019,22,63,"Izmit",40.8533,29.8815,14.9428571428571,22.7714285714286,0.558857142857143,68.3142857142857,48.9671428571429,51.4171428571429,453,84,54,119,39,323,369,269
2019,23,63,"Izmit",40.8533,29.8815,15.6714285714286,22.0857142857143,0.734714285714286,72.8,36.4971428571429,31.4714285714286,378,1,1,51,41,532,377,531
2019,24,63,"Izmit",40.8533,29.8815,13.9857142857143,22.5,4.71771428571429,81.0428571428571,40.5971428571429,41.0557142857143,378,44,61,221,76,244,334,183
2019,25,63,"Izmit",40.8533,29.8815,11.7714285714286,22.8571428571429,9.23328571428571,83.2571428571429,46.4014285714286,46.69,306,29,0,139,151,325,277,325
2019,26,63,"Izmit",40.8533,29.8815,16.3857142857143,23.8857142857143,0.151142857142857,70.9,30.5071428571429,33.5985714285714,377,35,24,52,28,342,342,318
2019,27,63,"Izmit",40.8533,29.8815,15.0428571428571,23.4857142857143,0,70.4714285714286,29.8314285714286,33.1328571428571,456,5,9,0,0,222,451,213
2019,28,63,"Izmit",40.8533,29.8815,12.2428571428571,22.0428571428571,5.72357142857143,73.6857142857143,29.9371428571429,43.39,398,136,66,86,166,421,262,355
2019,29,63,"Izmit",40.8533,29.8815,17.6714285714286,21.9285714285714,5.42671428571429,76.3,27.94,35.1585714285714,453,6,4,57,5,203,447,199
2019,30,63,"Izmit",40.8533,29.8815,16.1,23.6142857142857,0.143571428571429,72,26.4214285714286,31.55,456,2,1,3,1,335,454,334
2019,31,63,"Izmit",40.8533,29.8815,15.8714285714286,25.5142857142857,0.0584285714285714,69.3571428571429,28.8028571428571,33.84,334,2,2,110,113,375,332,373
2019,32,63,"Izmit",40.8533,29.8815,17.2714285714286,22.8857142857143,1.38585714285714,69.9285714285714,24.4857142857143,31.8314285714286,346,82,134,0,0,395,264,261
2019,33,63,"Izmit",40.8533,29.8815,14.9,22.7714285714286,15.723,82.3285714285714,23.3342857142857,28.5657142857143,337,1,1,239,411,531,336,530
2019,34,63,"Izmit",40.8533,29.8815,13.3142857142857,22.8142857142857,4.38928571428571,82.3428571428571,35.3014285714286,36.9185714285714,299,2,1,134,123,345,297,344
2019,35,63,"Izmit",40.8533,29.8815,16.6428571428571,23.6,0,76.7857142857143,32.1714285714286,27.3114285714286,307,7,10,0,0,415,300,405
2019,36,63,"Izmit",40.8533,29.8815,18.2285714285714,22.2142857142857,0,75.4,31.2771428571429,32.3357142857143,171,4,1,0,0,67,167,66
2019,37,63,"Izmit",40.8533,29.8815,17.6142857142857,21.2857142857143,0.05,76.7571428571429,30.0328571428571,34.5628571428571,218,52,18,0,0,55,166,37
2019,38,63,"Izmit",40.8533,29.8815,13.9,18.0285714285714,6.07328571428571,75.1,34.4528571428571,43.9314285714286,266,22,5,127,46,91,244,86
2019,39,63,"Izmit",40.8533,29.8815,10.4285714285714,18.1714285714286,0.509857142857143,79.0428571428571,37.1542857142857,44.4185714285714,237,63,21,71,21,79,174,58
2019,40,63,"Izmit",40.8533,29.8815,12.6,19.4428571428571,4.55914285714286,74.7285714285714,41.2142857142857,49.3771428571429,241,63,33,66,34,111,178,78
2019,41,63,"Izmit",40.8533,29.8815,12.9142857142857,16.1142857142857,1.54971428571429,82.8571428571429,29.5728571428571,36.6714285714286,416,100,51,126,197,448,316,397
2019,42,63,"Izmit",40.8533,29.8815,7.82857142857143,17.9714285714286,0,84.3285714285714,53.1685714285714,38.9757142857143,356,227,174,0,0,408,129,234
2019,43,63,"Izmit",40.8533,29.8815,12.5857142857143,17.0571428571429,0.00442857142857143,81.1142857142857,36.0042857142857,34.3657142857143,306,53,44,0,0,300,253,256
2019,44,63,"Izmit",40.8533,29.8815,9.72857142857143,13.6857142857143,3.21885714285714,83.5428571428571,37.9142857142857,38.9471428571429,350,59,37,34,62,250,291,213
2019,45,63,"Izmit",40.8533,29.8815,10.3571428571429,16.9142857142857,0.00514285714285714,70.5142857142857,64.45,48.6642857142857,417,133,76,229,178,328,284,252
2019,46,63,"Izmit",40.8533,29.8815,8.52857142857143,15.7428571428571,0.0291428571428571,77.2285714285714,75.0871428571429,46.5457142857143,401,275,219,56,39,337,126,118
2019,47,63,"Izmit",40.8533,29.8815,8.17142857142857,11.1714285714286,0.0288571428571429,82.3428571428571,72.5442857142857,45.704,391,178,148,54,61,339,213,191
2019,48,63,"Izmit",40.8533,29.8815,12.5571428571429,12.4857142857143,6.937,83.2571428571429,53.4871428571429,43.5666666666667,320,34,5,169,176,251,286,246
2019,49,63,"Izmit",40.8533,29.8815,9.57142857142857,6.5,0.924285714285714,83.0571428571428,54.3028571428571,43.03,393,103,78,176,120,274,290,196
2019,50,63,"Izmit",40.8533,29.8815,8.91428571428571,9.45714285714286,0.175857142857143,78.0428571428571,79.9071428571429,53.5385714285714,218,134,44,16,17,119,84,75
2019,51,63,"Izmit",40.8533,29.8815,9.15714285714286,9.31428571428571,0,74.5285714285714,121.381428571429,66.3242857142857,361,103,136,139,177,488,258,352
2019,52,63,"Izmit",40.8533,29.8815,11.9285714285714,8.44285714285714,5.22885714285714,82.4285714285714,23.15,35.7842857142857,279,47,64,230,215,281,232,217
2020,1,63,"Izmit",40.8533,29.8815,12.38,4.54,3.7834,85.82,50.354,45.242,160,58,56,67,43,126,102,70
2020,2,63,"Izmit",40.8533,29.8815,8.07142857142857,4.7,7.56657142857143,87.2428571428571,51.7057142857143,50.0942857142857,240,1,1,116,105,173,239,172
2020,3,63,"Izmit",40.8533,29.8815,11.6428571428571,5.8,0.510714285714286,85.1,47.5342857142857,39.7285714285714,270,70,87,1,0,382,200,295
2020,4,63,"Izmit",40.8533,29.8815,10.9571428571429,3.97142857142857,1.67914285714286,81.0714285714286,47.7916666666667,45.565,358,0,0,349,291,295,358,295
2020,5,63,"Izmit",40.8533,29.8815,14.6285714285714,8.61428571428571,3.10185714285714,76.7142857142857,66.7928571428571,51.3685714285714,331,41,37,267,215,272,290,235
2020,6,63,"Izmit",40.8533,29.8815,18.1857142857143,7.37142857142857,5.44428571428571,77.6857142857143,36.4714285714286,39.1,343,0,0,278,190,267,343,267
2020,7,63,"Izmit",40.8533,29.8815,12.2285714285714,7.08571428571429,2.25485714285714,74.7142857142857,57.79,49.3085714285714,341,83,138,177,129,338,258,200
2020,8,63,"Izmit",40.8533,29.8815,11,6.68571428571429,1.48514285714286,81.3,55.86,52.7957142857143,283,77,64,33,6,187,206,123
2020,9,63,"Izmit",40.8533,29.8815,14.7142857142857,9.97142857142857,1.51742857142857,68.4285714285714,54.38,61.4257142857143,393,0,0,158,159,528,393,528
2020,10,63,"Izmit",40.8533,29.8815,14.2285714285714,13.2428571428571,0.658857142857143,66.9571428571429,83.1814285714286,67.6428571428571,205,0,0,192,198,210,205,210
2020,11,63,"Izmit",40.8533,29.8815,19.0285714285714,11.2142857142857,0.901714285714286,78,55.76,54.0128571428571,115,6,14,39,41,94,109,80
2020,12,63,"Izmit",40.8533,29.8815,15.6857142857143,5.95714285714286,1.67242857142857,76.6142857142857,40.3914285714286,57.0357142857143,117,19,23,11,10,118,98,95
2020,13,63,"Izmit",40.8533,29.8815,12.9285714285714,8.41428571428571,5.41128571428571,88.4,38.4114285714286,36.6285714285714,136,0,0,36,34,92,136,92
2020,14,63,"Izmit",40.8533,29.8815,16.3714285714286,9.22857142857143,1.91885714285714,85.6857142857143,43.3242857142857,46.44,155,8,3,39,37,121,147,118
2020,15,63,"Izmit",40.8533,29.8815,17.2142857142857,9.57142857142857,2.57214285714286,70.9,37.06,56.4933333333333,133,2,2,23,11,118,131,116
2020,16,63,"Izmit",40.8533,29.8815,16.4714285714286,12.2857142857143,0.574571428571429,66.0714285714286,47.1185714285714,54.4842857142857,141,1,1,69,46,106,140,105
2020,17,63,"Izmit",40.8533,29.8815,19.3,10.2571428571429,0.028,74.2857142857143,33.1857142857143,45.14,137,6,5,32,25,123,131,118
2020,18,63,"Izmit",40.8533,29.8815,14.2857142857143,15.0571428571429,0.212428571428571,72.6857142857143,36.3014285714286,47.0985714285714,146,21,17,77,62,164,125,147
2020,19,63,"Izmit",40.8533,29.8815,14.0571428571429,13.1142857142857,4.78442857142857,79.8285714285714,32.5957142857143,39.2357142857143,137,27,68,92,76,157,110,89
2020,20,63,"Izmit",40.8533,29.8815,13.8571428571429,19.9857142857143,0,72.9142857142857,60.6814285714286,44.7514285714286,164,49,60,62,47,164,115,104
2020,21,63,"Izmit",40.8533,29.8815,14.7857142857143,16.6142857142857,5.35714285714286,80.4571428571429,35.5642857142857,26.93,146,1,0,66,49,96,145,96
2020,22,63,"Izmit",40.8533,29.8815,14.4142857142857,14.6285714285714,4.341,82.8714285714286,21.8014285714286,35.6457142857143,118,0,0,86,77,100,118,100
2020,23,63,"Izmit",40.8533,29.8815,12.2857142857143,18.2857142857143,4.89342857142857,77.8,38.55,60.185,112,3,0,47,46,70,109,70
2020,24,63,"Izmit",40.8533,29.8815,14.4142857142857,21.2428571428571,0.45,76.4285714285714,39.5,55.6357142857143,140,0,0,104,98,150,140,150
2020,25,63,"Izmit",40.8533,29.8815,15.6714285714286,21.2571428571429,6.48214285714286,81.4714285714286,39.7757142857143,52.1757142857143,137,0,0,63,46,108,137,108
2020,26,63,"Izmit",40.8533,29.8815,16.4142857142857,21.6142857142857,1.27771428571429,81.6428571428571,26.2233333333333,35.3816666666667,173,0,0,37,41,133,173,133
2020,27,63,"Izmit",40.8533,29.8815,14.3285714285714,24.4428571428571,0,75.1428571428571,29.6257142857143,37.2642857142857,113,0,0,0,0,113,113,113
2020,28,63,"Izmit",40.8533,29.8815,17.5142857142857,23.7714285714286,1.80314285714286,75.5285714285714,24.8685714285714,28.9542857142857,164,10,3,0,0,122,154,119
2020,29,63,"Izmit",40.8533,29.8815,12.5142857142857,21.4428571428571,0.0415714285714286,77.9428571428571,22.1157142857143,32.3214285714286,186,4,6,38,27,111,182,105
2020,30,63,"Izmit",40.8533,29.8815,16.9285714285714,23.7714285714286,0,74.9142857142857,28.7071428571429,33.5071428571429,190,5,3,50,29,142,185,139
2020,31,63,"Izmit",40.8533,29.8815,17.4142857142857,24.5,0,71.8857142857143,25.81,32.7157142857143,150,9,5,2,0,127,141,122
2020,32,63,"Izmit",40.8533,29.8815,16.8571428571429,24.8857142857143,0,69.1,23.7385714285714,30.9171428571429,146,1,1,20,7,107,145,106
2020,33,63,"Izmit",40.8533,29.8815,19.5428571428571,24.7,0,63.5142857142857,22.9228571428571,33.1685714285714,183,3,3,0,0,83,180,80
2020,34,63,"Izmit",40.8533,29.8815,17.8428571428571,23.4714285714286,0.0354285714285714,66.5714285714286,29.7366666666667,46.958,197,0,0,127,77,97,197,97
2020,35,63,"Izmit",40.8533,29.8815,15.8571428571429,24.4571428571429,0,64.2714285714286,31.2833333333333,44.6966666666667,164,6,5,25,27,157,158,152
2020,36,63,"Izmit",40.8533,29.8815,16.6571428571429,24.1,0.0582857142857143,70.8714285714286,36.16,40.59,179,23,6,99,70,112,156,106
2020,37,63,"Izmit",40.8533,29.8815,17.6857142857143,23.9428571428571,0.000142857142857143,71.1,37.6714285714286,35.7242857142857,193,6,6,0,0,91,187,85
2020,38,63,"Izmit",40.8533,29.8815,17.8,23.3571428571429,0.0285714285714286,69.4428571428571,39.4142857142857,33.1628571428571,235,2,0,35,19,157,233,157
2020,39,63,"Izmit",40.8533,29.8815,11.2428571428571,22.8285714285714,0.389571428571429,63.3857142857143,48.37,42.6371428571429,220,117,38,39,25,129,103,91
2020,40,63,"Izmit",40.8533,29.8815,9.61428571428571,20.3285714285714,1.34157142857143,64.8857142857143,43.3066666666667,43,187,21,47,81,72,154,166,107
2020,41,63,"Izmit",40.8533,29.8815,12.6571428571429,21.6571428571429,2.62242857142857,67.9142857142857,62.09,46.1957142857143,182,82,48,54,37,127,100,79
2020,42,63,"Izmit",40.8533,29.8815,13.3857142857143,20.1571428571429,0.886285714285714,70.2571428571429,56.7614285714286,40.8542857142857,177,4,0,95,59,111,173,111
2020,43,63,"Izmit",40.8533,29.8815,9.07142857142857,17.5142857142857,2.46685714285714,80.3857142857143,49.9866666666667,31.2466666666667,194,53,26,4,2,161,141,135
2020,44,63,"Izmit",40.8533,29.8815,15.2571428571429,16.9142857142857,2.83071428571429,80.2428571428571,52.7928571428571,29.3271428571429,255,1,0,190,157,233,254,233
2020,45,63,"Izmit",40.8533,29.8815,7.55714285714286,13.1285714285714,1.30085714285714,78.1,51.5214285714286,37.3614285714286,156,49,36,0,0,103,107,67
2020,46,63,"Izmit",40.8533,29.8815,10.2857142857143,13.7714285714286,1.55357142857143,79.8571428571429,46.13,37.5514285714286,208,82,34,0,0,109,126,75
2020,47,63,"Izmit",40.8533,29.8815,11.6857142857143,11.3285714285714,0.322714285714286,76.1428571428571,48.785,42.0933333333333,173,40,19,0,0,83,133,64
2020,48,63,"Izmit",40.8533,29.8815,9.22857142857143,8.95714285714286,0.0288571428571429,72.6571428571429,75.7714285714286,43.612,199,60,84,23,5,262,139,178
2020,49,63,"Izmit",40.8533,29.8815,8.87142857142857,10.7857142857143,1.90271428571429,79.2142857142857,74.1014285714286,44.395,207,43,7,51,23,116,164,109
2020,50,63,"Izmit",40.8533,29.8815,13.3571428571429,13.7857142857143,0.0401428571428571,65.2142857142857,76.9271428571429,43.9657142857143,181,62,43,24,8,98,119,55
2020,51,63,"Izmit",40.8533,29.8815,7.91428571428571,11.2,5.32285714285714,83.4857142857143,41.57,33.2714285714286,171,13,6,20,2,90,158,84
2020,52,63,"Izmit",40.8533,29.8815,9.94285714285714,10.9857142857143,0.174857142857143,71.4714285714286,78.6966666666667,35.1683333333333,203,73,43,31,35,113,130,70
2020,53,63,"Izmit",40.8533,29.8815,11.925,13.55,0.251,59.125,84.5075,39.8775,122,36,17,27,49,111,86,94
2017,1,64,"Karkent",37.8746,32.4932,22.2857142857143,-4.58571428571429,43.5285714285714,86.8857142857143,47.5085714285714,NA,563,315,439,84,139,847,248,408
2017,2,64,"Karkent",37.8746,32.4932,22.3285714285714,-5.18571428571429,33.7142857142857,86.2285714285714,63.5157142857143,NA,757,257,418,116,261,1214,500,796
2017,3,64,"Karkent",37.8746,32.4932,16.2142857142857,-1.72857142857143,0.114285714285714,88.7571428571429,92.714,NA,762,92,100,492,797,1449,670,1349
2017,4,64,"Karkent",37.8746,32.4932,27.0142857142857,-5.67142857142857,0.171428571428571,83.2142857142857,63.7916666666667,NA,639,159,278,301,365,889,480,611
2017,5,64,"Karkent",37.8746,32.4932,10.9428571428571,-9.08571428571429,0.357142857142857,75.8857142857143,103.281428571429,NA,588,0,0,174,241,1163,588,1163
2017,6,64,"Karkent",37.8746,32.4932,15.1571428571429,-0.0142857142857143,15.7142857142857,88.9857142857143,78.2157142857143,NA,736,0,0,478,924,1519,736,1519
2017,7,64,"Karkent",37.8746,32.4932,25.4142857142857,-4.08571428571429,35.7142857142857,74.7571428571429,47.31,NA,492,0,0,351,555,717,492,717
2017,8,64,"Karkent",37.8746,32.4932,17.2428571428571,2.95714285714286,0,75.5857142857143,103.084285714286,NA,739,91,219,297,666,1747,648,1528
2017,9,64,"Karkent",37.8746,32.4932,22.8,6.64285714285714,0.828571428571429,72.2285714285714,92.1414285714286,NA,574,145,252,158,170,866,429,614
2017,10,64,"Karkent",37.8746,32.4932,25.9428571428571,6.84285714285714,7.47142857142857,69.9142857142857,72.9085714285714,NA,712,544,786,0,0,1043,168,257
2017,11,64,"Karkent",37.8746,32.4932,28.1285714285714,3.17142857142857,0.0857142857142857,72.8714285714286,41.9585714285714,NA,525,64,130,368,480,725,461,595
2017,12,64,"Karkent",37.8746,32.4932,24.6428571428571,9.47142857142857,0.0285714285714286,48.8428571428571,40.8457142857143,NA,589,0,0,336,771,1077,589,1077
2017,13,64,"Karkent",37.8746,32.4932,29.4285714285714,9.01428571428571,3.22857142857143,62.0428571428571,44.9057142857143,NA,574,67,141,349,508,887,507,746
2017,14,64,"Karkent",37.8746,32.4932,21.9714285714286,10.0857142857143,0.0857142857142857,53.0428571428571,46.46,NA,639,171,445,372,694,1336,468,891
2017,15,64,"Karkent",37.8746,32.4932,21.4571428571429,9.35714285714286,1.8,61.9142857142857,32.1171428571429,NA,587,27,76,234,585,1187,560,1111
2017,16,64,"Karkent",37.8746,32.4932,32.0428571428571,11.7714285714286,0,54.7,42.3,NA,717,40,66,235,206,920,677,854
2017,17,64,"Karkent",37.8746,32.4932,17.5,12.9142857142857,0,39.1142857142857,48.3242857142857,NA,731,60,185,402,818,1478,671,1293
2017,18,64,"Karkent",37.8746,32.4932,26.7,15.3142857142857,0.985714285714286,59.4428571428571,42.95,NA,506,41,91,151,282,923,465,832
2017,19,64,"Karkent",37.8746,32.4932,31.2714285714286,19.2857142857143,0,41.8285714285714,55.9557142857143,NA,471,23,61,240,518,966,448,905
2017,20,64,"Karkent",37.8746,32.4932,29.0428571428571,13.8857142857143,0.371428571428571,62.3571428571429,26.5614285714286,NA,472,0,0,277,680,1205,472,1205
2017,21,64,"Karkent",37.8746,32.4932,26.5428571428571,13.2857142857143,4.55714285714286,67.6571428571429,37.2214285714286,NA,448,0,0,255,449,849,448,849
2017,22,64,"Karkent",37.8746,32.4932,24.1142857142857,17.1285714285714,1,61.4285714285714,38.0885714285714,NA,522,11,12,316,571,1015,511,1003
2017,23,64,"Karkent",37.8746,32.4932,20.3285714285714,19.2571428571429,0.2,62.0857142857143,47.9842857142857,NA,578,69,126,315,867,1388,509,1262
2017,24,64,"Karkent",37.8746,32.4932,27.8142857142857,19.8285714285714,0.128571428571429,55.3428571428571,33.2542857142857,NA,552,0,0,390,910,1139,552,1139
2017,25,64,"Karkent",37.8746,32.4932,27.0428571428571,19.2285714285714,1.15714285714286,56.6428571428571,22.0042857142857,NA,584,0,0,447,851,1041,584,1041
2017,26,64,"Karkent",37.8746,32.4932,24.6285714285714,26.8428571428571,0,34.9571428571429,44.6085714285714,NA,564,0,0,371,671,971,564,971
2017,27,64,"Karkent",37.8746,32.4932,28.5857142857143,24.0428571428571,0,40.1428571428571,79.8257142857143,NA,511,0,0,244,301,642,511,642
2017,28,64,"Karkent",37.8746,32.4932,25.7,26.2571428571429,0,30.7142857142857,67.6371428571429,NA,481,0,0,338,653,864,481,864
2017,29,64,"Karkent",37.8746,32.4932,27.4428571428571,25.7,0,39.7,56.7485714285714,NA,532,0,0,420,1031,1272,532,1272
2017,30,64,"Karkent",37.8746,32.4932,27.5714285714286,25.1571428571429,0,33.6428571428571,75.9271428571429,NA,531,70,118,236,402,928,461,810
2017,31,64,"Karkent",37.8746,32.4932,29.1142857142857,24.1571428571429,0.0142857142857143,48.3428571428571,52.38,NA,559,0,0,431,896,1047,559,1047
2017,32,64,"Karkent",37.8746,32.4932,27,27.6285714285714,0,37.0571428571429,68.5371428571429,NA,567,0,0,276,563,1092,567,1092
2017,33,64,"Karkent",37.8746,32.4932,32.3,25.9428571428571,0,42.7285714285714,72.47,NA,596,0,0,450,1037,1199,596,1199
2017,34,64,"Karkent",37.8746,32.4932,25.9142857142857,20.9142857142857,2.71428571428571,53.4,40.1042857142857,NA,601,0,0,413,1027,1280,601,1280
2017,35,64,"Karkent",37.8746,32.4932,24.6428571428571,21.9714285714286,0.0285714285714286,41.3285714285714,42.8614285714286,NA,493,0,0,363,813,1014,493,1014
2017,36,64,"Karkent",37.8746,32.4932,18.5428571428571,21.0714285714286,0.571428571428572,34.0142857142857,69.1157142857143,NA,507,145,286,110,302,1321,362,1035
2017,37,64,"Karkent",37.8746,32.4932,19.5571428571429,25.4142857142857,0,24.6,88.3357142857143,NA,589,94,164,239,581,1138,495,974
2017,38,64,"Karkent",37.8746,32.4932,24.0571428571429,23.3857142857143,0,28.5,79.126,NA,671,1,1,412,918,1312,670,1311
2017,39,64,"Karkent",37.8746,32.4932,24.3571428571429,18.9714285714286,0.428571428571429,45.0571428571429,50.7571428571429,NA,782,0,0,634,1359,1630,782,1630
2017,40,64,"Karkent",37.8746,32.4932,23.5,13.3857142857143,0,49.2,40.6371428571429,NA,543,104,204,230,584,1137,439,933
2017,41,64,"Karkent",37.8746,32.4932,25.1428571428571,12.0142857142857,0,50.9285714285714,28.54,NA,487,0,0,392,728,843,487,843
2017,42,64,"Karkent",37.8746,32.4932,17.4571428571429,12.9428571428571,0,41.1428571428571,96.6171428571429,NA,530,0,0,296,524,815,530,815
2017,43,64,"Karkent",37.8746,32.4932,25.3571428571429,12.1428571428571,1.44285714285714,68.3714285714286,52.0614285714286,NA,506,174,321,32,58,919,332,598
2017,44,64,"Karkent",37.8746,32.4932,19.3,6.4,4.52857142857143,64.3,45.9985714285714,NA,561,69,129,294,693,1102,492,973
2017,45,64,"Karkent",37.8746,32.4932,13.5571428571429,7.22857142857143,0.585714285714286,77.1428571428571,60.7542857142857,NA,577,67,61,323,556,829,510,768
2017,46,64,"Karkent",37.8746,32.4932,13.0428571428571,8.48571428571429,0.0571428571428571,73.3714285714286,119.874285714286,NA,587,105,174,83,181,1085,482,911
2017,47,64,"Karkent",37.8746,32.4932,20.9,4.15714285714286,2.64285714285714,72.3428571428571,63.2957142857143,NA,418,81,152,203,407,804,337,652
2017,48,64,"Karkent",37.8746,32.4932,16.1714285714286,5.24285714285714,1,84.5285714285714,95.2257142857143,NA,386,149,245,159,255,619,237,374
2017,49,64,"Karkent",37.8746,32.4932,22.2714285714286,1.68571428571429,0.571428571428572,78.1285714285714,84.0157142857143,NA,407,140,159,222,454,645,267,486
2017,50,64,"Karkent",37.8746,32.4932,17.2142857142857,3.98571428571429,0.0428571428571429,81.6571428571429,124.824285714286,NA,346,130,195,92,100,442,216,247
2017,51,64,"Karkent",37.8746,32.4932,25.4285714285714,5.91428571428571,0.742857142857143,79.7142857142857,57.3242857142857,NA,386,83,48,218,245,349,303,301
2017,52,64,"Karkent",37.8746,32.4932,19.0625,0.2875,0.9125,85.0625,81.94625,NA,528,319,304,138,123,507,209,203
2018,1,64,"Karkent",37.8746,32.4932,18.525,2.35,7.5625,84.4375,65.5214285714286,NA,618,278,373,230,272,914,340,541
2018,2,64,"Karkent",37.8746,32.4932,19.6,3.28571428571429,0.2,86.6142857142857,69.14,NA,624,323,460,104,48,1309,301,849
2018,3,64,"Karkent",37.8746,32.4932,30.1857142857143,1.62857142857143,0.928571428571429,78.0428571428571,62.11,NA,639,243,407,257,130,655,396,248
2018,4,64,"Karkent",37.8746,32.4932,33.1285714285714,-0.5,4.74285714285714,81.8428571428571,21.4042857142857,NA,604,70,135,476,546,764,534,629
2018,5,64,"Karkent",37.8746,32.4932,12.4857142857143,-0.8,0,86,71.7871428571429,NA,670,216,198,0,0,819,454,621
2018,6,64,"Karkent",37.8746,32.4932,22.8428571428571,8.1,0.342857142857143,66.3857142857143,114.874285714286,NA,704,133,209,301,445,1022,571,813
2018,7,64,"Karkent",37.8746,32.4932,29.0714285714286,5.78571428571429,0.214285714285714,69.9857142857143,49.8457142857143,NA,478,99,161,253,285,557,379,396
2018,8,64,"Karkent",37.8746,32.4932,17.2,6.01428571428571,0.414285714285714,74.1428571428571,65.2714285714286,NA,711,297,520,94,286,1321,414,801
2018,9,64,"Karkent",37.8746,32.4932,31.0285714285714,7.22857142857143,0.142857142857143,64.2142857142857,59.18,NA,621,280,439,31,79,956,341,517
2018,10,64,"Karkent",37.8746,32.4932,21.2,9.95714285714286,0.242857142857143,63.6857142857143,78.2142857142857,NA,556,58,159,95,129,1330,498,1171
2018,11,64,"Karkent",37.8746,32.4932,21.9714285714286,9.47142857142857,0.285714285714286,66.4285714285714,56.8628571428571,NA,551,293,1073,88,127,1426,258,353
2018,12,64,"Karkent",37.8746,32.4932,34.7,12.1571428571429,0,45.6571428571429,87.7257142857143,NA,425,106,288,0,0,1187,319,899
2018,13,64,"Karkent",37.8746,32.4932,27.7714285714286,10.6,2.97142857142857,55.4571428571429,83.46,NA,356,143,222,42,51,428,213,206
2018,14,64,"Karkent",37.8746,32.4932,25.9428571428571,11.1714285714286,0.0571428571428571,47.5571428571429,58.5216666666667,NA,407,180,316,199,143,486,227,170
2018,15,64,"Karkent",37.8746,32.4932,24.2857142857143,14.0714285714286,0.157142857142857,59.9571428571429,49.3414285714286,NA,374,0,0,256,286,450,374,450
2018,16,64,"Karkent",37.8746,32.4932,25.1142857142857,13.2857142857143,0.585714285714286,45.5428571428571,57.48,NA,411,5,0,286,421,648,406,648
2018,17,64,"Karkent",37.8746,32.4932,24.8285714285714,17.3714285714286,0,37.2571428571429,50.7657142857143,NA,419,61,96,103,111,652,358,556
2018,18,64,"Karkent",37.8746,32.4932,28.3285714285714,17.7285714285714,2.05714285714286,51.1714285714286,65.7885714285714,NA,303,128,170,35,16,474,175,304
2018,19,64,"Karkent",37.8746,32.4932,28.5857142857143,13.5142857142857,1,70.4428571428572,39.9771428571429,NA,275,6,11,115,145,467,269,456
2018,20,64,"Karkent",37.8746,32.4932,23.8714285714286,19.5857142857143,0.114285714285714,47.5857142857143,48.9514285714286,NA,204,0,0,160,222,306,204,306
2018,21,64,"Karkent",37.8746,32.4932,23.3,18.9428571428571,2.87142857142857,58.9142857142857,50.0942857142857,NA,252,0,0,137,149,281,252,281
2018,22,64,"Karkent",37.8746,32.4932,27.5714285714286,17.9714285714286,0.485714285714286,61.1857142857143,33.5342857142857,NA,249,6,7,174,298,427,243,420
2018,23,64,"Karkent",37.8746,32.4932,25.2,22.7285714285714,0.142857142857143,38.0571428571429,50.1471428571429,NA,267,0,0,189,519,812,267,812
2018,24,64,"Karkent",37.8746,32.4932,25.0857142857143,21.0428571428571,4.6,48.4428571428571,37.725,NA,267,10,14,147,221,448,257,434
2018,25,64,"Karkent",37.8746,32.4932,28.7857142857143,19.5285714285714,7.02857142857143,66.2857142857143,35.5883333333333,NA,358,0,0,253,406,518,358,518
2018,26,64,"Karkent",37.8746,32.4932,24.1571428571429,23.4571428571429,0,43.8571428571429,38.9642857142857,NA,355,0,0,178,256,587,355,587
2018,27,64,"Karkent",37.8746,32.4932,29.1571428571429,24.9285714285714,0,36.7285714285714,36.3514285714286,NA,342,0,0,197,223,418,342,418
2018,28,64,"Karkent",37.8746,32.4932,29.1285714285714,26.2428571428571,0,40.1,46.9871428571429,NA,286,0,0,206,407,585,286,585
2018,29,64,"Karkent",37.8746,32.4932,29.4714285714286,23.9571428571429,0.714285714285714,42.5,38.8914285714286,NA,260,0,0,130,356,756,260,756
2018,30,64,"Karkent",37.8746,32.4932,28.3285714285714,24.8285714285714,0.428571428571429,42.5,50.1957142857143,NA,265,0,0,131,262,822,265,822
2018,31,64,"Karkent",37.8746,32.4932,29.9142857142857,25.6714285714286,0.0285714285714286,44.1142857142857,30.1471428571429,NA,267,0,0,217,165,499,267,499
2018,32,64,"Karkent",37.8746,32.4932,27.5,23.5571428571429,0,39.7428571428571,30.5471428571429,NA,297,0,0,209,255,403,297,403
2018,33,64,"Karkent",37.8746,32.4932,22.4285714285714,24.2571428571429,0,30.3714285714286,44.1628571428571,NA,216,20,48,135,120,332,196,284
2018,34,64,"Karkent",37.8746,32.4932,21.7,25.1857142857143,0,30.1285714285714,36.4057142857143,NA,144,31,40,40,49,227,113,187
2018,35,64,"Karkent",37.8746,32.4932,25.4,25.7285714285714,0,37.0428571428571,49.2914285714286,NA,201,55,26,133,231,314,146,288
2018,36,64,"Karkent",37.8746,32.4932,22.2714285714286,22.5142857142857,0.0428571428571429,39.8428571428571,53.3757142857143,NA,341,54,52,206,225,370,287,318
2018,37,64,"Karkent",37.8746,32.4932,25.9714285714286,19.4142857142857,0.1,47.3571428571429,38.1014285714286,NA,241,0,0,192,352,419,241,419
2018,38,64,"Karkent",37.8746,32.4932,24.0714285714286,19.8285714285714,0,37.1714285714286,38.5085714285714,NA,189,0,0,163,241,344,189,344
2018,39,64,"Karkent",37.8746,32.4932,26.2285714285714,17.2285714285714,0.571428571428572,49.6714285714286,60.7985714285714,NA,180,40,101,103,181,353,140,252
2018,40,64,"Karkent",37.8746,32.4932,24.6428571428571,16.4714285714286,0.0571428571428571,49.0142857142857,45.9257142857143,NA,191,29,38,100,172,341,162,303
2018,41,64,"Karkent",37.8746,32.4932,20.4285714285714,15.0428571428571,3.42857142857143,63.1857142857143,55.61,NA,187,12,25,131,349,422,175,397
2018,42,64,"Karkent",37.8746,32.4932,19.8714285714286,15.6714285714286,0.757142857142857,64.7571428571429,85.85,NA,168,83,266,38,34,381,85,115
2018,43,64,"Karkent",37.8746,32.4932,24.0857142857143,9.37142857142857,1.01428571428571,70.2857142857143,60.68,NA,187,94,179,62,169,402,93,223
2018,44,64,"Karkent",37.8746,32.4932,17.7571428571429,11.4285714285714,0,50.4857142857143,75.3142857142857,NA,196,0,0,188,237,264,196,264
2018,45,64,"Karkent",37.8746,32.4932,17.5142857142857,8.72857142857143,0,58.8857142857143,61.5157142857143,NA,231,0,0,210,431,473,231,473
2018,46,64,"Karkent",37.8746,32.4932,20.1714285714286,4.92857142857143,0.614285714285714,68.1857142857143,39.9557142857143,NA,230,37,78,120,225,465,193,387
2018,47,64,"Karkent",37.8746,32.4932,18.8,7.77142857142857,0.214285714285714,75.9,66.2285714285714,NA,270,117,253,69,175,499,153,246
2018,48,64,"Karkent",37.8746,32.4932,19.1,7.01428571428571,1.91428571428571,87.2571428571429,63.7257142857143,NA,245,119,119,41,50,201,126,82
2018,49,64,"Karkent",37.8746,32.4932,21.9857142857143,4.7,0.528571428571429,82.8714285714286,55.06,NA,257,40,37,61,144,420,217,383
2018,50,64,"Karkent",37.8746,32.4932,19.5571428571429,4.3,3.04285714285714,78.0571428571428,57.2957142857143,NA,256,185,199,32,42,305,71,106
2018,51,64,"Karkent",37.8746,32.4932,20.3714285714286,4.37142857142857,1.94285714285714,86.1428571428571,70.44,NA,250,144,154,72,44,248,106,94
2018,52,64,"Karkent",37.8746,32.4932,28.0857142857143,-1.67142857142857,4.71428571428571,80.2,NA,NA,244,60,59,128,158,273,184,214
2019,1,64,"Karkent",37.8746,32.4932,22.475,1.2375,2.9375,86.225,30.07,NA,343,196,529,89,122,784,147,255
2019,2,64,"Karkent",37.8746,32.4932,21.4714285714286,-2.71428571428571,1.45714285714286,83.8571428571429,NA,NA,255,168,169,42,27,208,87,39
2019,3,64,"Karkent",37.8746,32.4932,27.5714285714286,-0.828571428571429,1.84285714285714,83.2857142857143,NA,NA,192,112,126,43,41,198,80,72
2019,4,64,"Karkent",37.8746,32.4932,25.7142857142857,3.71428571428571,1.6,82.1571428571429,NA,NA,308,224,267,0,0,314,84,47
2019,5,64,"Karkent",37.8746,32.4932,20.3857142857143,3.58571428571429,0.871428571428571,75.0857142857143,NA,NA,253,187,116,26,6,143,66,27
2019,6,64,"Karkent",37.8746,32.4932,20.6285714285714,5.1,0.828571428571429,79.4285714285714,NA,NA,276,122,36,73,64,127,154,91
2019,7,64,"Karkent",37.8746,32.4932,25.7142857142857,3.94285714285714,0.128571428571429,73.3,NA,NA,325,61,120,190,78,234,264,114
2019,8,64,"Karkent",37.8746,32.4932,19.2571428571429,4.82857142857143,0,65.0714285714286,NA,NA,305,41,23,208,167,219,264,196
2019,9,64,"Karkent",37.8746,32.4932,28.8428571428571,2.84285714285714,0.428571428571429,72.9428571428571,NA,NA,331,0,0,248,207,310,331,310
2019,10,64,"Karkent",37.8746,32.4932,20.9428571428571,6.34285714285714,0.428571428571429,59.7714285714286,NA,NA,359,60,26,197,152,252,299,226
2019,11,64,"Karkent",37.8746,32.4932,29.9857142857143,8.22857142857143,1.12857142857143,62.2428571428571,NA,NA,373,121,52,135,145,400,252,348
2019,12,64,"Karkent",37.8746,32.4932,28.8571428571429,8.42857142857143,0,51.1571428571429,NA,NA,343,0,0,202,127,416,343,416
2019,13,64,"Karkent",37.8746,32.4932,29.3714285714286,4.17142857142857,1.7,64.4428571428571,NA,NA,256,0,0,181,140,194,256,194
2019,14,64,"Karkent",37.8746,32.4932,19.1,8.71428571428572,1.42857142857143,62.2857142857143,49.685,NA,365,88,55,87,42,208,277,153
2019,15,64,"Karkent",37.8746,32.4932,28.0285714285714,11.2857142857143,1.2,62.6,39.09,NA,359,123,89,104,60,183,236,94
2019,16,64,"Karkent",37.8746,32.4932,31.2142857142857,5.75714285714286,1.85714285714286,72.1142857142857,24.5585714285714,NA,318,0,0,304,197,208,318,208
2019,17,64,"Karkent",37.8746,32.4932,22.7857142857143,11.0571428571429,1.25714285714286,64.4714285714286,59.8585714285714,NA,412,64,71,282,178,313,348,242
2019,18,64,"Karkent",37.8746,32.4932,26.7428571428571,14.4857142857143,0.657142857142857,54.0857142857143,43.9514285714286,NA,523,248,109,72,44,353,275,244
2019,19,64,"Karkent",37.8746,32.4932,28.2428571428571,12.8285714285714,0.342857142857143,58.9571428571429,37.3042857142857,NA,452,85,55,116,89,386,367,331
2019,20,64,"Karkent",37.8746,32.4932,23.5142857142857,18.7428571428571,0.0285714285714286,41.4428571428571,54.4642857142857,NA,454,75,52,207,157,389,379,337
2019,21,64,"Karkent",37.8746,32.4932,29.4142857142857,20.4285714285714,0,42.4714285714286,39.868,NA,457,0,0,144,101,413,457,413
2019,22,64,"Karkent",37.8746,32.4932,24.0571428571429,23.8142857142857,0.142857142857143,36.7285714285714,45.8314285714286,NA,453,0,0,379,260,323,453,323
2019,23,64,"Karkent",37.8746,32.4932,28.6428571428571,22.5571428571429,0,35.5428571428571,30.7328571428571,NA,378,59,66,105,206,532,319,466
2019,24,64,"Karkent",37.8746,32.4932,29.4,19.2714285714286,4.54285714285714,64.3857142857143,24.7342857142857,NA,378,0,0,277,159,244,378,244
2019,25,64,"Karkent",37.8746,32.4932,25.6428571428571,20.5857142857143,3.94285714285714,64.2571428571429,23.2485714285714,NA,306,0,0,273,304,325,306,325
2019,26,64,"Karkent",37.8746,32.4932,27.5,23.8285714285714,0.142857142857143,42.7428571428571,30.4257142857143,NA,377,0,0,311,280,342,377,342
2019,27,64,"Karkent",37.8746,32.4932,26.9285714285714,22.9428571428571,0,36.4571428571429,45.0857142857143,NA,456,0,0,348,187,222,456,222
2019,28,64,"Karkent",37.8746,32.4932,30.4428571428571,23.3571428571429,0,39.1428571428571,42.1671428571429,NA,398,0,0,329,380,421,398,421
2019,29,64,"Karkent",37.8746,32.4932,26.1714285714286,20.6142857142857,2.8,57.1571428571429,29.4714285714286,NA,453,0,0,330,137,203,453,203
2019,30,64,"Karkent",37.8746,32.4932,25.7142857142857,22.7571428571429,0,42.1285714285714,38.8128571428571,NA,456,0,0,271,248,335,456,335
2019,31,64,"Karkent",37.8746,32.4932,28.0714285714286,26.9285714285714,0,36.4285714285714,50.6071428571429,NA,334,35,42,185,196,375,299,333
2019,32,64,"Karkent",37.8746,32.4932,28.0714285714286,22.4857142857143,0,34.4857142857143,36.6228571428571,NA,346,0,0,282,290,395,346,395
2019,33,64,"Karkent",37.8746,32.4932,28.8571428571429,24.1714285714286,1.14285714285714,45.9285714285714,36.9457142857143,NA,337,0,0,283,443,531,337,531
2019,34,64,"Karkent",37.8746,32.4932,28.0142857142857,21.3428571428571,0.0857142857142857,55.8571428571429,31.8728571428571,NA,299,0,0,291,337,345,299,345
2019,35,64,"Karkent",37.8746,32.4932,24.6285714285714,23.4571428571429,0,40.1,42.5771428571429,NA,307,0,0,264,392,415,307,415
2019,36,64,"Karkent",37.8746,32.4932,24.8857142857143,23.2571428571429,0,35.8,47.59,NA,171,1,0,108,50,67,170,67
2019,37,64,"Karkent",37.8746,32.4932,27.4714285714286,19.8285714285714,0.714285714285714,43.3714285714286,43.5828571428571,NA,218,0,0,150,43,55,218,55
2019,38,64,"Karkent",37.8746,32.4932,22.4857142857143,16.9571428571429,0,47.0857142857143,56.8328571428571,NA,266,127,55,132,24,91,139,36
2019,39,64,"Karkent",37.8746,32.4932,19.3,17.6714285714286,0.314285714285714,48.7571428571429,56.8885714285714,NA,237,5,3,130,26,79,232,76
2019,40,64,"Karkent",37.8746,32.4932,20.9,18.2428571428571,0.114285714285714,42.0142857142857,70.8914285714286,NA,241,77,37,36,7,111,164,74
2019,41,64,"Karkent",37.8746,32.4932,22.2142857142857,16.9714285714286,0,50.2714285714286,49.0457142857143,NA,416,13,6,336,417,448,403,442
2019,42,64,"Karkent",37.8746,32.4932,17.4571428571429,16.7142857142857,0.514285714285714,53.1,65.0242857142857,NA,356,126,174,98,142,408,230,234
2019,43,64,"Karkent",37.8746,32.4932,27.5571428571429,14.4571428571429,0,55.9714285714286,43.5128571428571,NA,306,0,0,294,274,300,306,300
2019,44,64,"Karkent",37.8746,32.4932,18.8285714285714,10.1,0.342857142857143,63.0285714285714,79.49,NA,350,52,29,236,174,250,298,221
2019,45,64,"Karkent",37.8746,32.4932,11.4571428571429,11.3571428571429,0,53.0571428571429,117.408571428571,NA,417,183,168,107,94,328,234,160
2019,46,64,"Karkent",37.8746,32.4932,15.3571428571429,10.8714285714286,2.97142857142857,66.2428571428571,113.675,NA,401,100,68,249,203,337,301,269
2019,47,64,"Karkent",37.8746,32.4932,8.88571428571429,3.6,0.114285714285714,90.8428571428571,115.361666666667,NA,391,165,133,44,52,339,226,206
2019,48,64,"Karkent",37.8746,32.4932,20.0857142857143,7.72857142857143,1.77142857142857,79.2142857142857,78.65,NA,320,92,47,84,89,251,228,204
2019,49,64,"Karkent",37.8746,32.4932,21.7142857142857,1.67142857142857,0.742857142857143,80.7714285714286,50.1042857142857,NA,393,123,105,170,138,274,270,169
2019,50,64,"Karkent",37.8746,32.4932,17.4571428571429,4.4,4.48571428571429,87.1,60.3342857142857,NA,218,156,90,16,17,119,62,29
2019,51,64,"Karkent",37.8746,32.4932,11.4428571428571,2.12857142857143,0.2,89.9714285714286,131.722857142857,NA,361,92,127,56,12,488,269,361
2019,52,64,"Karkent",37.8746,32.4932,28.8714285714286,3.6,3.4,84.8142857142857,22.9157142857143,NA,279,67,109,112,72,281,212,172
2020,1,64,"Karkent",37.8746,32.4932,23.68,0.9,0.04,81.88,34.076,NA,160,31,24,98,95,126,129,102
2020,2,64,"Karkent",37.8746,32.4932,27.5857142857143,0.8,4.85714285714286,80.2285714285714,32.7757142857143,NA,240,97,54,97,103,173,143,119
2020,3,64,"Karkent",37.8746,32.4932,20.3285714285714,0.314285714285714,0.2,80.1,65.5383333333333,NA,270,36,33,213,334,382,234,349
2020,4,64,"Karkent",37.8746,32.4932,31.4857142857143,-1.88571428571429,0.142857142857143,70.2857142857143,42.6285714285714,NA,358,55,83,300,211,295,303,212
2020,5,64,"Karkent",37.8746,32.4932,21.7285714285714,2.25714285714286,0.885714285714286,77.1285714285714,68.9828571428571,NA,331,120,93,61,82,272,211,179
2020,6,64,"Karkent",37.8746,32.4932,36.8142857142857,2.47142857142857,1.67142857142857,71.8571428571429,25.5457142857143,NA,343,109,97,87,65,267,234,170
2020,7,64,"Karkent",37.8746,32.4932,21.1571428571429,0.671428571428571,0.8,77.9857142857143,41.6157142857143,NA,341,114,113,140,175,338,227,225
2020,8,64,"Karkent",37.8746,32.4932,23.5142857142857,3.25714285714286,1.8,73.3571428571429,52.78,NA,283,2,0,205,89,187,281,187
2020,9,64,"Karkent",37.8746,32.4932,31.2714285714286,5.71428571428571,1.91428571428571,65.6571428571429,41.2628571428571,NA,393,177,245,129,137,528,216,283
2020,10,64,"Karkent",37.8746,32.4932,20.6428571428571,8.2,0.0571428571428571,62.6,70.4571428571429,NA,205,127,123,21,23,210,78,87
2020,11,64,"Karkent",37.8746,32.4932,30.2285714285714,10.6428571428571,0.4,59.2714285714286,58.27,NA,115,25,13,44,32,94,90,81
2020,12,64,"Karkent",37.8746,32.4932,31.8,1.04285714285714,1.38571428571429,78.0857142857143,19.8528571428571,NA,117,9,10,94,79,118,108,108
2020,13,64,"Karkent",37.8746,32.4932,24.6285714285714,9.38571428571429,2.51428571428571,69.8142857142857,39.4942857142857,NA,136,22,37,44,14,92,114,55
2020,14,64,"Karkent",37.8746,32.4932,26.4857142857143,8.7,1.28571428571429,70.0571428571428,31.2442857142857,NA,155,87,61,48,40,121,68,60
2020,15,64,"Karkent",37.8746,32.4932,30.7571428571429,9.02857142857143,1.28571428571429,61.9571428571429,28.4957142857143,NA,133,0,0,107,100,118,133,118
2020,16,64,"Karkent",37.8746,32.4932,21.6714285714286,11.9285714285714,0.228571428571429,55.2857142857143,37.5514285714286,NA,141,12,9,76,56,106,129,97
2020,17,64,"Karkent",37.8746,32.4932,22.5285714285714,10.9285714285714,0.3,60.8714285714286,31.1442857142857,NA,137,0,0,106,78,123,137,123
2020,18,64,"Karkent",37.8746,32.4932,22.7428571428571,12.9428571428571,3.68571428571429,62.4428571428571,29.5871428571429,NA,146,19,17,47,94,164,127,147
2020,19,64,"Karkent",37.8746,32.4932,27,11.7428571428571,0.857142857142857,67,23.1885714285714,NA,137,0,0,90,108,157,137,157
2020,20,64,"Karkent",37.8746,32.4932,21.9571428571429,20.8285714285714,0,43.6714285714286,66.3757142857143,NA,164,0,0,127,120,164,164,164
2020,21,64,"Karkent",37.8746,32.4932,34.9714285714286,18.3571428571429,0.428571428571429,45.3571428571429,57.2085714285714,NA,146,13,8,83,69,96,133,88
2020,22,64,"Karkent",37.8746,32.4932,25.3571428571429,14.7857142857143,0,47.9285714285714,18.6057142857143,NA,118,2,1,73,69,100,116,99
2020,23,64,"Karkent",37.8746,32.4932,21.9714285714286,17.7571428571429,1.91428571428571,48.2571428571429,33.7957142857143,NA,112,14,3,50,29,70,98,67
2020,24,64,"Karkent",37.8746,32.4932,24.0714285714286,19.9285714285714,0.228571428571429,48.0571428571429,53.09,NA,140,13,9,70,34,150,127,141
2020,25,64,"Karkent",37.8746,32.4932,26.4428571428571,20.3142857142857,0.0857142857142857,53.0571428571429,42.2742857142857,NA,137,24,31,97,70,108,113,77
2020,26,64,"Karkent",37.8746,32.4932,24.8857142857143,22.2428571428571,0,46.9428571428571,38.5942857142857,NA,173,4,10,119,83,133,169,123
2020,27,64,"Karkent",37.8746,32.4932,23.5428571428571,25.3285714285714,0,32.0142857142857,44.7457142857143,NA,113,0,0,85,93,113,113,113
2020,28,64,"Karkent",37.8746,32.4932,27.3,25.1857142857143,0,38.7,46.6085714285714,NA,164,20,36,108,74,122,144,86
2020,29,64,"Karkent",37.8746,32.4932,25.8714285714286,25.9,0.285714285714286,40.5571428571429,47.0114285714286,NA,186,0,0,149,82,111,186,111
2020,30,64,"Karkent",37.8746,32.4932,26.5428571428571,24.7142857142857,0,37.8285714285714,52.1385714285714,NA,190,36,25,141,101,142,154,117
2020,31,64,"Karkent",37.8746,32.4932,24.3285714285714,26.6285714285714,0.0571428571428571,35.9285714285714,50.1057142857143,NA,150,0,0,102,92,127,150,127
2020,32,64,"Karkent",37.8746,32.4932,21.4428571428571,25.5285714285714,0,28.8285714285714,45.1828571428571,NA,146,0,0,74,72,107,146,107
2020,33,64,"Karkent",37.8746,32.4932,24.8857142857143,23.3285714285714,0,35.3,44.468,NA,183,0,0,138,68,83,183,83
2020,34,64,"Karkent",37.8746,32.4932,23.3,22.5,0,36.5571428571429,50.7814285714286,NA,197,29,7,138,79,97,168,90
2020,35,64,"Karkent",37.8746,32.4932,20.6857142857143,24.7285714285714,0,25.9571428571429,54.7214285714286,NA,164,0,0,147,140,157,164,157
2020,36,64,"Karkent",37.8746,32.4932,19.8142857142857,25.4285714285714,0,30.7714285714286,77.1957142857143,NA,179,43,23,69,47,112,136,89
2020,37,64,"Karkent",37.8746,32.4932,21.7285714285714,22.4,0.571428571428572,46,61.1242857142857,NA,193,0,0,152,63,91,193,91
2020,38,64,"Karkent",37.8746,32.4932,23.8142857142857,23.0428571428571,0,41.0428571428571,60.9428571428571,NA,235,0,0,220,144,157,235,157
2020,39,64,"Karkent",37.8746,32.4932,23.0142857142857,20.7142857142857,0.0857142857142857,49.0428571428571,59.8785714285714,NA,220,3,3,83,74,129,217,126
2020,40,64,"Karkent",37.8746,32.4932,25.1571428571429,18.9571428571429,0.114285714285714,43.5857142857143,63.4142857142857,NA,187,0,0,127,80,154,187,154
2020,41,64,"Karkent",37.8746,32.4932,22.2285714285714,20.4857142857143,0,36,95.5471428571429,NA,182,36,18,95,59,127,146,109
2020,42,64,"Karkent",37.8746,32.4932,18.8428571428571,17.4142857142857,0,43.9571428571429,94.7714285714286,NA,177,47,21,47,25,111,130,90
2020,43,64,"Karkent",37.8746,32.4932,16.7714285714286,15.3428571428571,0.685714285714286,61.8714285714286,67.8942857142857,NA,194,20,16,168,139,161,174,145
2020,44,64,"Karkent",37.8746,32.4932,23.0428571428571,14.0142857142857,0,51.0714285714286,72.8942857142857,NA,255,74,77,49,41,233,181,156
2020,45,64,"Karkent",37.8746,32.4932,27.0428571428571,9,1.62857142857143,67.1142857142857,39.5714285714286,NA,156,0,0,145,89,103,156,103
2020,46,64,"Karkent",37.8746,32.4932,17.7571428571429,7.37142857142857,0.5,71.0428571428571,101.234285714286,NA,208,0,0,166,79,109,208,109
2020,47,64,"Karkent",37.8746,32.4932,17.7571428571429,5.52857142857143,0.142857142857143,72.5,74.8114285714286,NA,173,0,0,145,66,83,173,83
2020,48,64,"Karkent",37.8746,32.4932,18.5857142857143,2.21428571428571,0,64.9714285714286,104.88,NA,199,0,0,155,195,262,199,262
2020,49,64,"Karkent",37.8746,32.4932,12.2285714285714,5.41428571428571,0.0571428571428571,70.3142857142857,120.445714285714,NA,207,43,44,84,40,116,164,72
2020,50,64,"Karkent",37.8746,32.4932,18.8571428571429,5.4,0.242857142857143,81.2,98.2971428571429,NA,181,104,40,21,34,98,77,58
2020,51,64,"Karkent",37.8746,32.4932,18.8428571428571,5.71428571428571,1.85714285714286,80.2857142857143,52.1942857142857,NA,171,69,55,58,24,90,102,35
2020,52,64,"Karkent",37.8746,32.4932,13.3428571428571,1.5,0,79.2142857142857,112.764285714286,NA,203,31,35,94,32,113,172,78
2020,53,64,"Karkent",37.8746,32.4932,12.1,5,0.05,73.575,161.755,NA,122,61,33,0,0,111,61,78
2017,1,65,"Kentpark",39.4167,29.9833,21.2428571428571,-2.82857142857143,2.17057142857143,82.4285714285714,48.4585714285714,NA,563,360,521,128,207,847,203,326
2017,2,65,"Kentpark",39.4167,29.9833,19.2571428571429,-1.11428571428571,2.085,79.6857142857143,47.7057142857143,NA,757,553,998,53,40,1214,204,216
2017,3,65,"Kentpark",39.4167,29.9833,13.6428571428571,1.78571428571429,1.62857142857143,85.8142857142857,44.5771428571429,NA,762,434,918,64,76,1449,328,531
2017,4,65,"Kentpark",39.4167,29.9833,18.2857142857143,-2.82857142857143,1.22814285714286,81.3285714285714,42.3966666666667,NA,639,283,423,234,258,889,356,466
2017,5,65,"Kentpark",39.4167,29.9833,11.4428571428571,-2.37142857142857,0.714285714285714,76.1571428571429,102.245714285714,NA,588,190,185,157,299,1163,398,978
2017,6,65,"Kentpark",39.4167,29.9833,14.2714285714286,3.37142857142857,0.142857142857143,83,53.0828571428571,NA,736,285,416,292,720,1519,451,1103
2017,7,65,"Kentpark",39.4167,29.9833,14.7142857142857,-1.12857142857143,0.0857142857142857,68.0285714285714,67.8714285714286,NA,492,125,87,208,341,717,367,630
2017,8,65,"Kentpark",39.4167,29.9833,13.6571428571429,6.14285714285714,1.71371428571429,74.9857142857143,65.5114285714286,NA,739,118,263,238,724,1747,621,1484
2017,9,65,"Kentpark",39.4167,29.9833,13.0857142857143,7.65714285714286,0.314571428571429,69.3571428571429,89.2642857142857,NA,574,195,375,130,138,866,379,491
2017,10,65,"Kentpark",39.4167,29.9833,17.1857142857143,9.15714285714286,0.371428571428571,63.2285714285714,55.9185714285714,NA,712,681,995,0,0,1043,31,48
2017,11,65,"Kentpark",39.4167,29.9833,17.3714285714286,2.92857142857143,3.19885714285714,80.7428571428571,58.2157142857143,NA,525,0,0,504,690,725,525,725
2017,12,65,"Kentpark",39.4167,29.9833,15.5285714285714,9.91428571428571,0.0285714285714286,59.6571428571429,98.5771428571429,NA,589,0,0,442,683,1077,589,1077
2017,13,65,"Kentpark",39.4167,29.9833,15.2428571428571,7.97142857142857,0.0857142857142857,60.9285714285714,70.6283333333333,NA,574,71,123,330,449,887,503,764
2017,14,65,"Kentpark",39.4167,29.9833,12.5,8.9,3.25657142857143,66.2142857142857,67.2471428571429,NA,639,128,264,311,579,1336,511,1072
2017,15,65,"Kentpark",39.4167,29.9833,14.1285714285714,9.75714285714286,0.114428571428571,60.0285714285714,62.0628571428571,NA,587,191,403,169,550,1187,396,784
2017,16,65,"Kentpark",39.4167,29.9833,18.6857142857143,8.04285714285714,6.65657142857143,74.3285714285714,38.6871428571429,NA,717,0,0,274,203,920,717,920
2017,17,65,"Kentpark",39.4167,29.9833,11.1142857142857,12.3,0,58.5428571428571,74.6357142857143,NA,731,123,171,287,539,1478,608,1307
2017,18,65,"Kentpark",39.4167,29.9833,12.0285714285714,15.1714285714286,2.42828571428571,66.5571428571429,62.8857142857143,NA,506,0,0,281,560,923,506,923
2017,19,65,"Kentpark",39.4167,29.9833,17.0571428571429,16.3857142857143,0.856857142857143,61.5571428571429,59.1571428571429,NA,471,0,0,280,595,966,471,966
2017,20,65,"Kentpark",39.4167,29.9833,14.9,12.2285714285714,10.297,75.0857142857143,46.54,NA,472,54,73,399,1117,1205,418,1132
2017,21,65,"Kentpark",39.4167,29.9833,11.8857142857143,13.1428571428571,0.714571428571429,74.3285714285714,57.2728571428571,NA,448,0,0,407,687,849,448,849
2017,22,65,"Kentpark",39.4167,29.9833,14.1857142857143,15.9714285714286,1.45757142857143,78.3,63.5728571428571,NA,522,0,0,366,568,1015,522,1015
2017,23,65,"Kentpark",39.4167,29.9833,13.2571428571429,17.7571428571429,3.71371428571429,76.4857142857143,56.0414285714286,NA,578,31,81,490,1203,1388,547,1307
2017,24,65,"Kentpark",39.4167,29.9833,13.9,17.7428571428571,3.74157142857143,71.8428571428571,54.7785714285714,NA,552,0,0,503,1007,1139,552,1139
2017,25,65,"Kentpark",39.4167,29.9833,13.4857142857143,17.8857142857143,2.91371428571429,71.2142857142857,50.5471428571429,NA,584,0,0,555,994,1041,584,1041
2017,26,65,"Kentpark",39.4167,29.9833,14.5857142857143,24.5142857142857,0,57.3285714285714,57.1614285714286,NA,564,0,0,564,971,971,564,971
2017,27,65,"Kentpark",39.4167,29.9833,19.7857142857143,21.5714285714286,0,60.2571428571429,49.5128571428571,NA,511,0,0,414,509,642,511,642
2017,28,65,"Kentpark",39.4167,29.9833,16.6428571428571,23.1,0,54.9571428571429,58.3271428571429,NA,481,0,0,481,864,864,481,864
2017,29,65,"Kentpark",39.4167,29.9833,20.0857142857143,21.3571428571429,2.57071428571429,71.1714285714286,57.0342857142857,NA,532,0,0,532,1272,1272,532,1272
2017,30,65,"Kentpark",39.4167,29.9833,16.3714285714286,22.5571428571429,0.372428571428571,56.5,63.1957142857143,NA,531,0,0,362,554,928,531,928
2017,31,65,"Kentpark",39.4167,29.9833,18.0857142857143,21.5571428571429,8.91157142857143,69.4714285714286,56.2242857142857,NA,559,0,0,559,1047,1047,559,1047
2017,32,65,"Kentpark",39.4167,29.9833,16.6,24.3428571428571,0,65.0714285714286,66.2428571428571,NA,567,0,0,565,1082,1092,567,1092
2017,33,65,"Kentpark",39.4167,29.9833,19.4857142857143,21.5571428571429,0,68.6857142857143,62.5828571428571,NA,596,0,0,596,1199,1199,596,1199
2017,34,65,"Kentpark",39.4167,29.9833,16.1714285714286,18.6571428571429,2.31357142857143,70.9571428571429,52.9771428571429,NA,601,0,0,565,994,1280,601,1280
2017,35,65,"Kentpark",39.4167,29.9833,16.0714285714286,18.7,0,59.6285714285714,47.7042857142857,NA,493,0,0,412,822,1014,493,1014
2017,36,65,"Kentpark",39.4167,29.9833,13.0142857142857,18.8428571428571,0.571142857142857,57.1571428571429,65.5114285714286,NA,507,0,0,305,796,1321,507,1321
2017,37,65,"Kentpark",39.4167,29.9833,15.1,22.8285714285714,0,52.6142857142857,84.34,NA,589,0,0,429,839,1138,589,1138
2017,38,65,"Kentpark",39.4167,29.9833,15.6428571428571,19.5285714285714,0,49.4142857142857,70.58,NA,671,0,0,439,854,1312,671,1312
2017,39,65,"Kentpark",39.4167,29.9833,14.7714285714286,15,5.227,77.2285714285714,58.5971428571429,NA,782,0,0,486,976,1630,782,1630
2017,40,65,"Kentpark",39.4167,29.9833,11.1714285714286,11.6714285714286,1.4,71.7857142857143,53.204,NA,543,75,141,264,508,1137,468,996
2017,41,65,"Kentpark",39.4167,29.9833,13.8285714285714,9.82857142857143,0.428428571428571,66.8571428571429,67.7285714285714,NA,487,0,0,487,843,843,487,843
2017,42,65,"Kentpark",39.4167,29.9833,9.07142857142857,11.8857142857143,0,62.0857142857143,91.1285714285714,NA,530,34,48,324,489,815,496,767
2017,43,65,"Kentpark",39.4167,29.9833,12.2,9.8,6.77014285714286,82.9,66.7914285714286,NA,506,272,368,145,301,919,234,551
2017,44,65,"Kentpark",39.4167,29.9833,10.6142857142857,4.7,0.114571428571429,73.5571428571428,77.0157142857143,NA,561,74,143,367,767,1102,487,959
2017,45,65,"Kentpark",39.4167,29.9833,11.6285714285714,6.47142857142857,0.142857142857143,84.3428571428571,100.644285714286,NA,577,53,12,212,366,829,524,817
2017,46,65,"Kentpark",39.4167,29.9833,10.9,8.84285714285714,0,74.3857142857143,115.961428571429,NA,587,333,572,0,0,1085,254,513
2017,47,65,"Kentpark",39.4167,29.9833,14.0571428571429,3.74285714285714,2.91328571428571,84.6857142857143,84.52,NA,418,61,140,195,320,804,357,664
2017,48,65,"Kentpark",39.4167,29.9833,15.1571428571429,7.47142857142857,1.68514285714286,77.4857142857143,57.872,NA,386,334,510,0,0,619,52,109
2017,49,65,"Kentpark",39.4167,29.9833,16.2142857142857,3.84285714285714,2.94271428571429,79.0714285714286,74.1985714285714,NA,407,146,156,144,225,645,261,489
2017,50,65,"Kentpark",39.4167,29.9833,12.5,6.2,0.114285714285714,81.9857142857143,84.8585714285714,NA,346,205,239,0,0,442,141,203
2017,51,65,"Kentpark",39.4167,29.9833,16.1714285714286,2.8,5.59871428571429,88.7571428571429,37.735,NA,386,4,14,252,224,349,382,335
2017,52,65,"Kentpark",39.4167,29.9833,13.825,1.45,0.67475,82.875,83.48375,NA,528,423,433,105,74,507,105,74
2018,1,65,"Kentpark",39.4167,29.9833,12.75,2.1375,0.89975,86.325,93.5675,51.19,618,399,660,87,77,914,219,254
2018,2,65,"Kentpark",39.4167,29.9833,15.3,2.98571428571429,1.68557142857143,91.3857142857143,93.4628571428571,NA,624,496,1242,107,49,1309,128,67
2018,3,65,"Kentpark",39.4167,29.9833,21.4571428571429,2.25714285714286,4.99828571428571,81.1142857142857,46.5857142857143,NA,639,361,505,277,150,655,278,150
2018,4,65,"Kentpark",39.4167,29.9833,19.3428571428571,-0.928571428571429,0.799714285714286,77.6857142857143,41.9814285714286,NA,604,101,182,329,396,764,503,582
2018,5,65,"Kentpark",39.4167,29.9833,9.94285714285714,4.27142857142857,0,73.5285714285714,86.3271428571429,NA,670,167,290,318,226,819,503,529
2018,6,65,"Kentpark",39.4167,29.9833,16.7714285714286,6.98571428571429,1.94242857142857,81.8571428571429,81.4814285714286,NA,704,391,629,117,199,1022,313,393
2018,7,65,"Kentpark",39.4167,29.9833,15.7714285714286,4.77142857142857,0.828285714285714,79,50.2342857142857,NA,478,192,243,203,239,557,286,314
2018,8,65,"Kentpark",39.4167,29.9833,14,5.68571428571429,2.45657142857143,79.4428571428571,70.295,NA,711,404,705,204,395,1321,307,616
2018,9,65,"Kentpark",39.4167,29.9833,19.0285714285714,5.78571428571429,8.369,78.3714285714286,50.6425,NA,621,275,438,93,162,956,346,518
2018,10,65,"Kentpark",39.4167,29.9833,15.7857142857143,9.1,2.22814285714286,74.9142857142857,74.9085714285714,NA,556,183,515,237,455,1330,373,815
2018,11,65,"Kentpark",39.4167,29.9833,12.9428571428571,9.31428571428571,1.74314285714286,71.9571428571429,61.922,NA,551,115,276,0,0,1426,436,1150
2018,12,65,"Kentpark",39.4167,29.9833,15.6285714285714,10.8428571428571,0.543,59.1428571428571,99.69,NA,425,95,198,6,5,1187,330,989
2018,13,65,"Kentpark",39.4167,29.9833,18.5,9.8,1.34242857142857,65.4428571428572,78.9871428571429,NA,356,130,128,105,180,428,226,300
2018,14,65,"Kentpark",39.4167,29.9833,14.5285714285714,10.8857142857143,0.856857142857143,59.3142857142857,66.3685714285714,NA,407,135,268,112,88,486,272,218
2018,15,65,"Kentpark",39.4167,29.9833,13.3714285714286,14.7571428571429,0.114285714285714,66.4,80.1342857142857,NA,374,0,0,297,233,450,374,450
2018,16,65,"Kentpark",39.4167,29.9833,16.6142857142857,12.5714285714286,0.142857142857143,57.7857142857143,64.2942857142857,NA,411,56,42,274,491,648,355,606
2018,17,65,"Kentpark",39.4167,29.9833,13.8142857142857,16.4714285714286,0.428428571428571,50.9142857142857,70.56,NA,419,0,0,403,617,652,419,652
2018,18,65,"Kentpark",39.4167,29.9833,15.2142857142857,17.7142857142857,1.28571428571429,61.3428571428571,75.5857142857143,NA,303,104,152,109,163,474,199,322
2018,19,65,"Kentpark",39.4167,29.9833,14.1142857142857,12.6,6.59828571428571,82.3714285714286,61.5885714285714,NA,275,0,0,259,419,467,275,467
2018,20,65,"Kentpark",39.4167,29.9833,11.1857142857143,17.4428571428571,2.19957142857143,65.7857142857143,74.6266666666667,NA,204,4,1,122,203,306,200,305
2018,21,65,"Kentpark",39.4167,29.9833,13.8,17.2714285714286,3.31357142857143,80.8714285714286,NA,NA,252,0,0,243,275,281,252,281
2018,22,65,"Kentpark",39.4167,29.9833,16.2571428571429,16.7142857142857,0.371714285714286,73.5571428571429,56.5733333333333,NA,249,0,0,249,427,427,249,427
2018,23,65,"Kentpark",39.4167,29.9833,11.2857142857143,19.8,1.88514285714286,66.1,NA,11.07,267,0,0,193,519,812,267,812
2018,24,65,"Kentpark",39.4167,29.9833,15.6428571428571,19.3428571428571,6.59785714285714,66.9428571428572,NA,9.7475,267,34,30,163,371,448,233,418
2018,25,65,"Kentpark",39.4167,29.9833,12,18.6285714285714,6.57028571428571,80.2428571428571,NA,7.4175,358,0,0,358,518,518,358,518
2018,26,65,"Kentpark",39.4167,29.9833,12.7285714285714,20.2,0.171428571428571,69.1,NA,6.872,355,75,175,149,297,587,280,412
2018,27,65,"Kentpark",39.4167,29.9833,14.3142857142857,22.2571428571429,0,54.2714285714286,NA,16.335,342,0,0,339,406,418,342,418
2018,28,65,"Kentpark",39.4167,29.9833,19.2285714285714,22.1714285714286,0.714857142857143,68.1142857142857,NA,NA,286,0,0,286,585,585,286,585
2018,29,65,"Kentpark",39.4167,29.9833,14.0428571428571,21.3714285714286,0.000142857142857143,63.8,NA,26.85,260,0,0,260,756,756,260,756
2018,30,65,"Kentpark",39.4167,29.9833,12.1285714285714,21.1,4.17085714285714,71.9285714285714,NA,27.18,265,0,0,206,513,822,265,822
2018,31,65,"Kentpark",39.4167,29.9833,14.4142857142857,22.2285714285714,1.99971428571429,73.2,NA,28.1216666666667,267,0,0,237,491,499,267,499
2018,32,65,"Kentpark",39.4167,29.9833,15.0571428571429,21.5285714285714,0.571142857142857,64.7714285714286,NA,28.845,297,0,0,279,354,403,297,403
2018,33,65,"Kentpark",39.4167,29.9833,15.3857142857143,22.4857142857143,0.142857142857143,58.6285714285714,NA,39.71,216,0,0,201,276,332,216,332
2018,34,65,"Kentpark",39.4167,29.9833,15.9,22.8142857142857,3.88385714285714,61.6,NA,NA,144,0,0,68,70,227,144,227
2018,35,65,"Kentpark",39.4167,29.9833,19.4285714285714,23.0857142857143,1.51357142857143,63.2142857142857,NA,NA,201,0,0,132,225,314,201,314
2018,36,65,"Kentpark",39.4167,29.9833,13.8428571428571,20.3571428571429,0,63.3571428571429,NA,NA,341,0,0,333,355,370,341,370
2018,37,65,"Kentpark",39.4167,29.9833,16.2857142857143,16.3142857142857,0.600142857142857,71.0142857142857,NA,NA,241,0,0,218,387,419,241,419
2018,38,65,"Kentpark",39.4167,29.9833,17.4142857142857,17.9428571428571,0,62.3714285714286,NA,39.45,189,0,0,156,288,344,189,344
2018,39,65,"Kentpark",39.4167,29.9833,17.7428571428571,16.0857142857143,0.142857142857143,63.1142857142857,57.45,34.0366666666667,180,19,50,71,123,353,161,303
2018,40,65,"Kentpark",39.4167,29.9833,12.3,14.5714285714286,0.428571428571429,68.3,64.4471428571429,35.3583333333333,191,31,45,73,146,341,160,296
2018,41,65,"Kentpark",39.4167,29.9833,14.7,13.6285714285714,5.883,78.0285714285714,79.1671428571429,41.645,187,0,0,161,404,422,187,422
2018,42,65,"Kentpark",39.4167,29.9833,14.1857142857143,14.6428571428571,3.71371428571429,83.8714285714286,140.607142857143,41.2383333333333,168,0,0,82,145,381,168,381
2018,43,65,"Kentpark",39.4167,29.9833,16.3,9.41428571428571,3.68471428571429,78.5285714285714,94.0028571428571,44.735,187,54,85,67,124,402,133,317
2018,44,65,"Kentpark",39.4167,29.9833,8.44285714285714,10.2428571428571,0,67.3,168.98,52.8357142857143,196,37,26,90,100,264,159,238
2018,45,65,"Kentpark",39.4167,29.9833,9.78571428571428,8.37142857142857,0,78.7857142857143,136.051428571429,46.8285714285714,231,3,4,88,199,473,228,469
2018,46,65,"Kentpark",39.4167,29.9833,15.0285714285714,4.8,0.771428571428571,82.2714285714286,64.86,29.6828571428571,230,45,58,150,331,465,185,407
2018,47,65,"Kentpark",39.4167,29.9833,12.7285714285714,7.65714285714286,0.0571428571428571,81.4714285714286,86.2414285714286,37.106,270,123,104,58,121,499,147,395
2018,48,65,"Kentpark",39.4167,29.9833,14.5857142857143,6.32857142857143,5.79814285714286,85.2285714285714,91.79,27.1542857142857,245,137,85,76,80,201,108,116
2018,49,65,"Kentpark",39.4167,29.9833,16.3428571428571,4.07142857142857,0.828428571428571,83.2285714285714,NA,34.5642857142857,257,60,48,61,144,420,197,372
2018,50,65,"Kentpark",39.4167,29.9833,15.2571428571429,3.15714285714286,5.34142857142857,88.5428571428571,88.4,39.3457142857143,256,118,112,60,85,305,138,193
2018,51,65,"Kentpark",39.4167,29.9833,12.5,2.98571428571429,2.17142857142857,89.5285714285714,81.73,36.6171428571429,250,25,12,205,201,248,225,236
2018,52,65,"Kentpark",39.4167,29.9833,12.4428571428571,-0.771428571428571,4.16971428571429,83.7285714285714,62.37,38.2457142857143,244,37,51,149,175,273,207,222
2019,1,65,"Kentpark",39.4167,29.9833,17.425,0.4375,22.44075,89.4625,49.9225,36.33125,343,132,379,31,95,784,211,405
2019,2,65,"Kentpark",39.4167,29.9833,16.5428571428571,-0.414285714285714,25.6742857142857,82.6714285714286,50.5428571428571,34.6157142857143,255,97,56,95,118,208,158,152
2019,3,65,"Kentpark",39.4167,29.9833,16.0857142857143,-0.157142857142857,6.45528571428571,85.7428571428571,82.18,54.1571428571429,192,25,28,25,33,198,167,170
2019,4,65,"Kentpark",39.4167,29.9833,16.6857142857143,4.77142857142857,23.1607142857143,83.1571428571429,75.6085714285714,39.7242857142857,308,250,253,0,0,314,58,61
2019,5,65,"Kentpark",39.4167,29.9833,13.3857142857143,4.85714285714286,0.856857142857143,75.4285714285714,69.9157142857143,34.0742857142857,253,148,91,0,0,143,105,52
2019,6,65,"Kentpark",39.4167,29.9833,14.8428571428571,4.27142857142857,3.34257142857143,80.7857142857143,84.4528571428571,42.53,276,105,24,111,69,127,171,103
2019,7,65,"Kentpark",39.4167,29.9833,14.6857142857143,2.58571428571429,15.6508571428571,80.7428571428571,42.63,20.6325,325,89,123,195,84,234,236,111
2019,8,65,"Kentpark",39.4167,29.9833,12.2714285714286,2.95714285714286,0,73.0285714285714,109.968571428571,39.9957142857143,305,0,0,261,199,219,305,219
2019,9,65,"Kentpark",39.4167,29.9833,15.9428571428571,2.25714285714286,0.314285714285714,76.6285714285714,58.21,30.8157142857143,331,0,0,268,290,310,331,310
2019,10,65,"Kentpark",39.4167,29.9833,15.2714285714286,6.8,0.857,63.3428571428571,90.1525,35.4714285714286,359,51,18,63,76,252,308,234
2019,11,65,"Kentpark",39.4167,29.9833,17.9142857142857,7.38571428571429,2.142,72.3285714285714,52.93,22.6433333333333,373,0,0,184,262,400,373,400
2019,12,65,"Kentpark",39.4167,29.9833,18.0285714285714,7.54285714285714,0.314142857142857,60.0142857142857,58.6966666666667,25.665,343,0,0,253,115,416,343,416
2019,13,65,"Kentpark",39.4167,29.9833,18.0714285714286,4.67142857142857,0,57.3714285714286,51.7485714285714,26.44,256,0,0,235,189,194,256,194
2019,14,65,"Kentpark",39.4167,29.9833,16.7571428571429,7.85714285714286,0.142857142857143,69.4,71.9685714285714,37.7114285714286,365,102,46,149,71,208,263,162
2019,15,65,"Kentpark",39.4167,29.9833,14.1428571428571,10.5428571428571,4.57171428571429,75.2714285714286,32.5342857142857,26.4957142857143,359,201,108,54,27,183,158,75
2019,16,65,"Kentpark",39.4167,29.9833,19.3857142857143,4.82857142857143,1.19957142857143,73.5571428571429,40.8925,24.11,318,0,0,318,208,208,318,208
2019,17,65,"Kentpark",39.4167,29.9833,12.9,11.8714285714286,0.200428571428571,58.4428571428571,89.8483333333333,37.486,412,0,0,348,226,313,412,313
2019,18,65,"Kentpark",39.4167,29.9833,14.7142857142857,13.6571428571429,0.557285714285714,60.2857142857143,46.2185714285714,25.9085714285714,523,90,38,149,77,353,433,315
2019,19,65,"Kentpark",39.4167,29.9833,14.4,11.6428571428571,2.34271428571429,70.6285714285714,55.69,23.0171428571429,452,81,54,170,128,386,371,332
2019,20,65,"Kentpark",39.4167,29.9833,13.7,17.7714285714286,1.74285714285714,61.2142857142857,52.1628571428571,31.0342857142857,454,33,42,100,94,389,421,347
2019,21,65,"Kentpark",39.4167,29.9833,15.9714285714286,17.6428571428571,0.457,63.6285714285714,49.42,25.9314285714286,457,0,0,62,21,413,457,413
2019,22,65,"Kentpark",39.4167,29.9833,14.3571428571429,21.5285714285714,0,54.6142857142857,60.2671428571429,27.3257142857143,453,161,108,121,67,323,292,215
2019,23,65,"Kentpark",39.4167,29.9833,16,19.9,0.457142857142857,59.8428571428571,47.6471428571429,18.73,378,0,0,223,384,532,378,532
2019,24,65,"Kentpark",39.4167,29.9833,16.1857142857143,19.0285714285714,5.51242857142857,74.4,41.49,23.9514285714286,378,0,0,323,203,244,378,244
2019,25,65,"Kentpark",39.4167,29.9833,12.3,19.6857142857143,1.39971428571429,74.2571428571429,36.82,21.1957142857143,306,0,0,264,294,325,306,325
2019,26,65,"Kentpark",39.4167,29.9833,16.3428571428571,21.1142857142857,4.02742857142857,63.7571428571429,36.8442857142857,19.9471428571429,377,0,0,325,317,342,377,342
2019,27,65,"Kentpark",39.4167,29.9833,14.4285714285714,21.9714285714286,0,54.6142857142857,39.7257142857143,22.6428571428571,456,0,0,381,157,222,456,222
2019,28,65,"Kentpark",39.4167,29.9833,12.8857142857143,19.5857142857143,2.02828571428571,61.9714285714286,40.0642857142857,22.7442857142857,398,0,0,352,409,421,398,421
2019,29,65,"Kentpark",39.4167,29.9833,14.7285714285714,18.9571428571429,0.743285714285714,69.5714285714286,32.7257142857143,20.54,453,0,0,320,161,203,453,203
2019,30,65,"Kentpark",39.4167,29.9833,15.8,21.3714285714286,0,60.1285714285714,41.3628571428571,21.31,456,0,0,424,291,335,456,335
2019,31,65,"Kentpark",39.4167,29.9833,15.4,23.8142857142857,0,57.5428571428571,53.4914285714286,23.9885714285714,334,0,0,238,256,375,334,375
2019,32,65,"Kentpark",39.4167,29.9833,16.6428571428571,21.3142857142857,0,52.8571428571429,39.6028571428571,26.7085714285714,346,0,0,345,390,395,346,395
2019,33,65,"Kentpark",39.4167,29.9833,19.2857142857143,22.2285714285714,0.228571428571429,60.0857142857143,42.06,22.2914285714286,337,0,0,278,461,531,337,531
2019,34,65,"Kentpark",39.4167,29.9833,15.3571428571429,20.9714285714286,0.0571428571428571,65.5714285714286,26.495,19.8557142857143,299,0,0,298,345,345,299,345
2019,35,65,"Kentpark",39.4167,29.9833,16.3,21.5571428571429,0,61.9142857142857,45.3185714285714,23.5671428571429,307,0,0,270,337,415,307,415
2019,36,65,"Kentpark",39.4167,29.9833,16,20.4,0.2,62,46.1014285714286,25.3814285714286,171,0,0,120,52,67,171,67
2019,37,65,"Kentpark",39.4167,29.9833,17.5714285714286,18.8142857142857,0,61.4142857142857,39.4814285714286,20.2742857142857,218,0,0,216,55,55,218,55
2019,38,65,"Kentpark",39.4167,29.9833,13.7285714285714,16,0,58.2714285714286,47.8928571428571,27.2342857142857,266,0,0,205,70,91,266,91
2019,39,65,"Kentpark",39.4167,29.9833,12.0428571428571,16.2714285714286,0.428857142857143,64.2714285714286,53.2828571428571,30.2614285714286,237,0,0,119,39,79,237,79
2019,40,65,"Kentpark",39.4167,29.9833,13.1142857142857,17.2428571428571,0.828285714285714,55.6428571428571,46.3185714285714,34.0314285714286,241,13,22,37,8,111,228,89
2019,41,65,"Kentpark",39.4167,29.9833,10.9571428571429,14.1428571428571,2.11357142857143,76.2714285714286,47.9571428571429,31.0357142857143,416,0,0,224,323,448,416,448
2019,42,65,"Kentpark",39.4167,29.9833,8.07142857142857,14.6571428571429,0.257142857142857,66.9428571428572,83.1857142857143,47.4128571428571,356,2,2,116,181,408,354,406
2019,43,65,"Kentpark",39.4167,29.9833,13.3142857142857,12.4285714285714,0,72.5428571428571,63.3528571428571,33.6585714285714,306,0,0,212,139,300,306,300
2019,44,65,"Kentpark",39.4167,29.9833,11.7142857142857,8.91428571428571,0.371285714285714,75.3857142857143,60.632,38.6314285714286,350,92,59,98,65,250,258,191
2019,45,65,"Kentpark",39.4167,29.9833,9.21428571428572,11.5285714285714,0,64.1285714285714,80.2114285714286,44.1742857142857,417,143,122,0,0,328,274,206
2019,46,65,"Kentpark",39.4167,29.9833,8.54285714285714,10.3142857142857,0.285571428571429,69.2285714285714,120.131666666667,50.8583333333333,401,286,201,0,0,337,115,136
2019,47,65,"Kentpark",39.4167,29.9833,7.4,5.58571428571429,0.428428571428571,75.2571428571429,135.824285714286,50.5971428571429,391,166,144,39,28,339,225,195
2019,48,65,"Kentpark",39.4167,29.9833,11.4285714285714,8.21428571428571,4.25714285714286,84.7714285714286,56.91,33.3328571428571,320,152,74,89,92,251,168,177
2019,49,65,"Kentpark",39.4167,29.9833,11.0142857142857,0.457142857142857,3.22857142857143,86.1714285714286,80.6314285714286,46.2114285714286,393,112,103,109,76,274,281,171
2019,50,65,"Kentpark",39.4167,29.9833,14.4428571428571,4.8,0.172,87.3142857142857,69.0728571428571,40.3971428571429,218,173,96,0,0,119,45,23
2019,51,65,"Kentpark",39.4167,29.9833,13.2,3.01428571428571,0,89.5714285714286,117.507142857143,34.1825,361,156,267,0,0,488,205,221
2019,52,65,"Kentpark",39.4167,29.9833,17.4571428571429,3.3,3.48514285714286,85.3857142857143,30.2014285714286,25.1814285714286,279,49,66,143,85,281,230,215
2020,1,65,"Kentpark",39.4167,29.9833,12.56,0.18,0.2,79.66,57.2825,35.406,160,32,24,103,80,126,128,102
2020,2,65,"Kentpark",39.4167,29.9833,15.8285714285714,-1.37142857142857,40.2118571428571,87.1,113.948,40.8628571428571,240,0,0,178,144,173,240,173
2020,3,65,"Kentpark",39.4167,29.9833,9.27142857142857,-1.62857142857143,0.0285714285714286,88.1285714285714,107.065714285714,55.7114285714286,270,43,38,137,214,382,227,344
2020,4,65,"Kentpark",39.4167,29.9833,14.5571428571429,-1.98571428571429,34.3265714285714,79.1,90.7028571428571,42.1185714285714,358,56,83,239,136,295,302,212
2020,5,65,"Kentpark",39.4167,29.9833,15.1857142857143,2.82857142857143,2.19942857142857,82.9857142857143,67.28,40.0971428571429,331,45,81,115,70,272,286,191
2020,6,65,"Kentpark",39.4167,29.9833,20.5142857142857,2.4,4.941,78.0857142857143,27.6214285714286,19.744,343,65,77,106,83,267,278,190
2020,7,65,"Kentpark",39.4167,29.9833,17.7,1.35714285714286,3.62757142857143,84.3714285714286,63.1514285714286,56.76,341,104,110,149,193,338,237,228
2020,8,65,"Kentpark",39.4167,29.9833,12.7285714285714,2.71428571428571,2.88471428571429,79.0571428571429,73.7385714285714,NA,283,42,20,121,71,187,241,167
2020,9,65,"Kentpark",39.4167,29.9833,21.8714285714286,5.75714285714286,2.742,67.1428571428571,64.69,NA,393,113,153,188,256,528,280,375
2020,10,65,"Kentpark",39.4167,29.9833,12.7285714285714,9.17142857142857,0.428428571428571,60.7428571428571,87.16,31.77,205,124,119,0,0,210,81,91
2020,11,65,"Kentpark",39.4167,29.9833,16.3714285714286,9.54285714285714,1.34242857142857,65.6714285714286,77.0614285714286,30.975,115,29,13,38,23,94,86,81
2020,12,65,"Kentpark",39.4167,29.9833,18.4285714285714,1.67142857142857,1.11385714285714,71.0285714285714,40.4728571428571,NA,117,16,10,96,103,118,101,108
2020,13,65,"Kentpark",39.4167,29.9833,17.0142857142857,7.82857142857143,0.857571428571428,79.8285714285714,54.8071428571429,36.545,136,0,0,48,47,92,136,92
2020,14,65,"Kentpark",39.4167,29.9833,19.0571428571429,7.57142857142857,1.58542857142857,78.3,68.5533333333333,35.245,155,38,20,62,45,121,117,101
2020,15,65,"Kentpark",39.4167,29.9833,15.9571428571429,8.04285714285714,0.115,64.7428571428571,56.6214285714286,30.5971428571429,133,0,0,130,118,118,133,118
2020,16,65,"Kentpark",39.4167,29.9833,12.5857142857143,11.2571428571429,0.142857142857143,54.7571428571429,39.64,30.3625,141,12,6,111,91,106,129,100
2020,17,65,"Kentpark",39.4167,29.9833,16.0571428571429,9.78571428571429,0.114285714285714,61.9857142857143,6.89428571428571,NA,137,1,1,114,106,123,136,122
2020,18,65,"Kentpark",39.4167,29.9833,11.8571428571429,12.6142857142857,1.94214285714286,65.0142857142857,20.33,33.73,146,23,18,92,112,164,123,146
2020,19,65,"Kentpark",39.4167,29.9833,13.7714285714286,10.9571428571429,4.28428571428571,71.7,29.7928571428571,30.2442857142857,137,0,0,105,117,157,137,157
2020,20,65,"Kentpark",39.4167,29.9833,10.5857142857143,20.2428571428571,0,49.4,57.432,40.2257142857143,164,0,0,76,67,164,164,164
2020,21,65,"Kentpark",39.4167,29.9833,16.5,17.1428571428571,1.92785714285714,58.1428571428571,17.73,31.32,146,0,0,93,77,96,146,96
2020,22,65,"Kentpark",39.4167,29.9833,12.9714285714286,11.7285714285714,3.94242857142857,75.7714285714286,27.81,32.7985714285714,118,0,0,66,62,100,118,100
2020,23,65,"Kentpark",39.4167,29.9833,11.8428571428571,15.6428571428571,1.44314285714286,66.7714285714286,36.7228571428571,37.8166666666667,112,26,12,58,31,70,86,58
2020,24,65,"Kentpark",39.4167,29.9833,12.4857142857143,18.2428571428571,3.37014285714286,69.6857142857143,48.3471428571429,29.352,140,0,0,60,63,150,140,150
2020,25,65,"Kentpark",39.4167,29.9833,15.6714285714286,18.5428571428571,5.49042857142857,71.8428571428571,45.8971428571429,24.2014285714286,137,19,5,32,25,108,118,103
2020,26,65,"Kentpark",39.4167,29.9833,13.7571428571429,18.5571428571429,1.887,75.1428571428571,40.0542857142857,22.6314285714286,173,0,0,116,89,133,173,133
2020,27,65,"Kentpark",39.4167,29.9833,13.7571428571429,22.8,2.14185714285714,58.8142857142857,47.3942857142857,25.89,113,0,0,107,110,113,113,113
2020,28,65,"Kentpark",39.4167,29.9833,18.7428571428571,22.0428571428571,0.114428571428571,67.1571428571429,42.6457142857143,22.7614285714286,164,0,0,107,79,122,164,122
2020,29,65,"Kentpark",39.4167,29.9833,17.9571428571429,20.3714285714286,0,69.6285714285714,41.0671428571429,20.1757142857143,186,0,0,146,88,111,186,111
2020,30,65,"Kentpark",39.4167,29.9833,17.9142857142857,22.1571428571429,0,60.2142857142857,45.9985714285714,23.4914285714286,190,0,0,169,128,142,190,142
2020,31,65,"Kentpark",39.4167,29.9833,18.0857142857143,22.9428571428571,0,54.1714285714286,37.6242857142857,19.6971428571429,150,0,0,147,116,127,150,127
2020,32,65,"Kentpark",39.4167,29.9833,18.5571428571429,23.8142857142857,0.457,57.1142857142857,44.5375,21.9925,146,0,0,136,105,107,146,107
2020,33,65,"Kentpark",39.4167,29.9833,17.5285714285714,20.7,1.34228571428571,59.9714285714286,40.4414285714286,23.0142857142857,183,0,0,166,79,83,183,83
2020,34,65,"Kentpark",39.4167,29.9833,14.9857142857143,20.7857142857143,0,60.1571428571429,44.6171428571429,24.5666666666667,197,0,0,173,74,97,197,97
2020,35,65,"Kentpark",39.4167,29.9833,15.3714285714286,22.7571428571429,0,51.3428571428571,52.5728571428571,33.3266666666667,164,2,2,75,68,157,162,155
2020,36,65,"Kentpark",39.4167,29.9833,17.2857142857143,22.7714285714286,0,54.7285714285714,44.5433333333333,NA,179,0,0,139,77,112,179,112
2020,37,65,"Kentpark",39.4167,29.9833,15.6,20.9142857142857,2.37042857142857,64.3142857142857,55.7142857142857,NA,193,0,0,165,79,91,193,91
2020,38,65,"Kentpark",39.4167,29.9833,16.3142857142857,19.7571428571429,0.114285714285714,68.8857142857143,56.62,NA,235,0,0,215,145,157,235,157
2020,39,65,"Kentpark",39.4167,29.9833,11.8714285714286,18.5857142857143,2.11342857142857,68.5714285714286,52.3266666666667,25.7525,220,3,3,79,33,129,217,126
2020,40,65,"Kentpark",39.4167,29.9833,11.0857142857143,16.6142857142857,0,58.3285714285714,59.66,32.3083333333333,187,0,0,59,58,154,187,154
2020,41,65,"Kentpark",39.4167,29.9833,11.1285714285714,17.6428571428571,1.00014285714286,59.4714285714286,73.7985714285714,31.09,182,5,3,30,18,127,177,124
2020,42,65,"Kentpark",39.4167,29.9833,9.57142857142857,15.6857142857143,0.714571428571429,62.4571428571429,66.1785714285714,32.0571428571429,177,66,47,13,2,111,111,64
2020,43,65,"Kentpark",39.4167,29.9833,10.0142857142857,13.3285714285714,0.400285714285714,78.8714285714286,79.2528571428571,33.1585714285714,194,27,11,48,38,161,167,150
2020,44,65,"Kentpark",39.4167,29.9833,6.68571428571429,11.6857142857143,0.671571428571428,72.7857142857143,53.874,34.47,255,63,75,100,68,233,192,158
2020,45,65,"Kentpark",39.4167,29.9833,10.7285714285714,7.72857142857143,0,76.9,57.31,28.1385714285714,156,0,0,110,76,103,156,103
2020,46,65,"Kentpark",39.4167,29.9833,9.7,6.94285714285714,0.571142857142857,77.7714285714286,74.2633333333333,33.6871428571429,208,53,44,81,32,109,155,65
2020,47,65,"Kentpark",39.4167,29.9833,7.7,4.07142857142857,0.0285714285714286,78.3714285714286,91.2414285714286,36.5171428571429,173,14,2,108,65,83,159,81
2020,48,65,"Kentpark",39.4167,29.9833,9.85714285714286,1.35714285714286,0,73.3285714285714,113.26,44.9371428571429,199,73,89,48,77,262,126,173
2020,49,65,"Kentpark",39.4167,29.9833,6.55714285714286,3.62857142857143,0,76.2,155.344,46.9471428571429,207,50,32,5,10,116,157,84
2020,50,65,"Kentpark",39.4167,29.9833,15.1857142857143,6.94285714285714,0.628428571428571,75.7,67.5842857142857,34.59,181,176,96,0,0,98,5,2
2020,51,65,"Kentpark",39.4167,29.9833,13.1857142857143,5.02857142857143,0.029,87.3571428571429,63.4471428571429,32.38,171,24,26,37,16,90,147,64
2020,52,65,"Kentpark",39.4167,29.9833,10.1714285714286,3.9,0,77.3285714285714,71.51,30.436,203,67,14,74,53,113,136,99
2020,53,65,"Kentpark",39.4167,29.9833,11.475,6.5,0.60025,78.325,60.62,NA,122,78,78,0,0,111,44,33
2017,1,66,"Malatya",38.3552,38.3095,12.7142857142857,1.81428571428571,0.342285714285714,78.7,45,NA,563,61,99,394,542,847,502,748
2017,2,66,"Malatya",38.3552,38.3095,12.0428571428571,0.214285714285714,0.665714285714286,74.1,39.5914285714286,NA,757,108,247,404,620,1214,649,967
2017,3,66,"Malatya",38.3552,38.3095,10.3571428571429,0.414285714285714,0,68.1571428571429,48.2,NA,762,151,343,170,211,1449,611,1106
2017,4,66,"Malatya",38.3552,38.3095,14.4,-1.74285714285714,0.401857142857143,68.8142857142857,31.5185714285714,NA,639,221,319,277,388,889,418,570
2017,5,66,"Malatya",38.3552,38.3095,17.2428571428571,-2.11428571428571,0.0481428571428571,55.8714285714286,34.9714285714286,NA,588,162,244,283,479,1163,426,919
2017,6,66,"Malatya",38.3552,38.3095,10.5,4.3,0.00128571428571429,68.6428571428571,54.84,NA,736,240,549,189,453,1519,496,970
2017,7,66,"Malatya",38.3552,38.3095,19.3285714285714,-0.871428571428571,0,46.6571428571429,28.2028571428571,NA,492,126,107,110,248,717,366,610
2017,8,66,"Malatya",38.3552,38.3095,14.6571428571429,6.07142857142857,0,52.4571428571429,50.75,NA,739,197,461,124,273,1747,542,1286
2017,9,66,"Malatya",38.3552,38.3095,14,9.37142857142857,0.746428571428571,60.1,50.4685714285714,NA,574,133,223,128,138,866,441,643
2017,10,66,"Malatya",38.3552,38.3095,20.3571428571429,10.2714285714286,1.04942857142857,59.2857142857143,35.77,NA,712,25,28,52,148,1043,687,1015
2017,11,66,"Malatya",38.3552,38.3095,19.7428571428571,5.91428571428571,5.18357142857143,72.2285714285714,22.59,NA,525,64,149,176,182,725,461,576
2017,12,66,"Malatya",38.3552,38.3095,18.1,9.01428571428571,0.168285714285714,52.8142857142857,30.4485714285714,NA,589,279,488,218,473,1077,310,589
2017,13,66,"Malatya",38.3552,38.3095,23.0857142857143,11.1428571428571,1.76185714285714,57.6714285714286,29.4114285714286,NA,574,77,135,186,242,887,497,752
2017,14,66,"Malatya",38.3552,38.3095,21.4428571428571,11,1.70142857142857,56.2571428571429,25.9157142857143,NA,639,189,507,121,204,1336,450,829
2017,15,66,"Malatya",38.3552,38.3095,16.5285714285714,10.5714285714286,3.27528571428571,66.4571428571429,25.3057142857143,NA,587,16,42,202,377,1187,571,1145
2017,16,66,"Malatya",38.3552,38.3095,27.8857142857143,15.5571428571429,1.19671428571429,57.3142857142857,52.66,NA,717,19,28,164,295,920,698,892
2017,17,66,"Malatya",38.3552,38.3095,20.5857142857143,15.0142857142857,0.104142857142857,36.7285714285714,32.2871428571429,NA,731,292,526,30,110,1478,439,952
2017,18,66,"Malatya",38.3552,38.3095,19.9285714285714,15.9142857142857,2.37114285714286,62.9571428571429,31.9214285714286,NA,506,73,104,133,209,923,433,819
2017,19,66,"Malatya",38.3552,38.3095,21.7,19.7571428571429,0.00257142857142857,44.9714285714286,37.0271428571429,NA,471,3,11,253,484,966,468,955
2017,20,66,"Malatya",38.3552,38.3095,26.5285714285714,18.0285714285714,0.379714285714286,47.4714285714286,20.6242857142857,NA,472,6,3,226,726,1205,466,1202
2017,21,66,"Malatya",38.3552,38.3095,21.3,16.1428571428571,2.97985714285714,58.3714285714286,18.3185714285714,NA,448,81,216,65,188,849,367,633
2017,22,66,"Malatya",38.3552,38.3095,17.1428571428571,20.4714285714286,0,38.8,17.5,NA,522,155,402,224,287,1015,367,613
2017,23,66,"Malatya",38.3552,38.3095,22,25.3428571428571,0.00257142857142857,30.3142857142857,26.1128571428571,NA,578,82,212,253,492,1388,496,1176
2017,24,66,"Malatya",38.3552,38.3095,21.1142857142857,23.4428571428571,0.00128571428571429,32.1428571428571,20.7542857142857,NA,552,60,150,201,493,1139,492,989
2017,25,66,"Malatya",38.3552,38.3095,21.5857142857143,23.7428571428571,0,33.6285714285714,16.5571428571429,NA,584,0,0,188,359,1041,584,1041
2017,26,66,"Malatya",38.3552,38.3095,18.2142857142857,29.6142857142857,0,21.9,22.125,NA,564,141,208,41,121,971,423,763
2017,27,66,"Malatya",38.3552,38.3095,18.4285714285714,28.8857142857143,0,25.0571428571429,28.5828571428571,NA,511,70,84,242,246,642,441,558
2017,28,66,"Malatya",38.3552,38.3095,15.5,28.8285714285714,0,17.9,25.0914285714286,NA,481,136,143,62,224,864,345,721
2017,29,66,"Malatya",38.3552,38.3095,24.0285714285714,30.4,0,22.1714285714286,37.17,NA,532,0,0,171,371,1272,532,1272
2017,30,66,"Malatya",38.3552,38.3095,21.6857142857143,29.1285714285714,0,23,35.7228571428571,NA,531,61,76,340,574,928,470,852
2017,31,66,"Malatya",38.3552,38.3095,18.4428571428571,30.5857142857143,0,20.3285714285714,34.72,NA,559,173,220,18,23,1047,386,827
2017,32,66,"Malatya",38.3552,38.3095,16.8714285714286,31.1857142857143,0,18.0571428571429,38.61,NA,567,327,530,0,0,1092,240,562
2017,33,66,"Malatya",38.3552,38.3095,17.3142857142857,30.2142857142857,0,24.7857142857143,34.07,NA,596,237,493,102,207,1199,359,706
2017,34,66,"Malatya",38.3552,38.3095,14.7,28.5857142857143,0,26.4571428571429,42.2485714285714,NA,601,243,493,95,184,1280,358,787
2017,35,66,"Malatya",38.3552,38.3095,15.9,26.7142857142857,0.026,28.1,46.4414285714286,NA,493,85,278,1,0,1014,408,736
2017,36,66,"Malatya",38.3552,38.3095,17.0142857142857,25.6857142857143,0,21.5285714285714,55.0457142857143,NA,507,354,918,91,231,1321,153,403
2017,37,66,"Malatya",38.3552,38.3095,11.4714285714286,27.0714285714286,0,17.9857142857143,87.2971428571429,NA,589,508,1057,0,0,1138,81,81
2017,38,66,"Malatya",38.3552,38.3095,15.5142857142857,26.0428571428571,0,25.1285714285714,98.0042857142857,NA,671,486,870,0,0,1312,185,442
2017,39,66,"Malatya",38.3552,38.3095,17.5428571428571,21.3285714285714,0.298428571428571,38.5571428571429,72.6985714285714,NA,782,313,641,224,467,1630,469,989
2017,40,66,"Malatya",38.3552,38.3095,18.7285714285714,16.0714285714286,0,36.8714285714286,42.4585714285714,NA,543,226,442,164,273,1137,317,695
2017,41,66,"Malatya",38.3552,38.3095,12.4714285714286,15.2142857142857,0.881285714285714,48.8142857142857,46.25,NA,487,189,312,142,312,843,298,531
2017,42,66,"Malatya",38.3552,38.3095,11.8142857142857,14.3857142857143,0,40.7857142857143,45.9457142857143,NA,530,265,403,142,214,815,265,412
2017,43,66,"Malatya",38.3552,38.3095,16.5142857142857,15.9857142857143,0.307857142857143,45.9,96.875,NA,506,216,271,69,78,919,290,648
2017,44,66,"Malatya",38.3552,38.3095,14.8857142857143,10.5857142857143,0.632714285714286,52.9571428571429,50.9928571428571,NA,561,258,415,69,207,1102,303,687
2017,45,66,"Malatya",38.3552,38.3095,10.0714285714286,10.3857142857143,0.323714285714286,65.2571428571429,136.555714285714,NA,577,266,519,28,65,829,311,310
2017,46,66,"Malatya",38.3552,38.3095,9.85714285714286,9.82857142857143,0.00628571428571429,62.2857142857143,118.34,NA,587,385,679,64,107,1085,202,406
2017,47,66,"Malatya",38.3552,38.3095,19.3714285714286,5.61428571428571,2.62728571428571,64.3857142857143,69,NA,418,145,378,204,300,804,273,426
2017,48,66,"Malatya",38.3552,38.3095,9.7,4.58571428571429,1.09114285714286,83.3714285714286,109.372857142857,NA,386,105,172,162,223,619,281,447
2017,49,66,"Malatya",38.3552,38.3095,14.2571428571429,2.78571428571429,0.212714285714286,73.6285714285714,74.4771428571429,NA,407,36,96,231,392,645,371,549
2017,50,66,"Malatya",38.3552,38.3095,9.31428571428571,1.81428571428571,0.0114285714285714,86.6428571428571,135.131428571429,NA,346,55,71,109,125,442,291,371
2017,51,66,"Malatya",38.3552,38.3095,11.9714285714286,6.4,0.616142857142857,85.6,194.095714285714,NA,386,81,90,191,161,349,305,259
2017,52,66,"Malatya",38.3552,38.3095,11.3,3.65,0.0045,75.1625,128.67125,NA,528,70,103,113,75,507,458,404
2018,1,66,"Malatya",38.3552,38.3095,12.675,4.375,0.953875,72.75,71.7357142857143,NA,618,253,428,206,206,914,365,486
2018,2,66,"Malatya",38.3552,38.3095,12.7571428571429,5.01428571428571,0.0168571428571429,62.8857142857143,87.6928571428571,NA,624,21,27,105,71,1309,603,1282
2018,3,66,"Malatya",38.3552,38.3095,11.9571428571429,3.08571428571429,9.68928571428571,75.3857142857143,57.6914285714286,NA,639,9,5,159,166,655,630,650
2018,4,66,"Malatya",38.3552,38.3095,12.5571428571429,4.37142857142857,3.39842857142857,77.5857142857143,99.8528571428571,NA,604,0,0,282,309,764,604,764
2018,5,66,"Malatya",38.3552,38.3095,12.6428571428571,3.31428571428571,0,66.1714285714286,77.8742857142857,NA,670,359,454,197,139,819,311,365
2018,6,66,"Malatya",38.3552,38.3095,11.5,6.25714285714286,0.0142857142857143,67.8285714285714,137.288571428571,NA,704,529,815,81,62,1022,175,207
2018,7,66,"Malatya",38.3552,38.3095,15.1714285714286,8.04285714285714,4.02142857142857,61.5571428571429,60.7685714285714,NA,478,154,153,30,40,557,324,404
2018,8,66,"Malatya",38.3552,38.3095,12.6571428571429,6.94285714285714,1.51528571428571,72.3428571428571,58.3142857142857,NA,711,310,601,3,8,1321,401,720
2018,9,66,"Malatya",38.3552,38.3095,18.8571428571429,7.22857142857143,0.613,68.8428571428571,60.6514285714286,NA,621,99,203,95,110,956,522,753
2018,10,66,"Malatya",38.3552,38.3095,16.2714285714286,9.91428571428571,0.391714285714286,65.8857142857143,87.82,NA,556,270,832,87,197,1330,286,498
2018,11,66,"Malatya",38.3552,38.3095,22.7428571428571,12.2714285714286,0.0792857142857143,51.3571428571429,39.92,NA,551,58,109,94,198,1426,493,1317
2018,12,66,"Malatya",38.3552,38.3095,22.6571428571429,15.1142857142857,0,41.8857142857143,113.748571428571,NA,425,58,108,162,332,1187,367,1079
2018,13,66,"Malatya",38.3552,38.3095,23.4285714285714,13.9142857142857,1.44257142857143,47.4142857142857,66.8042857142857,NA,356,117,98,109,106,428,239,330
2018,14,66,"Malatya",38.3552,38.3095,20.6857142857143,14.2285714285714,0,35.4428571428571,32.53,NA,407,172,301,17,28,486,235,185
2018,15,66,"Malatya",38.3552,38.3095,21.6571428571429,16.1142857142857,0.689142857142857,48.0857142857143,44.0585714285714,NA,374,32,20,154,165,450,342,430
2018,16,66,"Malatya",38.3552,38.3095,18.9571428571429,16.4285714285714,0.0254285714285714,29.0714285714286,35.0271428571429,NA,411,59,153,134,262,648,352,495
2018,17,66,"Malatya",38.3552,38.3095,16.9428571428571,19.2,0.193571428571429,35.8571428571429,44.2471428571429,NA,419,177,266,2,0,652,242,386
2018,18,66,"Malatya",38.3552,38.3095,20.1714285714286,17.8714285714286,2.496,61.9428571428571,47.9585714285714,NA,303,33,28,61,40,474,270,446
2018,19,66,"Malatya",38.3552,38.3095,17.5571428571429,14.5857142857143,5.91271428571429,75.2142857142857,37.0428571428571,NA,275,84,99,111,264,467,191,368
2018,20,66,"Malatya",38.3552,38.3095,22.0857142857143,20.3714285714286,0.390571428571429,42.3857142857143,29.9142857142857,NA,204,84,138,69,58,306,120,168
2018,21,66,"Malatya",38.3552,38.3095,21.6428571428571,21.8571428571429,0.152571428571429,45.9285714285714,59.7571428571429,NA,252,64,50,59,117,281,188,231
2018,22,66,"Malatya",38.3552,38.3095,22.1,19.1285714285714,0.917428571428571,61.6857142857143,44.8128571428571,NA,249,9,30,113,185,427,240,397
2018,23,66,"Malatya",38.3552,38.3095,19.4,23.4142857142857,0.730428571428572,40.1857142857143,35.0642857142857,NA,267,80,238,60,91,812,187,574
2018,24,66,"Malatya",38.3552,38.3095,22.9,23.2142857142857,0.897714285714286,45.9428571428571,49.1642857142857,NA,267,71,125,106,63,448,196,323
2018,25,66,"Malatya",38.3552,38.3095,20.2857142857143,24.1714285714286,0.026,42.4571428571429,29.7614285714286,NA,358,0,0,253,360,518,358,518
2018,26,66,"Malatya",38.3552,38.3095,17.3,29,0,27.9857142857143,39.04,NA,355,104,142,48,54,587,251,445
2018,27,66,"Malatya",38.3552,38.3095,22.6,28.4714285714286,0,26.3714285714286,36.6742857142857,NA,342,90,104,81,105,418,252,314
2018,28,66,"Malatya",38.3552,38.3095,19.6,30.0571428571429,0,26.8571428571429,50.12,NA,286,122,216,39,80,585,164,369
2018,29,66,"Malatya",38.3552,38.3095,24.6142857142857,27.6857142857143,0,27.2428571428571,32.3571428571429,NA,260,45,78,157,583,756,215,678
2018,30,66,"Malatya",38.3552,38.3095,17.5428571428571,29.4285714285714,0,24.1571428571429,59.9314285714286,NA,265,102,321,129,354,822,163,501
2018,31,66,"Malatya",38.3552,38.3095,20.0428571428571,30.1857142857143,0,27.3714285714286,46.6014285714286,NA,267,0,0,119,251,499,267,499
2018,32,66,"Malatya",38.3552,38.3095,20.3714285714286,27.9571428571429,0,28.4142857142857,43.2585714285714,NA,297,22,7,158,198,403,275,396
2018,33,66,"Malatya",38.3552,38.3095,21.3857142857143,27.7571428571429,0,24.3,40.1357142857143,NA,216,43,92,55,89,332,173,240
2018,34,66,"Malatya",38.3552,38.3095,13.6714285714286,28.8714285714286,0,24.9142857142857,42.5314285714286,NA,144,73,99,22,51,227,71,128
2018,35,66,"Malatya",38.3552,38.3095,19.8571428571429,29,0,22.7428571428571,54.11,NA,201,7,7,96,130,314,194,307
2018,36,66,"Malatya",38.3552,38.3095,18.2428571428571,25.7285714285714,0.266428571428571,29.1571428571429,45.8942857142857,NA,341,61,60,127,128,370,280,310
2018,37,66,"Malatya",38.3552,38.3095,20.6142857142857,23.1571428571429,0.863571428571429,40.9142857142857,50.6957142857143,NA,241,78,146,57,94,419,163,273
2018,38,66,"Malatya",38.3552,38.3095,22.3857142857143,23.4,0,29.7857142857143,31.3485714285714,NA,189,31,78,46,152,344,158,266
2018,39,66,"Malatya",38.3552,38.3095,14.6,21.9428571428571,0,31.2285714285714,41.81,NA,180,49,96,42,40,353,131,257
2018,40,66,"Malatya",38.3552,38.3095,15.2,19.6714285714286,0,36.3285714285714,40.08,NA,191,89,177,26,59,341,102,164
2018,41,66,"Malatya",38.3552,38.3095,13.8285714285714,17.5857142857143,0.640857142857143,59.7142857142857,87.8914285714286,NA,187,15,44,100,164,422,172,378
2018,42,66,"Malatya",38.3552,38.3095,12.1142857142857,17.2428571428571,1.04928571428571,64.2142857142857,160.688571428571,NA,168,0,0,108,115,381,168,381
2018,43,66,"Malatya",38.3552,38.3095,17.8714285714286,12.7142857142857,3.53114285714286,67.3142857142857,48.5657142857143,NA,187,21,15,47,146,402,166,387
2018,44,66,"Malatya",38.3552,38.3095,9.95714285714286,12.3428571428571,0.0857142857142857,58.6571428571429,58.7571428571429,NA,196,137,164,0,0,264,59,100
2018,45,66,"Malatya",38.3552,38.3095,8.4,11.2,0.437142857142857,70.9714285714286,53.7685714285714,NA,231,136,328,20,7,473,95,145
2018,46,66,"Malatya",38.3552,38.3095,13.1142857142857,5.81428571428571,1.15485714285714,66.8285714285714,47.5971428571429,NA,230,121,192,45,79,465,109,273
2018,47,66,"Malatya",38.3552,38.3095,9.38571428571429,7.55714285714286,0.441714285714286,80.4857142857143,116.114285714286,NA,270,122,220,34,68,499,148,279
2018,48,66,"Malatya",38.3552,38.3095,12.9142857142857,8.18571428571429,4.26628571428571,84.0285714285714,76.0328571428571,NA,245,29,5,120,147,201,216,196
2018,49,66,"Malatya",38.3552,38.3095,8.85714285714286,7.27142857142857,2.18185714285714,83.5285714285714,84.7916666666667,NA,257,64,51,123,183,420,193,369
2018,50,66,"Malatya",38.3552,38.3095,16.8,5.55714285714286,3.52857142857143,76.5571428571428,67.1557142857143,NA,256,20,6,94,107,305,236,299
2018,51,66,"Malatya",38.3552,38.3095,9.92857142857143,4.98571428571429,2.96514285714286,87.4857142857143,83.2428571428571,NA,250,81,47,92,120,248,169,201
2018,52,66,"Malatya",38.3552,38.3095,17.6428571428571,1.72857142857143,4.53357142857143,74.8285714285714,59.84,NA,244,7,15,183,168,273,237,258
2019,1,66,"Malatya",38.3552,38.3095,12.575,3.275,3.143375,82.9625,89.86,NA,343,0,0,124,263,784,343,784
2019,2,66,"Malatya",38.3552,38.3095,13.0714285714286,-1.34285714285714,2.52057142857143,75.8285714285714,54.61,NA,255,12,26,149,114,208,243,182
2019,3,66,"Malatya",38.3552,38.3095,19.0571428571429,0.985714285714286,4.226,65.6,68.5528571428571,NA,192,26,25,39,15,198,166,173
2019,4,66,"Malatya",38.3552,38.3095,13.4571428571429,3.81428571428571,0.0155714285714286,70.3,122.52,NA,308,0,0,179,194,314,308,314
2019,5,66,"Malatya",38.3552,38.3095,16.4857142857143,5.3,0.633428571428571,66.5857142857143,45.5325,NA,253,70,50,39,23,143,183,93
2019,6,66,"Malatya",38.3552,38.3095,9.67142857142857,3.07142857142857,5.78228571428571,79.1,68.4142857142857,NA,276,79,35,115,49,127,197,92
2019,7,66,"Malatya",38.3552,38.3095,11.8857142857143,5.04285714285714,0.544,70.8142857142857,58.986,NA,325,44,43,80,35,234,281,191
2019,8,66,"Malatya",38.3552,38.3095,17.8857142857143,6.21428571428571,0.168714285714286,58.9714285714286,48.845,NA,305,123,83,172,134,219,182,136
2019,9,66,"Malatya",38.3552,38.3095,17.2,5.3,1.184,62.3571428571429,60.07,NA,331,150,127,137,45,310,181,183
2019,10,66,"Malatya",38.3552,38.3095,15.4285714285714,7.31428571428571,0.451428571428571,56.7,29.6975,NA,359,159,81,91,80,252,200,171
2019,11,66,"Malatya",38.3552,38.3095,23.3571428571429,9.3,2.15485714285714,63.3142857142857,NA,NA,373,62,99,26,40,400,311,301
2019,12,66,"Malatya",38.3552,38.3095,17.5857142857143,9.32857142857143,0.0431428571428571,44.3857142857143,NA,NA,343,181,313,41,33,416,162,103
2019,13,66,"Malatya",38.3552,38.3095,15.6571428571429,8.25714285714286,4.65657142857143,72.5428571428571,NA,NA,256,78,42,51,100,194,178,152
2019,14,66,"Malatya",38.3552,38.3095,15.9142857142857,10.2428571428571,1.20385714285714,71.2,41.255,NA,365,96,41,176,96,208,269,167
2019,15,66,"Malatya",38.3552,38.3095,17.3428571428571,12.8857142857143,1.94885714285714,63.7285714285714,NA,NA,359,112,55,48,19,183,247,128
2019,16,66,"Malatya",38.3552,38.3095,16.5,9.02857142857143,4.63657142857143,69,16.53,NA,318,0,0,210,121,208,318,208
2019,17,66,"Malatya",38.3552,38.3095,17.3142857142857,12.2571428571429,0.428571428571429,49.7571428571429,18.895,NA,412,118,52,147,97,313,294,261
2019,18,66,"Malatya",38.3552,38.3095,21.1857142857143,15.8428571428571,1.52771428571429,57.9285714285714,NA,NA,523,148,68,78,24,353,375,285
2019,19,66,"Malatya",38.3552,38.3095,21.9857142857143,16.9,0.189714285714286,47.9428571428571,43.18,NA,452,15,11,67,62,386,437,375
2019,20,66,"Malatya",38.3552,38.3095,18.2,21.6428571428571,0,38.4285714285714,55.4671428571429,NA,454,338,263,13,4,389,116,126
2019,21,66,"Malatya",38.3552,38.3095,24.2142857142857,23.0857142857143,0,35.8142857142857,56.772,NA,457,70,30,319,328,413,387,383
2019,22,66,"Malatya",38.3552,38.3095,16.5571428571429,24.2428571428571,0.390571428571429,37.9571428571429,61.8271428571429,NA,453,261,121,0,0,323,192,202
2019,23,66,"Malatya",38.3552,38.3095,21.1714285714286,26.4857142857143,0,27.9285714285714,64.6828571428571,NA,378,165,342,0,0,532,213,190
2019,24,66,"Malatya",38.3552,38.3095,21.4428571428571,23.8857142857143,1.13271428571429,44.7857142857143,53.0314285714286,NA,378,55,51,53,16,244,323,193
2019,25,66,"Malatya",38.3552,38.3095,18.2571428571429,23.5714285714286,1.40642857142857,53.0714285714286,47.9542857142857,NA,306,135,59,37,80,325,171,266
2019,26,66,"Malatya",38.3552,38.3095,20.7,27.3285714285714,0,35.2,46.6428571428571,NA,377,146,74,114,169,342,231,268
2019,27,66,"Malatya",38.3552,38.3095,16.8571428571429,25.8857142857143,0,30.9428571428571,42.4728571428571,NA,456,242,139,87,27,222,214,83
2019,28,66,"Malatya",38.3552,38.3095,22.5857142857143,26.2285714285714,0.00514285714285714,33.3142857142857,44.075,NA,398,2,3,132,228,421,396,418
2019,29,66,"Malatya",38.3552,38.3095,20.6571428571429,25.8857142857143,0,37.7285714285714,47.3628571428571,NA,453,3,3,275,142,203,450,200
2019,30,66,"Malatya",38.3552,38.3095,15.7142857142857,27.1285714285714,0.00257142857142857,33.7,43.2557142857143,NA,456,71,61,183,148,335,385,274
2019,31,66,"Malatya",38.3552,38.3095,19.9,29.6428571428571,0,26.4857142857143,53.6285714285714,NA,334,56,62,140,173,375,278,313
2019,32,66,"Malatya",38.3552,38.3095,17.4142857142857,26.5571428571429,0,30.3714285714286,45.1857142857143,NA,346,17,13,172,185,395,329,382
2019,33,66,"Malatya",38.3552,38.3095,18.1428571428571,29.0714285714286,0,30.3142857142857,59.3285714285714,NA,337,187,277,46,81,531,150,254
2019,34,66,"Malatya",38.3552,38.3095,17.5571428571429,26.0285714285714,0.0361428571428571,41.5142857142857,51.9585714285714,NA,299,79,121,170,152,345,220,224
2019,35,66,"Malatya",38.3552,38.3095,17.2714285714286,25.4857142857143,0.635428571428572,43.5,57.2157142857143,NA,307,192,200,0,0,415,115,215
2019,36,66,"Malatya",38.3552,38.3095,19,24.0142857142857,0,30.1,36.3257142857143,NA,171,20,7,97,45,67,151,60
2019,37,66,"Malatya",38.3552,38.3095,13.3,22.5285714285714,0.130142857142857,38.8428571428571,41.1742857142857,NA,218,62,8,38,11,55,156,47
2019,38,66,"Malatya",38.3552,38.3095,18.5714285714286,19.9857142857143,0.371428571428571,45.3285714285714,52.4914285714286,NA,266,116,25,7,14,91,150,66
2019,39,66,"Malatya",38.3552,38.3095,15.6428571428571,20.0142857142857,0,39.1571428571429,49.3857142857143,NA,237,56,38,1,0,79,181,41
2019,40,66,"Malatya",38.3552,38.3095,15.1857142857143,20.3571428571429,0,37.6285714285714,68.6557142857143,NA,241,108,80,66,16,111,133,31
2019,41,66,"Malatya",38.3552,38.3095,13.7714285714286,19.4428571428571,0,43.2714285714286,60.8028571428571,NA,416,216,276,0,0,448,200,172
2019,42,66,"Malatya",38.3552,38.3095,13.6714285714286,17.5428571428571,0.301,54.9714285714286,68.5085714285714,NA,356,198,218,9,10,408,158,190
2019,43,66,"Malatya",38.3552,38.3095,10.2,13.4857142857143,1.21228571428571,79.5714285714286,65.9814285714286,NA,306,143,130,8,34,300,163,170
2019,44,66,"Malatya",38.3552,38.3095,12.0142857142857,10.7285714285714,1.946,72.8285714285714,56.0685714285714,NA,350,119,70,56,61,250,231,180
2019,45,66,"Malatya",38.3552,38.3095,8.08571428571429,8.71428571428571,0,71.5142857142857,90.4942857142857,NA,417,226,217,0,0,328,191,111
2019,46,66,"Malatya",38.3552,38.3095,7.97142857142857,8.51428571428571,0,64.9428571428571,109.351428571429,NA,401,122,138,0,0,337,279,199
2019,47,66,"Malatya",38.3552,38.3095,9.4,5.42857142857143,0,57.4857142857143,103.737142857143,NA,391,168,203,0,0,339,223,136
2019,48,66,"Malatya",38.3552,38.3095,9.9,7.2,1.12142857142857,78.7,125.325714285714,NA,320,166,157,64,29,251,154,94
2019,49,66,"Malatya",38.3552,38.3095,11.5571428571429,2.67142857142857,7.17685714285714,83.5285714285714,69.7371428571429,NA,393,167,107,57,48,274,226,167
2019,50,66,"Malatya",38.3552,38.3095,8.97142857142857,4.61428571428571,2.43614285714286,89.9571428571429,109.332857142857,NA,218,29,29,152,79,119,189,90
2019,51,66,"Malatya",38.3552,38.3095,9,3.78571428571429,0,82.5714285714286,112.607142857143,NA,361,146,234,103,194,488,215,254
2019,52,66,"Malatya",38.3552,38.3095,15.0285714285714,4.82857142857143,3.88871428571429,84.0714285714286,83.2685714285714,NA,279,77,33,95,64,281,202,248
2020,1,66,"Malatya",38.3552,38.3095,10.42,2.98,3.5504,89.4,56.276,NA,160,8,12,75,47,126,152,114
2020,2,66,"Malatya",38.3552,38.3095,15.1,3.02857142857143,1.68414285714286,76.4571428571429,49.3214285714286,NA,240,42,36,122,86,173,198,137
2020,3,66,"Malatya",38.3552,38.3095,11.3857142857143,0.842857142857143,0.116142857142857,72.5428571428571,66.4871428571429,NA,270,155,277,85,94,382,115,105
2020,4,66,"Malatya",38.3552,38.3095,15.6142857142857,0.5,0.478571428571429,62.3142857142857,48.1214285714286,NA,358,59,18,106,55,295,299,277
2020,5,66,"Malatya",38.3552,38.3095,17.0142857142857,2.58571428571429,3.47642857142857,74.1285714285714,80.0285714285714,NA,331,157,133,111,105,272,174,139
2020,6,66,"Malatya",38.3552,38.3095,30.3428571428571,3.55714285714286,0.736142857142857,68.3142857142857,54.52,NA,343,16,5,52,20,267,327,262
2020,7,66,"Malatya",38.3552,38.3095,11.5285714285714,-4.25714285714286,2.54042857142857,76.2285714285714,74.6428571428571,NA,341,0,0,74,39,338,341,338
2020,8,66,"Malatya",38.3552,38.3095,9.87142857142857,2.94285714285714,1.88442857142857,87.0142857142857,119.271428571429,NA,283,4,1,72,22,187,279,186
2020,9,66,"Malatya",38.3552,38.3095,19.9285714285714,6.87142857142857,1.01914285714286,63.6428571428571,61.9,NA,393,8,3,110,96,528,385,525
2020,10,66,"Malatya",38.3552,38.3095,12.7285714285714,8.71428571428572,0.987285714285714,59.7142857142857,69.6828571428571,NA,205,140,116,0,0,210,65,94
2020,11,66,"Malatya",38.3552,38.3095,18.5571428571429,12.5,4.74285714285714,64.9,90.7457142857143,NA,115,41,31,4,2,94,74,63
2020,12,66,"Malatya",38.3552,38.3095,17.5857142857143,6.28571428571429,6.341,74.6714285714286,41.23,NA,117,18,17,45,24,118,99,101
2020,13,66,"Malatya",38.3552,38.3095,17.6428571428571,9.58571428571429,4.25171428571429,76.2857142857143,47.0585714285714,NA,136,63,62,8,3,92,73,30
2020,14,66,"Malatya",38.3552,38.3095,20.5428571428571,9.02857142857143,3.48885714285714,70.7142857142857,48.5257142857143,NA,155,28,34,62,34,121,127,87
2020,15,66,"Malatya",38.3552,38.3095,19.1,11.5142857142857,2.00242857142857,60.7428571428571,46.2942857142857,NA,133,31,6,57,26,118,102,112
2020,16,66,"Malatya",38.3552,38.3095,20.1,14.1142857142857,0.0571428571428571,52.5857142857143,43.5328571428571,NA,141,74,59,3,4,106,67,47
2020,17,66,"Malatya",38.3552,38.3095,17.7428571428571,14.1571428571429,0.0532857142857143,49.3571428571429,46.2757142857143,NA,137,15,6,42,48,123,122,117
2020,18,66,"Malatya",38.3552,38.3095,30.7857142857143,14.6857142857143,1.568,59.5857142857143,43.4714285714286,NA,146,12,6,37,21,164,134,158
2020,19,66,"Malatya",38.3552,38.3095,23.5571428571429,14.9285714285714,1.37957142857143,57.2857142857143,51.392,NA,137,12,23,65,82,157,125,134
2020,20,66,"Malatya",38.3552,38.3095,17.7571428571429,21.4,0,40.7,73.2275,NA,164,41,16,34,32,164,123,148
2020,21,66,"Malatya",38.3552,38.3095,24.6428571428571,21.3,1.45771428571429,39.5428571428571,69.0271428571428,NA,146,29,6,35,21,96,117,90
2020,22,66,"Malatya",38.3552,38.3095,21.6285714285714,18.1714285714286,1.55285714285714,50.6,38.54,NA,118,42,25,10,11,100,76,75
2020,23,66,"Malatya",38.3552,38.3095,22.1857142857143,20.9571428571429,0.013,40.2285714285714,43.7314285714286,NA,112,38,14,14,1,70,74,56
2020,24,66,"Malatya",38.3552,38.3095,23.9142857142857,22.2571428571429,1.17157142857143,46.0285714285714,60.9342857142857,NA,140,39,55,0,0,150,101,95
2020,25,66,"Malatya",38.3552,38.3095,18.6571428571429,23.2285714285714,0.527142857142857,42,49.4885714285714,NA,137,0,0,63,61,108,137,108
2020,26,66,"Malatya",38.3552,38.3095,15.7285714285714,25.7714285714286,0,36.9285714285714,52.85,NA,173,7,8,62,64,133,166,125
2020,27,66,"Malatya",38.3552,38.3095,15.7714285714286,27.1,0,34.1285714285714,51.4242857142857,NA,113,15,30,53,26,113,98,83
2020,28,66,"Malatya",38.3552,38.3095,21.6571428571429,27.9428571428571,0.00128571428571429,37.5285714285714,51.1514285714286,NA,164,45,35,25,40,122,119,87
2020,29,66,"Malatya",38.3552,38.3095,16.3714285714286,28.4285714285714,0,31.4857142857143,55.0485714285714,NA,186,89,56,34,23,111,97,55
2020,30,66,"Malatya",38.3552,38.3095,18.4714285714286,29.0857142857143,0,33.6571428571429,69.8857142857143,NA,190,78,34,30,67,142,112,108
2020,31,66,"Malatya",38.3552,38.3095,22.6,29.1142857142857,0.0177142857142857,30.2857142857143,59.4471428571429,NA,150,10,4,32,25,127,140,123
2020,32,66,"Malatya",38.3552,38.3095,15.0285714285714,27.6,0,27.5,46.2628571428571,NA,146,24,7,57,38,107,122,100
2020,33,66,"Malatya",38.3552,38.3095,21,26.1428571428571,0,33.9571428571429,48.8971428571429,NA,183,21,7,105,60,83,162,76
2020,34,66,"Malatya",38.3552,38.3095,19.4428571428571,24.8,0.00257142857142857,32.9,54.7271428571429,NA,197,94,61,64,22,97,103,36
2020,35,66,"Malatya",38.3552,38.3095,10.9285714285714,24.4285714285714,0,30.7428571428571,52.2871428571429,NA,164,119,94,0,0,157,45,63
2020,36,66,"Malatya",38.3552,38.3095,19.7,27.3,0,30.1142857142857,84.7585714285714,NA,179,76,30,23,4,112,103,82
2020,37,66,"Malatya",38.3552,38.3095,15.5142857142857,25.0285714285714,0,37.4571428571429,71.19,NA,193,61,19,39,22,91,132,72
2020,38,66,"Malatya",38.3552,38.3095,12.8428571428571,24.7,0,31.6,69.5814285714286,NA,235,122,88,18,11,157,113,69
2020,39,66,"Malatya",38.3552,38.3095,12.2714285714286,22.5285714285714,0.142857142857143,45.2857142857143,72.3928571428571,NA,220,148,70,0,0,129,72,59
2020,40,66,"Malatya",38.3552,38.3095,15.8285714285714,21.8142857142857,0,40.0571428571429,75.3142857142857,NA,187,37,45,95,55,154,150,109
2020,41,66,"Malatya",38.3552,38.3095,12.0428571428571,17.4428571428571,0,33.7285714285714,56.85,NA,182,101,59,18,11,127,81,68
2020,42,66,"Malatya",38.3552,38.3095,8.97142857142857,17.2142857142857,0,42.7857142857143,113.144285714286,NA,177,141,91,0,0,111,36,20
2020,43,66,"Malatya",38.3552,38.3095,9.6,16.0428571428571,0,54.4428571428571,91.6514285714286,NA,194,155,113,0,0,161,39,48
2020,44,66,"Malatya",38.3552,38.3095,15.1571428571429,16.7857142857143,0,41.6428571428571,129.131428571429,NA,255,128,119,22,16,233,127,114
2020,45,66,"Malatya",38.3552,38.3095,14.5571428571429,11.9428571428571,5.75971428571429,75,60.3042857142857,NA,156,37,20,28,6,103,119,83
2020,46,66,"Malatya",38.3552,38.3095,8.11428571428571,7.64285714285714,0,73.2285714285714,69.0914285714286,NA,208,96,55,40,21,109,112,54
2020,47,66,"Malatya",38.3552,38.3095,10.4714285714286,5.85714285714286,1.18342857142857,75.1571428571429,74.3028571428571,NA,173,52,22,24,11,83,121,61
2020,48,66,"Malatya",38.3552,38.3095,10.4285714285714,4.17142857142857,0.0355714285714286,70.6571428571429,86.78,NA,199,83,61,31,60,262,116,201
2020,49,66,"Malatya",38.3552,38.3095,8.68571428571429,5.58571428571429,2.17814285714286,81.8857142857143,88.9671428571429,NA,207,73,58,67,38,116,134,58
2020,50,66,"Malatya",38.3552,38.3095,8.52857142857143,4.01428571428571,0.998,84.9142857142857,106.691428571429,NA,181,17,2,87,58,98,164,96
2020,51,66,"Malatya",38.3552,38.3095,10.4857142857143,5,1.98514285714286,83.0285714285714,75.6642857142857,NA,171,60,37,44,20,90,111,53
2020,52,66,"Malatya",38.3552,38.3095,15.2142857142857,0.485714285714286,0.180285714285714,73.3428571428571,90.7614285714286,NA,203,0,0,124,41,113,203,113
2020,53,66,"Malatya",38.3552,38.3095,8.775,-1.525,0,96.25,141.4475,NA,122,0,0,34,20,111,122,111
2017,1,67,"Soma",39.1852,27.6094,13.4857142857143,2.72857142857143,14.6771428571429,81.6142857142857,98.69,70.2342857142857,563,143,203,30,53,847,420,644
2017,2,67,"Soma",39.1852,27.6094,14.2142857142857,3.42857142857143,9.58857142857143,81.0571428571428,88.0285714285714,84.92,757,0,0,309,479,1214,757,1214
2017,3,67,"Soma",39.1852,27.6094,15.3285714285714,6.24285714285714,6.65714285714286,83.2428571428571,75.3142857142857,79.2771428571429,762,0,0,1,0,1449,762,1449
2017,4,67,"Soma",39.1852,27.6094,19.1,1.81428571428571,1.28357142857143,74.8,119.462857142857,86.5357142857143,639,0,0,155,343,889,639,889
2017,5,67,"Soma",39.1852,27.6094,11.9285714285714,4.51428571428571,0.152285714285714,71.9285714285714,139.318571428571,94.6642857142857,588,81,145,182,323,1163,507,1018
2017,6,67,"Soma",39.1852,27.6094,20.3714285714286,8.57142857142857,2.23514285714286,70.7142857142857,81.6142857142857,63.5042857142857,736,245,370,107,299,1519,491,1149
2017,7,67,"Soma",39.1852,27.6094,15.4,4.35714285714286,0.106857142857143,62.8428571428571,110.055714285714,90.1942857142857,492,0,0,59,136,717,492,717
2017,8,67,"Soma",39.1852,27.6094,11.9,10.9857142857143,2.55357142857143,77.9428571428571,105.415714285714,88.0771428571429,739,0,0,301,662,1747,739,1747
2017,9,67,"Soma",39.1852,27.6094,8.52857142857143,11.5,0.488857142857143,76.1,123.825,86.5842857142857,574,0,0,507,766,866,574,866
2017,10,67,"Soma",39.1852,27.6094,13.9857142857143,11.2714285714286,5.419,79.4285714285714,NA,87.52,712,0,0,290,409,1043,712,1043
2017,11,67,"Soma",39.1852,27.6094,9.95714285714286,7.24285714285714,1.19328571428571,76.0285714285714,NA,NA,525,0,0,350,483,725,525,725
2017,12,67,"Soma",39.1852,27.6094,11.1714285714286,13.2571428571429,0.0312857142857143,64.3714285714286,111.19,NA,589,0,0,464,987,1077,589,1077
2017,13,67,"Soma",39.1852,27.6094,18.5,12.1714285714286,0.209571428571429,60.1,NA,NA,574,0,0,295,515,887,574,887
2017,14,67,"Soma",39.1852,27.6094,11.1571428571429,13.4285714285714,1.88528571428571,66.2428571428571,NA,NA,639,0,0,617,1298,1336,639,1336
2017,15,67,"Soma",39.1852,27.6094,12.6571428571429,14.4,0,55.0857142857143,NA,NA,587,0,0,420,646,1187,587,1187
2017,16,67,"Soma",39.1852,27.6094,15.4571428571429,13.1571428571429,2.14485714285714,67.7857142857143,55.085,20.14,717,1,0,258,360,920,716,920
2017,17,67,"Soma",39.1852,27.6094,9.61428571428571,15.9857142857143,0,54.1142857142857,NA,28.23,731,0,0,625,1258,1478,731,1478
2017,18,67,"Soma",39.1852,27.6094,14.7428571428571,19.0428571428571,0.180714285714286,61.0857142857143,NA,NA,506,0,0,425,788,923,506,923
2017,19,67,"Soma",39.1852,27.6094,14.2857142857143,20.1714285714286,0.0618571428571429,58.2,NA,NA,471,0,0,229,464,966,471,966
2017,20,67,"Soma",39.1852,27.6094,19.1,17.4,1.834,63.3714285714286,NA,NA,472,0,0,97,139,1205,472,1205
2017,21,67,"Soma",39.1852,27.6094,16.2571428571429,18.0857142857143,2.09442857142857,65.6285714285714,NA,NA,448,0,0,291,591,849,448,849
2017,22,67,"Soma",39.1852,27.6094,11.0714285714286,20.7714285714286,1.67485714285714,70.9142857142857,70.3866666666667,25.425,522,0,0,279,489,1015,522,1015
2017,23,67,"Soma",39.1852,27.6094,12.3857142857143,22.2571428571429,0.812142857142857,68.7857142857143,48.49,17.9442857142857,578,0,0,556,1368,1388,578,1388
2017,24,67,"Soma",39.1852,27.6094,14.8428571428571,23.1857142857143,0.474428571428571,57.5571428571429,47.3971428571429,16.6257142857143,552,0,0,435,1004,1139,552,1139
2017,25,67,"Soma",39.1852,27.6094,15.2428571428571,24.1714285714286,0.004,54.1857142857143,52.5942857142857,21.3528571428571,584,0,0,527,960,1041,584,1041
2017,26,67,"Soma",39.1852,27.6094,13.4857142857143,29.1714285714286,0,46.5428571428571,54.734,21.39,564,0,0,564,971,971,564,971
2017,27,67,"Soma",39.1852,27.6094,21.2571428571429,25.8142857142857,0,50.3714285714286,NA,NA,511,0,0,162,189,642,511,642
2017,28,67,"Soma",39.1852,27.6094,20.2142857142857,27.7714285714286,0,48.3285714285714,NA,NA,481,0,0,190,478,864,481,864
2017,29,67,"Soma",39.1852,27.6094,23.3285714285714,25.2,0.306714285714286,59.2714285714286,46.025,8.265,532,0,0,321,747,1272,532,1272
2017,30,67,"Soma",39.1852,27.6094,17.4428571428571,26.0714285714286,0.802857142857143,52.0571428571429,63.9185714285714,26.8671428571429,531,0,0,281,471,928,531,928
2017,31,67,"Soma",39.1852,27.6094,22.2857142857143,27.4571428571429,0,53.9714285714286,53.43,21.7771428571429,559,0,0,32,138,1047,559,1047
2017,32,67,"Soma",39.1852,27.6094,22.2,28.2285714285714,0.314428571428571,56.7714285714286,62.7928571428571,19.3733333333333,567,0,0,144,291,1092,567,1092
2017,33,67,"Soma",39.1852,27.6094,19,26.7857142857143,0.0111428571428571,56.3714285714286,52.5471428571429,17.5575,596,0,0,144,404,1199,596,1199
2017,34,67,"Soma",39.1852,27.6094,19.2285714285714,24.0714285714286,0.485142857142857,58.9142857142857,44.9185714285714,20.7785714285714,601,0,0,235,765,1280,601,1280
2017,35,67,"Soma",39.1852,27.6094,17.1571428571429,23.8,0,50.4714285714286,37.3757142857143,19.4,493,0,0,235,447,1014,493,1014
2017,36,67,"Soma",39.1852,27.6094,12.7,22.8142857142857,0.00214285714285714,48.5714285714286,64.9528571428571,34.5285714285714,507,0,0,410,1098,1321,507,1321
2017,37,67,"Soma",39.1852,27.6094,13.5285714285714,25.1714285714286,0,53.2285714285714,74.2342857142857,28.6214285714286,589,0,0,412,836,1138,589,1138
2017,38,67,"Soma",39.1852,27.6094,14.5571428571429,22.4857142857143,0.0117142857142857,48.1714285714286,71.4414285714286,33.4671428571429,671,0,0,415,889,1312,671,1312
2017,39,67,"Soma",39.1852,27.6094,15.7857142857143,19.8142857142857,0.380285714285714,63.7714285714286,48.5957142857143,30.725,782,0,0,255,514,1630,782,1630
2017,40,67,"Soma",39.1852,27.6094,15,17.7714285714286,0.713142857142857,58.9857142857143,47.5228571428571,22.5,543,11,10,289,621,1137,532,1127
2017,41,67,"Soma",39.1852,27.6094,16.2857142857143,16,0,53.0428571428571,48.6128571428571,32.8566666666667,487,0,0,257,358,843,487,843
2017,42,67,"Soma",39.1852,27.6094,10.9,17.3428571428571,0,57.4142857142857,70.5816666666667,12.07,530,0,0,435,697,815,530,815
2017,43,67,"Soma",39.1852,27.6094,10.9285714285714,14.9857142857143,4.68857142857143,74.5142857142857,77.98,12.1542857142857,506,83,54,262,648,919,423,865
2017,44,67,"Soma",39.1852,27.6094,12.9857142857143,10.6857142857143,0.0222857142857143,62.3,88.6428571428571,38.5028571428571,561,0,0,177,340,1102,561,1102
2017,45,67,"Soma",39.1852,27.6094,6.74285714285714,11.7571428571429,0.0405714285714286,73.6857142857143,128.252857142857,53.6942857142857,577,0,0,518,782,829,577,829
2017,46,67,"Soma",39.1852,27.6094,8.37142857142857,13.9142857142857,2.07814285714286,75.9285714285714,139.225714285714,50.4814285714286,587,0,0,338,681,1085,587,1085
2017,47,67,"Soma",39.1852,27.6094,7.67142857142857,7.64285714285714,2.197,79.3857142857143,99.6042857142857,43.81,418,0,0,303,554,804,418,804
2017,48,67,"Soma",39.1852,27.6094,12.4,12.2714285714286,4.13042857142857,78.7,65.4385714285714,33.1128571428571,386,100,149,184,320,619,286,470
2017,49,67,"Soma",39.1852,27.6094,14.3571428571429,7.94285714285714,2.61285714285714,75.6714285714286,87.6014285714286,40.2442857142857,407,94,119,101,114,645,313,526
2017,50,67,"Soma",39.1852,27.6094,10.2857142857143,11.4142857142857,1.90271428571429,81.7,114.561428571429,40.3571428571429,346,92,106,174,258,442,254,336
2017,51,67,"Soma",39.1852,27.6094,17.6857142857143,6.9,5.27371428571429,78.6,51.1985714285714,33.8214285714286,386,0,0,127,120,349,386,349
2017,52,67,"Soma",39.1852,27.6094,10.1,6.9875,3.82325,81.1125,91.0475,47.2125,528,134,139,207,247,507,394,368
2018,1,67,"Soma",39.1852,27.6094,9.1375,6.1375,1.42,85,122.72125,46.6514285714286,618,0,0,325,472,914,618,914
2018,2,67,"Soma",39.1852,27.6094,10.2142857142857,7.92857142857143,2.63114285714286,89.5142857142857,118.575714285714,43.6157142857143,624,0,0,100,206,1309,624,1309
2018,3,67,"Soma",39.1852,27.6094,12.9571428571429,7.22857142857143,3.24771428571429,78.6142857142857,82.58,40.4057142857143,639,87,60,235,147,655,552,595
2018,4,67,"Soma",39.1852,27.6094,20.1857142857143,4.78571428571429,1.24328571428571,66.4571428571429,54.9428571428571,27.7966666666667,604,0,0,132,141,764,604,764
2018,5,67,"Soma",39.1852,27.6094,11.0571428571429,9.27142857142857,0.314,73.7857142857143,137.595714285714,26.6228571428571,670,217,349,319,227,819,453,470
2018,6,67,"Soma",39.1852,27.6094,12.2428571428571,10.3571428571429,4.57642857142857,80.5857142857143,108.865714285714,5.58142857142857,704,0,0,237,280,1022,704,1022
2018,7,67,"Soma",39.1852,27.6094,14.3428571428571,8.88571428571429,2.31814285714286,79.8714285714286,70.8014285714286,2.78857142857143,478,48,79,211,234,557,430,478
2018,8,67,"Soma",39.1852,27.6094,14.1285714285714,9.01428571428571,3.08314285714286,82.2428571428571,87.5314285714286,2.99,711,0,0,225,252,1321,711,1321
2018,9,67,"Soma",39.1852,27.6094,16.5142857142857,9.75714285714286,6.44614285714286,76.4142857142857,86.8142857142857,NA,621,35,59,183,264,956,586,897
2018,10,67,"Soma",39.1852,27.6094,12.8142857142857,13.5428571428571,0.689714285714286,74.0428571428571,101.945714285714,NA,556,3,9,179,359,1330,553,1321
2018,11,67,"Soma",39.1852,27.6094,12.6857142857143,13.3428571428571,2.40142857142857,72.8,91.8728571428571,NA,551,0,0,167,725,1426,551,1426
2018,12,67,"Soma",39.1852,27.6094,13.7428571428571,13.5285714285714,3.38857142857143,68.7428571428571,79.7085714285714,NA,425,1,0,1,0,1187,424,1187
2018,13,67,"Soma",39.1852,27.6094,13.7,13.1857142857143,0.434571428571429,67.7142857142857,130.224285714286,NA,356,53,53,156,208,428,303,375
2018,14,67,"Soma",39.1852,27.6094,11.7142857142857,14.0714285714286,1.49942857142857,65.7571428571429,90.5057142857143,NA,407,0,0,298,236,486,407,486
2018,15,67,"Soma",39.1852,27.6094,10.2285714285714,17.2428571428571,0,69.9428571428571,104.32,NA,374,0,0,332,433,450,374,450
2018,16,67,"Soma",39.1852,27.6094,15.1428571428571,16.7571428571429,0.0348571428571429,58.3571428571429,73.2357142857143,NA,411,0,0,246,315,648,411,648
2018,17,67,"Soma",39.1852,27.6094,11.4714285714286,20.2,0.103428571428571,53.8142857142857,77.4725,24.19,419,0,0,383,602,652,419,652
2018,18,67,"Soma",39.1852,27.6094,10.6428571428571,21.1,1.64285714285714,60.9285714285714,69.4585714285714,22,303,0,0,297,388,474,303,474
2018,19,67,"Soma",39.1852,27.6094,12.5142857142857,18.8142857142857,0.761571428571429,67.2428571428571,51.0157142857143,NA,275,0,0,229,376,467,275,467
2018,20,67,"Soma",39.1852,27.6094,10.8428571428571,22.9857142857143,0.00214285714285714,51.0142857142857,62.94,NA,204,0,0,101,157,306,204,306
2018,21,67,"Soma",39.1852,27.6094,15.8,22.5,0.881142857142857,65.0428571428571,52.2985714285714,NA,252,0,0,170,191,281,252,281
2018,22,67,"Soma",39.1852,27.6094,17.5857142857143,22.6714285714286,0,53.7571428571429,47.1742857142857,20.6433333333333,249,0,0,113,199,427,249,427
2018,23,67,"Soma",39.1852,27.6094,13.0428571428571,25.4142857142857,0.039,51.2714285714286,64.7771428571429,28.4228571428571,267,0,0,218,681,812,267,812
2018,24,67,"Soma",39.1852,27.6094,14.7285714285714,24.9428571428571,1.74428571428571,52.7714285714286,44.5828571428571,23.1928571428571,267,0,0,189,382,448,267,448
2018,25,67,"Soma",39.1852,27.6094,14.9714285714286,23.5571428571429,2.16057142857143,69.7428571428571,41.9714285714286,23.55,358,0,0,188,268,518,358,518
2018,26,67,"Soma",39.1852,27.6094,14.6571428571429,23.6428571428571,5.241,65.6428571428571,34.1914285714286,20.7857142857143,355,0,0,157,270,587,355,587
2018,27,67,"Soma",39.1852,27.6094,14.8285714285714,28.0428571428571,0,47.2428571428571,48.14,14.57,342,0,0,306,365,418,342,418
2018,28,67,"Soma",39.1852,27.6094,17.3,27.8571428571429,0,53.9,43.2714285714286,10.0885714285714,286,0,0,252,463,585,286,585
2018,29,67,"Soma",39.1852,27.6094,14.6571428571429,27.6,0.203571428571429,50.1,50.47,17.6257142857143,260,0,0,195,495,756,260,756
2018,30,67,"Soma",39.1852,27.6094,13.1714285714286,26.3857142857143,1.646,60.8571428571429,49.1214285714286,16.2357142857143,265,0,0,226,734,822,265,822
2018,31,67,"Soma",39.1852,27.6094,19.0571428571429,28.5285714285714,0.698142857142857,59.4857142857143,45.8775,13.4814285714286,267,0,0,110,87,499,267,499
2018,32,67,"Soma",39.1852,27.6094,21.0428571428571,27.7714285714286,0.00885714285714286,51.9,45.9214285714286,14.0142857142857,297,0,0,71,99,403,297,403
2018,33,67,"Soma",39.1852,27.6094,17.8714285714286,27.0857142857143,0,54.4,50.8242857142857,17.0914285714286,216,0,0,145,230,332,216,332
2018,34,67,"Soma",39.1852,27.6094,18.5571428571429,26.8571428571429,0,56.3857142857143,44.0571428571429,13.1328571428571,144,0,0,106,151,227,144,227
2018,35,67,"Soma",39.1852,27.6094,17.3714285714286,27.6285714285714,0.0585714285714286,58.0285714285714,54.3342857142857,17.7242857142857,201,0,0,136,186,314,201,314
2018,36,67,"Soma",39.1852,27.6094,13.8714285714286,25.4428571428571,0.431857142857143,57.8285714285714,58.2028571428571,22.9228571428571,341,0,0,338,353,370,341,370
2018,37,67,"Soma",39.1852,27.6094,15.8571428571429,22.2285714285714,0.479285714285714,60.4142857142857,45.3314285714286,25.0557142857143,241,0,0,171,275,419,241,419
2018,38,67,"Soma",39.1852,27.6094,23.4714285714286,22.7857142857143,0,61.3,43.5,17.9,189,0,0,69,128,344,189,344
2018,39,67,"Soma",39.1852,27.6094,22.3,19.6,3.74671428571429,62.0285714285714,54.6942857142857,23.76,180,0,0,21,31,353,180,353
2018,40,67,"Soma",39.1852,27.6094,13.9571428571429,19,1.57242857142857,69.8714285714286,47.16,31.23,191,0,0,80,124,341,191,341
2018,41,67,"Soma",39.1852,27.6094,18.1571428571429,19.1428571428571,0.402142857142857,69.1142857142857,48.4,27.5314285714286,187,0,0,21,31,422,187,422
2018,42,67,"Soma",39.1852,27.6094,13.6571428571429,19.3285714285714,0.103571428571429,73.5857142857143,91.9428571428572,32.8942857142857,168,0,0,87,267,381,168,381
2018,43,67,"Soma",39.1852,27.6094,13,13.7857142857143,1.01542857142857,68.3,83.7585714285714,46.78,187,0,0,88,220,402,187,402
2018,44,67,"Soma",39.1852,27.6094,9.25714285714286,15.6714285714286,0.002,66.0428571428571,101.971428571429,59.9257142857143,196,0,0,129,166,264,196,264
2018,45,67,"Soma",39.1852,27.6094,12.6428571428571,14.6142857142857,0,72.4571428571429,81.3714285714286,44.4528571428571,231,0,0,67,99,473,231,473
2018,46,67,"Soma",39.1852,27.6094,19.3571428571429,10.8428571428571,2.90328571428571,70.2857142857143,60.4871428571429,39.7585714285714,230,0,0,0,0,465,230,465
2018,47,67,"Soma",39.1852,27.6094,14.6571428571429,12.1142857142857,4.49371428571429,83.9285714285714,71.9042857142857,43.8142857142857,270,24,20,0,0,499,246,479
2018,48,67,"Soma",39.1852,27.6094,17.6571428571429,10.4714285714286,6.11628571428571,80.3,48.6771428571429,30.14,245,41,15,29,5,201,204,186
2018,49,67,"Soma",39.1852,27.6094,12.0142857142857,7.51428571428571,2.09542857142857,78.6571428571429,80.2028571428571,48.6666666666667,257,0,0,61,53,420,257,420
2018,50,67,"Soma",39.1852,27.6094,9.48571428571429,7.27142857142857,5.05714285714286,88.4571428571429,71.7057142857143,51.465,256,0,0,99,114,305,256,305
2018,51,67,"Soma",39.1852,27.6094,13.5142857142857,6.21428571428571,2.29142857142857,87.2142857142857,80.6271428571429,42.505,250,0,0,1,0,248,250,248
2018,52,67,"Soma",39.1852,27.6094,13.7714285714286,3.88571428571429,2.26728571428571,79.1,89.5585714285714,50.262,244,0,0,6,1,273,244,273
2019,1,67,"Soma",39.1852,27.6094,17.4375,5.0375,3.918875,80.65,60.515,36.1266666666667,343,0,0,7,11,784,343,784
2019,2,67,"Soma",39.1852,27.6094,17.7142857142857,5.3,18.2704285714286,79.2142857142857,64.67,46.02,255,65,46,1,0,208,190,162
2019,3,67,"Soma",39.1852,27.6094,9.64285714285714,5.24285714285714,1.87185714285714,81.8857142857143,NA,49.73,192,0,0,64,76,198,192,198
2019,4,67,"Soma",39.1852,27.6094,12.3285714285714,9.27142857142857,11.094,84.6714285714286,64.662,41.132,308,75,85,45,77,314,233,229
2019,5,67,"Soma",39.1852,27.6094,10.9285714285714,10,4.75042857142857,77.7285714285714,53.1642857142857,46.8071428571429,253,98,61,29,20,143,155,82
2019,6,67,"Soma",39.1852,27.6094,15.3285714285714,8.5,1.13557142857143,77.5714285714286,60.4328571428571,45.8928571428571,276,0,0,44,13,127,276,127
2019,7,67,"Soma",39.1852,27.6094,22.7,7.62857142857143,4.77842857142857,72.5428571428571,46.0385714285714,39.0185714285714,325,67,24,27,102,234,258,210
2019,8,67,"Soma",39.1852,27.6094,14.0142857142857,6.98571428571429,0.619571428571429,74.9,107.858571428571,60.0528571428571,305,1,1,43,58,219,304,218
2019,9,67,"Soma",39.1852,27.6094,19.0714285714286,7.18571428571429,1.00114285714286,70.9142857142857,37.985,33.62,331,0,0,70,114,310,331,310
2019,10,67,"Soma",39.1852,27.6094,9.41428571428571,10.7571428571429,0,69.5,88.82,56.895,359,0,0,195,86,252,359,252
2019,11,67,"Soma",39.1852,27.6094,15.2142857142857,10.5428571428571,4.36357142857143,76.0142857142857,66.7185714285714,48.8728571428571,373,71,40,75,107,400,302,360
2019,12,67,"Soma",39.1852,27.6094,19.2,11.8857142857143,0,59.8571428571429,66.7071428571429,44.0985714285714,343,0,0,3,2,416,343,416
2019,13,67,"Soma",39.1852,27.6094,22.9571428571429,10,0,51.8714285714286,59.1371428571429,37.3071428571429,256,0,0,101,74,194,256,194
2019,14,67,"Soma",39.1852,27.6094,13.7,12.1857142857143,1.07914285714286,65.7285714285714,67.7157142857143,47.0985714285714,365,0,0,147,109,208,365,208
2019,15,67,"Soma",39.1852,27.6094,11.7,14.1714285714286,8.16228571428571,80.2857142857143,63.36,48.9428571428571,359,53,29,159,76,183,306,154
2019,16,67,"Soma",39.1852,27.6094,17.0571428571429,11.0142857142857,0.617571428571429,61,48.8114285714286,42.8357142857143,318,0,0,83,39,208,318,208
2019,17,67,"Soma",39.1852,27.6094,9.31428571428571,16.3428571428571,0.0501428571428571,57.5285714285714,78.596,64.552,412,0,0,300,236,313,412,313
2019,18,67,"Soma",39.1852,27.6094,13.8,17.3285714285714,0.849,62.5571428571429,67.705,37.4833333333333,523,0,0,149,77,353,523,353
2019,19,67,"Soma",39.1852,27.6094,12.6571428571429,16.7,0.489571428571429,65.3857142857143,43.7725,39.69,452,0,0,211,154,386,452,386
2019,20,67,"Soma",39.1852,27.6094,10.1,21.1428571428571,0.0244285714285714,60.3428571428571,55.3528571428571,43.675,454,0,0,309,278,389,454,389
2019,21,67,"Soma",39.1852,27.6094,12.6857142857143,21.8,0.387,58.7714285714286,55.798,19.45,457,0,0,206,233,413,457,413
2019,22,67,"Soma",39.1852,27.6094,12.9285714285714,24.2,0.0141428571428571,52.8142857142857,55.5671428571429,18.575,453,0,0,249,188,323,453,323
2019,23,67,"Soma",39.1852,27.6094,15.5571428571429,23.8142857142857,0.0952857142857143,52.8,38.0042857142857,NA,378,0,0,225,285,532,378,532
2019,24,67,"Soma",39.1852,27.6094,15.2714285714286,25.4142857142857,1.61214285714286,62.7,45.6585714285714,NA,378,0,0,223,94,244,378,244
2019,25,67,"Soma",39.1852,27.6094,14.6428571428571,25.8285714285714,0.530571428571429,60.5142857142857,44.3271428571429,25.4975,306,0,0,166,175,325,306,325
2019,26,67,"Soma",39.1852,27.6094,21.8857142857143,27.7,0.0188571428571429,48.8142857142857,47.98,54.12,377,0,0,48,34,342,377,342
2019,27,67,"Soma",39.1852,27.6094,16.9571428571429,27.4714285714286,0,46.2714285714286,42.7314285714286,23.9342857142857,456,0,0,287,142,222,456,222
2019,28,67,"Soma",39.1852,27.6094,13.4857142857143,24.8857142857143,2.93228571428571,55.5428571428571,41.8671428571429,NA,398,0,0,371,350,421,398,421
2019,29,67,"Soma",39.1852,27.6094,16.5857142857143,24.7857142857143,0.320285714285714,58.0428571428571,36.4785714285714,NA,453,0,0,152,72,203,453,203
2019,30,67,"Soma",39.1852,27.6094,17.2571428571429,26.5428571428571,0,50.2714285714286,38.3742857142857,NA,456,0,0,153,108,335,456,335
2019,31,67,"Soma",39.1852,27.6094,14.2285714285714,27.8428571428571,0.0185714285714286,53,44.9985714285714,NA,334,0,0,184,189,375,334,375
2019,32,67,"Soma",39.1852,27.6094,22.2285714285714,26.1428571428571,0,47.8714285714286,36.2414285714286,NA,346,0,0,38,27,395,346,395
2019,33,67,"Soma",39.1852,27.6094,18.9571428571429,26.0428571428571,0.159142857142857,57.6,39.8528571428571,NA,337,0,0,158,249,531,337,531
2019,34,67,"Soma",39.1852,27.6094,24.5857142857143,26.3142857142857,0,57.0571428571429,49.97,27.28,299,0,0,2,0,345,299,345
2019,35,67,"Soma",39.1852,27.6094,20.3714285714286,26.4857142857143,0,54.7714285714286,44.4228571428571,30.0314285714286,307,0,0,14,7,415,307,415
2019,36,67,"Soma",39.1852,27.6094,20.2285714285714,24.9857142857143,0,55.8571428571429,41.4457142857143,32.5728571428571,171,0,0,65,36,67,171,67
2019,37,67,"Soma",39.1852,27.6094,22.8142857142857,23.7571428571429,0.328428571428571,56.5,42.7828571428571,35.8314285714286,218,0,0,14,7,55,218,55
2019,38,67,"Soma",39.1852,27.6094,17.4,20.1571428571429,0,55.2714285714286,48.4657142857143,7.66571428571429,266,0,0,89,48,91,266,91
2019,39,67,"Soma",39.1852,27.6094,10.1142857142857,20.2714285714286,0.582142857142857,61.9285714285714,49.035,10.2866666666667,237,0,0,172,55,79,237,79
2019,40,67,"Soma",39.1852,27.6094,12.5285714285714,21.0857142857143,2.41114285714286,61.1571428571429,53.3271428571429,16.0757142857143,241,0,0,131,66,111,241,111
2019,41,67,"Soma",39.1852,27.6094,10.8714285714286,18.4571428571429,2.33914285714286,74.4285714285714,47.1785714285714,14.2642857142857,416,0,0,177,288,448,416,448
2019,42,67,"Soma",39.1852,27.6094,7.44285714285714,18.9857142857143,0.003,77.3428571428571,95.0614285714286,17.9885714285714,356,0,0,229,228,408,356,408
2019,43,67,"Soma",39.1852,27.6094,16.8285714285714,18.4285714285714,0,66.0428571428571,52.3128571428571,19.1071428571429,306,0,0,13,15,300,306,300
2019,44,67,"Soma",39.1852,27.6094,10.6142857142857,14.6714285714286,0.585,72.3285714285714,72.5857142857143,29.5042857142857,350,65,30,138,95,250,285,220
2019,45,67,"Soma",39.1852,27.6094,10.4285714285714,17.5857142857143,0.365142857142857,73.7,83.73,28.576,417,140,109,0,0,328,277,219
2019,46,67,"Soma",39.1852,27.6094,5.6,14.3857142857143,0.550571428571428,81.6571428571429,116.22,33.5142857142857,401,0,0,92,83,337,401,337
2019,47,67,"Soma",39.1852,27.6094,7.17142857142857,12.2857142857143,0.382142857142857,79.5285714285714,127.367142857143,43.0728571428571,391,0,0,148,156,339,391,339
2019,48,67,"Soma",39.1852,27.6094,11.8142857142857,12.9857142857143,3.7,84.8571428571429,71.8085714285714,27.4371428571429,320,51,34,0,0,251,269,217
2019,49,67,"Soma",39.1852,27.6094,11.6857142857143,7.37142857142857,1.68685714285714,77.9428571428571,94.1771428571429,36.4085714285714,393,50,38,0,0,274,343,236
2019,50,67,"Soma",39.1852,27.6094,8.07142857142857,8.7,3.05385714285714,84.4142857142857,114.367142857143,44.9342857142857,218,0,0,0,0,119,218,119
2019,51,67,"Soma",39.1852,27.6094,10.7,9.44285714285714,0.0455714285714286,83.2142857142857,120.095714285714,46.5857142857143,361,17,19,0,0,488,344,469
2019,52,67,"Soma",39.1852,27.6094,18.9428571428571,8.2,5.76385714285714,78.1714285714286,46.1071428571429,29.2285714285714,279,49,66,6,4,281,230,215
2020,1,67,"Soma",39.1852,27.6094,19.5,5.52,0.011,70.32,60.23,32.712,160,0,0,0,0,126,160,126
2020,2,67,"Soma",39.1852,27.6094,18.0571428571429,5.15714285714286,1.81485714285714,74.2571428571429,67.8128571428571,34.5242857142857,240,0,0,57,35,173,240,173
2020,3,67,"Soma",39.1852,27.6094,17.2285714285714,6.2,0,73.3,87.9985714285714,39.7942857142857,270,0,0,0,0,382,270,382
2020,4,67,"Soma",39.1852,27.6094,12.1142857142857,4.22857142857143,0.0624285714285714,66.5285714285714,78.39,42.5585714285714,358,54,73,6,13,295,304,222
2020,5,67,"Soma",39.1852,27.6094,8.78571428571429,8.9,3.44371428571429,79.7142857142857,85.0957142857143,46.0471428571429,331,146,128,40,26,272,185,144
2020,6,67,"Soma",39.1852,27.6094,15.6571428571429,7.2,3.92985714285714,72.6142857142857,62.8057142857143,36.1628571428571,343,160,96,2,16,267,183,171
2020,7,67,"Soma",39.1852,27.6094,11.3285714285714,7.95714285714286,3.653,74.5428571428571,78.9657142857143,43.1428571428571,341,0,0,6,0,338,341,338
2020,8,67,"Soma",39.1852,27.6094,14.7714285714286,8.18571428571429,1.64728571428571,71.0857142857143,74.64,38.3257142857143,283,0,0,104,43,187,283,187
2020,9,67,"Soma",39.1852,27.6094,13.3571428571429,9.72857142857143,2.21414285714286,69.2142857142857,84.6414285714286,36.9671428571429,393,41,80,214,285,528,352,448
2020,10,67,"Soma",39.1852,27.6094,10.3714285714286,12.4714285714286,2.456,74.4714285714286,87.6271428571429,42.2871428571429,205,0,0,145,163,210,205,210
2020,11,67,"Soma",39.1852,27.6094,14.0857142857143,12.8857142857143,0.605,71.1142857142857,68.3271428571429,37.5871428571429,115,0,0,62,68,94,115,94
2020,12,67,"Soma",39.1852,27.6094,18.4714285714286,8.14285714285714,0.189571428571429,57.3,54.1985714285714,28.9,117,0,0,29,21,118,117,118
2020,13,67,"Soma",39.1852,27.6094,18.6,10.9714285714286,0.725571428571429,76.3285714285714,65.47,21.07,136,0,0,50,31,92,136,92
2020,14,67,"Soma",39.1852,27.6094,17.3,10.8285714285714,3.63242857142857,76.5714285714286,69.1657142857143,27.9371428571429,155,0,0,76,80,121,155,121
2020,15,67,"Soma",39.1852,27.6094,22.2714285714286,11.6428571428571,1.17328571428571,59.5857142857143,50.6928571428571,21.4357142857143,133,0,0,52,19,118,133,118
2020,16,67,"Soma",39.1852,27.6094,17.3428571428571,13.6714285714286,1.021,61.2,56.6528571428571,30.4242857142857,141,0,0,94,70,106,141,106
2020,17,67,"Soma",39.1852,27.6094,23.2571428571429,13.0428571428571,0.0111428571428571,61.9428571428571,45.5457142857143,18.9914285714286,137,0,0,63,71,123,137,123
2020,18,67,"Soma",39.1852,27.6094,14.2428571428571,16.3571428571429,1.90271428571429,67.9714285714286,48.7028571428571,24.7557142857143,146,0,0,39,81,164,146,164
2020,19,67,"Soma",39.1852,27.6094,16.2857142857143,15.2142857142857,1.58771428571429,68.7,37.3857142857143,18.7928571428571,137,0,0,98,91,157,137,157
2020,20,67,"Soma",39.1852,27.6094,15.0285714285714,22.7857142857143,0,56.0142857142857,64.8366666666667,28.7383333333333,164,0,0,123,103,164,164,164
2020,21,67,"Soma",39.1852,27.6094,22.0285714285714,20.4142857142857,1.64314285714286,61.9,60.6466666666667,24.63,146,0,0,103,78,96,146,96
2020,22,67,"Soma",39.1852,27.6094,18.8714285714286,16.4428571428571,2.72457142857143,69.3142857142857,25.9985714285714,17.61,118,0,0,69,63,100,118,100
2020,23,67,"Soma",39.1852,27.6094,14.6142857142857,19.2428571428571,1.58271428571429,65.9428571428572,36.6585714285714,21.62,112,0,0,43,21,70,112,70
2020,24,67,"Soma",39.1852,27.6094,13.0571428571429,22.5142857142857,1.42171428571429,63.1571428571429,38.4785714285714,21.7571428571429,140,0,0,59,69,150,140,150
2020,25,67,"Soma",39.1852,27.6094,13.9714285714286,24.0142857142857,0.307285714285714,61.0285714285714,41.4414285714286,23.6671428571429,137,0,0,53,71,108,137,108
2020,26,67,"Soma",39.1852,27.6094,16.5285714285714,24.3571428571429,0.741714285714286,62.0857142857143,34.8085714285714,19.2185714285714,173,0,0,123,97,133,173,133
2020,27,67,"Soma",39.1852,27.6094,17.1142857142857,28.2428571428571,0,51.1428571428571,40.2875,24.5225,113,0,0,71,88,113,113,113
2020,28,67,"Soma",39.1852,27.6094,20.6142857142857,26.8285714285714,0.612142857142857,57.3428571428571,NA,NA,164,0,0,78,81,122,164,122
2020,29,67,"Soma",39.1852,27.6094,22.3428571428571,24.8857142857143,0,55.3285714285714,NA,NA,186,0,0,60,29,111,186,111
2020,30,67,"Soma",39.1852,27.6094,20.8,27.1142857142857,0.0167142857142857,52.8571428571429,NA,NA,190,0,0,61,37,142,190,142
2020,31,67,"Soma",39.1852,27.6094,24,28.6285714285714,0,46.7142857142857,NA,NA,150,0,0,48,58,127,150,127
2020,32,67,"Soma",39.1852,27.6094,19.5,27.0142857142857,0,57.3571428571429,48.9666666666667,11.1925,146,0,0,100,58,107,146,107
2020,33,67,"Soma",39.1852,27.6094,22.3714285714286,27.1142857142857,0.0565714285714286,47.6714285714286,35.48,11.2657142857143,183,0,0,31,12,83,183,83
2020,34,67,"Soma",39.1852,27.6094,19.2,25.8285714285714,0,52.7857142857143,35.7557142857143,13.8016666666667,197,0,0,108,65,97,197,97
2020,35,67,"Soma",39.1852,27.6094,16.6857142857143,26.9714285714286,0,52.3428571428571,40.5671428571429,16.6557142857143,164,0,0,84,89,157,164,157
2020,36,67,"Soma",39.1852,27.6094,17.8428571428571,26.1857142857143,0,54.6428571428571,49.0185714285714,22.9542857142857,179,0,0,96,63,112,179,112
2020,37,67,"Soma",39.1852,27.6094,23.6428571428571,26.1714285714286,0,58.0285714285714,43.1271428571429,14.9771428571429,193,0,0,39,21,91,193,91
2020,38,67,"Soma",39.1852,27.6094,22.7142857142857,24.9857142857143,0,59.8428571428571,43.9971428571429,15.7257142857143,235,0,0,65,43,157,235,157
2020,39,67,"Soma",39.1852,27.6094,16.1857142857143,23.2,0.0114285714285714,59.5714285714286,48.8957142857143,19.5871428571429,220,9,6,78,22,129,211,123
2020,40,67,"Soma",39.1852,27.6094,11.2285714285714,20.7571428571429,0.112571428571429,55.7714285714286,51.2085714285714,27.4714285714286,187,0,0,126,93,154,187,154
2020,41,67,"Soma",39.1852,27.6094,8.6,21.1285714285714,1.94757142857143,63.7428571428571,76.8057142857143,33.05,182,0,0,158,113,127,182,127
2020,42,67,"Soma",39.1852,27.6094,12.0285714285714,19.1285714285714,2.81271428571429,72.5285714285714,54.4283333333333,28.9283333333333,177,63,18,15,13,111,114,93
2020,43,67,"Soma",39.1852,27.6094,16.6571428571429,18.2428571428571,0.496571428571429,73.5571428571429,53.5116666666667,18.3166666666667,194,0,0,76,27,161,194,161
2020,44,67,"Soma",39.1852,27.6094,10.0142857142857,15.6285714285714,0.240714285714286,73.8428571428571,58.5842857142857,19.4985714285714,255,8,11,175,160,233,247,222
2020,45,67,"Soma",39.1852,27.6094,22.3714285714286,14.1714285714286,0.156142857142857,64.3428571428571,47.5585714285714,17.0628571428571,156,0,0,20,7,103,156,103
2020,46,67,"Soma",39.1852,27.6094,15.1428571428571,13.3571428571429,0.657428571428571,71.8714285714286,70.83,31.02,208,0,0,23,28,109,208,109
2020,47,67,"Soma",39.1852,27.6094,24.1,11.3571428571429,0.162,67.9142857142857,NA,NA,173,0,0,0,0,83,173,83
2020,48,67,"Soma",39.1852,27.6094,18.3571428571429,8.81428571428571,0.00557142857142857,65.3571428571429,66.575,NA,199,1,1,0,0,262,198,261
2020,49,67,"Soma",39.1852,27.6094,18.1285714285714,9.58571428571429,0.0101428571428571,73.6714285714286,NA,NA,207,0,0,33,4,116,207,116
2020,50,67,"Soma",39.1852,27.6094,13.2142857142857,11.7285714285714,11.4792857142857,83.5142857142857,NA,NA,181,27,34,17,7,98,154,64
2020,51,67,"Soma",39.1852,27.6094,20.1285714285714,10.0857142857143,2.32142857142857,80.2142857142857,NA,NA,171,0,0,0,0,90,171,90
2020,52,67,"Soma",39.1852,27.6094,15.7571428571429,9.41428571428571,0.126571428571429,75.6428571428571,NA,35.5933333333333,203,85,53,38,6,113,118,60
2020,53,67,"Soma",39.1852,27.6094,13.1,11.925,2.9335,78.975,NA,37.9275,122,68,47,0,0,111,54,64
2017,1,68,"Mardin",37.3212,40.7245,16.8142857142857,4.84285714285714,0.442571428571429,73.8,58.06,NA,563,304,458,0,0,847,259,389
2017,2,68,"Mardin",37.3212,40.7245,19.1857142857143,4.71428571428571,0.447571428571429,65.9857142857143,147.582857142857,NA,757,195,323,107,220,1214,562,891
2017,3,68,"Mardin",37.3212,40.7245,15.0857142857143,5.62857142857143,0.314428571428571,61.3428571428571,52.3557142857143,NA,762,171,322,87,93,1449,591,1127
2017,4,68,"Mardin",37.3212,40.7245,26.7,3.82857142857143,4.29671428571429,65.6142857142857,44.62,NA,639,250,382,1,14,889,389,507
2017,5,68,"Mardin",37.3212,40.7245,23.6285714285714,-0.357142857142857,0.527714285714286,66.4571428571429,38.048,NA,588,381,611,0,0,1163,207,552
2017,6,68,"Mardin",37.3212,40.7245,18.1714285714286,4.97142857142857,0.199857142857143,69.0428571428571,42.7614285714286,NA,736,621,1286,2,2,1519,115,233
2017,7,68,"Mardin",37.3212,40.7245,26.1428571428571,3.44285714285714,0.0704285714285714,47.4428571428571,43.3725,NA,492,270,367,1,0,717,222,350
2017,8,68,"Mardin",37.3212,40.7245,14.5142857142857,7.68571428571429,0,50.2285714285714,NA,NA,739,187,487,135,291,1747,552,1260
2017,9,68,"Mardin",37.3212,40.7245,16.4857142857143,11.3285714285714,6.12285714285714,66.0142857142857,38.54,NA,574,367,519,0,0,866,207,347
2017,10,68,"Mardin",37.3212,40.7245,21.3571428571429,12.9428571428571,0.191285714285714,55.6857142857143,52.5114285714286,NA,712,259,418,5,7,1043,453,625
2017,11,68,"Mardin",37.3212,40.7245,22.4142857142857,9.4,12.1368571428571,80.0857142857143,36.08,NA,525,260,376,138,229,725,265,349
2017,12,68,"Mardin",37.3212,40.7245,20.4571428571429,10.0571428571429,1.80985714285714,65.8571428571429,31.7242857142857,NA,589,288,673,1,0,1077,301,404
2017,13,68,"Mardin",37.3212,40.7245,22.3,13.0571428571429,5.81128571428571,70.9857142857143,32.284,NA,574,165,280,7,2,887,409,607
2017,14,68,"Mardin",37.3212,40.7245,17.6857142857143,12.7714285714286,4.70371428571429,69.0428571428571,25.3614285714286,NA,639,332,705,94,164,1336,307,631
2017,15,68,"Mardin",37.3212,40.7245,19.2,13.8571428571429,7.629,69.4285714285714,53.2157142857143,NA,587,186,357,70,107,1187,401,830
2017,16,68,"Mardin",37.3212,40.7245,17.2142857142857,15.9142857142857,6.30857142857143,72.6285714285714,56.425,NA,717,339,619,17,9,920,378,301
2017,17,68,"Mardin",37.3212,40.7245,22.7142857142857,17.4142857142857,0.113285714285714,49.0428571428571,46.614,NA,731,134,195,28,56,1478,597,1283
2017,18,68,"Mardin",37.3212,40.7245,16.6714285714286,17.9,6.48342857142857,69.4285714285714,73.6828571428571,NA,506,241,381,14,2,923,265,542
2017,19,68,"Mardin",37.3212,40.7245,20.7428571428571,22.1142857142857,0,49.5428571428571,83.5028571428571,NA,471,136,241,38,51,966,335,725
2017,20,68,"Mardin",37.3212,40.7245,26.1,21.8,0.187428571428571,48.6,139.947142857143,NA,472,84,209,51,42,1205,388,996
2017,21,68,"Mardin",37.3212,40.7245,20.5,20.4285714285714,2.47557142857143,49.5571428571429,36.6416666666667,NA,448,148,223,137,332,849,300,626
2017,22,68,"Mardin",37.3212,40.7245,20.2857142857143,23.9857142857143,0.0285714285714286,36.5857142857143,45.3757142857143,NA,522,22,36,215,421,1015,500,979
2017,23,68,"Mardin",37.3212,40.7245,21.9,28.6714285714286,0,28.7428571428571,87.7216666666667,NA,578,66,111,204,534,1388,512,1277
2017,24,68,"Mardin",37.3212,40.7245,23.1571428571429,27.1714285714286,0,30.1142857142857,80.6433333333333,NA,552,74,165,200,412,1139,478,974
2017,25,68,"Mardin",37.3212,40.7245,25.3142857142857,27.6857142857143,0.206714285714286,31.2142857142857,129.4,NA,584,30,72,170,296,1041,554,969
2017,26,68,"Mardin",37.3212,40.7245,25.5571428571429,33.4571428571429,0,20.7857142857143,139.314285714286,NA,564,210,332,127,271,971,354,639
2017,27,68,"Mardin",37.3212,40.7245,21.3571428571429,32.8857142857143,0,22.7857142857143,130.625714285714,NA,511,13,20,200,307,642,498,622
2017,28,68,"Mardin",37.3212,40.7245,20.8428571428571,33.4285714285714,0,18.9428571428571,125.97,NA,481,113,124,119,227,864,368,740
2017,29,68,"Mardin",37.3212,40.7245,19.8285714285714,32.9285714285714,0,23.0571428571429,112.64,NA,532,0,0,282,703,1272,532,1272
2017,30,68,"Mardin",37.3212,40.7245,19.6857142857143,32.0285714285714,0,22.4714285714286,85.3742857142857,NA,531,0,0,352,677,928,531,928
2017,31,68,"Mardin",37.3212,40.7245,17.3714285714286,32.7142857142857,0,21.3,86.24,NA,559,0,0,320,705,1047,559,1047
2017,32,68,"Mardin",37.3212,40.7245,20.8571428571429,34,0,20.6571428571429,43.5728571428571,NA,567,19,2,257,590,1092,548,1090
2017,33,68,"Mardin",37.3212,40.7245,18.9857142857143,30.9428571428571,0,30.6,28.4071428571429,NA,596,0,0,231,582,1199,596,1199
2017,34,68,"Mardin",37.3212,40.7245,17.7,30.6,0,29.4857142857143,28.9457142857143,NA,601,0,0,345,907,1280,601,1280
2017,35,68,"Mardin",37.3212,40.7245,18.1571428571429,29.6857142857143,0,25.9857142857143,13.0157142857143,NA,493,0,0,196,353,1014,493,1014
2017,36,68,"Mardin",37.3212,40.7245,19.9857142857143,28.5571428571429,0,21.7,11.3642857142857,NA,507,8,4,129,479,1321,499,1317
2017,37,68,"Mardin",37.3212,40.7245,17.3857142857143,30.0571428571429,0,17.1571428571429,28.8171428571429,NA,589,113,195,105,283,1138,476,943
2017,38,68,"Mardin",37.3212,40.7245,19.7571428571429,27.8571428571429,0,27.8285714285714,29.1471428571429,NA,671,72,101,292,679,1312,599,1211
2017,39,68,"Mardin",37.3212,40.7245,18.3857142857143,24.6142857142857,0,34.6142857142857,20.4114285714286,NA,782,256,533,176,429,1630,526,1097
2017,40,68,"Mardin",37.3212,40.7245,21.2714285714286,20.4571428571429,0.000142857142857143,30.8285714285714,11.1942857142857,NA,543,96,133,141,394,1137,447,1004
2017,41,68,"Mardin",37.3212,40.7245,18.2,20.0428571428571,0.0137142857142857,35.1428571428571,17.6642857142857,NA,487,75,66,161,350,843,412,777
2017,42,68,"Mardin",37.3212,40.7245,21.9142857142857,18.6428571428571,0,26.6142857142857,29.0771428571429,NA,530,73,84,42,61,815,457,731
2017,43,68,"Mardin",37.3212,40.7245,19.6714285714286,18.9428571428571,2.01071428571429,39.1714285714286,13.9485714285714,NA,506,216,457,31,59,919,290,462
2017,44,68,"Mardin",37.3212,40.7245,17.1857142857143,15.1285714285714,2.26885714285714,62.6285714285714,50.0775,NA,561,212,499,89,237,1102,349,603
2017,45,68,"Mardin",37.3212,40.7245,18,15.4142857142857,0.496714285714286,64.6571428571429,142.484285714286,NA,577,299,304,60,279,829,278,525
2017,46,68,"Mardin",37.3212,40.7245,16.0142857142857,14.1571428571429,0.957285714285714,51.4714285714286,85.8171428571429,NA,587,270,530,14,29,1085,317,555
2017,47,68,"Mardin",37.3212,40.7245,21.9,9.42857142857143,1.11371428571429,59.7571428571429,70.5242857142857,NA,418,139,274,83,142,804,279,530
2017,48,68,"Mardin",37.3212,40.7245,16.6857142857143,10.6714285714286,1.448,59.3714285714286,49.5742857142857,NA,386,164,298,10,44,619,222,321
2017,49,68,"Mardin",37.3212,40.7245,20.7571428571429,7.84285714285714,1.276,56.0428571428571,137.648333333333,NA,407,83,107,19,34,645,324,538
2017,50,68,"Mardin",37.3212,40.7245,15.1428571428571,8.71428571428572,0.242285714285714,53.2,51.5842857142857,NA,346,187,162,0,0,442,159,280
2017,51,68,"Mardin",37.3212,40.7245,27.5285714285714,11.8,0.762,64.2428571428571,104.381428571429,NA,386,255,219,0,0,349,131,130
2017,52,68,"Mardin",37.3212,40.7245,25.2125,10.1875,0.334875,58.45,64.77625,NA,528,302,326,8,0,507,226,181
2018,1,68,"Mardin",37.3212,40.7245,22.425,7.85,5.267625,76.25,41.6628571428571,NA,618,366,559,1,1,914,252,355
2018,2,68,"Mardin",37.3212,40.7245,24.5857142857143,8.05714285714286,0.147857142857143,53.8142857142857,68.6214285714286,NA,624,306,363,1,1,1309,318,946
2018,3,68,"Mardin",37.3212,40.7245,22.9428571428571,6.81428571428571,6.06357142857143,79.6285714285714,107.551666666667,NA,639,193,193,1,0,655,446,462
2018,4,68,"Mardin",37.3212,40.7245,29.8571428571429,7.91428571428571,5.83657142857143,80.4142857142857,130.881428571429,NA,604,289,417,0,0,764,315,347
2018,5,68,"Mardin",37.3212,40.7245,14.1,6.72857142857143,0,62.2714285714286,51.7442857142857,NA,670,168,186,49,114,819,502,633
2018,6,68,"Mardin",37.3212,40.7245,18.8714285714286,11.0857142857143,0.114142857142857,53.0714285714286,76.3983333333333,NA,704,529,756,0,0,1022,175,266
2018,7,68,"Mardin",37.3212,40.7245,22.0714285714286,10.0571428571429,8.25328571428572,77.7,NA,NA,478,172,205,81,119,557,306,352
2018,8,68,"Mardin",37.3212,40.7245,17.2142857142857,9.81428571428571,5.45785714285714,78.8142857142857,NA,NA,711,437,817,0,0,1321,274,504
2018,9,68,"Mardin",37.3212,40.7245,18.8571428571429,10.9,4.24971428571429,79.5714285714286,42.47,NA,621,199,405,6,36,956,422,551
2018,10,68,"Mardin",37.3212,40.7245,19.4571428571429,13.7857142857143,0.00757142857142857,64.4,80.4842857142857,NA,556,113,316,85,323,1330,443,1014
2018,11,68,"Mardin",37.3212,40.7245,16.9571428571429,13.3571428571429,0.00528571428571429,61.3285714285714,34.3,NA,551,57,173,12,24,1426,494,1253
2018,12,68,"Mardin",37.3212,40.7245,21.8285714285714,15.6428571428571,0,53.0285714285714,154.787142857143,NA,425,119,613,12,5,1187,306,574
2018,13,68,"Mardin",37.3212,40.7245,19.5714285714286,15.5714285714286,0.387142857142857,56.8142857142857,84.4614285714286,NA,356,131,170,15,28,428,225,258
2018,14,68,"Mardin",37.3212,40.7245,19.8285714285714,17.7142857142857,0,35.0714285714286,34.5085714285714,NA,407,174,187,47,35,486,233,299
2018,15,68,"Mardin",37.3212,40.7245,23.2142857142857,17.6571428571429,7.35714285714286,60.7,42.8471428571429,NA,374,252,311,0,0,450,122,139
2018,16,68,"Mardin",37.3212,40.7245,19.8142857142857,17.1714285714286,0.730285714285714,47.5714285714286,35.17,NA,411,394,637,0,0,648,17,11
2018,17,68,"Mardin",37.3212,40.7245,23.9428571428571,18.5714285714286,2.33957142857143,55.1714285714286,56.6185714285714,NA,419,122,251,54,83,652,297,401
2018,18,68,"Mardin",37.3212,40.7245,22.2714285714286,20.5571428571429,4.05142857142857,62.9714285714286,43.2375,NA,303,184,287,50,90,474,119,187
2018,19,68,"Mardin",37.3212,40.7245,20.6428571428571,16.2714285714286,29.0718571428571,83.1428571428571,26.6528571428571,NA,275,122,280,0,0,467,153,187
2018,20,68,"Mardin",37.3212,40.7245,16.1714285714286,22.7142857142857,4.26371428571429,52.3142857142857,22.4242857142857,NA,204,56,60,18,30,306,148,246
2018,21,68,"Mardin",37.3212,40.7245,20.4,25.6142857142857,5.12542857142857,44.2857142857143,58.4228571428571,NA,252,125,85,31,27,281,127,196
2018,22,68,"Mardin",37.3212,40.7245,23.6714285714286,25,4.05628571428571,45.3285714285714,72.6757142857143,NA,249,0,0,169,257,427,249,427
2018,23,68,"Mardin",37.3212,40.7245,21.6142857142857,27.5714285714286,3.15814285714286,34.6,33.0785714285714,NA,267,18,22,38,258,812,249,790
2018,24,68,"Mardin",37.3212,40.7245,23.4428571428571,27.9714285714286,0.738714285714286,34.8,62.7528571428571,NA,267,40,25,143,229,448,227,423
2018,25,68,"Mardin",37.3212,40.7245,16.3714285714286,28.1285714285714,1.867,36.9714285714286,57.6228571428571,NA,358,0,0,307,436,518,358,518
2018,26,68,"Mardin",37.3212,40.7245,17.6857142857143,30.2285714285714,0,30.7714285714286,61.1714285714286,NA,355,0,0,287,515,587,355,587
2018,27,68,"Mardin",37.3212,40.7245,18.4428571428571,32.0857142857143,0,25.3428571428571,23.29,NA,342,0,0,294,349,418,342,418
2018,28,68,"Mardin",37.3212,40.7245,18.2571428571429,31.2714285714286,0.00742857142857143,31.0571428571429,75.1171428571429,NA,286,35,105,156,358,585,251,480
2018,29,68,"Mardin",37.3212,40.7245,21.6857142857143,31.2,0.00742857142857143,27.6714285714286,42.1185714285714,NA,260,0,0,83,220,756,260,756
2018,30,68,"Mardin",37.3212,40.7245,21.7571428571429,30.6857142857143,0,31.0857142857143,71.3216666666667,NA,265,0,0,147,619,822,265,822
2018,31,68,"Mardin",37.3212,40.7245,20.4285714285714,31.5,0.0551428571428571,38.1428571428571,57.8042857142857,NA,267,0,0,195,440,499,267,499
2018,32,68,"Mardin",37.3212,40.7245,20.6,31.3,0,30.8428571428571,45.22,NA,297,0,0,99,181,403,297,403
2018,33,68,"Mardin",37.3212,40.7245,22.1428571428571,31.7142857142857,0,26.9,48.4614285714286,NA,216,0,0,71,154,332,216,332
2018,34,68,"Mardin",37.3212,40.7245,19.2571428571429,30.9857142857143,0,30.7857142857143,44.3528571428571,NA,144,0,0,51,147,227,144,227
2018,35,68,"Mardin",37.3212,40.7245,19.5714285714286,30.8571428571429,0,29.5428571428571,50.8414285714286,NA,201,0,0,62,214,314,201,314
2018,36,68,"Mardin",37.3212,40.7245,16.5857142857143,28.1,0.074,32.7857142857143,62.5,NA,341,72,72,129,164,370,269,298
2018,37,68,"Mardin",37.3212,40.7245,19.9857142857143,27.2428571428571,0.000714285714285714,33.9285714285714,71.3785714285714,NA,241,13,9,60,230,419,228,410
2018,38,68,"Mardin",37.3212,40.7245,18.3857142857143,28.2285714285714,0,25.1142857142857,41.2,NA,189,3,0,36,97,344,186,344
2018,39,68,"Mardin",37.3212,40.7245,16.2428571428571,26.5285714285714,0,27.1,43.0514285714286,NA,180,6,7,36,166,353,174,346
2018,40,68,"Mardin",37.3212,40.7245,22.7285714285714,25.5428571428571,0,29.9142857142857,62.8028571428571,NA,191,70,126,41,91,341,121,215
2018,41,68,"Mardin",37.3212,40.7245,27.5714285714286,23.9285714285714,1.14185714285714,42.0857142857143,176.215714285714,NA,187,97,167,13,105,422,90,255
2018,42,68,"Mardin",37.3212,40.7245,22.7714285714286,22.4,2.11771428571429,48.2285714285714,85.5571428571428,NA,168,109,247,0,0,381,59,134
2018,43,68,"Mardin",37.3212,40.7245,23.0714285714286,15.9714285714286,18.3647142857143,74.3142857142857,55.5485714285714,NA,187,64,165,20,22,402,123,237
2018,44,68,"Mardin",37.3212,40.7245,19.8,16.6428571428571,0.0434285714285714,50.6142857142857,29.2771428571429,NA,196,122,173,8,15,264,74,91
2018,45,68,"Mardin",37.3212,40.7245,17.7571428571429,13.1285714285714,8.24014285714286,81.9714285714286,22.7342857142857,NA,231,102,256,9,74,473,129,217
2018,46,68,"Mardin",37.3212,40.7245,14.8285714285714,12.0857142857143,6.84257142857143,76.1,29.4257142857143,NA,230,60,137,11,38,465,170,328
2018,47,68,"Mardin",37.3212,40.7245,15.7285714285714,11.2714285714286,2.54957142857143,80.0428571428571,26.17,NA,270,108,225,18,58,499,162,274
2018,48,68,"Mardin",37.3212,40.7245,23.4857142857143,11.1,17.321,88.7142857142857,25.6114285714286,NA,245,91,123,0,0,201,154,78
2018,49,68,"Mardin",37.3212,40.7245,20.9142857142857,10.4142857142857,5.18342857142857,87.4428571428571,27.0728571428571,NA,257,127,275,0,0,420,130,145
2018,50,68,"Mardin",37.3212,40.7245,20.9,8.6,13.726,83.6142857142857,23.6942857142857,NA,256,63,74,27,34,305,193,231
2018,51,68,"Mardin",37.3212,40.7245,18.1142857142857,8.31428571428571,6.10142857142857,87.5571428571428,29.7185714285714,NA,250,77,69,19,50,248,173,179
2018,52,68,"Mardin",37.3212,40.7245,26.9428571428571,6.2,7.81614285714286,83.6857142857143,26.3485714285714,NA,244,103,185,4,21,273,141,88
2019,1,68,"Mardin",37.3212,40.7245,25.0125,7.575,2.4315,83.8125,44.21,NA,343,160,471,2,1,784,183,313
2019,2,68,"Mardin",37.3212,40.7245,25.2428571428571,3.67142857142857,10.2275714285714,77.1571428571429,54.382,NA,255,105,91,51,21,208,150,117
2019,3,68,"Mardin",37.3212,40.7245,24.6,4.67142857142857,1.625,78.1571428571429,74.3557142857143,NA,192,99,98,0,0,198,93,100
2019,4,68,"Mardin",37.3212,40.7245,19.9142857142857,7.15714285714286,0.0837142857142857,75.4142857142857,89.2557142857143,NA,308,121,188,0,0,314,187,126
2019,5,68,"Mardin",37.3212,40.7245,23,8,4.67871428571429,79,2.45285714285714,NA,253,33,18,33,19,143,220,125
2019,6,68,"Mardin",37.3212,40.7245,20.8714285714286,7.37142857142857,2.73314285714286,74.1428571428571,2.67,NA,276,228,101,0,0,127,48,26
2019,7,68,"Mardin",37.3212,40.7245,19.2142857142857,6.91428571428571,6.75328571428572,79.1714285714286,2.96142857142857,NA,325,89,73,1,0,234,236,161
2019,8,68,"Mardin",37.3212,40.7245,15.2714285714286,8.18571428571429,0.629714285714286,66.3857142857143,3.52428571428571,NA,305,166,64,2,2,219,139,155
2019,9,68,"Mardin",37.3212,40.7245,21.1285714285714,7.72857142857143,10.398,74.6714285714286,2.87,NA,331,65,93,35,13,310,266,217
2019,10,68,"Mardin",37.3212,40.7245,21.3,9.5,4.34471428571429,70.3,3.28142857142857,NA,359,183,77,8,54,252,176,175
2019,11,68,"Mardin",37.3212,40.7245,26.2857142857143,10.9142857142857,2.86214285714286,77.4285714285714,2.72,NA,373,64,214,12,44,400,309,186
2019,12,68,"Mardin",37.3212,40.7245,23.0285714285714,9.92857142857143,5.61885714285714,62.2714285714286,3.11,NA,343,108,35,14,24,416,235,381
2019,13,68,"Mardin",37.3212,40.7245,25.7,10.4428571428571,10.4618571428571,86.6428571428571,2.84714285714286,NA,256,82,113,1,0,194,174,81
2019,14,68,"Mardin",37.3212,40.7245,18.1714285714286,12.2714285714286,13.6267142857143,83.2285714285714,3.16714285714286,NA,365,160,106,53,42,208,205,102
2019,15,68,"Mardin",37.3212,40.7245,17.7428571428571,14.9857142857143,5.17985714285714,73.1285714285714,3.33285714285714,NA,359,112,61,17,27,183,247,122
2019,16,68,"Mardin",37.3212,40.7245,18.6142857142857,11.8285714285714,11.9427142857143,83.8571428571429,8.11166666666667,NA,318,24,14,136,120,208,294,194
2019,17,68,"Mardin",37.3212,40.7245,17.9,13.5857142857143,1.90942857142857,63.2428571428571,2.88428571428571,NA,412,214,111,4,4,313,198,202
2019,18,68,"Mardin",37.3212,40.7245,18.4571428571429,17.3714285714286,7.21528571428571,71.8428571428571,8.26142857142857,NA,523,210,122,4,1,353,313,231
2019,19,68,"Mardin",37.3212,40.7245,15.9714285714286,18.3285714285714,0.440857142857143,64.1714285714286,35.4285714285714,NA,452,265,216,17,28,386,187,170
2019,20,68,"Mardin",37.3212,40.7245,18.0285714285714,23.9,0,48.4,43.1628571428571,NA,454,337,260,12,20,389,117,129
2019,21,68,"Mardin",37.3212,40.7245,17.7857142857143,24.0285714285714,0,45.7,67.3485714285714,NA,457,71,31,12,15,413,386,382
2019,22,68,"Mardin",37.3212,40.7245,18.1857142857143,28.1428571428571,0,29.4857142857143,39.01,NA,453,213,176,2,1,323,240,147
2019,23,68,"Mardin",37.3212,40.7245,18.5142857142857,28.5571428571429,0,33.0428571428571,77.1785714285714,NA,378,58,121,56,105,532,320,411
2019,24,68,"Mardin",37.3212,40.7245,23.2571428571429,28.6714285714286,0.0502857142857143,30.5571428571429,84.4814285714286,NA,378,114,73,193,141,244,264,171
2019,25,68,"Mardin",37.3212,40.7245,18.9714285714286,27.8428571428571,0.000142857142857143,38.8571428571429,77.2614285714286,NA,306,0,0,241,277,325,306,325
2019,26,68,"Mardin",37.3212,40.7245,21.8428571428571,32.4571428571429,0,25.5571428571429,59.6414285714286,NA,377,0,0,111,176,342,377,342
2019,27,68,"Mardin",37.3212,40.7245,23.2285714285714,30.7857142857143,0,21.5714285714286,63.2371428571429,NA,456,164,119,86,34,222,292,103
2019,28,68,"Mardin",37.3212,40.7245,28.3714285714286,31.0857142857143,0,28.0142857142857,46.9185714285714,NA,398,7,2,127,103,421,391,419
2019,29,68,"Mardin",37.3212,40.7245,19.2571428571429,29.7428571428571,0,33.6571428571429,43.97,NA,453,0,0,133,123,203,453,203
2019,30,68,"Mardin",37.3212,40.7245,18.6142857142857,31.1714285714286,0,29.5142857142857,51.2314285714286,NA,456,3,3,153,182,335,453,332
2019,31,68,"Mardin",37.3212,40.7245,20.0714285714286,31.8857142857143,0,27.6571428571429,53.0914285714286,NA,334,0,0,67,89,375,334,375
2019,32,68,"Mardin",37.3212,40.7245,26.7142857142857,32.9571428571429,1.92457142857143,22.3714285714286,56.7114285714286,NA,346,66,85,16,16,395,280,310
2019,33,68,"Mardin",37.3212,40.7245,20.9428571428571,32.7857142857143,0,29.9285714285714,70.4942857142857,NA,337,125,138,84,188,531,212,393
2019,34,68,"Mardin",37.3212,40.7245,17.5857142857143,30.4142857142857,0,33.1857142857143,58.9771428571429,NA,299,12,4,28,14,345,287,341
2019,35,68,"Mardin",37.3212,40.7245,20.3142857142857,30.9857142857143,0.171142857142857,29.1428571428571,67.0657142857143,NA,307,7,5,54,67,415,300,410
2019,36,68,"Mardin",37.3212,40.7245,18.7571428571429,28.2142857142857,0,29.9428571428571,51.2271428571429,NA,171,0,0,30,41,67,171,67
2019,37,68,"Mardin",37.3212,40.7245,19.2571428571429,27.7142857142857,0.000142857142857143,25.8857142857143,57.2614285714286,NA,218,62,11,6,6,55,156,44
2019,38,68,"Mardin",37.3212,40.7245,21.2285714285714,25.5285714285714,0,33.0857142857143,68.4042857142857,NA,266,1,0,88,56,91,265,91
2019,39,68,"Mardin",37.3212,40.7245,16.4857142857143,24.2285714285714,0,29.8142857142857,54.5542857142857,NA,237,41,17,41,34,79,196,62
2019,40,68,"Mardin",37.3212,40.7245,15.4,24,0.413428571428571,34.0428571428571,66.5971428571429,NA,241,4,2,46,43,111,237,109
2019,41,68,"Mardin",37.3212,40.7245,18.7857142857143,25.1428571428571,0,32.9,75.9816666666667,NA,416,250,315,16,13,448,166,133
2019,42,68,"Mardin",37.3212,40.7245,16.0714285714286,23.1,0.910571428571428,35.2428571428571,50.5771428571429,NA,356,103,58,13,20,408,253,350
2019,43,68,"Mardin",37.3212,40.7245,18.3,19.2714285714286,3.05228571428571,53.8285714285714,3.15,NA,306,136,98,3,1,300,170,202
2019,44,68,"Mardin",37.3212,40.7245,19.9285714285714,15.1142857142857,8.85157142857143,70.8142857142857,8.30285714285714,NA,350,166,99,15,13,250,184,151
2019,45,68,"Mardin",37.3212,40.7245,12.6428571428571,15.2142857142857,0,50.8571428571429,28.36,NA,417,122,94,13,28,328,295,234
2019,46,68,"Mardin",37.3212,40.7245,13.5285714285714,14.2571428571429,0,42.9142857142857,64.0314285714286,NA,401,311,235,8,9,337,90,102
2019,47,68,"Mardin",37.3212,40.7245,14.8428571428571,9.95714285714286,0,38.6142857142857,57.1642857142857,NA,391,223,190,3,1,339,168,149
2019,48,68,"Mardin",37.3212,40.7245,17.8714285714286,11.6857142857143,2.46142857142857,67.3428571428571,67.3285714285714,NA,320,137,110,0,0,251,183,141
2019,49,68,"Mardin",37.3212,40.7245,21.6714285714286,9.3,9.24685714285714,80.1,26.4085714285714,NA,393,222,141,1,0,274,171,133
2019,50,68,"Mardin",37.3212,40.7245,21.1285714285714,8.35714285714286,7.655,90.1571428571429,36.2657142857143,NA,218,121,94,0,0,119,97,25
2019,51,68,"Mardin",37.3212,40.7245,18.3,9.45714285714286,0.513285714285714,64.6714285714286,33.9485714285714,NA,361,233,248,1,0,488,128,240
2019,52,68,"Mardin",37.3212,40.7245,31.6285714285714,8.62857142857143,6.704,78.7571428571429,59.3142857142857,NA,279,48,65,0,0,281,231,216
2020,1,68,"Mardin",37.3212,40.7245,14.82,4.4,6.5586,94.26,31.668,NA,160,96,81,0,0,126,64,45
2020,2,68,"Mardin",37.3212,40.7245,20.6428571428571,4.84285714285714,2.72342857142857,79.6857142857143,25.82,NA,240,163,120,1,2,173,77,53
2020,3,68,"Mardin",37.3212,40.7245,21.4285714285714,3.58571428571429,1.80428571428571,72.0285714285714,32.9166666666667,NA,270,212,291,0,0,382,58,91
2020,4,68,"Mardin",37.3212,40.7245,25.3857142857143,3.05714285714286,3.16957142857143,69.9857142857143,26.6085714285714,NA,358,291,271,3,1,295,67,24
2020,5,68,"Mardin",37.3212,40.7245,18.5857142857143,3.91428571428571,6.29085714285714,77.2428571428571,41.1342857142857,NA,331,240,208,0,0,272,91,64
2020,6,68,"Mardin",37.3212,40.7245,23.5,3.91428571428571,4.74514285714286,79.5714285714286,31.4457142857143,NA,343,105,90,34,5,267,238,177
2020,7,68,"Mardin",37.3212,40.7245,26.0428571428571,-1.15714285714286,2.39428571428571,68.4142857142857,38.1785714285714,NA,341,235,241,0,0,338,106,97
2020,8,68,"Mardin",37.3212,40.7245,20.8428571428571,8.02857142857143,8.001,83.1857142857143,43.2328571428571,NA,283,166,120,0,0,187,117,67
2020,9,68,"Mardin",37.3212,40.7245,23.5,8.88571428571429,2.17285714285714,67.3857142857143,48.0257142857143,NA,393,292,353,0,0,528,101,175
2020,10,68,"Mardin",37.3212,40.7245,19.6285714285714,10.7571428571429,0.0211428571428571,59.3714285714286,41.6214285714286,NA,205,113,90,0,0,210,92,120
2020,11,68,"Mardin",37.3212,40.7245,21.0714285714286,13.7571428571429,0.226428571428571,59.8571428571429,52.4528571428571,NA,115,67,73,3,0,94,48,21
2020,12,68,"Mardin",37.3212,40.7245,23.6142857142857,9.05714285714286,15.5118571428571,82.8428571428571,25.0985714285714,NA,117,29,17,4,0,118,88,101
2020,13,68,"Mardin",37.3212,40.7245,23.7428571428571,11.2857142857143,12.0695714285714,77.3142857142857,27.5542857142857,NA,136,66,51,6,0,92,70,41
2020,14,68,"Mardin",37.3212,40.7245,17.3,9.75714285714286,7.321,83.3857142857143,14.2785714285714,NA,155,64,36,23,20,121,91,85
2020,15,68,"Mardin",37.3212,40.7245,19.3,12.4857142857143,3.21657142857143,73.5142857142857,26.4642857142857,NA,133,56,46,1,0,118,77,72
2020,16,68,"Mardin",37.3212,40.7245,14.4857142857143,13.6571428571429,0.377714285714286,66.6571428571429,3.39285714285714,NA,141,45,54,22,10,106,96,52
2020,17,68,"Mardin",37.3212,40.7245,20.0285714285714,15.0857142857143,6.01785714285714,72.8285714285714,3.16428571428571,NA,137,14,20,12,3,123,123,103
2020,18,68,"Mardin",37.3212,40.7245,16,14.2285714285714,1.96414285714286,71.2428571428571,3.53285714285714,NA,146,62,46,32,18,164,84,118
2020,19,68,"Mardin",37.3212,40.7245,22.3857142857143,15.7571428571429,4.75228571428571,71.7714285714286,3.43428571428571,NA,137,32,22,2,4,157,105,135
2020,20,68,"Mardin",37.3212,40.7245,18.5,20.1142857142857,0,51.8285714285714,4.64428571428571,NA,164,81,50,2,5,164,83,114
2020,21,68,"Mardin",37.3212,40.7245,23.0571428571429,22.2428571428571,2.085,44.3,5.13,NA,146,60,27,31,32,96,86,69
2020,22,68,"Mardin",37.3212,40.7245,17.7857142857143,19,1.79342857142857,54.3428571428571,4.37142857142857,NA,118,18,29,37,27,100,100,71
2020,23,68,"Mardin",37.3212,40.7245,17.1428571428571,22.3428571428571,0.0712857142857143,37.8428571428571,5.00857142857143,NA,112,21,4,45,30,70,91,66
2020,24,68,"Mardin",37.3212,40.7245,19.4571428571429,25.1714285714286,0,35.2571428571429,5.85714285714286,NA,140,38,55,72,45,150,102,95
2020,25,68,"Mardin",37.3212,40.7245,18.7428571428571,25.0571428571429,0.000142857142857143,40.1714285714286,5.10142857142857,NA,137,20,6,53,52,108,117,102
2020,26,68,"Mardin",37.3212,40.7245,17.1857142857143,27.1428571428571,0.0998571428571428,31.8571428571429,5.77571428571429,NA,173,54,24,70,81,133,119,109
2020,27,68,"Mardin",37.3212,40.7245,24.1714285714286,28.9857142857143,0.0512857142857143,31.2571428571429,5.76285714285714,NA,113,86,65,1,2,113,27,48
2020,28,68,"Mardin",37.3212,40.7245,20.0428571428571,30.2,0.0551428571428571,30.8,5.51,NA,164,50,25,4,4,122,114,97
2020,29,68,"Mardin",37.3212,40.7245,20.1714285714286,29.5428571428571,0.556,29.8714285714286,3.62428571428571,NA,186,99,43,61,29,111,87,68
2020,30,68,"Mardin",37.3212,40.7245,19.6285714285714,30.9857142857143,0,26.9714285714286,3.89,NA,190,32,45,59,21,142,158,97
2020,31,68,"Mardin",37.3212,40.7245,19.3714285714286,31.7428571428571,0,26.0714285714286,4.11857142857143,NA,150,61,58,13,6,127,89,69
2020,32,68,"Mardin",37.3212,40.7245,17.9,30.0857142857143,0,27.1857142857143,3.61571428571429,NA,146,42,23,34,17,107,104,84
2020,33,68,"Mardin",37.3212,40.7245,23.7857142857143,28.7857142857143,0,34.2142857142857,3.62857142857143,NA,183,24,12,38,19,83,159,71
2020,34,68,"Mardin",37.3212,40.7245,20.0428571428571,27.6285714285714,0,30.6714285714286,3.54714285714286,NA,197,35,9,41,20,97,162,88
2020,35,68,"Mardin",37.3212,40.7245,18.6857142857143,27.6428571428571,0,26.3285714285714,4.05142857142857,NA,164,83,63,16,32,157,81,94
2020,36,68,"Mardin",37.3212,40.7245,16.9428571428571,29.3428571428571,0.0295714285714286,22.9714285714286,4.60285714285714,NA,179,83,46,52,20,112,96,66
2020,37,68,"Mardin",37.3212,40.7245,18.8857142857143,28.4285714285714,0,24.3,3.77285714285714,NA,193,70,14,34,8,91,123,77
2020,38,68,"Mardin",37.3212,40.7245,14.3285714285714,26.4857142857143,0,28.0285714285714,11.1457142857143,NA,235,12,2,99,88,157,223,155
2020,39,68,"Mardin",37.3212,40.7245,13.2571428571429,24.5428571428571,0,36.6285714285714,59.9471428571429,NA,220,24,15,116,67,129,196,114
2020,40,68,"Mardin",37.3212,40.7245,18.6857142857143,23.0714285714286,0,32.6571428571429,62.015,NA,187,44,13,54,52,154,143,141
2020,41,68,"Mardin",37.3212,40.7245,19.2142857142857,19.8571428571429,0,30.1857142857143,43.0157142857143,NA,182,91,64,1,3,127,91,63
2020,42,68,"Mardin",37.3212,40.7245,11.7571428571429,20.6142857142857,0,28.4571428571429,72.2657142857143,NA,177,34,12,42,44,111,143,99
2020,43,68,"Mardin",37.3212,40.7245,14.6,19.3428571428571,0,33.3142857142857,61.69,NA,194,135,122,3,2,161,59,39
2020,44,68,"Mardin",37.3212,40.7245,18.8142857142857,19.7428571428571,0,25.5142857142857,123.262857142857,NA,255,144,172,0,0,233,111,61
2020,45,68,"Mardin",37.3212,40.7245,23.0428571428571,16.5142857142857,5.69914285714286,63.8857142857143,94.8028571428571,NA,156,79,68,0,0,103,77,35
2020,46,68,"Mardin",37.3212,40.7245,13.7714285714286,13.6142857142857,0.969428571428571,63.0428571428571,42.2714285714286,NA,208,124,74,2,0,109,84,35
2020,47,68,"Mardin",37.3212,40.7245,16.5285714285714,10.7571428571429,0.875714285714286,70.2714285714286,39.7742857142857,NA,173,36,34,8,2,83,137,49
2020,48,68,"Mardin",37.3212,40.7245,19.7,10.0714285714286,0.519857142857143,58.4,37.43,NA,199,127,135,7,2,262,72,127
2020,49,68,"Mardin",37.3212,40.7245,17.1428571428571,9.27142857142857,0.913142857142857,70.5,41.8142857142857,NA,207,123,46,0,0,116,84,70
2020,50,68,"Mardin",37.3212,40.7245,19.7857142857143,8.24285714285714,0.930285714285714,70.4714285714286,38.4457142857143,NA,181,111,43,2,2,98,70,55
2020,51,68,"Mardin",37.3212,40.7245,21.2285714285714,8.74285714285714,1.75114285714286,80.1142857142857,38.8271428571429,NA,171,98,53,1,0,90,73,37
2020,52,68,"Mardin",37.3212,40.7245,18.8285714285714,5,2.61428571428571,68.4571428571429,31.6128571428571,NA,203,58,25,7,2,113,145,88
2020,53,68,"Mardin",37.3212,40.7245,11.975,7.225,0,60.975,46.0925,NA,122,53,32,6,2,111,69,79
2017,1,69,"Yenisehir",36.8121,34.6415,9.64285714285714,9.97142857142857,9.79328571428571,70.0857142857143,NA,NA,563,0,0,235,338,847,563,847
2017,2,69,"Yenisehir",36.8121,34.6415,9.64285714285714,9.34285714285714,3.85685714285714,59.2857142857143,NA,NA,757,37,60,132,280,1214,720,1154
2017,3,69,"Yenisehir",36.8121,34.6415,8.08571428571429,11.0285714285714,0,52.2142857142857,NA,NA,762,173,309,42,81,1449,589,1140
2017,4,69,"Yenisehir",36.8121,34.6415,6.87142857142857,9.28571428571429,0.499428571428571,45.5285714285714,NA,NA,639,202,303,46,65,889,437,586
2017,5,69,"Yenisehir",36.8121,34.6415,8.57142857142857,7.77142857142857,0,44.7571428571429,NA,NA,588,160,314,14,39,1163,428,849
2017,6,69,"Yenisehir",36.8121,34.6415,9.07142857142857,13.9428571428571,0.185571428571429,50.6714285714286,NA,NA,736,135,198,7,16,1519,601,1321
2017,7,69,"Yenisehir",36.8121,34.6415,11.1142857142857,9.57142857142857,0,38.5,NA,NA,492,229,300,0,0,717,263,417
2017,8,69,"Yenisehir",36.8121,34.6415,8.88571428571429,13.0714285714286,0,56.7142857142857,14.7533333333333,NA,739,256,631,0,0,1747,483,1116
2017,9,69,"Yenisehir",36.8121,34.6415,10.1,15.8857142857143,13.1428571428571,50.9285714285714,16.4028571428571,NA,574,84,62,34,117,866,490,804
2017,10,69,"Yenisehir",36.8121,34.6415,11.0571428571429,15.8857142857143,7.39728571428571,57.4142857142857,18.1114285714286,NA,712,126,174,49,46,1043,586,869
2017,11,69,"Yenisehir",36.8121,34.6415,14.3714285714286,13.5428571428571,0.572571428571429,56.3571428571429,5.71428571428571,NA,525,102,105,0,0,725,423,620
2017,12,69,"Yenisehir",36.8121,34.6415,9.12857142857143,16.1,0,58.9857142857143,72.6614285714286,NA,589,203,321,0,0,1077,386,756
2017,13,69,"Yenisehir",36.8121,34.6415,12.6571428571429,16.8714285714286,1.81314285714286,62.4,73.3342857142857,NA,574,60,106,99,165,887,514,781
2017,14,69,"Yenisehir",36.8121,34.6415,13.8142857142857,18.3857142857143,0.344285714285714,61.1,62.8357142857143,NA,639,234,461,0,0,1336,405,875
2017,15,69,"Yenisehir",36.8121,34.6415,11.6857142857143,17.1714285714286,12.9764285714286,58.6428571428571,49.9628571428571,NA,587,102,311,9,31,1187,485,876
2017,16,69,"Yenisehir",36.8121,34.6415,13.3,18.9571428571429,0,65.0714285714286,79.9557142857143,NA,717,310,326,0,0,920,407,594
2017,17,69,"Yenisehir",36.8121,34.6415,9.4,20.6142857142857,0,46.1285714285714,97.1171428571429,NA,731,134,340,0,0,1478,597,1138
2017,18,69,"Yenisehir",36.8121,34.6415,11.4571428571429,21.2857142857143,0.0297142857142857,67.3142857142857,92.3814285714286,NA,506,221,522,0,0,923,285,401
2017,19,69,"Yenisehir",36.8121,34.6415,9.84285714285714,22.5571428571429,0,66.8857142857143,77.6328571428571,NA,471,206,431,0,0,966,265,535
2017,20,69,"Yenisehir",36.8121,34.6415,10.6857142857143,22.3142857142857,0.872857142857143,60.3571428571429,54.7771428571429,NA,472,194,689,0,0,1205,278,516
2017,21,69,"Yenisehir",36.8121,34.6415,11.4428571428571,21.1428571428571,0.917714285714286,64.7428571428571,57.0528571428571,NA,448,151,331,40,61,849,297,518
2017,22,69,"Yenisehir",36.8121,34.6415,11.2,23.1428571428571,0.0152857142857143,64.7857142857143,56.1257142857143,NA,522,142,348,0,0,1015,380,667
2017,23,69,"Yenisehir",36.8121,34.6415,9.4,25.5142857142857,1.16971428571429,71.2,75.6171428571429,NA,578,308,767,0,0,1388,270,621
2017,24,69,"Yenisehir",36.8121,34.6415,10.6857142857143,25.8285714285714,0.0474285714285714,66.2142857142857,62.1971428571429,NA,552,189,600,0,0,1139,363,539
2017,25,69,"Yenisehir",36.8121,34.6415,12.7428571428571,26.2285714285714,0.029,60.1285714285714,55.6414285714286,NA,584,158,394,0,0,1041,426,647
2017,26,69,"Yenisehir",36.8121,34.6415,9.44285714285714,29.1285714285714,0,65.8571428571429,67.2328571428571,NA,564,151,369,50,76,971,413,602
2017,27,69,"Yenisehir",36.8121,34.6415,10.1714285714286,29.8142857142857,0,64.9142857142857,67.82,NA,511,241,314,0,0,642,270,328
2017,28,69,"Yenisehir",36.8121,34.6415,9.4,29.8,0,65.5142857142857,64.2714285714286,NA,481,278,562,0,0,864,203,302
2017,29,69,"Yenisehir",36.8121,34.6415,9.14285714285714,29.9857142857143,0,64.5857142857143,68.8942857142857,NA,532,206,559,0,0,1272,326,713
2017,30,69,"Yenisehir",36.8121,34.6415,10.9428571428571,30.2571428571429,0,62.4,70.0957142857143,NA,531,319,659,0,0,928,212,269
2017,31,69,"Yenisehir",36.8121,34.6415,8.62857142857143,30.0285714285714,1.01285714285714,63.0857142857143,65.8814285714286,NA,559,290,684,0,0,1047,269,363
2017,32,69,"Yenisehir",36.8121,34.6415,9.4,30.3571428571429,0,63.8285714285714,72.84,NA,567,157,374,0,0,1092,410,718
2017,33,69,"Yenisehir",36.8121,34.6415,9.65714285714286,30.2,0,62.3714285714286,72.8485714285714,NA,596,205,660,0,0,1199,391,539
2017,34,69,"Yenisehir",36.8121,34.6415,10.1714285714286,29.7428571428571,0,61.4714285714286,66.8142857142857,NA,601,236,527,0,0,1280,365,753
2017,35,69,"Yenisehir",36.8121,34.6415,10.1714285714286,29.4428571428571,0,60,62.0514285714286,NA,493,205,614,0,0,1014,288,400
2017,36,69,"Yenisehir",36.8121,34.6415,8.31428571428571,28.1428571428571,1.42671428571429,54.4428571428571,71.0557142857143,NA,507,208,799,0,0,1321,299,522
2017,37,69,"Yenisehir",36.8121,34.6415,8.88571428571429,28.6571428571429,0,65.1,83.88,NA,589,133,452,0,0,1138,456,686
2017,38,69,"Yenisehir",36.8121,34.6415,10.4142857142857,28.1571428571429,0,61.7,78.1614285714286,NA,671,152,342,0,0,1312,519,970
2017,39,69,"Yenisehir",36.8121,34.6415,11.2,26.1428571428571,0.442714285714286,55.6,70.3816666666667,NA,782,131,300,0,0,1630,651,1330
2017,40,69,"Yenisehir",36.8121,34.6415,9.4,24.0571428571429,0.0285714285714286,39.8428571428571,NA,NA,543,108,393,0,0,1137,435,744
2017,41,69,"Yenisehir",36.8121,34.6415,9.05714285714286,23.1142857142857,0.000142857142857143,39.6,NA,NA,487,80,173,18,19,843,407,670
2017,42,69,"Yenisehir",36.8121,34.6415,8.25714285714286,22.8428571428571,0,37.5857142857143,74.17,NA,530,126,156,24,28,815,404,659
2017,43,69,"Yenisehir",36.8121,34.6415,5.07142857142857,21.7428571428571,1.29028571428571,56.3142857142857,70.4242857142857,NA,506,239,574,76,89,919,267,345
2017,44,69,"Yenisehir",36.8121,34.6415,5.62857142857143,18.2571428571429,7.17371428571429,55.9571428571429,53.32,NA,561,104,137,197,546,1102,457,965
2017,45,69,"Yenisehir",36.8121,34.6415,6.91428571428571,18.0428571428571,0.0295714285714286,54.2857142857143,74.9342857142857,NA,577,161,341,120,157,829,416,488
2017,46,69,"Yenisehir",36.8121,34.6415,9.02857142857143,19.8714285714286,5.422,45.4714285714286,111.417142857143,NA,587,26,38,51,122,1085,561,1047
2017,47,69,"Yenisehir",36.8121,34.6415,9.28571428571429,14.1714285714286,1.71757142857143,51.1571428571429,90.4714285714286,NA,418,0,0,92,126,804,418,804
2017,48,69,"Yenisehir",36.8121,34.6415,7.21428571428571,15,4.14528571428571,62.9857142857143,90.4871428571429,NA,386,0,0,116,171,619,386,619
2017,49,69,"Yenisehir",36.8121,34.6415,6.54285714285714,12.3714285714286,0.586571428571429,51.8142857142857,101.787142857143,NA,407,0,0,131,315,645,407,645
2017,50,69,"Yenisehir",36.8121,34.6415,4.88571428571429,14.9285714285714,0.0285714285714286,55.6428571428571,119.83,NA,346,0,0,62,112,442,346,442
2017,51,69,"Yenisehir",36.8121,34.6415,9.01428571428571,16.4428571428571,3.42542857142857,57.3714285714286,186.741666666667,NA,386,0,0,75,88,349,386,349
2017,52,69,"Yenisehir",36.8121,34.6415,9.6375,13.3,5.62425,54.725,91.8714285714286,NA,528,0,0,60,142,507,528,507
2018,1,69,"Yenisehir",36.8121,34.6415,14.0125,11.6,13.32975,69.2,72.41125,NA,618,0,0,134,209,914,618,914
2018,2,69,"Yenisehir",36.8121,34.6415,11.7142857142857,12.2428571428571,0.958,62.4857142857143,130.816,NA,624,0,0,71,62,1309,624,1309
2018,3,69,"Yenisehir",36.8121,34.6415,14.7285714285714,10.8571428571429,2.27728571428571,65.0714285714286,93.99,NA,639,0,0,198,198,655,639,655
2018,4,69,"Yenisehir",36.8121,34.6415,14.5571428571429,10.4285714285714,13.6078571428571,68.8571428571429,71.4357142857143,NA,604,0,0,298,434,764,604,764
2018,5,69,"Yenisehir",36.8121,34.6415,9.2,10.9,0,66.0714285714286,116.661428571429,NA,670,0,0,36,57,819,670,819
2018,6,69,"Yenisehir",36.8121,34.6415,11.1571428571429,14.5428571428571,0,61.7,157.364285714286,NA,704,0,0,193,251,1022,704,1022
2018,7,69,"Yenisehir",36.8121,34.6415,17.4285714285714,14.7571428571429,0.215,61.2285714285714,80.6328571428571,NA,478,82,74,125,137,557,396,483
2018,8,69,"Yenisehir",36.8121,34.6415,12.4,14.0714285714286,3.91142857142857,66.9,71.2771428571429,NA,711,75,214,74,36,1321,636,1107
2018,9,69,"Yenisehir",36.8121,34.6415,14.0571428571429,14.3,2.95971428571429,71.7714285714286,75.02,NA,621,13,3,9,9,956,608,953
2018,10,69,"Yenisehir",36.8121,34.6415,10.4142857142857,16.7,0.0572857142857143,70.3714285714286,134.244285714286,NA,556,193,559,6,0,1330,363,771
2018,11,69,"Yenisehir",36.8121,34.6415,11.2142857142857,16.8142857142857,0.0287142857142857,65.9142857142857,72.7457142857143,NA,551,142,298,0,0,1426,409,1128
2018,12,69,"Yenisehir",36.8121,34.6415,14.8857142857143,19.3142857142857,0,55.1285714285714,114.195714285714,NA,425,180,433,0,0,1187,245,754
2018,13,69,"Yenisehir",36.8121,34.6415,12.0714285714286,18.2571428571429,1.91542857142857,57.9714285714286,125.878571428571,NA,356,50,44,0,0,428,306,384
2018,14,69,"Yenisehir",36.8121,34.6415,9.65714285714286,19.1,0.0142857142857143,52.1142857142857,65.7116666666667,NA,407,23,40,0,0,486,384,446
2018,15,69,"Yenisehir",36.8121,34.6415,11.0142857142857,19.0428571428571,2.00142857142857,73.7142857142857,81.15,NA,374,108,117,0,0,450,266,333
2018,16,69,"Yenisehir",36.8121,34.6415,10.1714285714286,20.1142857142857,0.713428571428571,57.3285714285714,82.0228571428571,NA,411,42,91,12,22,648,369,557
2018,17,69,"Yenisehir",36.8121,34.6415,9.91428571428571,22.4285714285714,0.242857142857143,56.5571428571429,85.3242857142857,NA,419,156,152,0,0,652,263,500
2018,18,69,"Yenisehir",36.8121,34.6415,9.6,25.7428571428571,0.0437142857142857,46.6714285714286,113.428571428571,NA,303,119,232,0,0,474,184,242
2018,19,69,"Yenisehir",36.8121,34.6415,10.9428571428571,21.2428571428571,3.28842857142857,62.7857142857143,51.984,NA,275,136,175,0,0,467,139,292
2018,20,69,"Yenisehir",36.8121,34.6415,8,25.3285714285714,0.000142857142857143,54.5714285714286,70.0271428571429,NA,204,43,66,0,0,306,161,240
2018,21,69,"Yenisehir",36.8121,34.6415,8.88571428571429,25.8714285714286,2.22528571428571,64.3,97.8585714285714,NA,252,140,191,0,0,281,112,90
2018,22,69,"Yenisehir",36.8121,34.6415,9.58571428571429,25.1428571428571,2.00314285714286,60.1714285714286,80.3675,NA,249,139,331,0,0,427,110,96
2018,23,69,"Yenisehir",36.8121,34.6415,10.4571428571429,27.4,0,62.3285714285714,81.5775,NA,267,114,383,0,0,812,153,429
2018,24,69,"Yenisehir",36.8121,34.6415,10.6857142857143,26.6142857142857,1.81428571428571,64.7571428571429,56.3257142857143,NA,267,127,292,0,0,448,140,156
2018,25,69,"Yenisehir",36.8121,34.6415,11.4285714285714,26.3714285714286,0.416,65.1714285714286,51.0228571428571,NA,358,126,231,0,0,518,232,287
2018,26,69,"Yenisehir",36.8121,34.6415,10.6285714285714,27.3428571428571,0,65.0714285714286,53.8028571428571,NA,355,75,114,0,0,587,280,473
2018,27,69,"Yenisehir",36.8121,34.6415,8.61428571428571,28.5428571428571,0,67.7857142857143,64.1742857142857,NA,342,234,287,0,0,418,108,131
2018,28,69,"Yenisehir",36.8121,34.6415,8.62857142857143,29.3,0,66.9428571428572,70.3842857142857,NA,286,158,317,0,0,585,128,268
2018,29,69,"Yenisehir",36.8121,34.6415,9.91428571428571,29.7571428571429,0,64.3428571428571,74.5757142857143,NA,260,142,208,0,0,756,118,548
2018,30,69,"Yenisehir",36.8121,34.6415,10.1714285714286,29.6428571428571,0,64.1857142857143,68.67,NA,265,128,489,0,0,822,137,333
2018,31,69,"Yenisehir",36.8121,34.6415,9.4,29.8857142857143,0.057,68.1857142857143,73.7242857142857,NA,267,124,119,0,0,499,143,380
2018,32,69,"Yenisehir",36.8121,34.6415,12.1714285714286,30.3857142857143,0,59.9285714285714,66.15,NA,297,81,98,0,0,403,216,305
2018,33,69,"Yenisehir",36.8121,34.6415,9.65714285714286,29.8285714285714,0,62.1428571428571,62.45,NA,216,132,187,0,0,332,84,145
2018,34,69,"Yenisehir",36.8121,34.6415,9.4,30.0285714285714,0,66.0142857142857,67.476,NA,144,84,110,0,0,227,60,117
2018,35,69,"Yenisehir",36.8121,34.6415,9.4,29.7,0,61.1142857142857,64.2728571428571,NA,201,45,87,0,0,314,156,227
2018,36,69,"Yenisehir",36.8121,34.6415,10.4285714285714,28.9857142857143,0.214428571428571,60.0857142857143,69.9157142857143,NA,341,92,134,0,0,370,249,236
2018,37,69,"Yenisehir",36.8121,34.6415,10.5142857142857,27.8142857142857,0.0142857142857143,48.3428571428571,78.142,NA,241,133,195,0,0,419,108,224
2018,38,69,"Yenisehir",36.8121,34.6415,12.4571428571429,28.2285714285714,0,56.5857142857143,72.4457142857143,NA,189,66,110,39,30,344,123,234
2018,39,69,"Yenisehir",36.8121,34.6415,9.21428571428571,27.2,0.199857142857143,56.7571428571429,82.8957142857143,NA,180,75,131,2,0,353,105,222
2018,40,69,"Yenisehir",36.8121,34.6415,10.8857142857143,25.6428571428571,0.142857142857143,48.5857142857143,63.8828571428571,NA,191,65,111,0,0,341,126,230
2018,41,69,"Yenisehir",36.8121,34.6415,11.2,23.7285714285714,2.012,57.9285714285714,133.41,NA,187,2,2,55,141,422,185,420
2018,42,69,"Yenisehir",36.8121,34.6415,8.48571428571429,24.4142857142857,2.91114285714286,52.7,188.802857142857,NA,168,0,0,12,14,381,168,381
2018,43,69,"Yenisehir",36.8121,34.6415,10.1571428571429,20.7714285714286,3.04714285714286,53.6285714285714,72.46,NA,187,88,242,34,46,402,99,160
2018,44,69,"Yenisehir",36.8121,34.6415,4.74285714285714,21.0857142857143,0.000142857142857143,38.6428571428571,89.93,NA,196,6,3,2,10,264,190,261
2018,45,69,"Yenisehir",36.8121,34.6415,7.47142857142857,19.3857142857143,1.99771428571429,51.5285714285714,69.705,NA,231,94,187,0,0,473,137,286
2018,46,69,"Yenisehir",36.8121,34.6415,6.61428571428571,16.2714285714286,0.457714285714286,45.2142857142857,63.6557142857143,NA,230,52,138,1,2,465,178,327
2018,47,69,"Yenisehir",36.8121,34.6415,6.08571428571429,16.8571428571429,1.61342857142857,53.9285714285714,NA,NA,270,85,179,51,89,499,185,320
2018,48,69,"Yenisehir",36.8121,34.6415,8.3,16.7428571428571,4.84357142857143,62.7,93.9,NA,245,23,5,39,63,201,222,196
2018,49,69,"Yenisehir",36.8121,34.6415,9.18571428571429,13.9142857142857,32.1248571428571,70.0857142857143,58.7957142857143,NA,257,4,6,108,279,420,253,414
2018,50,69,"Yenisehir",36.8121,34.6415,14.0428571428571,13.9857142857143,5.04557142857143,57.3428571428571,73.0371428571429,NA,256,0,0,26,46,305,256,305
2018,51,69,"Yenisehir",36.8121,34.6415,7.94285714285714,12.9714285714286,18.0212857142857,71.9857142857143,81.5885714285714,NA,250,1,1,62,61,248,249,247
2018,52,69,"Yenisehir",36.8121,34.6415,8.6,11.4714285714286,12.0081428571429,61.9571428571429,101.71,NA,244,0,0,63,63,273,244,273
2019,1,69,"Yenisehir",36.8121,34.6415,10.9625,10.7875,21.497375,75.7375,69.755,NA,343,0,0,125,429,784,343,784
2019,2,69,"Yenisehir",36.8121,34.6415,10.1714285714286,9.37142857142857,0.859571428571429,51.7142857142857,89.6757142857143,NA,255,2,2,14,10,208,253,206
2019,3,69,"Yenisehir",36.8121,34.6415,15.6285714285714,10,13.941,60.7428571428571,93.7042857142857,NA,192,74,86,19,40,198,118,112
2019,4,69,"Yenisehir",36.8121,34.6415,9.6,13.1,2.88457142857143,51.3428571428571,137.925714285714,NA,308,2,2,22,21,314,306,312
2019,5,69,"Yenisehir",36.8121,34.6415,10.5857142857143,12.6428571428571,3.40028571428571,60.5428571428571,136.574,NA,253,83,48,8,2,143,170,95
2019,6,69,"Yenisehir",36.8121,34.6415,17.8571428571429,12.0714285714286,13.636,64.5857142857143,61.742,NA,276,0,0,42,31,127,276,127
2019,7,69,"Yenisehir",36.8121,34.6415,12.1285714285714,12.2142857142857,2.12757142857143,66.3428571428571,76.598,NA,325,60,28,6,0,234,265,206
2019,8,69,"Yenisehir",36.8121,34.6415,8.05714285714286,13.5571428571429,0.215285714285714,60.5714285714286,89.2328571428571,NA,305,124,130,4,0,219,181,89
2019,9,69,"Yenisehir",36.8121,34.6415,17.2571428571429,12.2285714285714,1.78571428571429,58.3428571428571,73.3828571428571,NA,331,58,16,43,44,310,273,294
2019,10,69,"Yenisehir",36.8121,34.6415,11.7857142857143,13.7285714285714,2.85542857142857,63.7142857142857,73.6,NA,359,137,133,56,26,252,222,119
2019,11,69,"Yenisehir",36.8121,34.6415,12.1857142857143,14.8428571428571,5.14442857142857,69.5,71.8557142857143,NA,373,191,137,11,11,400,182,263
2019,12,69,"Yenisehir",36.8121,34.6415,8.5,16.4714285714286,0,51.8714285714286,65.71,NA,343,45,266,0,0,416,298,150
2019,13,69,"Yenisehir",36.8121,34.6415,10.9285714285714,14.6142857142857,6.89885714285714,61.5285714285714,51.9983333333333,NA,256,108,133,28,18,194,148,61
2019,14,69,"Yenisehir",36.8121,34.6415,10.3714285714286,16.6,0.174428571428571,63.3285714285714,52.84,NA,365,234,116,0,0,208,131,92
2019,15,69,"Yenisehir",36.8121,34.6415,10.1142857142857,18.5571428571429,0.000142857142857143,60.1714285714286,NA,NA,359,175,131,0,0,183,184,52
2019,16,69,"Yenisehir",36.8121,34.6415,13.0428571428571,15.8857142857143,0.420142857142857,58.9714285714286,NA,NA,318,52,35,0,0,208,266,173
2019,17,69,"Yenisehir",36.8121,34.6415,9.65714285714286,18.5285714285714,0.0148571428571429,52.4857142857143,NA,NA,412,32,18,48,47,313,380,295
2019,18,69,"Yenisehir",36.8121,34.6415,9.14285714285714,21.1714285714286,0.100142857142857,59.2285714285714,NA,NA,523,285,220,0,0,353,238,133
2019,19,69,"Yenisehir",36.8121,34.6415,13.3,20.6714285714286,0.185571428571429,56.5714285714286,NA,NA,452,122,113,0,0,386,330,273
2019,20,69,"Yenisehir",36.8121,34.6415,9.28571428571429,24.8285714285714,0,53.6142857142857,NA,NA,454,92,86,0,0,389,362,303
2019,21,69,"Yenisehir",36.8121,34.6415,9.12857142857143,24.3571428571429,0.0142857142857143,67.6714285714286,NA,NA,457,168,164,0,0,413,289,249
2019,22,69,"Yenisehir",36.8121,34.6415,8.37142857142857,26.2142857142857,0,62.6571428571429,NA,NA,453,128,133,0,0,323,325,190
2019,23,69,"Yenisehir",36.8121,34.6415,11.1857142857143,26.1857142857143,1.14128571428571,63.3714285714286,NA,NA,378,207,226,0,0,532,171,306
2019,24,69,"Yenisehir",36.8121,34.6415,9.4,26.0428571428571,0.0165714285714286,66.8714285714286,NA,NA,378,193,122,0,0,244,185,122
2019,25,69,"Yenisehir",36.8121,34.6415,10.9428571428571,26.6571428571429,0.0318571428571429,66.9571428571429,NA,NA,306,132,162,0,0,325,174,163
2019,26,69,"Yenisehir",36.8121,34.6415,9.08571428571429,29.2857142857143,0,67.0857142857143,NA,NA,377,270,181,0,0,342,107,161
2019,27,69,"Yenisehir",36.8121,34.6415,9.4,28.4857142857143,0,60,NA,NA,456,365,174,0,0,222,91,48
2019,28,69,"Yenisehir",36.8121,34.6415,8.72857142857143,29.0571428571429,0.285714285714286,65.0142857142857,NA,NA,398,364,400,0,0,421,34,21
2019,29,69,"Yenisehir",36.8121,34.6415,9.65714285714286,28.2142857142857,0.0327142857142857,61.5285714285714,NA,NA,453,179,94,0,0,203,274,109
2019,30,69,"Yenisehir",36.8121,34.6415,9.91428571428571,29.6285714285714,0,61.2571428571429,NA,NA,456,229,152,0,0,335,227,183
2019,31,69,"Yenisehir",36.8121,34.6415,8.62857142857143,29.8571428571429,0,66.6571428571429,NA,NA,334,189,233,0,0,375,145,142
2019,32,69,"Yenisehir",36.8121,34.6415,9.65714285714286,30,0.998857142857143,61.3714285714286,NA,NA,346,182,233,0,0,395,164,162
2019,33,69,"Yenisehir",36.8121,34.6415,8.05714285714286,29.9714285714286,0,64.5,NA,NA,337,183,197,0,0,531,154,334
2019,34,69,"Yenisehir",36.8121,34.6415,9.34285714285714,29.7,0.00128571428571429,52.8142857142857,NA,NA,299,136,182,0,0,345,163,163
2019,35,69,"Yenisehir",36.8121,34.6415,7.8,30.3,0,63.0714285714286,NA,NA,307,177,255,0,0,415,130,160
2019,36,69,"Yenisehir",36.8121,34.6415,10.9428571428571,29.4428571428571,0.00142857142857143,58.5142857142857,NA,NA,171,72,37,0,0,67,99,30
2019,37,69,"Yenisehir",36.8121,34.6415,10.4285714285714,28.6571428571429,2.28242857142857,51.7142857142857,NA,NA,218,59,15,1,0,55,159,40
2019,38,69,"Yenisehir",36.8121,34.6415,10.1142857142857,26.9857142857143,0,47.0142857142857,NA,NA,266,116,24,0,0,91,150,67
2019,39,69,"Yenisehir",36.8121,34.6415,10.1714285714286,26.2285714285714,0,54.9142857142857,NA,NA,237,78,44,0,0,79,159,35
2019,40,69,"Yenisehir",36.8121,34.6415,13.4,26.1714285714286,0,58.9571428571429,NA,NA,241,51,35,0,0,111,190,76
2019,41,69,"Yenisehir",36.8121,34.6415,9.27142857142857,25.7857142857143,0.00171428571428571,48.8714285714286,NA,NA,416,212,237,6,5,448,204,211
2019,42,69,"Yenisehir",36.8121,34.6415,9.6,26.7571428571429,0.443428571428571,45.0428571428571,NA,NA,356,43,67,37,61,408,313,341
2019,43,69,"Yenisehir",36.8121,34.6415,8.82857142857143,24.3,0.0285714285714286,43.1142857142857,NA,NA,306,54,96,53,46,300,252,204
2019,44,69,"Yenisehir",36.8121,34.6415,10.1,20.3,1.44385714285714,57.5285714285714,NA,NA,350,91,70,30,14,250,259,180
2019,45,69,"Yenisehir",36.8121,34.6415,6.88571428571429,22.2,0,36.4,NA,NA,417,9,3,85,96,328,408,325
2019,46,69,"Yenisehir",36.8121,34.6415,6.08571428571429,21.7714285714286,1.842,38,NA,NA,401,158,115,59,55,337,243,222
2019,47,69,"Yenisehir",36.8121,34.6415,5.82857142857143,17.1857142857143,0,38.8428571428571,NA,NA,391,55,28,72,55,339,336,311
2019,48,69,"Yenisehir",36.8121,34.6415,6.8,16.7428571428571,2.344,56.2142857142857,NA,NA,320,24,6,21,22,251,296,245
2019,49,69,"Yenisehir",36.8121,34.6415,5.71428571428571,14.3142857142857,0.0148571428571429,52.9285714285714,NA,NA,393,43,24,61,28,274,350,250
2019,50,69,"Yenisehir",36.8121,34.6415,11.2714285714286,13.4571428571429,10.2011428571429,64.3857142857143,NA,NA,218,4,4,24,7,119,214,115
2019,51,69,"Yenisehir",36.8121,34.6415,4.68571428571429,14.1571428571429,0,66.4142857142857,NA,NA,361,41,82,47,123,488,320,406
2019,52,69,"Yenisehir",36.8121,34.6415,11.5,11.9857142857143,14.6032857142857,71.1714285714286,NA,NA,279,0,0,93,63,281,279,281
2020,1,69,"Yenisehir",36.8121,34.6415,7.08,11.12,6.8394,62.76,NA,NA,160,4,2,14,11,126,156,124
2020,2,69,"Yenisehir",36.8121,34.6415,9.3,10.3428571428571,23.9592857142857,65.6142857142857,NA,NA,240,0,0,53,59,173,240,173
2020,3,69,"Yenisehir",36.8121,34.6415,8.14285714285714,11.4571428571429,0.885428571428571,54.8,NA,NA,270,18,9,29,24,382,252,373
2020,4,69,"Yenisehir",36.8121,34.6415,5.21428571428571,9.78571428571429,0,41.5285714285714,NA,NA,358,77,22,3,0,295,281,273
2020,5,69,"Yenisehir",36.8121,34.6415,4.42857142857143,11.8428571428571,2.00214285714286,54.1571428571429,NA,NA,331,29,23,41,30,272,302,249
2020,6,69,"Yenisehir",36.8121,34.6415,16.3714285714286,11.0714285714286,3.80028571428571,63.3571428571429,NA,NA,343,151,119,46,26,267,192,148
2020,7,69,"Yenisehir",36.8121,34.6415,9.65714285714286,8.31428571428571,0.285714285714286,46.5857142857143,NA,NA,341,1,1,24,10,338,340,337
2020,8,69,"Yenisehir",36.8121,34.6415,9.6,13.3571428571429,6.48957142857143,60.6714285714286,NA,NA,283,33,5,36,18,187,250,182
2020,9,69,"Yenisehir",36.8121,34.6415,6.6,14.1,2.46271428571429,66.1142857142857,NA,NA,393,155,143,5,0,528,238,385
2020,10,69,"Yenisehir",36.8121,34.6415,8,16.3714285714286,0,59.1428571428571,NA,NA,205,106,131,0,0,210,99,79
2020,11,69,"Yenisehir",36.8121,34.6415,10.1,18.3142857142857,2.758,56.9857142857143,NA,NA,115,22,3,24,18,94,93,91
2020,12,69,"Yenisehir",36.8121,34.6415,9.65714285714286,12.9,2.25842857142857,60.4,NA,NA,117,25,19,21,11,118,92,99
2020,13,69,"Yenisehir",36.8121,34.6415,12.7714285714286,16.8142857142857,1.96942857142857,58.9428571428571,NA,NA,136,49,18,9,2,92,87,74
2020,14,69,"Yenisehir",36.8121,34.6415,14.5857142857143,17.3285714285714,0.857857142857143,54.8857142857143,NA,NA,155,51,59,4,4,121,104,62
2020,15,69,"Yenisehir",36.8121,34.6415,9.91428571428571,17.3285714285714,0.0151428571428571,67.9,NA,NA,133,98,60,0,0,118,35,58
2020,16,69,"Yenisehir",36.8121,34.6415,8.24285714285714,19.0428571428571,0.0855714285714286,59.3285714285714,NA,NA,141,55,50,0,0,106,86,56
2020,17,69,"Yenisehir",36.8121,34.6415,8.78571428571429,18.8142857142857,0.614142857142857,64.3714285714286,NA,NA,137,72,72,6,1,123,65,51
2020,18,69,"Yenisehir",36.8121,34.6415,10.6857142857143,19.5,0.793,68.4,NA,NA,146,101,120,0,0,164,45,44
2020,19,69,"Yenisehir",36.8121,34.6415,10.4285714285714,20.4,0.574857142857143,63.1285714285714,NA,NA,137,77,99,0,0,157,60,58
2020,20,69,"Yenisehir",36.8121,34.6415,7.8,24.9428571428571,0,55.4142857142857,NA,NA,164,54,57,7,6,164,110,107
2020,21,69,"Yenisehir",36.8121,34.6415,8.77142857142857,26.6285714285714,1.28442857142857,46.0285714285714,NA,NA,146,50,51,0,0,96,96,45
2020,22,69,"Yenisehir",36.8121,34.6415,9.52857142857143,22.3,0,54.3142857142857,NA,NA,118,76,52,0,0,100,42,48
2020,23,69,"Yenisehir",36.8121,34.6415,12.5428571428571,23.6428571428571,0,57.0285714285714,NA,NA,112,29,28,0,0,70,83,42
2020,24,69,"Yenisehir",36.8121,34.6415,9.54285714285714,23.8285714285714,1.31485714285714,72.6571428571429,NA,NA,140,103,123,0,0,150,37,27
2020,25,69,"Yenisehir",36.8121,34.6415,9.14285714285714,24.5142857142857,0.200857142857143,73.6857142857143,NA,NA,137,100,90,2,0,108,37,18
2020,26,69,"Yenisehir",36.8121,34.6415,9.14285714285714,25.9571428571429,0,74.7428571428571,NA,NA,173,153,124,0,0,133,20,9
2020,27,69,"Yenisehir",36.8121,34.6415,8.47142857142857,27.7,0,75.8142857142857,NA,NA,113,94,96,0,0,113,19,17
2020,28,69,"Yenisehir",36.8121,34.6415,9.9,28.4285714285714,0,74.2285714285714,NA,NA,164,135,107,0,0,122,29,15
2020,29,69,"Yenisehir",36.8121,34.6415,7.42857142857143,29.8428571428571,0,65.6,NA,NA,186,87,54,0,0,111,99,57
2020,30,69,"Yenisehir",36.8121,34.6415,7.8,30.1285714285714,0,64.2714285714286,NA,NA,190,139,108,0,0,142,51,34
2020,31,69,"Yenisehir",36.8121,34.6415,9.61428571428571,30.1714285714286,0,72.7714285714286,NA,NA,150,118,106,0,0,127,32,21
2020,32,69,"Yenisehir",36.8121,34.6415,8.78571428571428,29.8285714285714,0,71.7142857142857,NA,NA,146,136,100,0,0,107,10,7
2020,33,69,"Yenisehir",36.8121,34.6415,12.4714285714286,29.1714285714286,0.000142857142857143,66.2,NA,NA,183,107,50,0,0,83,76,33
2020,34,69,"Yenisehir",36.8121,34.6415,11.7714285714286,29.0428571428571,0.285285714285714,62.2571428571429,NA,NA,197,144,69,17,3,97,53,28
2020,35,69,"Yenisehir",36.8121,34.6415,9.18571428571429,28.9285714285714,0,65.9428571428572,NA,NA,164,109,125,0,0,157,55,32
2020,36,69,"Yenisehir",36.8121,34.6415,9.6,29.9,0,70.2285714285714,NA,NA,179,84,32,0,0,112,95,80
2020,37,69,"Yenisehir",36.8121,34.6415,10,29.6714285714286,0,61.6857142857143,NA,NA,193,70,24,36,8,91,123,67
2020,38,69,"Yenisehir",36.8121,34.6415,9.08571428571429,28.9,0,72.8285714285714,NA,NA,235,204,125,0,0,157,31,32
2020,39,69,"Yenisehir",36.8121,34.6415,9.74285714285714,27.4285714285714,0.000857142857142857,67.9857142857143,NA,NA,220,128,66,0,0,129,92,63
2020,40,69,"Yenisehir",36.8121,34.6415,11.4571428571429,26.2714285714286,0,65.7714285714286,NA,NA,187,130,108,19,1,154,57,46
2020,41,69,"Yenisehir",36.8121,34.6415,11.8142857142857,26.4714285714286,0,47.7857142857143,NA,NA,182,6,7,27,11,127,176,120
2020,42,69,"Yenisehir",36.8121,34.6415,8.15714285714286,24.7142857142857,0,66.9714285714286,NA,NA,177,39,35,8,5,111,138,76
2020,43,69,"Yenisehir",36.8121,34.6415,11.8571428571429,24.8428571428571,0,53.1714285714286,NA,NA,194,21,17,37,14,161,173,144
2020,44,69,"Yenisehir",36.8121,34.6415,9.6,23.0285714285714,0,55.1285714285714,NA,NA,255,10,8,45,33,233,245,225
2020,45,69,"Yenisehir",36.8121,34.6415,17.4714285714286,19.7714285714286,3.13228571428571,57.3857142857143,NA,NA,156,0,0,50,31,103,156,103
2020,46,69,"Yenisehir",36.8121,34.6415,8.77142857142857,18.6142857142857,0.000142857142857143,49.3428571428571,NA,NA,208,0,0,81,31,109,208,109
2020,47,69,"Yenisehir",36.8121,34.6415,13.0142857142857,16.3857142857143,0.529857142857143,52.9,NA,NA,173,0,0,67,23,83,173,83
2020,48,69,"Yenisehir",36.8121,34.6415,12.7285714285714,14.3714285714286,0.0144285714285714,46.8285714285714,NA,NA,199,0,0,71,80,262,199,262
2020,49,69,"Yenisehir",36.8121,34.6415,11.9857142857143,14.7142857142857,0.886428571428571,57.3142857142857,NA,NA,207,0,0,107,46,116,207,116
2020,50,69,"Yenisehir",36.8121,34.6415,16.9714285714286,14.4428571428571,2.61285714285714,64.1571428571429,NA,NA,181,0,0,49,22,98,181,98
2020,51,69,"Yenisehir",36.8121,34.6415,15.2428571428571,14.3857142857143,8.43528571428572,60.8,NA,NA,171,0,0,76,30,90,171,90
2020,52,69,"Yenisehir",36.8121,34.6415,14.6285714285714,11.9285714285714,0.000142857142857143,47.4,NA,NA,203,0,0,78,45,113,203,113
2020,53,69,"Yenisehir",36.8121,34.6415,8.75,13.025,0,42.95,80.7,49.865,122,0,0,44,34,111,122,111
2017,1,70,"Musluhittin",37.2153,28.3636,12.5285714285714,3.3,18.3421428571429,84.6857142857143,NA,NA,563,312,494,137,179,847,251,353
2017,2,70,"Musluhittin",37.2153,28.3636,9.4,3.1,11.2284285714286,84.5571428571428,NA,NA,757,330,547,137,153,1214,427,667
2017,3,70,"Musluhittin",37.2153,28.3636,10.1142857142857,5.88571428571429,14.7851428571429,84.1714285714286,NA,NA,762,318,725,265,419,1449,444,724
2017,4,70,"Musluhittin",37.2153,28.3636,15.5857142857143,4.55714285714286,2.65728571428571,67.3142857142857,NA,NA,639,51,79,234,258,889,588,810
2017,5,70,"Musluhittin",37.2153,28.3636,8.9,5.64285714285714,1.57128571428571,73.9142857142857,NA,NA,588,0,0,269,744,1163,588,1163
2017,6,70,"Musluhittin",37.2153,28.3636,12.7285714285714,9.82857142857143,1.17157142857143,77.5428571428571,NA,NA,736,260,389,310,807,1519,476,1130
2017,7,70,"Musluhittin",37.2153,28.3636,17.1571428571429,5.52857142857143,0.0285714285714286,48.0428571428571,NA,NA,492,134,113,352,588,717,358,604
2017,8,70,"Musluhittin",37.2153,28.3636,8.57142857142857,8,0.185714285714286,79.6285714285714,NA,NA,739,616,1370,12,109,1747,123,377
2017,9,70,"Musluhittin",37.2153,28.3636,9.28571428571428,9.65714285714286,3.72842857142857,73.2428571428571,NA,NA,574,248,418,241,355,866,326,448
2017,10,70,"Musluhittin",37.2153,28.3636,11.4,8.34285714285714,14.9875714285714,83.1714285714286,NA,NA,712,607,875,0,0,1043,105,168
2017,11,70,"Musluhittin",37.2153,28.3636,11.4,7.62857142857143,0.0285714285714286,62.1571428571429,NA,NA,525,68,137,423,558,725,457,588
2017,12,70,"Musluhittin",37.2153,28.3636,8.31428571428571,13.1428571428571,0,60.2,NA,NA,589,354,667,170,267,1077,235,410
2017,13,70,"Musluhittin",37.2153,28.3636,8,11.9428571428571,1.8,73.5285714285714,NA,NA,574,211,324,147,250,887,363,563
2017,14,70,"Musluhittin",37.2153,28.3636,11.2,12.1,0.0428571428571429,62.0142857142857,NA,NA,639,473,1059,143,234,1336,166,277
2017,15,70,"Musluhittin",37.2153,28.3636,10.4285714285714,13.7571428571429,0.785571428571429,60.4428571428571,NA,NA,587,275,718,259,299,1187,312,469
2017,16,70,"Musluhittin",37.2153,28.3636,11.9714285714286,11.3142857142857,4.75714285714286,75.8,NA,NA,717,407,634,184,180,920,310,286
2017,17,70,"Musluhittin",37.2153,28.3636,9.91428571428571,15.9285714285714,0,51.4142857142857,NA,NA,731,365,804,121,159,1478,366,674
2017,18,70,"Musluhittin",37.2153,28.3636,8.25714285714286,17.2428571428571,2.14271428571429,64.7857142857143,NA,NA,506,89,139,85,183,923,417,784
2017,19,70,"Musluhittin",37.2153,28.3636,10.7714285714286,19.8428571428571,0,53.9428571428571,NA,NA,471,123,198,222,504,966,348,768
2017,20,70,"Musluhittin",37.2153,28.3636,12.2428571428571,18.6,1.6,59.1571428571429,NA,NA,472,140,332,329,873,1205,332,873
2017,21,70,"Musluhittin",37.2153,28.3636,9.6,16.8857142857143,1.457,59.8285714285714,NA,NA,448,229,537,150,229,849,219,312
2017,22,70,"Musluhittin",37.2153,28.3636,9.91428571428571,19.8857142857143,0.671428571428571,62.6142857142857,NA,NA,522,351,759,153,208,1015,171,256
2017,23,70,"Musluhittin",37.2153,28.3636,11.4571428571429,21.8285714285714,1.07128571428571,60.3285714285714,NA,NA,578,224,582,178,496,1388,354,806
2017,24,70,"Musluhittin",37.2153,28.3636,9.91428571428571,22.9142857142857,0.142857142857143,52.6285714285714,NA,NA,552,87,229,310,608,1139,465,910
2017,25,70,"Musluhittin",37.2153,28.3636,10.1714285714286,24.1571428571429,0,41.0142857142857,NA,NA,584,0,0,493,892,1041,584,1041
2017,26,70,"Musluhittin",37.2153,28.3636,11.9142857142857,30.3428571428571,0,35,NA,NA,564,23,65,415,660,971,541,906
2017,27,70,"Musluhittin",37.2153,28.3636,11.9571428571429,28.8285714285714,0,38.8857142857143,NA,NA,511,80,148,308,317,642,431,494
2017,28,70,"Musluhittin",37.2153,28.3636,12,29.8571428571429,0,37.8428571428571,NA,NA,481,75,129,124,316,864,406,735
2017,29,70,"Musluhittin",37.2153,28.3636,11.4714285714286,27.4714285714286,0.0571428571428571,50.5142857142857,NA,NA,532,70,214,301,735,1272,462,1058
2017,30,70,"Musluhittin",37.2153,28.3636,11.8428571428571,27.8714285714286,0,42.3571428571429,NA,NA,531,157,271,345,604,928,374,657
2017,31,70,"Musluhittin",37.2153,28.3636,10.3857142857143,27.2,7.07057142857143,52.6571428571429,NA,NA,559,82,221,266,385,1047,477,826
2017,32,70,"Musluhittin",37.2153,28.3636,8.65714285714286,28.5,1.22842857142857,58.1428571428571,NA,NA,567,77,158,340,671,1092,490,934
2017,33,70,"Musluhittin",37.2153,28.3636,10.8142857142857,26.6142857142857,7.65614285714286,58.9428571428571,NA,NA,596,166,324,428,871,1199,430,875
2017,34,70,"Musluhittin",37.2153,28.3636,10.6714285714286,26.1857142857143,0,48.6,NA,NA,601,87,343,511,927,1280,514,937
2017,35,70,"Musluhittin",37.2153,28.3636,9.58571428571429,25.4,0.142857142857143,51.6285714285714,NA,NA,493,272,458,185,442,1014,221,556
2017,36,70,"Musluhittin",37.2153,28.3636,11.6428571428571,24.2714285714286,0,43.0428571428571,NA,NA,507,73,144,230,685,1321,434,1177
2017,37,70,"Musluhittin",37.2153,28.3636,10.4571428571429,25.2142857142857,0,50.5571428571429,NA,NA,589,186,348,197,329,1138,403,790
2017,38,70,"Musluhittin",37.2153,28.3636,10.9428571428571,22.3571428571429,0,47.7,NA,NA,671,217,377,306,673,1312,454,935
2017,39,70,"Musluhittin",37.2153,28.3636,8.57142857142857,18.9142857142857,0.571285714285714,61.6142857142857,NA,NA,782,365,924,292,558,1630,417,706
2017,40,70,"Musluhittin",37.2153,28.3636,9.91428571428571,17.5857142857143,1.65757142857143,54.6857142857143,NA,NA,543,156,365,284,549,1137,387,772
2017,41,70,"Musluhittin",37.2153,28.3636,9.65714285714286,16.4,0,44.6,NA,NA,487,0,0,326,591,843,487,843
2017,42,70,"Musluhittin",37.2153,28.3636,8.05714285714286,17.2,0,52.6714285714286,NA,NA,530,386,600,144,215,815,144,215
2017,43,70,"Musluhittin",37.2153,28.3636,8.25714285714286,13.3428571428571,12.3568571428571,81.4571428571429,NA,NA,506,299,530,30,43,919,207,389
2017,44,70,"Musluhittin",37.2153,28.3636,8.51428571428571,9.48571428571429,0.285714285714286,66.0142857142857,NA,NA,561,157,354,290,534,1102,404,748
2017,45,70,"Musluhittin",37.2153,28.3636,6.91428571428571,10.6285714285714,0,70.5714285714286,NA,NA,577,313,505,144,167,829,264,324
2017,46,70,"Musluhittin",37.2153,28.3636,8,11.8285714285714,4.14314285714286,83.2571428571429,NA,NA,587,519,925,0,0,1085,68,160
2017,47,70,"Musluhittin",37.2153,28.3636,10.0428571428571,8.2,7.39985714285714,74.1142857142857,NA,NA,418,0,0,314,499,804,418,804
2017,48,70,"Musluhittin",37.2153,28.3636,11.3857142857143,11.3285714285714,9.68414285714286,84.8142857142857,NA,NA,386,170,279,18,35,619,216,340
2017,49,70,"Musluhittin",37.2153,28.3636,11.8428571428571,7.78571428571429,5.714,76.1,NA,NA,407,116,143,191,314,645,291,502
2017,50,70,"Musluhittin",37.2153,28.3636,11.3428571428571,10.8142857142857,2.19985714285714,84.1714285714286,NA,NA,346,143,197,98,121,442,203,245
2017,51,70,"Musluhittin",37.2153,28.3636,20.4857142857143,9.04285714285714,3.97128571428571,77.9714285714286,NA,NA,386,102,64,146,167,349,284,285
2017,52,70,"Musluhittin",37.2153,28.3636,15.6875,7.125,13.972625,79.6625,NA,NA,528,145,115,105,74,507,383,392
2018,1,70,"Musluhittin",37.2153,28.3636,10.9625,7.1,3.450125,79.2625,NA,NA,618,168,329,163,198,914,450,585
2018,2,70,"Musluhittin",37.2153,28.3636,7.8,7.5,11.6852857142857,85.9571428571429,NA,NA,624,255,390,273,800,1309,369,919
2018,3,70,"Musluhittin",37.2153,28.3636,11.5571428571429,5.14285714285714,9.45657142857143,79.6428571428571,NA,NA,639,217,389,153,103,655,422,266
2018,4,70,"Musluhittin",37.2153,28.3636,20.8857142857143,5.35714285714286,9.48514285714286,60.3714285714286,NA,NA,604,86,169,514,585,764,518,595
2018,5,70,"Musluhittin",37.2153,28.3636,7.68571428571429,7.78571428571429,0.0571428571428571,77.4714285714286,NA,NA,670,402,546,211,158,819,268,273
2018,6,70,"Musluhittin",37.2153,28.3636,18.2857142857143,11.5,0.914285714285714,73.8857142857143,NA,NA,704,396,635,0,0,1022,308,387
2018,7,70,"Musluhittin",37.2153,28.3636,12.6857142857143,8.8,11.8565714285714,73.9285714285714,NA,NA,478,75,125,336,360,557,403,432
2018,8,70,"Musluhittin",37.2153,28.3636,9.11428571428571,8.87142857142857,7.4,84.1142857142857,NA,NA,711,214,498,104,300,1321,497,823
2018,9,70,"Musluhittin",37.2153,28.3636,10.1714285714286,8.58571428571429,10.0137142857143,81.9428571428572,NA,NA,621,351,512,57,91,956,270,444
2018,10,70,"Musluhittin",37.2153,28.3636,9.91428571428571,11.6428571428571,3.54257142857143,75.3142857142857,NA,NA,556,287,727,57,207,1330,269,603
2018,11,70,"Musluhittin",37.2153,28.3636,10.9428571428571,10.6428571428571,1.2,74.6857142857143,NA,NA,551,419,915,50,353,1426,132,511
2018,12,70,"Musluhittin",37.2153,28.3636,12.9285714285714,11.4428571428571,4.42828571428571,68.5714285714286,NA,NA,425,392,1135,0,0,1187,33,52
2018,13,70,"Musluhittin",37.2153,28.3636,12.9428571428571,12.3142857142857,1.11428571428571,67.9857142857143,NA,NA,356,197,203,75,112,428,159,225
2018,14,70,"Musluhittin",37.2153,28.3636,10.6857142857143,14.0285714285714,0.999857142857143,54.8571428571429,NA,NA,407,234,357,151,97,486,173,129
2018,15,70,"Musluhittin",37.2153,28.3636,9.84285714285714,17.0428571428571,0.285714285714286,63.7857142857143,NA,NA,374,79,80,31,15,450,295,370
2018,16,70,"Musluhittin",37.2153,28.3636,15.0142857142857,17.7428571428571,0,48.2142857142857,NA,NA,411,181,263,221,372,648,230,385
2018,17,70,"Musluhittin",37.2153,28.3636,9.14285714285714,19.1571428571429,0,49.8714285714286,NA,NA,419,195,282,87,270,652,224,370
2018,18,70,"Musluhittin",37.2153,28.3636,10.9428571428571,19.9,4.828,54.9,NA,NA,303,210,309,37,70,474,93,165
2018,19,70,"Musluhittin",37.2153,28.3636,10.1714285714286,16.8285714285714,4.14242857142857,65.9571428571429,NA,NA,275,94,168,145,253,467,181,299
2018,20,70,"Musluhittin",37.2153,28.3636,10.6285714285714,21.9857142857143,0,44.6428571428571,NA,NA,204,35,40,118,227,306,169,266
2018,21,70,"Musluhittin",37.2153,28.3636,10.6857142857143,21.6714285714286,9.85614285714286,61.3285714285714,NA,NA,252,96,142,141,130,281,156,139
2018,22,70,"Musluhittin",37.2153,28.3636,9.14285714285714,19.8142857142857,4.971,67.2285714285714,NA,NA,249,0,0,169,313,427,249,427
2018,23,70,"Musluhittin",37.2153,28.3636,12.7,23.9857142857143,0.285714285714286,47.0571428571429,NA,NA,267,129,422,38,135,812,138,390
2018,24,70,"Musluhittin",37.2153,28.3636,11.2,22.1285714285714,6.88514285714286,63.9714285714286,NA,NA,267,143,239,97,125,448,124,209
2018,25,70,"Musluhittin",37.2153,28.3636,9.4,22.1571428571429,5.05657142857143,67.4,NA,NA,358,60,74,161,220,518,298,444
2018,26,70,"Musluhittin",37.2153,28.3636,9.65714285714286,21.9285714285714,0.0857142857142857,63.1571428571429,NA,NA,355,245,334,0,0,587,110,253
2018,27,70,"Musluhittin",37.2153,28.3636,10.6857142857143,28.4142857142857,0,34.1857142857143,NA,NA,342,0,0,288,345,418,342,418
2018,28,70,"Musluhittin",37.2153,28.3636,12.3428571428571,27.2857142857143,0,46.4714285714286,NA,NA,286,40,73,132,344,585,246,512
2018,29,70,"Musluhittin",37.2153,28.3636,12.3285714285714,27.9142857142857,0,43.2142857142857,NA,NA,260,29,17,228,727,756,231,739
2018,30,70,"Musluhittin",37.2153,28.3636,10.2857142857143,26.1857142857143,1.57128571428571,58.3428571428571,NA,NA,265,78,426,127,311,822,187,396
2018,31,70,"Musluhittin",37.2153,28.3636,10.3571428571429,27.5142857142857,2.14257142857143,59.6571428571429,NA,NA,267,46,120,171,281,499,221,379
2018,32,70,"Musluhittin",37.2153,28.3636,9.62857142857143,28.0571428571429,0.714142857142857,48.7142857142857,NA,NA,297,0,0,248,319,403,297,403
2018,33,70,"Musluhittin",37.2153,28.3636,10.4571428571429,27,0.0285714285714286,51.9142857142857,NA,NA,216,49,73,160,236,332,167,259
2018,34,70,"Musluhittin",37.2153,28.3636,9,26.5428571428571,0,57.1142857142857,NA,NA,144,71,107,70,119,227,73,120
2018,35,70,"Musluhittin",37.2153,28.3636,9.42857142857143,26.8,0,58.0714285714286,NA,NA,201,57,65,91,117,314,144,249
2018,36,70,"Musluhittin",37.2153,28.3636,10.6857142857143,25.9,0,50.0428571428571,NA,NA,341,0,0,312,327,370,341,370
2018,37,70,"Musluhittin",37.2153,28.3636,12.7857142857143,23.8285714285714,0.0285714285714286,45.8571428571429,NA,NA,241,1,14,208,355,419,240,405
2018,38,70,"Musluhittin",37.2153,28.3636,17.3571428571429,25.2142857142857,0,45.6142857142857,NA,NA,189,27,43,78,175,344,162,301
2018,39,70,"Musluhittin",37.2153,28.3636,13.2428571428571,20.8571428571429,3.143,61.6428571428571,NA,NA,180,88,181,84,168,353,92,172
2018,40,70,"Musluhittin",37.2153,28.3636,8.9,18.5285714285714,3.74314285714286,63.4714285714286,NA,NA,191,110,150,41,115,341,81,191
2018,41,70,"Musluhittin",37.2153,28.3636,10.1714285714286,17.2857142857143,6.742,65.8,NA,NA,187,52,66,113,341,422,135,356
2018,42,70,"Musluhittin",37.2153,28.3636,8.05714285714286,17.7857142857143,0,70.7714285714286,NA,NA,168,88,231,19,35,381,80,150
2018,43,70,"Musluhittin",37.2153,28.3636,11.8,13.2714285714286,4.914,70.7571428571429,NA,NA,187,75,113,62,169,402,112,289
2018,44,70,"Musluhittin",37.2153,28.3636,6.91428571428571,13.7428571428571,0,60.7,NA,NA,196,160,239,0,0,264,36,25
2018,45,70,"Musluhittin",37.2153,28.3636,7.22857142857143,12.7571428571429,0.0857142857142857,67.3142857142857,NA,NA,231,135,280,38,120,473,96,193
2018,46,70,"Musluhittin",37.2153,28.3636,10.1714285714286,10.6571428571429,8.07257142857143,63.0142857142857,NA,NA,230,3,25,125,304,465,227,440
2018,47,70,"Musluhittin",37.2153,28.3636,10.5285714285714,12.6571428571429,2.48571428571429,82.0428571428571,NA,NA,270,30,6,93,189,499,240,493
2018,48,70,"Musluhittin",37.2153,28.3636,11.4142857142857,10.7428571428571,12.4567142857143,90.1285714285714,NA,NA,245,81,65,68,92,201,164,136
2018,49,70,"Musluhittin",37.2153,28.3636,12.4,9.14285714285714,3.51414285714286,76.3571428571429,NA,NA,257,1,2,218,385,420,256,418
2018,50,70,"Musluhittin",37.2153,28.3636,11.2571428571429,8.37142857142857,17.4278571428571,86.0571428571428,NA,NA,256,34,22,67,104,305,222,283
2018,51,70,"Musluhittin",37.2153,28.3636,8.85714285714286,7.07142857142857,9.85714285714286,86.5571428571429,NA,NA,250,0,0,204,200,248,250,248
2018,52,70,"Musluhittin",37.2153,28.3636,14.1285714285714,5.5,2.54285714285714,66.2857142857143,NA,NA,244,39,47,183,211,273,205,226
2019,1,70,"Musluhittin",37.2153,28.3636,10.8375,5.7125,18.82525,87.075,NA,NA,343,157,493,89,122,784,186,291
2019,2,70,"Musluhittin",37.2153,28.3636,7.74285714285714,3.68571428571429,8.85642857142857,82.6142857142857,NA,NA,255,94,106,43,27,208,161,102
2019,3,70,"Musluhittin",37.2153,28.3636,8.71428571428571,4,8.55714285714286,82.4571428571429,NA,NA,192,75,99,27,35,198,117,99
2019,4,70,"Musluhittin",37.2153,28.3636,21.6,8.34285714285714,25.5994285714286,87.6857142857143,NA,NA,308,142,176,0,0,314,166,138
2019,5,70,"Musluhittin",37.2153,28.3636,18.8285714285714,8.02857142857143,12.828,84.6285714285714,NA,NA,253,117,63,2,1,143,136,80
2019,6,70,"Musluhittin",37.2153,28.3636,8.95714285714286,7.55714285714286,6.88528571428571,78.7571428571429,NA,NA,276,31,12,65,43,127,245,115
2019,7,70,"Musluhittin",37.2153,28.3636,9.91428571428571,7.22857142857143,4.68542857142857,77.0142857142857,NA,NA,325,123,145,59,31,234,202,89
2019,8,70,"Musluhittin",37.2153,28.3636,8.77142857142857,7.17142857142857,6.77142857142857,77.3857142857143,NA,NA,305,139,88,77,70,219,166,131
2019,9,70,"Musluhittin",37.2153,28.3636,12.5571428571429,7.98571428571429,1.60042857142857,70.0857142857143,NA,NA,331,34,91,297,219,310,297,219
2019,10,70,"Musluhittin",37.2153,28.3636,8.88571428571429,9.25714285714286,0,70.7571428571429,NA,NA,359,211,143,55,57,252,148,109
2019,11,70,"Musluhittin",37.2153,28.3636,12.0571428571429,9.48571428571429,3.94314285714286,73.1714285714286,NA,NA,373,164,107,71,96,400,209,293
2019,12,70,"Musluhittin",37.2153,28.3636,9.65714285714286,12.2142857142857,0.0285714285714286,58.5142857142857,NA,NA,343,138,319,160,75,416,205,97
2019,13,70,"Musluhittin",37.2153,28.3636,12.4857142857143,11.2285714285714,0.428714285714286,54.2428571428571,NA,NA,256,58,39,115,79,194,198,155
2019,14,70,"Musluhittin",37.2153,28.3636,9.27142857142857,10.8285714285714,5.14342857142857,74.6428571428571,NA,NA,365,328,193,0,0,208,37,15
2019,15,70,"Musluhittin",37.2153,28.3636,12.9428571428571,12.3714285714286,13.1427142857143,79.6571428571429,NA,NA,359,204,87,4,3,183,155,96
2019,16,70,"Musluhittin",37.2153,28.3636,12.1,10.9142857142857,1.28542857142857,56.1714285714286,NA,NA,318,6,6,260,152,208,312,202
2019,17,70,"Musluhittin",37.2153,28.3636,9.14285714285714,16.1142857142857,0,48.4571428571429,NA,NA,412,240,169,108,73,313,172,144
2019,18,70,"Musluhittin",37.2153,28.3636,11.3571428571429,16.1285714285714,0.771428571428571,63.8,NA,NA,523,341,272,71,44,353,182,81
2019,19,70,"Musluhittin",37.2153,28.3636,10.4285714285714,15.1285714285714,0.257142857142857,66.3714285714286,NA,NA,452,203,154,153,133,386,249,232
2019,20,70,"Musluhittin",37.2153,28.3636,10.9714285714286,20.2,0,51.4714285714286,NA,NA,454,279,260,4,2,389,175,129
2019,21,70,"Musluhittin",37.2153,28.3636,10.6857142857143,20.5428571428571,0,49.3714285714286,NA,NA,457,246,193,79,81,413,211,220
2019,22,70,"Musluhittin",37.2153,28.3636,10.9428571428571,23.3857142857143,0,42.2428571428571,NA,NA,453,277,189,139,102,323,176,134
2019,23,70,"Musluhittin",37.2153,28.3636,10.6857142857143,21.6714285714286,1.92828571428571,51.1571428571429,NA,NA,378,155,151,167,328,532,223,381
2019,24,70,"Musluhittin",37.2153,28.3636,11.2,21.9714285714286,1.88571428571429,61.2,NA,NA,378,21,29,307,178,244,357,215
2019,25,70,"Musluhittin",37.2153,28.3636,9.08571428571429,23.4428571428571,6.99914285714286,65.7857142857143,NA,NA,306,0,0,240,221,325,306,325
2019,26,70,"Musluhittin",37.2153,28.3636,10.1714285714286,27.5857142857143,0,44.7428571428571,NA,NA,377,116,59,192,234,342,261,283
2019,27,70,"Musluhittin",37.2153,28.3636,10.1714285714286,26.8142857142857,0,37.7,NA,NA,456,119,90,325,122,222,337,132
2019,28,70,"Musluhittin",37.2153,28.3636,12.5714285714286,26.7142857142857,0,42.9,NA,NA,398,56,25,299,293,421,342,396
2019,29,70,"Musluhittin",37.2153,28.3636,10.2285714285714,24.4857142857143,6.14214285714286,58.1428571428571,NA,NA,453,146,86,307,117,203,307,117
2019,30,70,"Musluhittin",37.2153,28.3636,11.5285714285714,28.1714285714286,0,41.9285714285714,NA,NA,456,61,24,246,239,335,395,311
2019,31,70,"Musluhittin",37.2153,28.3636,10.1714285714286,28.1857142857143,0,49.8857142857143,NA,NA,334,157,227,97,93,375,177,148
2019,32,70,"Musluhittin",37.2153,28.3636,10.2714285714286,28.4714285714286,0,39.5142857142857,NA,NA,346,53,82,151,122,395,293,313
2019,33,70,"Musluhittin",37.2153,28.3636,11.2285714285714,27,0,52.8285714285714,NA,NA,337,236,319,101,212,531,101,212
2019,34,70,"Musluhittin",37.2153,28.3636,11.7571428571429,28.3571428571429,0,40.2857142857143,NA,NA,299,0,0,105,108,345,299,345
2019,35,70,"Musluhittin",37.2153,28.3636,9.14285714285714,27.5142857142857,2.28542857142857,50.7571428571429,NA,NA,307,36,75,95,142,415,271,340
2019,36,70,"Musluhittin",37.2153,28.3636,9.34285714285714,25.2285714285714,1.57128571428571,61.4285714285714,NA,NA,171,54,22,63,31,67,117,45
2019,37,70,"Musluhittin",37.2153,28.3636,13.7714285714286,24.6142857142857,1.39985714285714,51.5142857142857,NA,NA,218,66,16,150,38,55,152,39
2019,38,70,"Musluhittin",37.2153,28.3636,11.2428571428571,22.6428571428571,0,47.8428571428571,NA,NA,266,127,55,139,36,91,139,36
2019,39,70,"Musluhittin",37.2153,28.3636,9.47142857142857,21.3,0.600571428571429,60.1571428571429,NA,NA,237,37,28,114,27,79,200,51
2019,40,70,"Musluhittin",37.2153,28.3636,11.7428571428571,20.0428571428571,5.88514285714286,66.0714285714286,NA,NA,241,195,103,35,7,111,46,8
2019,41,70,"Musluhittin",37.2153,28.3636,9.45714285714286,19.5142857142857,1.85771428571429,69.4857142857143,NA,NA,416,35,8,261,256,448,381,440
2019,42,70,"Musluhittin",37.2153,28.3636,6.08571428571429,18.1428571428571,1.74271428571429,71.5857142857143,NA,NA,356,245,285,21,11,408,111,123
2019,43,70,"Musluhittin",37.2153,28.3636,8.37142857142857,18.5,0,49.6285714285714,NA,NA,306,0,0,201,169,300,306,300
2019,44,70,"Musluhittin",37.2153,28.3636,7.22857142857143,13.7428571428571,2.17128571428571,72.8857142857143,NA,NA,350,214,165,45,32,250,136,85
2019,45,70,"Musluhittin",37.2153,28.3636,7.72857142857143,13.9285714285714,5.14385714285714,81.2571428571429,NA,NA,417,317,262,0,0,328,100,66
2019,46,70,"Musluhittin",37.2153,28.3636,8.67142857142857,14.2,3.99971428571429,76.0285714285714,NA,NA,401,7,10,158,131,337,394,327
2019,47,70,"Musluhittin",37.2153,28.3636,7.24285714285714,12.0428571428571,0.143,81.3285714285714,NA,NA,391,35,33,0,0,339,356,306
2019,48,70,"Musluhittin",37.2153,28.3636,9.08571428571429,12.0714285714286,13.8428571428571,87.7714285714286,NA,NA,320,39,28,89,92,251,281,223
2019,49,70,"Musluhittin",37.2153,28.3636,9.05714285714286,6.7,0.714285714285714,74.3428571428571,NA,NA,393,102,83,205,122,274,291,191
2019,50,70,"Musluhittin",37.2153,28.3636,9.44285714285714,8.3,8.82957142857143,87.9571428571429,NA,NA,218,72,56,41,7,119,146,63
2019,51,70,"Musluhittin",37.2153,28.3636,9.3,9.25714285714286,0,80.5,NA,NA,361,64,122,0,0,488,297,366
2019,52,70,"Musluhittin",37.2153,28.3636,12.7428571428571,7.7,19.7884285714286,80.2285714285714,NA,NA,279,49,66,175,103,281,230,215
2020,1,70,"Musluhittin",37.2153,28.3636,10.12,5.54,0.8,67.58,NA,NA,160,32,24,69,51,126,128,102
2020,2,70,"Musluhittin",37.2153,28.3636,10.3,5.74285714285714,7.85714285714286,73.6857142857143,NA,NA,240,56,35,169,116,173,184,138
2020,3,70,"Musluhittin",37.2153,28.3636,7.47142857142857,5.17142857142857,0,72.8857142857143,NA,NA,270,38,34,107,161,382,232,348
2020,4,70,"Musluhittin",37.2153,28.3636,12.1142857142857,4.51428571428571,0,50.9142857142857,NA,NA,358,118,159,185,125,295,240,136
2020,5,70,"Musluhittin",37.2153,28.3636,8.57142857142857,6.85714285714286,3.48614285714286,79.5428571428571,NA,NA,331,147,114,59,31,272,184,158
2020,6,70,"Musluhittin",37.2153,28.3636,12.6285714285714,5.38571428571429,14.6272857142857,78.1428571428571,NA,NA,343,200,158,77,45,267,143,109
2020,7,70,"Musluhittin",37.2153,28.3636,7.42857142857143,7.51428571428571,7.715,80.0714285714286,NA,NA,341,54,51,116,169,338,287,287
2020,8,70,"Musluhittin",37.2153,28.3636,8.57142857142857,7.38571428571429,3.79957142857143,73.5571428571429,NA,NA,283,71,79,134,60,187,212,108
2020,9,70,"Musluhittin",37.2153,28.3636,11.4571428571429,8.3,1.28557142857143,74.7142857142857,NA,NA,393,168,217,142,204,528,225,311
2020,10,70,"Musluhittin",37.2153,28.3636,9.08571428571429,9.78571428571429,4.28542857142857,76.6428571428571,NA,NA,205,182,187,0,0,210,23,23
2020,11,70,"Musluhittin",37.2153,28.3636,12.3142857142857,13.4571428571429,3.11442857142857,71.5428571428571,NA,NA,115,37,13,56,58,94,78,81
2020,12,70,"Musluhittin",37.2153,28.3636,15.3571428571429,7.65714285714286,0.285714285714286,52.5285714285714,NA,NA,117,11,10,93,100,118,106,108
2020,13,70,"Musluhittin",37.2153,28.3636,10.0428571428571,11.1285714285714,3.79985714285714,78.0714285714286,NA,NA,136,53,34,22,25,92,83,58
2020,14,70,"Musluhittin",37.2153,28.3636,15.6714285714286,12.6142857142857,2.17114285714286,71.4428571428571,NA,NA,155,94,78,29,21,121,61,43
2020,15,70,"Musluhittin",37.2153,28.3636,19.7571428571429,13.8857142857143,2.88557142857143,73.4857142857143,NA,NA,133,71,82,0,0,118,62,36
2020,16,70,"Musluhittin",37.2153,28.3636,22.9142857142857,15.4428571428571,1.60028571428571,68.3285714285714,NA,NA,141,47,22,33,39,106,94,84
2020,17,70,"Musluhittin",37.2153,28.3636,25.4285714285714,16.3285714285714,0.142857142857143,71.0285714285714,NA,NA,137,2,12,0,0,123,135,111
2020,18,70,"Musluhittin",37.2153,28.3636,22.7571428571429,16.1142857142857,2.48542857142857,73.7,NA,NA,146,60,51,0,0,164,86,113
2020,19,70,"Musluhittin",37.2153,28.3636,19.8285714285714,17.0142857142857,2.85714285714286,67.8285714285714,NA,NA,137,8,27,56,42,157,129,130
2020,20,70,"Musluhittin",37.2153,28.3636,20.6571428571429,23.1714285714286,0,54.5,NA,NA,164,37,58,5,4,164,127,106
2020,21,70,"Musluhittin",37.2153,28.3636,24.4142857142857,23.3285714285714,0.0285714285714286,46.3,NA,NA,146,0,0,45,43,96,146,96
2020,22,70,"Musluhittin",37.2153,28.3636,25.1714285714286,18.2571428571429,0.114285714285714,60.5571428571429,NA,NA,118,15,10,0,0,100,103,90
2020,23,70,"Musluhittin",37.2153,28.3636,19.8857142857143,18.7714285714286,0.428571428571429,61.3,NA,NA,112,62,50,0,0,70,50,20
2020,24,70,"Musluhittin",37.2153,28.3636,8.37142857142857,21.2714285714286,0.0285714285714286,54.5142857142857,NA,NA,140,80,74,40,56,150,60,76
2020,25,70,"Musluhittin",37.2153,28.3636,10.4285714285714,22.6142857142857,0,54.6142857142857,NA,NA,137,51,41,8,20,108,86,67
2020,26,70,"Musluhittin",37.2153,28.3636,8.62857142857143,23.6714285714286,5.28514285714286,61,NA,NA,173,54,43,69,55,133,119,90
2020,27,70,"Musluhittin",37.2153,28.3636,10.9428571428571,28.3428571428571,0.0571428571428571,44.9571428571429,NA,NA,113,0,0,60,51,113,113,113
2020,28,70,"Musluhittin",37.2153,28.3636,9.31428571428571,27.6714285714286,0.142857142857143,56.1428571428571,NA,NA,164,31,7,121,111,122,133,115
2020,29,70,"Musluhittin",37.2153,28.3636,8.9,27.2,0,47.9714285714286,NA,NA,186,45,25,81,50,111,141,86
2020,30,70,"Musluhittin",37.2153,28.3636,9.51428571428571,28.5,0,45.4857142857143,NA,NA,190,93,36,75,92,142,97,106
2020,31,70,"Musluhittin",37.2153,28.3636,10.1142857142857,29.6142857142857,0,44.0571428571429,NA,NA,150,38,14,36,36,127,112,113
2020,32,70,"Musluhittin",37.2153,28.3636,9.27142857142857,27.2571428571429,0,53.8428571428571,NA,NA,146,3,2,88,45,107,143,105
2020,33,70,"Musluhittin",37.2153,28.3636,8.81428571428571,27.6428571428571,0.142857142857143,46.5714285714286,NA,NA,183,0,0,177,82,83,183,83
2020,34,70,"Musluhittin",37.2153,28.3636,9.78571428571429,27.1857142857143,0,40.4,NA,NA,197,27,9,118,72,97,170,88
2020,35,70,"Musluhittin",37.2153,28.3636,7.48571428571429,26.7571428571429,2.28542857142857,48.2142857142857,NA,NA,164,50,74,54,39,157,114,83
2020,36,70,"Musluhittin",37.2153,28.3636,10.8428571428571,27.5,0,43.3571428571429,NA,NA,179,31,23,58,45,112,148,89
2020,37,70,"Musluhittin",37.2153,28.3636,7.7,26.6714285714286,0.285714285714286,50.7857142857143,NA,NA,193,4,4,50,27,91,189,87
2020,38,70,"Musluhittin",37.2153,28.3636,9.57142857142857,25.2571428571429,0.714142857142857,59.1142857142857,NA,NA,235,29,23,106,30,157,206,134
2020,39,70,"Musluhittin",37.2153,28.3636,8.07142857142857,22.5571428571429,0,60.4428571428571,NA,NA,220,63,33,100,40,129,157,96
2020,40,70,"Musluhittin",37.2153,28.3636,7.22857142857143,20.4857142857143,0,48.3142857142857,NA,NA,187,29,19,61,28,154,158,135
2020,41,70,"Musluhittin",37.2153,28.3636,5.14285714285714,21.4857142857143,0,50.2285714285714,NA,NA,182,76,62,70,49,127,106,65
2020,42,70,"Musluhittin",37.2153,28.3636,5.77142857142857,17.9142857142857,0.400142857142857,66.2571428571429,NA,NA,177,112,72,4,5,111,65,39
2020,43,70,"Musluhittin",37.2153,28.3636,6.41428571428571,16.9142857142857,1.84257142857143,69.8,NA,NA,194,76,90,57,29,161,118,71
2020,44,70,"Musluhittin",37.2153,28.3636,5.77142857142857,14.1571428571429,4.57171428571429,80.0571428571428,NA,NA,255,183,170,49,54,233,72,63
2020,45,70,"Musluhittin",37.2153,28.3636,9.32857142857143,13.8428571428571,0,51.5285714285714,NA,NA,156,0,0,122,86,103,156,103
2020,46,70,"Musluhittin",37.2153,28.3636,7.12857142857143,12.9857142857143,0,66.8857142857143,NA,NA,208,0,0,95,36,109,208,109
2020,47,70,"Musluhittin",37.2153,28.3636,8.17142857142857,11.0428571428571,0.285857142857143,71.0428571428571,NA,NA,173,0,0,119,78,83,173,83
2020,48,70,"Musluhittin",37.2153,28.3636,7.31428571428571,8.77142857142857,0,55.7142857142857,NA,NA,199,63,87,67,38,262,136,175
2020,49,70,"Musluhittin",37.2153,28.3636,7.35714285714286,9.1,2.28614285714286,90.2142857142857,NA,NA,207,90,60,85,40,116,117,56
2020,50,70,"Musluhittin",37.2153,28.3636,16.5714285714286,10.2428571428571,35.3834285714286,92.4,NA,NA,181,125,66,0,0,98,56,32
2020,51,70,"Musluhittin",37.2153,28.3636,12.1,9.65714285714286,4.77171428571429,83.2714285714286,NA,NA,171,19,9,23,12,90,152,81
2020,52,70,"Musluhittin",37.2153,28.3636,13.6,8.61428571428571,0.971285714285714,85.3285714285714,NA,NA,203,2,0,36,37,113,201,113
2020,53,70,"Musluhittin",37.2153,28.3636,12.05,10,9.65,92.725,NA,NA,122,19,49,0,0,111,103,62
2017,1,71,"Mus",38.7431,41.4918,5.02857142857143,-7.7,0.557142857142857,84.7,116.655714285714,NA,563,181,270,1,0,847,382,577
2017,2,71,"Mus",38.7431,41.4918,11.0714285714286,-7.57142857142857,1.05714285714286,80.6857142857143,99,NA,757,194,226,27,15,1214,563,988
2017,3,71,"Mus",38.7431,41.4918,7.21428571428571,-8.37142857142857,0.0714285714285714,80.7571428571429,121.535,NA,762,273,398,0,0,1449,489,1051
2017,4,71,"Mus",38.7431,41.4918,14,-8.95714285714286,9.08571428571429,79.3285714285714,154.881428571429,NA,639,129,132,244,329,889,510,757
2017,5,71,"Mus",38.7431,41.4918,10.0714285714286,-11.3571428571429,3.94285714285714,73.2857142857143,121.09,NA,588,215,438,91,395,1163,373,725
2017,6,71,"Mus",38.7431,41.4918,9.01428571428571,-4.94285714285714,0.385714285714286,79.6714285714286,97.0483333333333,NA,736,191,323,4,2,1519,545,1196
2017,7,71,"Mus",38.7431,41.4918,12.5571428571429,-9.21428571428571,1.35714285714286,68.3,79.6666666666667,NA,492,210,306,0,0,717,282,411
2017,8,71,"Mus",38.7431,41.4918,4.62857142857143,-7.1,0.342857142857143,72.0428571428571,192.221666666667,NA,739,177,344,129,296,1747,562,1403
2017,9,71,"Mus",38.7431,41.4918,9.01428571428571,-0.528571428571429,1.9,85.4714285714286,121.03,NA,574,528,825,0,0,866,46,41
2017,10,71,"Mus",38.7431,41.4918,10.2428571428571,-0.185714285714286,2.01428571428571,80.7285714285714,109.57,NA,712,223,392,50,51,1043,489,651
2017,11,71,"Mus",38.7431,41.4918,13.8571428571429,1.01428571428571,9.82857142857143,85.1857142857143,78.9833333333333,NA,525,137,144,54,48,725,388,581
2017,12,71,"Mus",38.7431,41.4918,10.8571428571429,1.45714285714286,0.785714285714286,68,73.08,NA,589,84,98,145,296,1077,505,979
2017,13,71,"Mus",38.7431,41.4918,10.4428571428571,7.05714285714286,1.6,69.0571428571428,48.45,NA,574,89,150,220,346,887,485,737
2017,14,71,"Mus",38.7431,41.4918,11.7142857142857,6.1,5.04285714285714,67,62.474,NA,639,21,56,227,407,1336,618,1280
2017,15,71,"Mus",38.7431,41.4918,10.9,7.7,7.14285714285714,68.2857142857143,45.1628571428571,NA,587,94,70,268,612,1187,493,1117
2017,16,71,"Mus",38.7431,41.4918,13.5571428571429,11.3428571428571,2.74285714285714,65.1,105.625,NA,717,102,273,296,207,920,615,647
2017,17,71,"Mus",38.7431,41.4918,13.4714285714286,11.1571428571429,0.628571428571429,50.3571428571429,48.6314285714286,NA,731,355,690,21,62,1478,376,788
2017,18,71,"Mus",38.7431,41.4918,7.62857142857143,12.1428571428571,5.45714285714286,71.0714285714286,44.98,NA,506,94,132,56,153,923,412,791
2017,19,71,"Mus",38.7431,41.4918,11.2714285714286,15.6,0.2,54.4285714285714,52.9914285714286,NA,471,64,172,292,566,966,407,794
2017,20,71,"Mus",38.7431,41.4918,19.5,14.7142857142857,2.31428571428571,59.0857142857143,37.3185714285714,NA,472,99,144,24,15,1205,373,1061
2017,21,71,"Mus",38.7431,41.4918,18.5285714285714,13.5714285714286,1.92857142857143,60.6,29.8,NA,448,81,191,77,158,849,367,658
2017,22,71,"Mus",38.7431,41.4918,7.8,16.6,0.0142857142857143,49.4571428571429,38.4557142857143,NA,522,90,159,116,97,1015,432,856
2017,23,71,"Mus",38.7431,41.4918,8.77142857142857,20.9571428571429,0,43.9857142857143,44.2471428571429,NA,578,289,679,157,436,1388,289,709
2017,24,71,"Mus",38.7431,41.4918,8.37142857142857,19.4428571428571,0.142857142857143,43.5428571428571,32.9728571428571,NA,552,71,163,268,532,1139,481,976
2017,25,71,"Mus",38.7431,41.4918,11.4571428571429,19.4714285714286,0.728571428571429,46.2,33.8414285714286,NA,584,181,299,83,72,1041,403,742
2017,26,71,"Mus",38.7431,41.4918,15.5142857142857,24.5857142857143,0,34.2,42.8075,NA,564,395,595,0,0,971,169,376
2017,27,71,"Mus",38.7431,41.4918,9.44285714285714,25.5,0.0571428571428571,30.3142857142857,53.1142857142857,NA,511,328,419,12,3,642,183,223
2017,28,71,"Mus",38.7431,41.4918,9.1,25.1857142857143,0.0285714285714286,30.1571428571429,53.43,NA,481,285,552,0,0,864,196,312
2017,29,71,"Mus",38.7431,41.4918,9.54285714285714,26.6428571428571,0,21.8571428571429,60.44,NA,532,79,195,264,570,1272,453,1077
2017,30,71,"Mus",38.7431,41.4918,8.62857142857143,26.0285714285714,0,24.0285714285714,64.51,NA,531,81,155,121,135,928,450,773
2017,31,71,"Mus",38.7431,41.4918,11.3714285714286,27.0285714285714,0.285714285714286,22.8142857142857,62.225,NA,559,247,560,36,39,1047,312,487
2017,32,71,"Mus",38.7431,41.4918,8.48571428571429,27.1285714285714,0,19.2142857142857,78.835,NA,567,130,347,128,212,1092,437,745
2017,33,71,"Mus",38.7431,41.4918,11.8,24.7571428571429,0.328571428571429,31.9285714285714,NA,NA,596,161,388,188,238,1199,435,811
2017,34,71,"Mus",38.7431,41.4918,11.4571428571429,24.8571428571429,0,25.0428571428571,68.4333333333333,NA,601,161,364,135,142,1280,440,916
2017,35,71,"Mus",38.7431,41.4918,11.1285714285714,23.5,0,23.8142857142857,73.8316666666667,NA,493,0,0,324,546,1014,493,1014
2017,36,71,"Mus",38.7431,41.4918,9.82857142857143,22.1428571428571,0,22.4,72.2557142857143,NA,507,172,513,120,365,1321,335,808
2017,37,71,"Mus",38.7431,41.4918,9.12857142857143,22.4428571428571,0,21.6714285714286,89.2757142857143,NA,589,513,793,0,0,1138,76,345
2017,38,71,"Mus",38.7431,41.4918,11.5857142857143,21.5285714285714,0.0142857142857143,26.8,115.012857142857,NA,671,303,475,211,415,1312,368,837
2017,39,71,"Mus",38.7431,41.4918,9.44285714285714,17.7285714285714,0.0571428571428571,34,88.9371428571429,NA,782,225,307,170,342,1630,557,1323
2017,40,71,"Mus",38.7431,41.4918,10.4142857142857,12.3142857142857,0.114285714285714,43.9857142857143,57.0833333333333,NA,543,238,442,152,279,1137,305,695
2017,41,71,"Mus",38.7431,41.4918,6.45714285714286,11.8142857142857,0.314285714285714,52.3,91.1,NA,487,130,297,48,59,843,357,546
2017,42,71,"Mus",38.7431,41.4918,15.4571428571429,9.88571428571429,0,39.9857142857143,147.993333333333,NA,530,179,305,79,121,815,351,510
2017,43,71,"Mus",38.7431,41.4918,7.35714285714286,10.7571428571429,4.25714285714286,48.7285714285714,83.5725,NA,506,71,159,176,259,919,435,760
2017,44,71,"Mus",38.7431,41.4918,8.24285714285714,7.7,3.08571428571429,68.5285714285714,80.3985714285714,NA,561,21,1,206,419,1102,540,1101
2017,45,71,"Mus",38.7431,41.4918,7,8.01428571428571,4.62857142857143,79.4285714285714,90.0471428571429,NA,577,20,53,179,398,829,557,776
2017,46,71,"Mus",38.7431,41.4918,6.18571428571429,6.35714285714286,0.0571428571428571,66.9428571428571,154.976666666667,NA,587,62,107,121,183,1085,525,978
2017,47,71,"Mus",38.7431,41.4918,11.4428571428571,0.585714285714286,3.71428571428571,77.4714285714286,67.3,NA,418,8,85,249,463,804,410,719
2017,48,71,"Mus",38.7431,41.4918,7.35714285714286,1.6,1.6,80.2,110.053333333333,NA,386,116,165,155,233,619,270,454
2017,49,71,"Mus",38.7431,41.4918,10.5285714285714,-1.1,0.914285714285714,74.4,78.6916666666667,NA,407,7,23,167,178,645,400,622
2017,50,71,"Mus",38.7431,41.4918,7.81428571428571,-3.27142857142857,0.214285714285714,83.4428571428571,60.8275,NA,346,153,115,0,0,442,193,327
2017,51,71,"Mus",38.7431,41.4918,11.0857142857143,3.52857142857143,2.44285714285714,83.5428571428571,NA,NA,386,0,0,263,222,349,386,349
2017,52,71,"Mus",38.7431,41.4918,6.9875,0.95,1.8,77.375,202.74,NA,528,39,15,142,177,507,489,492
2018,1,71,"Mus",38.7431,41.4918,9.3875,0.65,4.3125,84.1625,77.4233333333333,NA,618,59,46,112,192,914,559,868
2018,2,71,"Mus",38.7431,41.4918,8.92857142857143,-2.22857142857143,0.314285714285714,80.3285714285714,78.7033333333333,NA,624,115,55,185,254,1309,509,1254
2018,3,71,"Mus",38.7431,41.4918,13.2285714285714,0.485714285714286,4.85714285714286,82.0571428571428,76.8725,NA,639,116,136,84,78,655,523,519
2018,4,71,"Mus",38.7431,41.4918,14.5428571428571,1.28571428571429,3.54285714285714,80.2142857142857,25.97,NA,604,226,273,73,52,764,378,491
2018,5,71,"Mus",38.7431,41.4918,11.4428571428571,-1.12857142857143,0.0285714285714286,66.3,68.4825,NA,670,201,259,185,221,819,469,560
2018,6,71,"Mus",38.7431,41.4918,9.91428571428571,2.51428571428571,0.0714285714285714,63.7714285714286,117.1,NA,704,134,133,45,125,1022,570,889
2018,7,71,"Mus",38.7431,41.4918,11.4,4.25714285714286,8.94285714285714,73.9857142857143,NA,NA,478,89,93,95,124,557,389,464
2018,8,71,"Mus",38.7431,41.4918,8.82857142857143,3.18571428571429,2.11428571428571,76,NA,NA,711,0,0,294,524,1321,711,1321
2018,9,71,"Mus",38.7431,41.4918,10.3571428571429,4.6,2.8,76.4142857142857,NA,NA,621,0,0,551,812,956,621,956
2018,10,71,"Mus",38.7431,41.4918,12.6285714285714,6.62857142857143,4.57142857142857,69.8571428571429,NA,NA,556,46,19,342,923,1330,510,1311
2018,11,71,"Mus",38.7431,41.4918,16.3,7.7,0.228571428571429,61.9571428571429,38.74,NA,551,35,116,276,565,1426,516,1310
2018,12,71,"Mus",38.7431,41.4918,13.2285714285714,11.1142857142857,1.44285714285714,50.5285714285714,89.44,NA,425,0,0,297,700,1187,425,1187
2018,13,71,"Mus",38.7431,41.4918,11.2714285714286,9.15714285714286,1.51428571428571,64.9285714285714,45.0328571428571,NA,356,99,108,132,152,428,257,320
2018,14,71,"Mus",38.7431,41.4918,10.1142857142857,10.3,0,45.3285714285714,34.3657142857143,NA,407,202,277,55,33,486,205,209
2018,15,71,"Mus",38.7431,41.4918,10.7714285714286,11.3857142857143,1.12857142857143,60.2285714285714,32.3771428571429,NA,374,193,148,0,0,450,181,302
2018,16,71,"Mus",38.7431,41.4918,18.1285714285714,9.85714285714286,2.31428571428571,54.4,29.73,NA,411,97,97,220,359,648,314,551
2018,17,71,"Mus",38.7431,41.4918,11.7142857142857,12.6571428571429,0.657142857142857,55.9714285714286,47.0433333333333,NA,419,222,366,52,83,652,197,286
2018,18,71,"Mus",38.7431,41.4918,9.11428571428571,13.9571428571429,0.471428571428571,68.8857142857143,35.2628571428571,NA,303,56,20,121,203,474,247,454
2018,19,71,"Mus",38.7431,41.4918,14.7857142857143,11.0571428571429,10.2714285714286,80.3714285714286,24.04,NA,275,60,110,99,136,467,215,357
2018,20,71,"Mus",38.7431,41.4918,8.12857142857143,15.3142857142857,0.314285714285714,62.8428571428571,56.6942857142857,NA,204,163,227,0,0,306,41,79
2018,21,71,"Mus",38.7431,41.4918,10.3285714285714,16.3142857142857,2.9,67.9857142857143,47.9271428571429,NA,252,177,186,0,0,281,75,95
2018,22,71,"Mus",38.7431,41.4918,12.6142857142857,16.4285714285714,5.11428571428571,66.7142857142857,36.7971428571429,NA,249,111,151,32,29,427,138,276
2018,23,71,"Mus",38.7431,41.4918,10.2,17.7142857142857,0.428571428571429,57.8285714285714,46.0514285714286,NA,267,166,404,0,0,812,101,408
2018,24,71,"Mus",38.7431,41.4918,10.3428571428571,18.4571428571429,3.74285714285714,60.1571428571429,47.3016666666667,NA,267,136,151,20,14,448,131,297
2018,25,71,"Mus",38.7431,41.4918,8.27142857142857,20.1857142857143,0.157142857142857,51.7285714285714,39.5542857142857,NA,358,297,378,25,22,518,61,140
2018,26,71,"Mus",38.7431,41.4918,7.92857142857143,23.8714285714286,0,39.0285714285714,59.7642857142857,NA,355,127,221,64,85,587,228,366
2018,27,71,"Mus",38.7431,41.4918,9.4,26.0142857142857,0,32.2142857142857,72.5971428571429,NA,342,56,90,83,97,418,286,328
2018,28,71,"Mus",38.7431,41.4918,10.0714285714286,25.8142857142857,0,31.6428571428571,74.652,NA,286,40,63,70,178,585,246,522
2018,29,71,"Mus",38.7431,41.4918,10.7857142857143,23.3142857142857,0.742857142857143,38.6285714285714,11.358,NA,260,131,178,44,50,756,129,578
2018,30,71,"Mus",38.7431,41.4918,9.88571428571429,24.7428571428571,0,27.3714285714286,13.14,NA,265,68,121,143,586,822,197,701
2018,31,71,"Mus",38.7431,41.4918,10.2857142857143,25.6571428571429,0.0571428571428571,36.3142857142857,44.12,NA,267,63,79,84,35,499,204,420
2018,32,71,"Mus",38.7431,41.4918,9.7,25.2,0,32.9857142857143,50.8475,NA,297,189,158,0,0,403,108,245
2018,33,71,"Mus",38.7431,41.4918,12.4,24.8428571428571,0.0285714285714286,34.0857142857143,62.37,NA,216,123,167,24,16,332,93,165
2018,34,71,"Mus",38.7431,41.4918,7.92857142857143,24.8857142857143,0,33.4714285714286,46.146,NA,144,90,147,51,77,227,54,80
2018,35,71,"Mus",38.7431,41.4918,6.98571428571429,24.4857142857143,0,30.4857142857143,61.6016666666667,NA,201,80,168,51,44,314,121,146
2018,36,71,"Mus",38.7431,41.4918,9.47142857142857,21.7142857142857,0.628571428571429,38.9142857142857,54.478,NA,341,192,216,105,59,370,149,154
2018,37,71,"Mus",38.7431,41.4918,11.3142857142857,19.3142857142857,0.114285714285714,45.5428571428571,62.905,NA,241,78,86,87,71,419,163,333
2018,38,71,"Mus",38.7431,41.4918,9.34285714285714,19.2571428571429,0.0857142857142857,39.2571428571429,64.6257142857143,NA,189,117,235,0,0,344,72,109
2018,39,71,"Mus",38.7431,41.4918,5.92857142857143,18.7714285714286,0,32.4285714285714,69.5614285714286,NA,180,63,84,57,83,353,117,269
2018,40,71,"Mus",38.7431,41.4918,12.2142857142857,16.9,0.0285714285714286,40.6,74.3666666666667,NA,191,68,120,42,92,341,123,221
2018,41,71,"Mus",38.7431,41.4918,7.57142857142857,15.2285714285714,0.8,59.4857142857143,97.0585714285714,NA,187,144,373,6,12,422,43,49
2018,42,71,"Mus",38.7431,41.4918,7.44285714285714,13.7857142857143,0.871428571428571,62.9714285714286,104.142857142857,NA,168,3,42,68,98,381,165,339
2018,43,71,"Mus",38.7431,41.4918,16.8857142857143,9.5,17.6857142857143,82.5571428571428,49.6685714285714,NA,187,30,73,31,56,402,157,329
2018,44,71,"Mus",38.7431,41.4918,9.51428571428571,8.78571428571429,0.3,61.1857142857143,107.261666666667,NA,196,116,124,0,0,264,80,140
2018,45,71,"Mus",38.7431,41.4918,6.78571428571429,7,1.31428571428571,75.9,87.465,NA,231,159,146,0,0,473,72,327
2018,46,71,"Mus",38.7431,41.4918,6.45714285714286,4.41428571428571,6.15714285714286,81.2714285714286,79.3885714285714,NA,230,91,234,47,77,465,139,231
2018,47,71,"Mus",38.7431,41.4918,8.47142857142857,4.44285714285714,0.557142857142857,84.1714285714286,90.9042857142857,NA,270,108,92,13,35,499,162,407
2018,48,71,"Mus",38.7431,41.4918,5.88571428571429,5.5,9.42857142857143,88.1142857142857,56.5785714285714,NA,245,35,37,100,25,201,210,164
2018,49,71,"Mus",38.7431,41.4918,7.24285714285714,3.34285714285714,3.64285714285714,92.5714285714286,60.8628571428571,NA,257,117,161,39,35,420,140,259
2018,50,71,"Mus",38.7431,41.4918,13.6142857142857,2.11428571428571,11.2571428571429,87.5857142857143,40.5185714285714,NA,256,45,63,99,87,305,211,242
2018,51,71,"Mus",38.7431,41.4918,7.15714285714286,1.97142857142857,0.2,87.7857142857143,66.9371428571429,NA,250,27,35,9,20,248,223,213
2018,52,71,"Mus",38.7431,41.4918,11.6285714285714,-0.242857142857143,5.01428571428571,89.2,42.1814285714286,NA,244,32,31,87,119,273,212,242
2019,1,71,"Mus",38.7431,41.4918,8.4125,-0.95,1.9,89.9375,95.8175,NA,343,132,369,9,74,784,211,415
2019,2,71,"Mus",38.7431,41.4918,10.0857142857143,-6.02857142857143,6.91428571428571,85.9571428571429,46.052,NA,255,49,67,13,34,208,206,141
2019,3,71,"Mus",38.7431,41.4918,11.0714285714286,-5.5,3.05714285714286,85.1571428571429,88.6233333333333,NA,192,75,56,28,20,198,117,142
2019,4,71,"Mus",38.7431,41.4918,6.4,-3.68571428571429,1.68571428571429,88.5142857142857,NA,NA,308,212,203,0,0,314,96,111
2019,5,71,"Mus",38.7431,41.4918,8.12857142857143,-1.24285714285714,19.3571428571429,88.5285714285714,NA,NA,253,60,16,60,38,143,193,127
2019,6,71,"Mus",38.7431,41.4918,5.17142857142857,-4.38571428571429,1.5,90.2142857142857,114.554,NA,276,136,10,56,33,127,140,117
2019,7,71,"Mus",38.7431,41.4918,10.7428571428571,-2.34285714285714,4.08571428571429,87.3857142857143,51.12,NA,325,119,133,12,5,234,206,101
2019,8,71,"Mus",38.7431,41.4918,7.2,-5.25714285714286,0.642857142857143,83.8142857142857,NA,NA,305,122,43,24,17,219,183,176
2019,9,71,"Mus",38.7431,41.4918,10.1142857142857,-2.28571428571429,4.14285714285714,84.9285714285714,63.14,NA,331,92,47,26,32,310,239,263
2019,10,71,"Mus",38.7431,41.4918,13.5571428571429,0.771428571428571,2.57142857142857,80.1285714285714,NA,NA,359,77,15,6,3,252,282,237
2019,11,71,"Mus",38.7431,41.4918,12.1714285714286,1.87142857142857,4.8,84.5428571428571,107.873333333333,NA,373,15,97,69,77,400,358,303
2019,12,71,"Mus",38.7431,41.4918,10.9285714285714,2.41428571428571,2.77142857142857,65.2714285714286,109.381666666667,NA,343,55,37,56,28,416,288,379
2019,13,71,"Mus",38.7431,41.4918,12.3571428571429,4.25714285714286,7.75714285714286,87.5285714285714,43.84,NA,256,103,25,25,22,194,153,169
2019,14,71,"Mus",38.7431,41.4918,9.78571428571429,6.32857142857143,1.05714285714286,81.6,55.1785714285714,NA,365,122,64,0,0,208,243,144
2019,15,71,"Mus",38.7431,41.4918,9.14285714285714,8.7,2.98571428571429,69.6285714285714,83.8785714285714,NA,359,153,73,84,28,183,206,110
2019,16,71,"Mus",38.7431,41.4918,14.6571428571429,5.98571428571429,8.37142857142857,82.2714285714286,40.8885714285714,NA,318,8,22,71,40,208,310,186
2019,17,71,"Mus",38.7431,41.4918,8.11428571428571,7.3,1.81428571428571,61.2142857142857,70.5228571428571,NA,412,273,178,52,18,313,139,135
2019,18,71,"Mus",38.7431,41.4918,12.6714285714286,10.6571428571429,11.6857142857143,75.2,55.2728571428571,NA,523,5,2,397,301,353,518,351
2019,19,71,"Mus",38.7431,41.4918,8.27142857142857,13.2571428571429,1.67142857142857,63.2428571428571,86.7516666666667,NA,452,0,0,275,218,386,452,386
2019,20,71,"Mus",38.7431,41.4918,8.01428571428571,17.8571428571429,0.0571428571428571,49.6857142857143,108.688571428571,NA,454,151,93,0,0,389,303,296
2019,21,71,"Mus",38.7431,41.4918,10.3571428571429,17.7142857142857,0.0285714285714286,53.6428571428571,117.458571428571,NA,457,217,186,135,47,413,240,227
2019,22,71,"Mus",38.7431,41.4918,7.45714285714286,19.5285714285714,0.0428571428571429,44.8571428571429,96.5042857142857,NA,453,383,283,0,0,323,70,40
2019,23,71,"Mus",38.7431,41.4918,7.84285714285714,22.2428571428571,0,41.1571428571429,119.515,NA,378,106,194,107,60,532,272,338
2019,24,71,"Mus",38.7431,41.4918,9.88571428571429,20.9428571428571,0.785714285714286,45.9571428571429,85.9342857142857,NA,378,218,200,52,16,244,160,44
2019,25,71,"Mus",38.7431,41.4918,10.8857142857143,22.3571428571429,0.671428571428571,42.1714285714286,97.5742857142857,NA,306,107,70,12,2,325,199,255
2019,26,71,"Mus",38.7431,41.4918,9.21428571428571,25.0571428571429,0.0142857142857143,36.4142857142857,132.242857142857,NA,377,178,228,0,0,342,199,114
2019,27,71,"Mus",38.7431,41.4918,14.5428571428571,22.5857142857143,0.0142857142857143,33.6857142857143,93.8142857142857,NA,456,436,205,0,0,222,20,17
2019,28,71,"Mus",38.7431,41.4918,11.4714285714286,23.8571428571429,0.0285714285714286,36.3142857142857,103.685714285714,NA,398,175,198,189,183,421,223,223
2019,29,71,"Mus",38.7431,41.4918,8.41428571428571,24.3857142857143,0,33.2428571428571,145.187142857143,NA,453,60,8,84,11,203,393,195
2019,30,71,"Mus",38.7431,41.4918,9.42857142857143,25.8285714285714,0,29.7714285714286,NA,NA,456,139,58,58,17,335,317,277
2019,31,71,"Mus",38.7431,41.4918,8.84285714285714,26.5857142857143,0,25.5714285714286,NA,NA,334,21,35,219,258,375,313,340
2019,32,71,"Mus",38.7431,41.4918,13.3285714285714,25.3285714285714,0,29.8571428571429,200.94,NA,346,253,250,0,0,395,93,145
2019,33,71,"Mus",38.7431,41.4918,9.05714285714286,26.8,0,26.7428571428571,231.178333333333,NA,337,132,146,3,10,531,205,385
2019,34,71,"Mus",38.7431,41.4918,8.97142857142857,25.1428571428571,0,28.3571428571429,254.147142857143,NA,299,42,79,56,47,345,257,266
2019,35,71,"Mus",38.7431,41.4918,13.8,22.9428571428571,0.628571428571429,36.0714285714286,177.511428571429,NA,307,147,170,2,2,415,160,245
2019,36,71,"Mus",38.7431,41.4918,8.68571428571429,22.0857142857143,0,32.1571428571429,190.908333333333,NA,171,55,8,77,28,67,116,59
2019,37,71,"Mus",38.7431,41.4918,9.67142857142857,19.2857142857143,0.0857142857142857,39.3285714285714,232.751428571429,NA,218,215,54,0,0,55,3,1
2019,38,71,"Mus",38.7431,41.4918,11.4857142857143,19.2571428571429,0.0571428571428571,36.4428571428571,219.187142857143,NA,266,31,2,99,8,91,235,89
2019,39,71,"Mus",38.7431,41.4918,8.92857142857143,17.8142857142857,0,32.6,229.812857142857,NA,237,25,5,147,51,79,212,74
2019,40,71,"Mus",38.7431,41.4918,7.77142857142857,17.7142857142857,0.214285714285714,34.1571428571429,211.408571428571,NA,241,0,0,126,20,111,241,111
2019,41,71,"Mus",38.7431,41.4918,9.74285714285714,17,0.0285714285714286,41.2285714285714,210.861428571429,NA,416,69,69,119,133,448,347,379
2019,42,71,"Mus",38.7431,41.4918,7.55714285714286,14.0857142857143,1.21428571428571,44.6857142857143,206.702857142857,NA,356,159,173,99,117,408,197,235
2019,43,71,"Mus",38.7431,41.4918,8.47142857142857,10.8857142857143,1.34285714285714,71.0714285714286,152.061428571429,NA,306,210,151,0,0,300,96,149
2019,44,71,"Mus",38.7431,41.4918,6.51428571428571,8.08571428571429,3.97142857142857,73.8285714285714,102.311428571429,NA,350,91,30,145,85,250,259,220
2019,45,71,"Mus",38.7431,41.4918,7.01428571428571,6.7,0,61.1285714285714,215.277142857143,NA,417,190,107,0,0,328,227,221
2019,46,71,"Mus",38.7431,41.4918,8.45714285714286,5.84285714285714,0,52.8714285714286,250.05,NA,401,281,254,0,0,337,120,83
2019,47,71,"Mus",38.7431,41.4918,7.2,2.77142857142857,0,46.0285714285714,237.314285714286,NA,391,79,57,147,114,339,312,282
2019,48,71,"Mus",38.7431,41.4918,7.18571428571429,3.65714285714286,2.82857142857143,79.6285714285714,132.735714285714,NA,320,32,13,85,65,251,288,238
2019,49,71,"Mus",38.7431,41.4918,9.57142857142857,0.871428571428571,4.17142857142857,84.9,70.5114285714286,NA,393,141,68,64,55,274,252,206
2019,50,71,"Mus",38.7431,41.4918,6.25714285714286,1.98571428571429,2.24285714285714,92.0857142857143,74.3514285714286,NA,218,68,52,39,6,119,150,67
2019,51,71,"Mus",38.7431,41.4918,6.37142857142857,1.11428571428571,0,75.7428571428571,149.514285714286,NA,361,148,112,58,113,488,213,376
2019,52,71,"Mus",38.7431,41.4918,8.64285714285714,2.07142857142857,3.07142857142857,81.3857142857143,105.581428571429,NA,279,18,33,49,64,281,261,248
2020,1,71,"Mus",38.7431,41.4918,5.36,-1.38,2.62,92.52,71.804,NA,160,68,38,0,0,126,92,88
2020,2,71,"Mus",38.7431,41.4918,6.32857142857143,-4.62857142857143,0.214285714285714,88.0142857142857,151.384285714286,NA,240,189,151,0,0,173,51,22
2020,3,71,"Mus",38.7431,41.4918,6.38571428571429,-6.28571428571429,0.3,80.1428571428571,144.881428571429,NA,270,221,331,2,2,382,49,51
2020,4,71,"Mus",38.7431,41.4918,7.72857142857143,-7.01428571428571,0.614285714285714,75.8857142857143,106.954285714286,NA,358,314,266,0,0,295,44,29
2020,5,71,"Mus",38.7431,41.4918,9.48571428571429,-5.95714285714286,18.6,82.9571428571429,187.991428571429,NA,331,76,86,82,49,272,255,186
2020,6,71,"Mus",38.7431,41.4918,10.0714285714286,-2.27142857142857,3.51428571428571,81.6571428571429,84.47,NA,343,0,0,153,98,267,343,267
2020,7,71,"Mus",38.7431,41.4918,8.24285714285714,-9.6,0.314285714285714,75.6571428571429,85.14,NA,341,164,150,75,47,338,177,188
2020,8,71,"Mus",38.7431,41.4918,7.42857142857143,-0.485714285714286,2.44285714285714,87.7428571428571,116.825714285714,NA,283,174,149,0,0,187,109,38
2020,9,71,"Mus",38.7431,41.4918,9.01428571428571,-0.8,6.74285714285714,79.7,88.8885714285714,NA,393,271,335,0,0,528,122,193
2020,10,71,"Mus",38.7431,41.4918,7.01428571428571,0.171428571428571,0.114285714285714,79.0714285714286,119.117142857143,NA,205,174,182,0,0,210,31,28
2020,11,71,"Mus",38.7431,41.4918,8.04285714285714,4.24285714285714,3.04285714285714,80.8,122.421428571429,NA,115,72,73,10,11,94,43,21
2020,12,71,"Mus",38.7431,41.4918,12.1142857142857,3.72857142857143,14.1,87.2571428571429,42.89,NA,117,48,63,3,4,118,69,55
2020,13,71,"Mus",38.7431,41.4918,9.38571428571429,6.18571428571429,3.55714285714286,77.0714285714286,56.6328571428571,NA,136,72,54,0,0,92,64,38
2020,14,71,"Mus",38.7431,41.4918,11.6428571428571,5.58571428571429,6.15714285714286,79.8714285714286,37.8785714285714,NA,155,16,2,47,32,121,139,119
2020,15,71,"Mus",38.7431,41.4918,9.61428571428571,7.52857142857143,3.17142857142857,68.6857142857143,45.065,NA,133,48,62,0,0,118,85,56
2020,16,71,"Mus",38.7431,41.4918,8.88571428571429,9.94285714285714,1.45714285714286,59.1285714285714,NA,NA,141,23,7,39,35,106,118,99
2020,17,71,"Mus",38.7431,41.4918,10.7857142857143,10.6571428571429,6.68571428571429,74.3428571428571,NA,NA,137,10,4,29,11,123,127,119
2020,18,71,"Mus",38.7431,41.4918,8.65714285714286,9.91428571428571,3,74.2142857142857,NA,NA,146,39,28,46,77,164,107,136
2020,19,71,"Mus",38.7431,41.4918,12.7571428571429,11.3571428571429,8.31428571428571,76.3285714285714,32.385,NA,137,41,60,23,17,157,96,97
2020,20,71,"Mus",38.7431,41.4918,9.8,15.7285714285714,1.15714285714286,52.3428571428571,98.12,NA,164,49,17,12,7,164,115,147
2020,21,71,"Mus",38.7431,41.4918,9.77142857142857,17.5714285714286,3.17142857142857,51.0428571428571,108.001428571429,NA,146,54,13,17,20,96,92,83
2020,22,71,"Mus",38.7431,41.4918,7.65714285714286,15.6,1.28571428571429,56.9428571428571,84.1771428571429,NA,118,38,50,50,35,100,80,50
2020,23,71,"Mus",38.7431,41.4918,11.2142857142857,17.9428571428571,0.242857142857143,44.1142857142857,105.174285714286,NA,112,23,16,27,26,70,89,54
2020,24,71,"Mus",38.7431,41.4918,9.11428571428571,20.5142857142857,0.0285714285714286,41.6428571428571,119.672857142857,NA,140,80,106,15,11,150,60,44
2020,25,71,"Mus",38.7431,41.4918,9.25714285714286,19.4,3.91428571428571,53.2857142857143,95.2157142857143,NA,137,70,43,14,11,108,67,65
2020,26,71,"Mus",38.7431,41.4918,7.94285714285714,22.2714285714286,0,42.6,94.9642857142857,NA,173,138,108,0,0,133,35,25
2020,27,71,"Mus",38.7431,41.4918,12.0571428571429,22.0285714285714,0.228571428571429,47.0142857142857,94.7628571428571,NA,113,98,109,0,0,113,15,4
2020,28,71,"Mus",38.7431,41.4918,13.0428571428571,24.1571428571429,1.57142857142857,43.1285714285714,89.405,NA,164,115,105,22,5,122,49,17
2020,29,71,"Mus",38.7431,41.4918,7.05714285714286,24.4285714285714,2,41.8142857142857,110.678571428571,NA,186,130,86,3,1,111,56,25
2020,30,71,"Mus",38.7431,41.4918,10.4142857142857,26.5571428571429,0,31.7428571428571,138.105714285714,NA,190,107,73,31,22,142,83,69
2020,31,71,"Mus",38.7431,41.4918,10.4142857142857,25.9571428571429,0.0285714285714286,36.0285714285714,132.568571428571,NA,150,89,81,27,29,127,61,46
2020,32,71,"Mus",38.7431,41.4918,11.7428571428571,24.9857142857143,0,29.9714285714286,101.861428571429,NA,146,132,79,0,0,107,14,28
2020,33,71,"Mus",38.7431,41.4918,15.5714285714286,24.4857142857143,0,34.7142857142857,111.114285714286,NA,183,121,60,43,11,83,62,23
2020,34,71,"Mus",38.7431,41.4918,12.8857142857143,23.5571428571429,0.342857142857143,36.5428571428571,117.274285714286,NA,197,101,41,40,23,97,96,56
2020,35,71,"Mus",38.7431,41.4918,9.57142857142857,22.1714285714286,0,30.6285714285714,128.498571428571,NA,164,139,88,0,0,157,25,69
2020,36,71,"Mus",38.7431,41.4918,10.3285714285714,24.3285714285714,0,28.1714285714286,121.571666666667,NA,179,134,74,14,2,112,45,38
2020,37,71,"Mus",38.7431,41.4918,8.95714285714286,23.4142857142857,0,28.5857142857143,109.348571428571,NA,193,127,43,18,3,91,66,48
2020,38,71,"Mus",38.7431,41.4918,6.61428571428571,22.5714285714286,0,27.0857142857143,117.376666666667,NA,235,93,62,0,0,157,142,95
2020,39,71,"Mus",38.7431,41.4918,9.37142857142857,20.0142857142857,0.142857142857143,37.2571428571429,108.37,NA,220,30,8,50,12,129,190,121
2020,40,71,"Mus",38.7431,41.4918,10.0428571428571,18.3571428571429,0,35.7714285714286,103.955714285714,NA,187,96,53,22,4,154,91,101
2020,41,71,"Mus",38.7431,41.4918,11.3857142857143,13.8285714285714,0,40.2428571428571,101.495714285714,NA,182,162,118,0,0,127,20,9
2020,42,71,"Mus",38.7431,41.4918,6.38571428571429,16.0142857142857,0,30.4857142857143,151.99,NA,177,64,16,33,39,111,113,95
2020,43,71,"Mus",38.7431,41.4918,7.47142857142857,14.2428571428571,0,36.1,136.855714285714,NA,194,27,32,60,35,161,167,129
2020,44,71,"Mus",38.7431,41.4918,8.2,14.4714285714286,0.0428571428571429,30.7,154.598571428571,NA,255,79,66,60,62,233,176,167
2020,45,71,"Mus",38.7431,41.4918,9.27142857142857,9.71428571428571,5.08571428571429,78.7142857142857,72.0214285714286,NA,156,81,49,0,0,103,75,54
2020,46,71,"Mus",38.7431,41.4918,6.1,6.77142857142857,0,64.5,126.074285714286,NA,208,93,54,19,8,109,115,55
2020,47,71,"Mus",38.7431,41.4918,7.51428571428571,4.21428571428571,0.685714285714286,74.7571428571429,117.784285714286,NA,173,27,18,1,0,83,146,65
2020,48,71,"Mus",38.7431,41.4918,8.1,1.78571428571429,0.157142857142857,66.7285714285714,100.021428571429,NA,199,115,159,6,7,262,84,103
2020,49,71,"Mus",38.7431,41.4918,8.94285714285714,1.34285714285714,0.0428571428571429,86.8285714285714,94.79,NA,207,134,61,0,0,116,73,55
2020,50,71,"Mus",38.7431,41.4918,5.78571428571429,1.6,0.728571428571429,82.0428571428571,91.6,NA,181,59,13,85,27,98,122,85
2020,51,71,"Mus",38.7431,41.4918,7.32857142857143,2.98571428571429,0.371428571428571,84.2,86.4028571428571,NA,171,50,14,42,24,90,121,76
2020,52,71,"Mus",38.7431,41.4918,6.34285714285714,-4.18571428571429,1.34285714285714,79.4714285714286,90.3042857142857,NA,203,42,6,42,14,113,161,107
2020,53,71,"Mus",38.7431,41.4918,6.125,-5.525,0,89.375,140.8175,NA,122,98,67,0,0,111,24,44
2017,1,72,"Nevsehir",38.6244,34.7239,20.1857142857143,-1.18571428571429,2.99428571428571,77.3285714285714,46.9985714285714,NA,563,305,505,62,89,847,258,342
2017,2,72,"Nevsehir",38.6244,34.7239,22.9428571428571,-2.32857142857143,1.28471428571429,69.0285714285714,30.9828571428571,NA,757,497,897,0,0,1214,260,317
2017,3,72,"Nevsehir",38.6244,34.7239,14.9857142857143,-0.0571428571428571,0.000142857142857143,76.1571428571429,47.8128571428571,NA,762,485,813,0,0,1449,277,636
2017,4,72,"Nevsehir",38.6244,34.7239,17.4714285714286,-4.82857142857143,2.94628571428571,79.3428571428571,48.3214285714286,NA,639,334,500,130,142,889,305,389
2017,5,72,"Nevsehir",38.6244,34.7239,17.5285714285714,-7.52857142857143,0.2,68.2857142857143,55.5685714285714,NA,588,295,409,66,110,1163,293,754
2017,6,72,"Nevsehir",38.6244,34.7239,17.3,2.61428571428571,0.0658571428571429,76.5,50.65,NA,736,509,996,115,347,1519,227,523
2017,7,72,"Nevsehir",38.6244,34.7239,23.7571428571429,-3.35714285714286,0.170857142857143,64.7142857142857,39.8414285714286,NA,492,195,161,46,109,717,297,556
2017,8,72,"Nevsehir",38.6244,34.7239,16.6571428571429,4.74285714285714,0,59.8,44.0385714285714,NA,739,409,881,0,0,1747,330,866
2017,9,72,"Nevsehir",38.6244,34.7239,14.4285714285714,6.8,0.600571428571429,61.8571428571429,54.62,NA,574,357,574,77,94,866,217,292
2017,10,72,"Nevsehir",38.6244,34.7239,17.5,7.78571428571429,1.05885714285714,58.2428571428571,59.5414285714286,NA,712,682,989,0,0,1043,30,54
2017,11,72,"Nevsehir",38.6244,34.7239,15.9142857142857,2.28571428571429,3.68357142857143,77.7857142857143,28.8314285714286,NA,525,50,89,136,178,725,475,636
2017,12,72,"Nevsehir",38.6244,34.7239,22.2,7.04285714285714,0.4,53.3,43.0542857142857,NA,589,71,79,113,346,1077,518,998
2017,13,72,"Nevsehir",38.6244,34.7239,16.8142857142857,8.12857142857143,2.39871428571429,61.2285714285714,36.4142857142857,NA,574,180,265,116,179,887,394,622
2017,14,72,"Nevsehir",38.6244,34.7239,13.3,9.31428571428571,1.59871428571429,49.5571428571429,38.2642857142857,NA,639,82,199,82,135,1336,557,1137
2017,15,72,"Nevsehir",38.6244,34.7239,13.6,7.6,2.31442857142857,68.5142857142857,39.5471428571429,NA,587,101,239,256,496,1187,486,948
2017,16,72,"Nevsehir",38.6244,34.7239,23.6714285714286,12.2571428571429,0.0287142857142857,49.6142857142857,58.2057142857143,NA,717,71,66,17,27,920,646,854
2017,17,72,"Nevsehir",38.6244,34.7239,15.3571428571429,11.5714285714286,0,37.2428571428571,44.28,NA,731,155,398,183,295,1478,576,1080
2017,18,72,"Nevsehir",38.6244,34.7239,16.0714285714286,13.4571428571429,1.17185714285714,60.1857142857143,51.3085714285714,NA,506,46,94,7,5,923,460,829
2017,19,72,"Nevsehir",38.6244,34.7239,17.5142857142857,17.3428571428571,0.0861428571428571,44.8857142857143,73.7314285714286,NA,471,3,11,171,298,966,468,955
2017,20,72,"Nevsehir",38.6244,34.7239,14.4714285714286,12.9285714285714,3.495,62.8428571428571,28.3,NA,472,0,0,117,494,1205,472,1205
2017,21,72,"Nevsehir",38.6244,34.7239,12.5,12.7571428571429,0.663428571428571,64.3857142857143,22.5928571428571,NA,448,162,201,227,438,849,286,648
2017,22,72,"Nevsehir",38.6244,34.7239,12,16.4428571428571,1.71485714285714,58.7714285714286,29.4285714285714,NA,522,28,69,130,171,1015,494,946
2017,23,72,"Nevsehir",38.6244,34.7239,15.8714285714286,19.2,0.0301428571428571,54.3571428571429,45.0771428571429,NA,578,0,0,234,708,1388,578,1388
2017,24,72,"Nevsehir",38.6244,34.7239,15.2571428571429,18.2428571428571,2.02571428571429,58.5571428571429,27.4171428571429,NA,552,0,0,150,293,1139,552,1139
2017,25,72,"Nevsehir",38.6244,34.7239,14.7714285714286,17.7,3.79828571428571,60.5714285714286,33.5,NA,584,0,0,177,262,1041,584,1041
2017,26,72,"Nevsehir",38.6244,34.7239,15.9857142857143,24.2142857142857,0,38.8285714285714,45.4342857142857,NA,564,0,0,118,217,971,564,971
2017,27,72,"Nevsehir",38.6244,34.7239,23.1142857142857,22.4142857142857,0,44.3428571428571,39.2628571428571,NA,511,0,0,141,199,642,511,642
2017,28,72,"Nevsehir",38.6244,34.7239,24.1714285714286,23.5,0,32.6428571428571,46.7514285714286,NA,481,0,0,0,0,864,481,864
2017,29,72,"Nevsehir",38.6244,34.7239,27.1571428571429,24.5428571428571,0,41.4714285714286,55.1228571428571,NA,532,0,0,103,174,1272,532,1272
2017,30,72,"Nevsehir",38.6244,34.7239,21.5714285714286,23.9571428571429,0,37.4714285714286,59.8185714285714,NA,531,54,139,172,277,928,477,789
2017,31,72,"Nevsehir",38.6244,34.7239,25.0142857142857,22.6285714285714,1.83242857142857,52.0285714285714,43.1471428571429,NA,559,0,0,278,625,1047,559,1047
2017,32,72,"Nevsehir",38.6244,34.7239,20.5142857142857,25.4428571428571,0,40.8857142857143,55.5157142857143,NA,567,41,33,218,371,1092,526,1059
2017,33,72,"Nevsehir",38.6244,34.7239,22.9857142857143,24.5,0.00142857142857143,47.4285714285714,46.3071428571429,NA,596,99,196,43,188,1199,497,1003
2017,34,72,"Nevsehir",38.6244,34.7239,20.4285714285714,20.8714285714286,0.114,51.0571428571429,39.45,NA,601,0,0,175,314,1280,601,1280
2017,35,72,"Nevsehir",38.6244,34.7239,13.7142857142857,20.2428571428571,0.000714285714285714,45.6142857142857,38.6328571428571,NA,493,0,0,88,168,1014,493,1014
2017,36,72,"Nevsehir",38.6244,34.7239,14.3285714285714,20.1428571428571,0,33.5571428571429,49.5128571428571,NA,507,0,0,113,246,1321,507,1321
2017,37,72,"Nevsehir",38.6244,34.7239,14.5857142857143,24.1857142857143,0,26.1142857142857,88.874,NA,589,94,101,2,0,1138,495,1037
2017,38,72,"Nevsehir",38.6244,34.7239,16.6428571428571,21.7571428571429,0,31.2,77.9066666666667,NA,671,52,43,247,528,1312,619,1269
2017,39,72,"Nevsehir",38.6244,34.7239,12.2142857142857,16.7857142857143,0.456857142857143,50.1142857142857,71.75,NA,782,0,0,169,287,1630,782,1630
2017,40,72,"Nevsehir",38.6244,34.7239,11.7142857142857,11.6857142857143,1.31057142857143,52.9857142857143,37.91,NA,543,134,332,72,196,1137,409,805
2017,41,72,"Nevsehir",38.6244,34.7239,10.8285714285714,10.1142857142857,0.000571428571428571,57.0142857142857,61.0357142857143,NA,487,0,0,155,160,843,487,843
2017,42,72,"Nevsehir",38.6244,34.7239,12.1714285714286,10.6714285714286,0,46.0857142857143,70.79,NA,530,60,108,46,74,815,470,707
2017,43,72,"Nevsehir",38.6244,34.7239,17.0857142857143,12.4,1.165,52.0571428571429,68.21,NA,506,208,390,42,76,919,298,529
2017,44,72,"Nevsehir",38.6244,34.7239,14.1571428571429,5.41428571428571,1.14671428571429,61.7714285714286,50.0085714285714,NA,561,285,634,160,262,1102,276,468
2017,45,72,"Nevsehir",38.6244,34.7239,14.2,6.45714285714286,0.143,71.0285714285714,58.6,NA,577,374,581,0,0,829,203,248
2017,46,72,"Nevsehir",38.6244,34.7239,13.3571428571429,9.5,0.000142857142857143,56.9428571428571,91.87,NA,587,418,742,0,0,1085,169,343
2017,47,72,"Nevsehir",38.6244,34.7239,17.4,3.48571428571429,3.48114285714286,77.8857142857143,31.7957142857143,NA,418,120,313,4,1,804,298,491
2017,48,72,"Nevsehir",38.6244,34.7239,17.5428571428571,6.24285714285714,0.973285714285714,71.7714285714286,41.4671428571429,NA,386,309,470,0,0,619,77,149
2017,49,72,"Nevsehir",38.6244,34.7239,17.7142857142857,2.35714285714286,1.74071428571429,70.3285714285714,28.9785714285714,NA,407,210,321,61,98,645,197,324
2017,50,72,"Nevsehir",38.6244,34.7239,16.3142857142857,5.57142857142857,0.000142857142857143,69.4285714285714,47.3371428571429,NA,346,263,278,0,0,442,83,164
2017,51,72,"Nevsehir",38.6244,34.7239,17.5428571428571,7.12857142857143,3.32371428571429,77.4571428571429,36.5357142857143,NA,386,135,105,51,41,349,251,244
2017,52,72,"Nevsehir",38.6244,34.7239,13.425,2.05,1.00875,73.1,55.525,NA,528,278,291,68,31,507,250,216
2018,1,72,"Nevsehir",38.6244,34.7239,14.775,2.3875,1.3275,83.25,29.64625,NA,618,407,670,65,80,914,211,244
2018,2,72,"Nevsehir",38.6244,34.7239,15.1571428571429,2.57142857142857,1.69714285714286,82.0857142857143,57.45,NA,624,403,1151,2,0,1309,221,158
2018,3,72,"Nevsehir",38.6244,34.7239,18.4571428571429,1.42857142857143,2.43328571428571,77.5,22.0257142857143,NA,639,313,455,170,74,655,326,200
2018,4,72,"Nevsehir",38.6244,34.7239,25.2714285714286,-0.714285714285714,4.31014285714286,85.0571428571428,25.9942857142857,NA,604,156,241,193,165,764,448,523
2018,5,72,"Nevsehir",38.6244,34.7239,17.8571428571429,2.92857142857143,0,67.5714285714286,31.4342857142857,NA,670,505,634,20,20,819,165,185
2018,6,72,"Nevsehir",38.6244,34.7239,18.5,8.37142857142857,0.0287142857142857,56.8428571428571,95.4771428571429,NA,704,378,499,27,47,1022,326,523
2018,7,72,"Nevsehir",38.6244,34.7239,23.2428571428571,5.21428571428571,0.0572857142857143,64.0285714285714,43.3285714285714,NA,478,155,213,61,68,557,323,344
2018,8,72,"Nevsehir",38.6244,34.7239,18.3285714285714,5.62857142857143,1.35814285714286,71.4285714285714,37.4942857142857,NA,711,592,1017,0,0,1321,119,304
2018,9,72,"Nevsehir",38.6244,34.7239,24.4285714285714,6.65714285714286,0.452571428571429,63.1142857142857,41.8942857142857,NA,621,169,288,93,162,956,452,668
2018,10,72,"Nevsehir",38.6244,34.7239,17.1142857142857,8.72857142857143,2.586,69.2142857142857,70.7214285714286,NA,556,140,303,120,238,1330,416,1027
2018,11,72,"Nevsehir",38.6244,34.7239,21.3571428571429,9.2,2.47228571428571,64.1571428571429,43.9814285714286,NA,551,72,126,91,173,1426,479,1300
2018,12,72,"Nevsehir",38.6244,34.7239,20.8,13.0428571428571,0.13,44.7142857142857,98.1242857142857,NA,425,44,97,0,0,1187,381,1090
2018,13,72,"Nevsehir",38.6244,34.7239,17.2571428571429,11.1714285714286,1.59785714285714,55.1428571428571,59.9057142857143,NA,356,162,212,9,1,428,194,216
2018,14,72,"Nevsehir",38.6244,34.7239,16.0142857142857,10.6285714285714,0.427714285714286,48.9285714285714,46.5828571428571,NA,407,220,195,17,26,486,187,291
2018,15,72,"Nevsehir",38.6244,34.7239,18.6,12.6714285714286,0.915,62.9857142857143,46.71,NA,374,124,114,47,41,450,250,336
2018,16,72,"Nevsehir",38.6244,34.7239,20.9571428571429,11.5857142857143,0.428428571428571,44.5857142857143,51.5971428571429,NA,411,68,70,119,195,648,343,578
2018,17,72,"Nevsehir",38.6244,34.7239,18.5285714285714,15.8142857142857,0,39.5285714285714,56.14,NA,419,73,134,9,3,652,346,518
2018,18,72,"Nevsehir",38.6244,34.7239,16.0285714285714,16.9142857142857,1.001,53.4285714285714,55.69,NA,303,272,342,0,0,474,31,132
2018,19,72,"Nevsehir",38.6244,34.7239,13.2142857142857,12.6857142857143,0.789714285714286,71.8285714285714,28.0671428571429,NA,275,61,157,47,58,467,214,310
2018,20,72,"Nevsehir",38.6244,34.7239,13.7714285714286,17.4428571428571,0.656,54.5285714285714,43.9385714285714,NA,204,35,40,8,18,306,169,266
2018,21,72,"Nevsehir",38.6244,34.7239,15.1714285714286,18.3857142857143,1.541,57.7,51.58,NA,252,87,138,82,88,281,165,143
2018,22,72,"Nevsehir",38.6244,34.7239,14.5714285714286,16.2,3.33785714285714,69.2285714285714,39.3642857142857,NA,249,52,90,69,101,427,197,337
2018,23,72,"Nevsehir",38.6244,34.7239,16.2857142857143,21,0.000285714285714286,43.6571428571429,39.694,NA,267,14,37,64,159,812,253,775
2018,24,72,"Nevsehir",38.6244,34.7239,22.9428571428571,20.8857142857143,0.138,49.5,34.7328571428571,NA,267,80,107,32,34,448,187,341
2018,25,72,"Nevsehir",38.6244,34.7239,17.8142857142857,19.3,3.25171428571429,63.9142857142857,24.0214285714286,NA,358,82,151,77,131,518,276,367
2018,26,72,"Nevsehir",38.6244,34.7239,14.5428571428571,23.5857142857143,0.571714285714286,44.3428571428571,42.3085714285714,NA,355,1,0,102,141,587,354,587
2018,27,72,"Nevsehir",38.6244,34.7239,23.3857142857143,22.6714285714286,0,46.3428571428571,39.6171428571429,NA,342,2,0,3,4,418,340,418
2018,28,72,"Nevsehir",38.6244,34.7239,26.0142857142857,24.8285714285714,0.000142857142857143,42.2,55.5571428571429,NA,286,1,1,64,119,585,285,584
2018,29,72,"Nevsehir",38.6244,34.7239,21.4857142857143,22.8,0.143142857142857,40.5,41.85,NA,260,0,0,188,459,756,260,756
2018,30,72,"Nevsehir",38.6244,34.7239,17.0142857142857,24.8857142857143,0,41.8714285714286,61.2128571428571,NA,265,5,21,146,309,822,260,801
2018,31,72,"Nevsehir",38.6244,34.7239,31.1285714285714,24.8571428571429,0.000428571428571429,45.4285714285714,52.622,NA,267,0,0,45,92,499,267,499
2018,32,72,"Nevsehir",38.6244,34.7239,31.0428571428571,21.3285714285714,0,47.6428571428571,17.46,NA,297,0,0,6,11,403,297,403
2018,33,72,"Nevsehir",38.6244,34.7239,21.6428571428571,22.2571428571429,0,39.5714285714286,19.6257142857143,NA,216,0,0,62,108,332,216,332
2018,34,72,"Nevsehir",38.6244,34.7239,19.8428571428571,23.3428571428571,0,37.6714285714286,17.9814285714286,NA,144,32,24,7,1,227,112,203
2018,35,72,"Nevsehir",38.6244,34.7239,25.5,24.6428571428571,0.600714285714286,37.6571428571429,23.1128571428571,NA,201,25,24,2,2,314,176,290
2018,36,72,"Nevsehir",38.6244,34.7239,15.3,21.2142857142857,0.000285714285714286,41.3,20.5857142857143,NA,341,91,62,118,126,370,250,308
2018,37,72,"Nevsehir",38.6244,34.7239,19.2,18.9857142857143,0.128285714285714,47.6857142857143,23.8542857142857,NA,241,8,22,79,184,419,233,397
2018,38,72,"Nevsehir",38.6244,34.7239,18.5,17.8,0,42.9,21.5342857142857,NA,189,0,0,69,149,344,189,344
2018,39,72,"Nevsehir",38.6244,34.7239,16.3857142857143,17.3,0.029,47.1428571428571,28.61,NA,180,35,58,26,67,353,145,295
2018,40,72,"Nevsehir",38.6244,34.7239,15.7,15.4142857142857,1.11285714285714,49.6857142857143,21.5642857142857,NA,191,41,72,17,43,341,150,269
2018,41,72,"Nevsehir",38.6244,34.7239,14.9,14.4428571428571,1.99785714285714,68.9142857142857,21.1,NA,187,48,69,18,75,422,139,353
2018,42,72,"Nevsehir",38.6244,34.7239,13.8571428571429,14.8571428571429,2.197,64.3428571428571,38.5514285714286,NA,168,133,347,0,0,381,35,34
2018,43,72,"Nevsehir",38.6244,34.7239,14.9285714285714,9.14285714285714,3.338,72.9714285714286,18.7116666666667,NA,187,51,87,57,162,402,136,315
2018,44,72,"Nevsehir",38.6244,34.7239,11.7857142857143,9.64285714285714,0,60.2285714285714,23.5557142857143,NA,196,95,112,1,0,264,101,152
2018,45,72,"Nevsehir",38.6244,34.7239,11.2857142857143,6.9,0.0855714285714286,68.9857142857143,20.946,NA,231,113,288,21,32,473,118,185
2018,46,72,"Nevsehir",38.6244,34.7239,13.1714285714286,3.61428571428571,0.153428571428571,72.4428571428572,17.7085714285714,NA,230,79,134,32,37,465,151,331
2018,47,72,"Nevsehir",38.6244,34.7239,16.4142857142857,7.38571428571429,0.257285714285714,73.5142857142857,16.5842857142857,NA,270,158,178,50,195,499,112,321
2018,48,72,"Nevsehir",38.6244,34.7239,14.8428571428571,8.1,1.37214285714286,74.4571428571429,11.3257142857143,NA,245,177,160,0,0,201,68,41
2018,49,72,"Nevsehir",38.6244,34.7239,17.1285714285714,3.91428571428571,4.26671428571429,83.0571428571428,14.365,NA,257,145,217,6,67,420,112,203
2018,50,72,"Nevsehir",38.6244,34.7239,19.4428571428571,3.61428571428571,3.75714285714286,77.9571428571429,26.1342857142857,NA,256,147,160,0,0,305,109,145
2018,51,72,"Nevsehir",38.6244,34.7239,16.3142857142857,5.18571428571429,2.05328571428571,81.5142857142857,23.1071428571429,NA,250,93,117,0,0,248,157,131
2018,52,72,"Nevsehir",38.6244,34.7239,16.6142857142857,-1.78571428571429,1.12142857142857,79.4142857142857,11.8985714285714,NA,244,54,79,96,59,273,190,194
2019,1,72,"Nevsehir",38.6244,34.7239,19.8,1.6625,1.777375,82,14.09625,31.585,343,233,523,0,0,784,110,261
2019,2,72,"Nevsehir",38.6244,34.7239,22.5142857142857,-2.31428571428571,3.78785714285714,73.9571428571429,10.9,NA,255,127,90,54,28,208,128,118
2019,3,72,"Nevsehir",38.6244,34.7239,19.3857142857143,-2.54285714285714,4.87828571428572,77,14.8366666666667,NA,192,141,156,23,28,198,51,42
2019,4,72,"Nevsehir",38.6244,34.7239,20.1142857142857,3.01428571428571,0.708857142857143,72.6714285714286,18.2114285714286,NA,308,268,312,0,0,314,40,2
2019,5,72,"Nevsehir",38.6244,34.7239,17.4571428571429,3.58571428571429,1.06685714285714,70.1571428571429,17.7783333333333,NA,253,186,105,0,0,143,67,38
2019,6,72,"Nevsehir",38.6244,34.7239,17.1428571428571,4.8,5.649,73,14.4125,NA,276,185,55,51,45,127,91,72
2019,7,72,"Nevsehir",38.6244,34.7239,15.3714285714286,3.15714285714286,0,70.3571428571429,11.098,NA,325,134,132,0,0,234,191,102
2019,8,72,"Nevsehir",38.6244,34.7239,12.6428571428571,3.92857142857143,0.043,61.5714285714286,15.3071428571429,NA,305,56,29,83,46,219,249,190
2019,9,72,"Nevsehir",38.6244,34.7239,13.4857142857143,2,1.05514285714286,74.3714285714286,12.0385714285714,NA,331,0,0,78,52,310,331,310
2019,10,72,"Nevsehir",38.6244,34.7239,14.2571428571429,4.97142857142857,0.456857142857143,60.1714285714286,11.4985714285714,NA,359,124,77,48,36,252,235,175
2019,11,72,"Nevsehir",38.6244,34.7239,16.7857142857143,7.58571428571429,0.271857142857143,61.5571428571429,12.4428571428571,NA,373,98,189,12,0,400,275,211
2019,12,72,"Nevsehir",38.6244,34.7239,19.1142857142857,6.07142857142857,0.000142857142857143,51.7714285714286,16.094,NA,343,68,269,41,22,416,275,147
2019,13,72,"Nevsehir",38.6244,34.7239,24.3285714285714,3.55714285714286,2.45042857142857,62.1285714285714,12.235,NA,256,0,0,100,107,194,256,194
2019,14,72,"Nevsehir",38.6244,34.7239,13.8285714285714,7.51428571428571,0.228285714285714,65.9285714285714,11.2514285714286,NA,365,154,87,78,24,208,211,121
2019,15,72,"Nevsehir",38.6244,34.7239,16.3285714285714,10.8571428571429,3.82885714285714,63.4857142857143,10.902,NA,359,199,111,38,18,183,160,72
2019,16,72,"Nevsehir",38.6244,34.7239,15.5285714285714,5.18571428571429,4.02285714285714,78.5857142857143,6.0125,NA,318,13,32,140,92,208,305,176
2019,17,72,"Nevsehir",38.6244,34.7239,12.7,10.0428571428571,0.115428571428571,63.1,15.42,NA,412,143,123,97,87,313,269,190
2019,18,72,"Nevsehir",38.6244,34.7239,16.7857142857143,14.2714285714286,1.71257142857143,53.7428571428571,11.334,NA,523,69,35,146,67,353,454,318
2019,19,72,"Nevsehir",38.6244,34.7239,16.1285714285714,12.8,2.59557142857143,58.2142857142857,10.065,NA,452,189,146,40,43,386,263,240
2019,20,72,"Nevsehir",38.6244,34.7239,15.5,18.3714285714286,0.0285714285714286,47.3571428571429,18.11,NA,454,79,70,40,44,389,375,319
2019,21,72,"Nevsehir",38.6244,34.7239,16.8142857142857,19.6571428571429,0.151571428571429,45.2428571428571,23.9457142857143,NA,457,3,5,104,140,413,454,408
2019,22,72,"Nevsehir",38.6244,34.7239,15.0571428571429,21.6571428571429,4.41514285714286,45.3285714285714,19.3157142857143,NA,453,106,61,77,27,323,347,262
2019,23,72,"Nevsehir",38.6244,34.7239,15.4285714285714,22.1571428571429,0.427714285714286,39.2,15.9428571428571,NA,378,0,0,41,82,532,378,532
2019,24,72,"Nevsehir",38.6244,34.7239,14.3571428571429,18.2714285714286,10.3361428571429,72.4571428571429,10.2285714285714,NA,378,1,0,70,36,244,377,244
2019,25,72,"Nevsehir",38.6244,34.7239,12.3714285714286,19.2857142857143,4.51114285714286,72.3,8.11857142857143,NA,306,0,0,175,169,325,306,325
2019,26,72,"Nevsehir",38.6244,34.7239,22.7,22.5714285714286,0,49.4285714285714,12.6233333333333,NA,377,0,0,49,52,342,377,342
2019,27,72,"Nevsehir",38.6244,34.7239,26.6714285714286,21.2428571428571,0,44.5857142857143,14.0625,NA,456,0,0,125,87,222,456,222
2019,28,72,"Nevsehir",38.6244,34.7239,15.5714285714286,21.7714285714286,0.0722857142857143,47.5571428571429,13.2,NA,398,56,25,333,372,421,342,396
2019,29,72,"Nevsehir",38.6244,34.7239,19.1714285714286,19.0857142857143,4.11342857142857,63.8714285714286,10.1471428571429,NA,453,48,16,125,50,203,405,187
2019,30,72,"Nevsehir",38.6244,34.7239,24.8,20.8,0,48.9142857142857,14.17,NA,456,0,0,69,62,335,456,335
2019,31,72,"Nevsehir",38.6244,34.7239,14.9714285714286,25.3571428571429,0.284857142857143,37.6285714285714,32.74,NA,334,51,55,144,104,375,283,320
2019,32,72,"Nevsehir",38.6244,34.7239,28.1,20.0857142857143,1.13942857142857,49.7571428571429,28.65,26.2,346,0,0,20,21,395,346,395
2019,33,72,"Nevsehir",38.6244,34.7239,18.0857142857143,23.3857142857143,0.574857142857143,46.7714285714286,29.7657142857143,28.0542857142857,337,0,0,61,135,531,337,531
2019,34,72,"Nevsehir",38.6244,34.7239,20.2857142857143,19.5285714285714,1.48571428571429,67.0428571428571,20.918,NA,299,0,0,66,74,345,299,345
2019,35,72,"Nevsehir",38.6244,34.7239,24.4142857142857,21.3714285714286,0.0284285714285714,54.9142857142857,22.57,30.0475,307,0,0,55,35,415,307,415
2019,36,72,"Nevsehir",38.6244,34.7239,15.1142857142857,20.6857142857143,0,39.9571428571429,27.8885714285714,33.4757142857143,171,1,1,21,26,67,170,66
2019,37,72,"Nevsehir",38.6244,34.7239,23.7,17.7714285714286,0.551,56.1285714285714,21.6642857142857,29.7271428571429,218,0,0,4,2,55,218,55
2019,38,72,"Nevsehir",38.6244,34.7239,12.3428571428571,15.9714285714286,0.0284285714285714,52.8,26.0542857142857,31.935,266,115,41,42,11,91,151,50
2019,39,72,"Nevsehir",38.6244,34.7239,11.8142857142857,16.6571428571429,0.428,49.0142857142857,29.2557142857143,32.1471428571429,237,63,35,68,22,79,174,44
2019,40,72,"Nevsehir",38.6244,34.7239,12.9714285714286,18.9571428571429,0,36.6142857142857,44.6414285714286,34.4471428571429,241,12,5,75,16,111,229,106
2019,41,72,"Nevsehir",38.6244,34.7239,9.9,15.5857142857143,0,50.2,31.3614285714286,36.7085714285714,416,0,0,92,63,448,416,448
2019,42,72,"Nevsehir",38.6244,34.7239,10.6285714285714,17.0142857142857,0.313571428571429,48.4142857142857,39.656,37.504,356,81,94,164,210,408,275,314
2019,43,72,"Nevsehir",38.6244,34.7239,9.67142857142857,11.7142857142857,0.0602857142857143,73.2,30.7816666666667,42.9966666666667,306,0,0,117,169,300,306,300
2019,44,72,"Nevsehir",38.6244,34.7239,8.77142857142857,9.38571428571429,0.714142857142857,67.2,32.6128571428571,36.705,350,61,30,20,6,250,289,220
2019,45,72,"Nevsehir",38.6244,34.7239,14.4285714285714,11.2142857142857,0,49,53.5642857142857,49.2914285714286,417,347,237,0,0,328,70,91
2019,46,72,"Nevsehir",38.6244,34.7239,11.2,11.2714285714286,0.284857142857143,52.2,64.6257142857143,47.5114285714286,401,275,242,44,41,337,126,95
2019,47,72,"Nevsehir",38.6244,34.7239,8.04285714285714,4.12857142857143,0,58.0428571428571,78.6085714285714,58.2328571428571,391,153,142,67,38,339,238,197
2019,48,72,"Nevsehir",38.6244,34.7239,17.5,8.55714285714286,2.11471428571429,68.2428571428571,46.9742857142857,33.2114285714286,320,128,72,6,5,251,192,179
2019,49,72,"Nevsehir",38.6244,34.7239,9.32857142857143,-0.114285714285714,1.371,86.5142857142857,34.0557142857143,32.6171428571429,393,63,44,22,7,274,330,230
2019,50,72,"Nevsehir",38.6244,34.7239,13.3,4.02857142857143,1.19714285714286,80.1142857142857,34.2042857142857,33.7314285714286,218,124,73,31,0,119,94,46
2019,51,72,"Nevsehir",38.6244,34.7239,8.21428571428572,6.4,0,58.7142857142857,81.4785714285714,59.95,361,10,22,8,3,488,351,466
2019,52,72,"Nevsehir",38.6244,34.7239,13.0428571428571,2.4,4.96971428571429,86.6142857142857,32.1842857142857,31.93,279,132,185,73,29,281,147,96
2020,1,72,"Nevsehir",38.6244,34.7239,8.72,-0.7,0.9798,91.9,26.794,27.338,160,8,8,3,2,126,152,118
2020,2,72,"Nevsehir",38.6244,34.7239,14.5714285714286,0.371428571428572,1.71142857142857,78.4857142857143,24.6514285714286,28.9085714285714,240,49,31,63,51,173,191,142
2020,3,72,"Nevsehir",38.6244,34.7239,7.78571428571429,-0.6,0.0571428571428571,78.1142857142857,50.71,56.675,270,3,11,71,76,382,267,371
2020,4,72,"Nevsehir",38.6244,34.7239,11.4571428571429,-2.65714285714286,0.656571428571429,68.2857142857143,34.1057142857143,60.965,358,4,0,53,29,295,354,295
2020,5,72,"Nevsehir",38.6244,34.7239,18.8428571428571,2.35714285714286,4.45657142857143,73.6142857142857,39.8214285714286,33.6257142857143,331,64,97,32,24,272,267,175
2020,6,72,"Nevsehir",38.6244,34.7239,18.5571428571429,0.714285714285714,4.71328571428571,78.2285714285714,18.8971428571429,21.31,343,48,22,52,32,267,295,245
2020,7,72,"Nevsehir",38.6244,34.7239,14.9142857142857,-1.85714285714286,3.08571428571429,72.0857142857143,36.2085714285714,43.5428571428571,341,107,70,7,7,338,234,268
2020,8,72,"Nevsehir",38.6244,34.7239,9.82857142857143,1.8,0.101428571428571,78.2857142857143,47.0742857142857,49.3971428571429,283,63,70,0,0,187,220,117
2020,9,72,"Nevsehir",38.6244,34.7239,16.5428571428571,5.82857142857143,1.12785714285714,63.5142857142857,27.7285714285714,16.6128571428571,393,88,124,49,37,528,305,404
2020,10,72,"Nevsehir",38.6244,34.7239,12.5142857142857,10.0285714285714,0,46.8857142857143,40.4642857142857,18.1814285714286,205,95,61,0,0,210,110,149
2020,11,72,"Nevsehir",38.6244,34.7239,18.3428571428571,11.9857142857143,0.000714285714285714,48.3571428571429,52.9757142857143,15.2014285714286,115,36,28,1,0,94,79,66
2020,12,72,"Nevsehir",38.6244,34.7239,11.3571428571429,-0.957142857142857,4.86857142857143,89.2571428571429,17.9928571428571,NA,117,8,6,31,31,118,109,112
2020,13,72,"Nevsehir",38.6244,34.7239,14.0857142857143,8.07142857142857,1.494,70.6714285714286,28.058,24.7,136,68,32,5,4,92,68,60
2020,14,72,"Nevsehir",38.6244,34.7239,15.5,7.07142857142857,1.62842857142857,73.9857142857143,29.3114285714286,NA,155,35,12,26,14,121,120,109
2020,15,72,"Nevsehir",38.6244,34.7239,17.4428571428571,7.48571428571429,1.14271428571429,65.3857142857143,30.4857142857143,NA,133,3,1,31,15,118,130,117
2020,16,72,"Nevsehir",38.6244,34.7239,13.6428571428571,10.5714285714286,0.0147142857142857,54.2714285714286,32.9142857142857,NA,141,12,8,42,40,106,129,98
2020,17,72,"Nevsehir",38.6244,34.7239,13.5857142857143,9.81428571428571,0.912428571428571,60.6,29.16,NA,137,0,0,33,46,123,137,123
2020,18,72,"Nevsehir",38.6244,34.7239,14.6714285714286,11.7285714285714,8.50928571428571,65.2428571428571,24.3157142857143,NA,146,9,13,70,95,164,137,151
2020,19,72,"Nevsehir",38.6244,34.7239,12.8428571428571,10.5142857142857,2.83228571428571,74.2714285714286,18.2185714285714,NA,137,0,0,60,29,157,137,157
2020,20,72,"Nevsehir",38.6244,34.7239,13.6857142857143,19.0857142857143,0,46.6285714285714,52.4714285714286,NA,164,0,0,59,73,164,164,164
2020,21,72,"Nevsehir",38.6244,34.7239,15.7428571428571,18.1,0.0307142857142857,45.5,58.6242857142857,NA,146,0,0,72,48,96,146,96
2020,22,72,"Nevsehir",38.6244,34.7239,14.8142857142857,14.9714285714286,0.000428571428571429,44.5285714285714,24.9,NA,118,11,3,7,5,100,107,97
2020,23,72,"Nevsehir",38.6244,34.7239,15.0428571428571,17.9285714285714,0.827428571428571,43.7428571428571,26.73,NA,112,18,16,13,14,70,94,54
2020,24,72,"Nevsehir",38.6244,34.7239,13.5571428571429,19.5571428571429,2.49814285714286,49.0428571428571,39.9742857142857,NA,140,38,22,5,1,150,102,128
2020,25,72,"Nevsehir",38.6244,34.7239,11.5142857142857,19.1571428571429,2.23128571428571,55.4285714285714,30.9057142857143,NA,137,0,0,35,34,108,137,108
2020,26,72,"Nevsehir",38.6244,34.7239,18.5571428571429,20.5571428571429,0.858428571428572,54.5428571428571,32.9614285714286,NA,173,2,0,27,25,133,171,133
2020,27,72,"Nevsehir",38.6244,34.7239,16.9285714285714,22.8285714285714,0.000428571428571429,40.2142857142857,33.7128571428571,NA,113,0,0,12,27,113,113,113
2020,28,72,"Nevsehir",38.6244,34.7239,24.5,22.9571428571429,2.70742857142857,51.5,26.92,NA,164,0,0,4,0,122,164,122
2020,29,72,"Nevsehir",38.6244,34.7239,19.3,24.5857142857143,0,42.9,39.196,NA,186,28,10,29,6,111,158,101
2020,30,72,"Nevsehir",38.6244,34.7239,26,23.6428571428571,0,44.6857142857143,37.7528571428571,NA,190,0,0,50,35,142,190,142
2020,31,72,"Nevsehir",38.6244,34.7239,18.5285714285714,24.3,0,40.5428571428571,34.274,NA,150,0,0,19,17,127,150,127
2020,32,72,"Nevsehir",38.6244,34.7239,24.8285714285714,22.5428571428571,0,38.8428571428571,30.9666666666667,NA,146,0,0,32,24,107,146,107
2020,33,72,"Nevsehir",38.6244,34.7239,28.1571428571429,21.4714285714286,0,41.6,36.4775,NA,183,0,0,5,1,83,183,83
2020,34,72,"Nevsehir",38.6244,34.7239,17.0714285714286,20.5142857142857,0,42.6428571428571,35.3885714285714,NA,197,8,5,58,47,97,189,92
2020,35,72,"Nevsehir",38.6244,34.7239,13.1142857142857,22.2714285714286,0,30.9857142857143,42.4414285714286,37.334,164,22,15,40,26,157,142,142
2020,36,72,"Nevsehir",38.6244,34.7239,13.7285714285714,25.4142857142857,0,30.4714285714286,68.3728571428571,28.1914285714286,179,73,28,22,3,112,106,84
2020,37,72,"Nevsehir",38.6244,34.7239,26.0285714285714,21.9857142857143,0.356571428571429,46.5,51.1728571428571,28.26,193,1,1,22,6,91,192,90
2020,38,72,"Nevsehir",38.6244,34.7239,19.2571428571429,20.9714285714286,0,46.5428571428571,48.7028571428571,30.2242857142857,235,14,16,55,16,157,221,141
2020,39,72,"Nevsehir",38.6244,34.7239,17.4285714285714,19.0857142857143,0.00171428571428571,50.8285714285714,47.16,30.2571428571429,220,55,17,84,72,129,165,112
2020,40,72,"Nevsehir",38.6244,34.7239,15.3857142857143,17.6571428571429,0.716142857142857,47.6857142857143,49.7671428571429,32.4371428571429,187,16,13,22,10,154,171,141
2020,41,72,"Nevsehir",38.6244,34.7239,14.8,19.2428571428571,0,31.5285714285714,66.8757142857143,33.0771428571429,182,134,78,0,0,127,48,49
2020,42,72,"Nevsehir",38.6244,34.7239,14,17.0714285714286,0,38.9714285714286,69.2971428571429,38.6842857142857,177,146,92,0,0,111,31,19
2020,43,72,"Nevsehir",38.6244,34.7239,11.2142857142857,14.6285714285714,0.0327142857142857,54.1714285714286,63.64,33.9142857142857,194,60,50,5,4,161,134,111
2020,44,72,"Nevsehir",38.6244,34.7239,14.4571428571429,14.7428571428571,0,44.3285714285714,60.9414285714286,23.5514285714286,255,126,148,14,17,233,129,85
2020,45,72,"Nevsehir",38.6244,34.7239,23.5285714285714,7.94285714285714,2.88557142857143,74.5142857142857,33.1885714285714,25.6257142857143,156,1,2,39,21,103,155,101
2020,46,72,"Nevsehir",38.6244,34.7239,11.5857142857143,5.51428571428571,0,74.4714285714286,66.0442857142857,41.4,208,89,36,1,0,109,119,73
2020,47,72,"Nevsehir",38.6244,34.7239,10.2857142857143,3.27142857142857,0.00157142857142857,76,55.3728571428571,36.8671428571429,173,44,13,44,30,83,129,70
2020,48,72,"Nevsehir",38.6244,34.7239,17.2857142857143,0.285714285714286,0,69.1857142857143,72.2628571428571,42.6185714285714,199,100,159,0,0,262,99,103
2020,49,72,"Nevsehir",38.6244,34.7239,9.3,3.9,0.170857142857143,71.4142857142857,72.7528571428571,45.5642857142857,207,78,51,0,0,116,129,65
2020,50,72,"Nevsehir",38.6244,34.7239,19.5571428571429,6.02857142857143,2.45685714285714,71.9,30.6457142857143,21.2957142857143,181,181,98,0,0,98,0,0
2020,51,72,"Nevsehir",38.6244,34.7239,14.8428571428571,4.5,0.459857142857143,78.2142857142857,28.8742857142857,25.0428571428571,171,68,40,20,8,90,103,50
2020,52,72,"Nevsehir",38.6244,34.7239,14.0142857142857,1.42857142857143,0.0428571428571429,71.9428571428572,48.3771428571429,35.8742857142857,203,134,63,10,23,113,69,50
2020,53,72,"Nevsehir",38.6244,34.7239,13.025,4.35,0,61.325,58.5125,45.4,122,119,110,0,0,111,3,1
2017,1,73,"Nigde",37.9667,34.6833,21.2142857142857,-1.02857142857143,0.871428571428571,71.8857142857143,58.4814285714286,NA,563,92,170,0,0,847,471,677
2017,2,73,"Nigde",37.9667,34.6833,15.1428571428571,-1.58571428571429,0.114285714285714,67.3428571428571,49.7842857142857,NA,757,46,74,0,0,1214,711,1140
2017,3,73,"Nigde",37.9667,34.6833,13.7714285714286,0.814285714285714,0,70,70.3085714285714,NA,762,104,169,0,0,1449,658,1280
2017,4,73,"Nigde",37.9667,34.6833,14.3285714285714,-3.95714285714286,1.55185714285714,70.9857142857143,50.7471428571429,NA,639,79,94,31,70,889,560,795
2017,5,73,"Nigde",37.9667,34.6833,12.2285714285714,-6.81428571428571,0.1,62.5142857142857,73.2685714285714,NA,588,78,145,44,125,1163,510,1018
2017,6,73,"Nigde",37.9667,34.6833,11.9714285714286,2.4,0.142857142857143,74.4857142857143,86.4471428571429,NA,736,169,226,14,31,1519,567,1293
2017,7,73,"Nigde",37.9667,34.6833,14.5428571428571,-3.42857142857143,0.0428571428571429,62.4285714285714,45.9428571428571,NA,492,41,35,1,10,717,451,682
2017,8,73,"Nigde",37.9667,34.6833,15.4,4.38571428571429,0.0428571428571429,55.2285714285714,73.2757142857143,NA,739,28,98,0,0,1747,711,1649
2017,9,73,"Nigde",37.9667,34.6833,15.6142857142857,7.64285714285714,0.114285714285714,55.7714285714286,91.1185714285714,NA,574,308,521,0,0,866,266,345
2017,10,73,"Nigde",37.9667,34.6833,20.4285714285714,8.25714285714286,0.442857142857143,51.9142857142857,107.691428571429,NA,712,424,673,0,0,1043,288,370
2017,11,73,"Nigde",37.9667,34.6833,14.2857142857143,1.77142857142857,3.42857142857143,75.7,39.5714285714286,NA,525,111,169,41,51,725,414,556
2017,12,73,"Nigde",37.9667,34.6833,15.6142857142857,7.04285714285714,0.528571428571429,52.8571428571429,67.9314285714286,NA,589,0,0,0,0,1077,589,1077
2017,13,73,"Nigde",37.9667,34.6833,14.5857142857143,8.91428571428571,0.771428571428571,57.8285714285714,58.1185714285714,NA,574,142,207,0,0,887,432,680
2017,14,73,"Nigde",37.9667,34.6833,16.9428571428571,10.6142857142857,1.3,44.8285714285714,53.96,NA,639,239,524,0,0,1336,400,812
2017,15,73,"Nigde",37.9667,34.6833,13.2571428571429,8.15714285714286,4.45714285714286,66.0142857142857,49.2142857142857,NA,587,47,39,0,0,1187,540,1148
2017,16,73,"Nigde",37.9667,34.6833,24.6285714285714,12.4285714285714,0.1,49.0857142857143,103.607142857143,NA,717,37,88,0,0,920,680,832
2017,17,73,"Nigde",37.9667,34.6833,13,12.4142857142857,0,33.1571428571429,67.1842857142857,NA,731,106,282,0,0,1478,625,1196
2017,18,73,"Nigde",37.9667,34.6833,15.9571428571429,13.9857142857143,0.342857142857143,55.6428571428571,73.42,NA,506,108,178,0,0,923,398,745
2017,19,73,"Nigde",37.9667,34.6833,19.5714285714286,17.8428571428571,0.214285714285714,38.9714285714286,115.511428571429,NA,471,0,0,42,49,966,471,966
2017,20,73,"Nigde",37.9667,34.6833,14.5428571428571,14.4,2.28571428571429,55.2857142857143,62.3228571428571,NA,472,15,30,0,0,1205,457,1175
2017,21,73,"Nigde",37.9667,34.6833,14.8428571428571,13.2285714285714,2.38571428571429,61.8285714285714,56.0714285714286,NA,448,92,100,0,0,849,356,749
2017,22,73,"Nigde",37.9667,34.6833,12.7857142857143,17.4714285714286,0.114285714285714,51.8857142857143,52.8557142857143,NA,522,137,330,100,179,1015,385,685
2017,23,73,"Nigde",37.9667,34.6833,17.5142857142857,20.4571428571429,0.0857142857142857,48.6285714285714,79.8042857142857,NA,578,59,80,26,39,1388,519,1308
2017,24,73,"Nigde",37.9667,34.6833,14.8,18.7285714285714,0.342857142857143,51.4857142857143,66.9528571428571,NA,552,15,29,0,0,1139,537,1110
2017,25,73,"Nigde",37.9667,34.6833,15.1,18.7571428571429,0.385714285714286,50.0714285714286,57.2428571428571,NA,584,0,0,36,108,1041,584,1041
2017,26,73,"Nigde",37.9667,34.6833,14.1142857142857,25.1,0,29.8142857142857,73.4914285714286,NA,564,30,60,116,184,971,534,911
2017,27,73,"Nigde",37.9667,34.6833,15.5714285714286,23.2857142857143,0,36.3285714285714,84.0671428571429,NA,511,0,0,0,0,642,511,642
2017,28,73,"Nigde",37.9667,34.6833,14.3,24.5285714285714,0,23.4571428571429,85.38,NA,481,167,263,0,0,864,314,601
2017,29,73,"Nigde",37.9667,34.6833,13.5142857142857,25.0857142857143,0,35.7142857142857,89.0642857142857,NA,532,0,0,0,0,1272,532,1272
2017,30,73,"Nigde",37.9667,34.6833,16.1285714285714,24.0714285714286,0,32.0142857142857,107.924285714286,NA,531,13,14,0,0,928,518,914
2017,31,73,"Nigde",37.9667,34.6833,15.1,23.2285714285714,2.44285714285714,47.7857142857143,74.6857142857143,NA,559,16,30,96,226,1047,543,1017
2017,32,73,"Nigde",37.9667,34.6833,12.7428571428571,25.8571428571429,0,32.6857142857143,93.1228571428571,NA,567,104,221,108,113,1092,463,871
2017,33,73,"Nigde",37.9667,34.6833,12.4857142857143,24.7,0,42.0714285714286,91.9228571428571,NA,596,184,379,151,283,1199,412,820
2017,34,73,"Nigde",37.9667,34.6833,13.5142857142857,21.3571428571429,0.114285714285714,46.3,76.9028571428571,NA,601,0,0,29,72,1280,601,1280
2017,35,73,"Nigde",37.9667,34.6833,11.9714285714286,21.4142857142857,0,36.1428571428571,63.9571428571429,NA,493,0,0,184,238,1014,493,1014
2017,36,73,"Nigde",37.9667,34.6833,13.0428571428571,21.1714285714286,0.0571428571428571,28.3285714285714,89.6542857142857,NA,507,121,366,0,0,1321,386,955
2017,37,73,"Nigde",37.9667,34.6833,14.0285714285714,24.7571428571429,0,21.3857142857143,145.5,NA,589,200,309,0,0,1138,389,829
2017,38,73,"Nigde",37.9667,34.6833,14.3285714285714,21.7857142857143,0,27.6428571428571,145.961428571429,NA,671,160,225,0,0,1312,511,1087
2017,39,73,"Nigde",37.9667,34.6833,14.2857142857143,17.7428571428571,0.214285714285714,42.7571428571429,93.0071428571429,NA,782,176,454,0,0,1630,606,1176
2017,40,73,"Nigde",37.9667,34.6833,15.3571428571429,12.8428571428571,0.0142857142857143,42.8571428571429,98.9542857142857,NA,543,113,231,0,0,1137,430,906
2017,41,73,"Nigde",37.9667,34.6833,12.7428571428571,11.4142857142857,0.471428571428571,48.5714285714286,71.6,NA,487,27,30,25,14,843,460,813
2017,42,73,"Nigde",37.9667,34.6833,13.2571428571429,11.7428571428571,0,37.4,95.46,NA,530,154,208,0,0,815,376,607
2017,43,73,"Nigde",37.9667,34.6833,19.3571428571429,12.6142857142857,1.42857142857143,50.5857142857143,147.345714285714,NA,506,183,337,0,0,919,323,582
2017,44,73,"Nigde",37.9667,34.6833,13.2571428571429,6.55714285714286,1.57142857142857,58.7571428571429,67.62,NA,561,253,519,0,0,1102,308,583
2017,45,73,"Nigde",37.9667,34.6833,11.7142857142857,6.7,0.0285714285714286,62.9,93.3914285714286,NA,577,79,117,0,0,829,498,712
2017,46,73,"Nigde",37.9667,34.6833,16.1285714285714,9.84285714285714,0,49.0142857142857,146.318571428571,NA,587,326,588,0,0,1085,261,497
2017,47,73,"Nigde",37.9667,34.6833,14.6285714285714,2.5,1.75714285714286,73.9142857142857,56.38,NA,418,115,228,0,0,804,303,576
2017,48,73,"Nigde",37.9667,34.6833,14.1142857142857,6.14285714285714,0.857142857142857,66.2428571428571,75.3528571428571,NA,386,180,271,0,0,619,206,348
2017,49,73,"Nigde",37.9667,34.6833,13,1.41428571428571,2.61428571428571,66.2285714285714,73.3785714285714,NA,407,59,144,14,16,645,348,501
2017,50,73,"Nigde",37.9667,34.6833,14.0285714285714,4.75714285714286,0.0142857142857143,67.0428571428571,94.2042857142857,NA,346,54,35,0,0,442,292,407
2017,51,73,"Nigde",37.9667,34.6833,18.2285714285714,7.48571428571429,3.771,69.0714285714286,86.7714285714286,NA,386,71,73,0,0,349,315,276
2017,52,73,"Nigde",37.9667,34.6833,15.8875,2.075,0.4125,65.775,72.57625,NA,528,202,226,66,35,507,326,281
2018,1,73,"Nigde",37.9667,34.6833,11.15,1.7625,2.7625,80.8625,54.4625,NA,618,221,239,26,52,914,397,675
2018,2,73,"Nigde",37.9667,34.6833,13.0428571428571,2.75714285714286,1.31428571428571,71.7714285714286,79.8714285714286,NA,624,245,427,22,63,1309,379,882
2018,3,73,"Nigde",37.9667,34.6833,13.7,0.128571428571429,6.32857142857143,79.7,47.5514285714286,NA,639,105,134,66,19,655,534,521
2018,4,73,"Nigde",37.9667,34.6833,17.2428571428571,-0.657142857142857,1.17142857142857,78.8571428571429,23.4028571428571,NA,604,57,87,1,0,764,547,677
2018,5,73,"Nigde",37.9667,34.6833,13.4,1.25714285714286,0,66.9,88.1133333333333,NA,670,80,152,0,0,819,590,667
2018,6,73,"Nigde",37.9667,34.6833,15.6142857142857,7.74285714285714,0.0571428571428571,52.0142857142857,158.575714285714,NA,704,239,322,0,0,1022,465,700
2018,7,73,"Nigde",37.9667,34.6833,16.1285714285714,5.11428571428571,0.728571428571429,62.4428571428571,64.4171428571428,NA,478,182,231,1,4,557,296,326
2018,8,73,"Nigde",37.9667,34.6833,13.5142857142857,5.41428571428571,1.34285714285714,65.5428571428571,55.2628571428571,NA,711,188,275,0,0,1321,523,1046
2018,9,73,"Nigde",37.9667,34.6833,20.5857142857143,6.24285714285714,0.971428571428571,63.2285714285714,76.1214285714286,NA,621,257,431,0,0,956,364,525
2018,10,73,"Nigde",37.9667,34.6833,16.1714285714286,8.72857142857143,2.35714285714286,62.6,116.088571428571,NA,556,26,8,0,0,1330,530,1322
2018,11,73,"Nigde",37.9667,34.6833,18.0142857142857,9.04285714285714,0.0571428571428571,56.1285714285714,76.0114285714286,NA,551,24,46,0,0,1426,527,1380
2018,12,73,"Nigde",37.9667,34.6833,25.1571428571429,13,0,37.2142857142857,236.857142857143,NA,425,38,307,0,0,1187,387,880
2018,13,73,"Nigde",37.9667,34.6833,19.3571428571429,10.7428571428571,2.6,52.2,86.47,NA,356,31,66,0,0,428,325,362
2018,14,73,"Nigde",37.9667,34.6833,19.6142857142857,11.0571428571429,0,40,75.2957142857143,NA,407,135,149,0,0,486,272,337
2018,15,73,"Nigde",37.9667,34.6833,12.3714285714286,12.2857142857143,3.08571428571429,57.6571428571429,71.7342857142857,NA,374,50,166,92,91,450,324,284
2018,16,73,"Nigde",37.9667,34.6833,15.6142857142857,11.9428571428571,0.842857142857143,41.3,61.8666666666667,NA,411,110,183,40,100,648,301,465
2018,17,73,"Nigde",37.9667,34.6833,12.4857142857143,15.5428571428571,0.0571428571428571,37.2142857142857,74.5457142857143,NA,419,89,280,8,2,652,330,372
2018,18,73,"Nigde",37.9667,34.6833,14.5857142857143,16.8,0.714285714285714,47.8142857142857,93.5385714285714,NA,303,191,289,0,0,474,112,185
2018,19,73,"Nigde",37.9667,34.6833,14.8,12.1571428571429,5.26042857142857,70,42.5957142857143,NA,275,29,110,12,14,467,246,357
2018,20,73,"Nigde",37.9667,34.6833,11.9714285714286,17.6285714285714,0.742857142857143,46.1571428571429,62.7814285714286,NA,204,58,99,32,27,306,146,207
2018,21,73,"Nigde",37.9667,34.6833,15.1,18.3285714285714,0.1,49.1428571428571,88.2814285714286,NA,252,147,226,0,0,281,105,55
2018,22,73,"Nigde",37.9667,34.6833,15.8714285714286,16.6142857142857,2.88571428571429,59.7857142857143,69.2071428571429,NA,249,15,83,6,16,427,234,344
2018,23,73,"Nigde",37.9667,34.6833,12.2285714285714,20.6714285714286,0.371428571428571,39.9857142857143,66.87,NA,267,35,117,0,0,812,232,695
2018,24,73,"Nigde",37.9667,34.6833,14.5857142857143,19.9857142857143,0.428571428571429,49.9428571428571,50.17,NA,267,10,21,12,54,448,257,427
2018,25,73,"Nigde",37.9667,34.6833,12.2285714285714,19.1285714285714,4.58571428571429,58.7142857142857,42.3257142857143,NA,358,0,0,39,25,518,358,518
2018,26,73,"Nigde",37.9667,34.6833,14.8857142857143,22.5428571428571,0.571428571428572,46.2714285714286,70.9428571428572,NA,355,38,65,0,0,587,317,522
2018,27,73,"Nigde",37.9667,34.6833,14.2857142857143,23.2142857142857,0,36.4857142857143,66.37,NA,342,44,78,0,0,418,298,340
2018,28,73,"Nigde",37.9667,34.6833,14.8428571428571,24.4714285714286,0,40.9,95.8,NA,286,2,2,8,10,585,284,583
2018,29,73,"Nigde",37.9667,34.6833,13,22.5857142857143,0.142857142857143,35.5285714285714,82.16,NA,260,1,2,9,41,756,259,754
2018,30,73,"Nigde",37.9667,34.6833,16.3857142857143,23.9142857142857,0,41.3142857142857,89.9714285714286,NA,265,0,0,15,130,822,265,822
2018,31,73,"Nigde",37.9667,34.6833,14.0285714285714,24.7857142857143,0.114285714285714,37.6142857142857,90.4457142857143,NA,267,0,0,34,81,499,267,499
2018,32,73,"Nigde",37.9667,34.6833,16.3428571428571,21.6714285714286,0.0142857142857143,38.5,65.0914285714286,NA,297,0,0,0,0,403,297,403
2018,33,73,"Nigde",37.9667,34.6833,13.7714285714286,22.8571428571429,0,29.9857142857143,72.1557142857143,NA,216,33,51,0,0,332,183,281
2018,34,73,"Nigde",37.9667,34.6833,13.4571428571429,23.6714285714286,0,31.7714285714286,49.7228571428571,NA,144,30,34,0,0,227,114,193
2018,35,73,"Nigde",37.9667,34.6833,12.2714285714286,24.3714285714286,0,35.7857142857143,91.26,NA,201,9,42,0,0,314,192,272
2018,36,73,"Nigde",37.9667,34.6833,12.6142857142857,21.3142857142857,0.442857142857143,35.2857142857143,77.0071428571429,NA,341,53,36,1,18,370,288,334
2018,37,73,"Nigde",37.9667,34.6833,16.1857142857143,18.7285714285714,0.0142857142857143,42.7571428571429,89.7971428571429,NA,241,46,91,18,59,419,195,328
2018,38,73,"Nigde",37.9667,34.6833,13.5142857142857,18.2571428571429,0,35.8571428571429,75.7242857142857,NA,189,28,53,1,0,344,161,291
2018,39,73,"Nigde",37.9667,34.6833,14.8,17.5,0.542857142857143,40.8714285714286,99.9557142857143,NA,180,18,63,7,18,353,162,290
2018,40,73,"Nigde",37.9667,34.6833,13,15.5571428571429,1,46.9857142857143,63.8828571428571,NA,191,3,13,0,0,341,188,328
2018,41,73,"Nigde",37.9667,34.6833,12.0142857142857,14.1285714285714,2.07142857142857,63.6285714285714,86.5585714285714,NA,187,70,168,0,0,422,117,254
2018,42,73,"Nigde",37.9667,34.6833,11.7142857142857,14.8428571428571,2.64285714285714,60.2428571428571,133.528571428571,NA,168,120,317,0,0,381,48,64
2018,43,73,"Nigde",37.9667,34.6833,14.0142857142857,9.35714285714286,1.71057142857143,67.7571428571429,69.54,NA,187,33,79,0,0,402,154,323
2018,44,73,"Nigde",37.9667,34.6833,10.6857142857143,11.0142857142857,0.0571428571428571,47.9714285714286,87.6614285714286,NA,196,63,75,0,0,264,133,189
2018,45,73,"Nigde",37.9667,34.6833,9.91428571428571,7.92857142857143,0,59.2285714285714,86.1757142857143,NA,231,78,137,6,16,473,153,336
2018,46,73,"Nigde",37.9667,34.6833,13.2571428571429,4,1.11428571428571,67.4142857142857,59.2728571428571,NA,230,35,76,0,0,465,195,389
2018,47,73,"Nigde",37.9667,34.6833,11.4571428571429,7.14285714285714,0.157142857142857,69.7,76.3585714285714,NA,270,56,74,0,0,499,214,425
2018,48,73,"Nigde",37.9667,34.6833,17.7571428571429,7.47142857142857,4.75928571428571,77.7571428571429,54.5757142857143,NA,245,104,126,0,0,201,141,75
2018,49,73,"Nigde",37.9667,34.6833,10.9428571428571,4.25714285714286,3.79285714285714,85.4428571428572,44.8871428571429,NA,257,96,186,1,1,420,161,234
2018,50,73,"Nigde",37.9667,34.6833,15.1857142857143,3.68571428571429,2.91428571428571,78.8428571428571,42.0728571428571,NA,256,67,37,0,0,305,189,268
2018,51,73,"Nigde",37.9667,34.6833,11.6571428571429,3.58571428571429,4.94285714285714,86.5571428571428,52.61,NA,250,99,157,1,0,248,151,91
2018,52,73,"Nigde",37.9667,34.6833,17.7142857142857,-1.9,1.27142857142857,82.4428571428571,45.7914285714286,NA,244,43,39,2,5,273,201,234
2019,1,73,"Nigde",37.9667,34.6833,19.95,2,0.75,80.5,28.97125,36.03,343,102,137,0,0,784,241,647
2019,2,73,"Nigde",37.9667,34.6833,13.2571428571429,-3.57142857142857,1.67142857142857,80.8571428571429,51.7057142857143,NA,255,68,109,5,2,208,187,99
2019,3,73,"Nigde",37.9667,34.6833,17.1571428571429,-3.07142857142857,2.9,77.0285714285714,34.6275,NA,192,27,42,7,3,198,165,156
2019,4,73,"Nigde",37.9667,34.6833,19.1571428571429,3.01428571428571,0.771428571428571,69.6571428571429,NA,NA,308,155,216,0,0,314,153,98
2019,5,73,"Nigde",37.9667,34.6833,13.8142857142857,2.62857142857143,1.8,69.8714285714286,53.348,NA,253,92,55,0,0,143,161,88
2019,6,73,"Nigde",37.9667,34.6833,13.0428571428571,4.32857142857143,5,74.4714285714286,44.3,NA,276,96,35,0,0,127,180,92
2019,7,73,"Nigde",37.9667,34.6833,12.4857142857143,2.74285714285714,0.0857142857142857,72.6285714285714,53.2057142857143,NA,325,54,23,6,4,234,271,211
2019,8,73,"Nigde",37.9667,34.6833,12.7428571428571,3.68571428571429,0,64.4714285714286,77.2614285714286,NA,305,83,110,0,0,219,222,109
2019,9,73,"Nigde",37.9667,34.6833,15.5714285714286,1.92857142857143,1.71428571428571,73.5571428571429,43.4557142857143,NA,331,4,2,0,0,310,327,308
2019,10,73,"Nigde",37.9667,34.6833,16.1285714285714,4.91428571428571,0.157142857142857,57.1428571428571,56.5671428571429,NA,359,38,26,4,4,252,321,226
2019,11,73,"Nigde",37.9667,34.6833,16.9428571428571,6.62857142857143,0.628571428571429,68.7571428571429,56.2971428571429,NA,373,79,169,0,0,400,294,231
2019,12,73,"Nigde",37.9667,34.6833,14.3285714285714,6.75714285714286,0.157142857142857,49.6857142857143,73.0042857142857,NA,343,26,5,0,0,416,317,411
2019,13,73,"Nigde",37.9667,34.6833,15.3142857142857,3.58571428571429,2.22257142857143,67.4714285714286,45.1242857142857,NA,256,1,1,8,0,194,255,193
2019,14,73,"Nigde",37.9667,34.6833,12.2285714285714,6.87142857142857,0.789428571428571,71.6714285714286,45.4714285714286,NA,365,152,72,0,0,208,213,136
2019,15,73,"Nigde",37.9667,34.6833,18.7428571428571,10.8714285714286,0.257142857142857,58.3,73.9385714285714,NA,359,150,83,0,0,183,209,100
2019,16,73,"Nigde",37.9667,34.6833,16.4285714285714,5.37142857142857,1.67142857142857,75.6285714285714,33.0685714285714,NA,318,45,29,40,8,208,273,179
2019,17,73,"Nigde",37.9667,34.6833,13,9.42857142857143,0.476571428571429,61.8285714285714,68.8414285714286,NA,412,10,8,0,0,313,402,305
2019,18,73,"Nigde",37.9667,34.6833,14.8,13.2428571428571,2.48042857142857,58.7857142857143,57.6,NA,523,8,3,3,0,353,515,350
2019,19,73,"Nigde",37.9667,34.6833,18.2285714285714,12.7857142857143,0.542857142857143,57.3142857142857,26.06,NA,452,188,146,1,4,386,264,240
2019,20,73,"Nigde",37.9667,34.6833,15.0571428571429,18.3428571428571,1.28571428571429,43.6571428571429,43.756,NA,454,104,94,0,0,389,350,295
2019,21,73,"Nigde",37.9667,34.6833,15.3571428571429,19.5571428571429,0.0142857142857143,41.3,60.818,NA,457,0,0,2,2,413,457,413
2019,22,73,"Nigde",37.9667,34.6833,14.8428571428571,21.9571428571429,0,37.3571428571429,62.8285714285714,NA,453,0,0,0,0,323,453,323
2019,23,73,"Nigde",37.9667,34.6833,14.8428571428571,21.4285714285714,1.42857142857143,41.4571428571429,51.0042857142857,NA,378,58,121,0,0,532,320,411
2019,24,73,"Nigde",37.9667,34.6833,14.2857142857143,18.7428571428571,1.5,63.1571428571429,35.972,22.23,378,49,39,44,61,244,329,205
2019,25,73,"Nigde",37.9667,34.6833,13.2571428571429,18.9714285714286,5.35185714285714,68.3428571428571,37.425,25.96,306,0,0,7,48,325,306,325
2019,26,73,"Nigde",37.9667,34.6833,14.0285714285714,23.0571428571429,0,43.8857142857143,41.904,18.3233333333333,377,0,0,0,0,342,377,342
2019,27,73,"Nigde",37.9667,34.6833,15.3571428571429,21.0857142857143,0,38.9142857142857,42.99,19.512,456,0,0,67,14,222,456,222
2019,28,73,"Nigde",37.9667,34.6833,14.0285714285714,22.0142857142857,0.442857142857143,41.4142857142857,47.7114285714286,23.705,398,9,8,78,60,421,389,413
2019,29,73,"Nigde",37.9667,34.6833,15.8714285714286,19.8857142857143,1.05342857142857,57.3,40.77,20.502,453,3,1,4,3,203,450,202
2019,30,73,"Nigde",37.9667,34.6833,14.8,21.2428571428571,0.0285714285714286,43.7571428571429,39.5342857142857,18.82,456,0,0,46,21,335,456,335
2019,31,73,"Nigde",37.9667,34.6833,13,25.1142857142857,0.0285714285714286,35.6571428571429,57.8971428571429,29.09,334,7,2,12,19,375,327,373
2019,32,73,"Nigde",37.9667,34.6833,15.6142857142857,20.8857142857143,0,41.4857142857143,40.1485714285714,16.45,346,0,0,1,5,395,346,395
2019,33,73,"Nigde",37.9667,34.6833,13.7714285714286,23.7571428571429,0.0571428571428571,45.8857142857143,46.6528571428571,22.7816666666667,337,55,69,52,120,531,282,462
2019,34,73,"Nigde",37.9667,34.6833,13.2571428571429,19.5,0.942857142857143,62.8,38.5528571428571,18.946,299,45,34,4,20,345,254,311
2019,35,73,"Nigde",37.9667,34.6833,12.2285714285714,22.0285714285714,0,46.6,38.575,21.2,307,0,0,0,0,415,307,415
2019,36,73,"Nigde",37.9667,34.6833,13,21.3428571428571,0,36.9428571428571,45.5266666666667,25.525,171,0,0,0,0,67,171,67
2019,37,73,"Nigde",37.9667,34.6833,14.8428571428571,18.1571428571429,0.314285714285714,48.2428571428571,40.558,22.815,218,0,0,0,0,55,218,55
2019,38,73,"Nigde",37.9667,34.6833,12.4857142857143,16.0857142857143,0,50.0285714285714,41.836,24.894,266,70,19,7,13,91,196,72
2019,39,73,"Nigde",37.9667,34.6833,11.2,16.7571428571429,0.6,50.2285714285714,51.3228571428571,35.4142857142857,237,16,7,0,0,79,221,72
2019,40,73,"Nigde",37.9667,34.6833,13.7714285714286,18.6857142857143,0,38.8285714285714,66.9657142857143,37.6157142857143,241,26,25,4,2,111,215,86
2019,41,73,"Nigde",37.9667,34.6833,11.7142857142857,16.5142857142857,0,49.4142857142857,49.7442857142857,30.3757142857143,416,52,17,0,0,448,364,431
2019,42,73,"Nigde",37.9667,34.6833,12.0142857142857,16.9285714285714,1.61428571428571,51.1142857142857,52.46,38.36,356,107,104,0,0,408,249,304
2019,43,73,"Nigde",37.9667,34.6833,12.2285714285714,12.8142857142857,0.142857142857143,69.1,39.0214285714286,33.386,306,50,69,0,0,300,256,231
2019,44,73,"Nigde",37.9667,34.6833,10.6857142857143,9.9,1.28571428571429,68.2857142857143,45.1271428571429,36.38,350,68,34,0,0,250,282,216
2019,45,73,"Nigde",37.9667,34.6833,11.4571428571429,11.2571428571429,0,52.6714285714286,54.23,49.5757142857143,417,162,77,0,0,328,255,251
2019,46,73,"Nigde",37.9667,34.6833,13.2428571428571,10.7714285714286,1.02857142857143,59.2285714285714,63.0171428571429,43.6557142857143,401,239,190,0,0,337,162,147
2019,47,73,"Nigde",37.9667,34.6833,10.1714285714286,4.34285714285714,0,61.8571428571429,84.43,47.215,391,171,163,0,0,339,220,176
2019,48,73,"Nigde",37.9667,34.6833,16.0714285714286,8.12857142857143,1.44685714285714,67.5571428571428,60.1642857142857,NA,320,163,131,0,0,251,157,120
2019,49,73,"Nigde",37.9667,34.6833,12.4857142857143,0.457142857142857,1.88571428571429,84.2857142857143,35.2157142857143,NA,393,35,3,54,47,274,358,271
2019,50,73,"Nigde",37.9667,34.6833,11.4857142857143,4.32857142857143,0.669285714285714,82.4714285714286,40.4957142857143,NA,218,58,25,0,0,119,160,94
2019,51,73,"Nigde",37.9667,34.6833,12.4857142857143,5.52857142857143,0,66.6428571428571,59.52,NA,361,11,33,0,0,488,350,455
2019,52,73,"Nigde",37.9667,34.6833,16.7428571428571,3.17142857142857,2.97885714285714,84.6571428571429,27.2028571428571,28.61,279,99,107,17,14,281,180,174
2020,1,73,"Nigde",37.9667,34.6833,12.64,0.38,0.7954,89.44,26.674,23.73,160,0,0,0,0,126,160,126
2020,2,73,"Nigde",37.9667,34.6833,17.5142857142857,1.5,0.457142857142857,75.0142857142857,24.8357142857143,27.1457142857143,240,48,30,2,8,173,192,143
2020,3,73,"Nigde",37.9667,34.6833,11.4571428571429,-0.0142857142857144,0.457142857142857,82.8285714285714,41.5157142857143,34.2985714285714,270,3,0,7,3,382,267,382
2020,4,73,"Nigde",37.9667,34.6833,13.2,-2.2,0.312428571428571,69.0428571428571,30.0814285714286,30.5814285714286,358,3,0,9,4,295,355,295
2020,5,73,"Nigde",37.9667,34.6833,13.8285714285714,2.3,3.16542857142857,72.4,47.244,33.19,331,5,6,15,16,272,326,266
2020,6,73,"Nigde",37.9667,34.6833,20.6571428571429,1.94285714285714,2.73042857142857,73.1,15.33,25.62,343,66,67,0,0,267,277,200
2020,7,73,"Nigde",37.9667,34.6833,15.3571428571429,-1.41428571428571,2.27485714285714,76.9714285714286,29.19,NA,341,0,0,38,91,338,341,338
2020,8,73,"Nigde",37.9667,34.6833,15.1,2.92857142857143,0.0571428571428571,76.7428571428571,33.87,NA,283,34,18,2,0,187,249,169
2020,9,73,"Nigde",37.9667,34.6833,16.1,6.64285714285714,1.22857142857143,62.4285714285714,27.1471428571429,NA,393,11,6,37,11,528,382,522
2020,10,73,"Nigde",37.9667,34.6833,14.8428571428571,10.0571428571429,0.0285714285714286,46.7714285714286,41.8671428571429,NA,205,86,57,0,0,210,119,153
2020,11,73,"Nigde",37.9667,34.6833,20.6428571428571,12.0571428571429,0.0571428571428571,49.8428571428571,46.6671428571429,NA,115,36,25,1,0,94,79,69
2020,12,73,"Nigde",37.9667,34.6833,14.0714285714286,-0.228571428571429,5.41314285714286,85.3714285714286,17.0328571428571,NA,117,0,0,13,17,118,117,118
2020,13,73,"Nigde",37.9667,34.6833,14.2857142857143,7.64285714285714,3.68571428571429,70.3857142857143,32.2342857142857,NA,136,66,47,0,0,92,70,45
2020,14,73,"Nigde",37.9667,34.6833,18.3285714285714,7.04285714285714,0.914285714285714,71.7,22.5328571428571,NA,155,69,34,0,0,121,86,87
2020,15,73,"Nigde",37.9667,34.6833,15.1,8.17142857142857,2.25714285714286,65.1,29.1371428571429,NA,133,24,52,5,2,118,109,66
2020,16,73,"Nigde",37.9667,34.6833,13.7714285714286,11.2714285714286,0.114285714285714,53.2285714285714,34.934,NA,141,26,7,26,18,106,115,99
2020,17,73,"Nigde",37.9667,34.6833,14.0714285714286,10.3285714285714,0.142857142857143,58.7,NA,NA,137,18,32,2,2,123,119,91
2020,18,73,"Nigde",37.9667,34.6833,15.6142857142857,11.7714285714286,5.2,65.6428571428571,NA,NA,146,15,16,0,0,164,131,148
2020,19,73,"Nigde",37.9667,34.6833,12.4857142857143,10.8571428571429,3.15714285714286,70.7571428571429,19.98,NA,137,20,9,9,1,157,117,148
2020,20,73,"Nigde",37.9667,34.6833,14.8,19.7285714285714,0,40.4,56.4285714285714,NA,164,1,3,22,44,164,163,161
2020,21,73,"Nigde",37.9667,34.6833,18.5857142857143,19.1,0.621285714285714,42.3714285714286,67.0857142857143,NA,146,0,0,11,4,96,146,96
2020,22,73,"Nigde",37.9667,34.6833,18.8428571428571,15.6,0.0571428571428571,43.6,19.6871428571429,NA,118,24,13,0,0,100,94,87
2020,23,73,"Nigde",37.9667,34.6833,15.8714285714286,18.3857142857143,0.528571428571429,42.2285714285714,31.79,NA,112,23,24,0,0,70,89,46
2020,24,73,"Nigde",37.9667,34.6833,15.9142857142857,20.2428571428571,1.25571428571429,45.9142857142857,53.5928571428571,NA,140,44,22,0,0,150,96,128
2020,25,73,"Nigde",37.9667,34.6833,12.4857142857143,19.5285714285714,2.10957142857143,54.5714285714286,40.87,NA,137,10,2,0,0,108,127,106
2020,26,73,"Nigde",37.9667,34.6833,13.7714285714286,20.6428571428571,0.507857142857143,50.7857142857143,35.6328571428571,NA,173,9,8,9,16,133,164,125
2020,27,73,"Nigde",37.9667,34.6833,13.7714285714286,23.1714285714286,0.428571428571429,37.5857142857143,33.3383333333333,NA,113,7,12,0,0,113,106,101
2020,28,73,"Nigde",37.9667,34.6833,13.7714285714286,23.1285714285714,0,46.6571428571429,35.22,NA,164,7,0,5,22,122,157,122
2020,29,73,"Nigde",37.9667,34.6833,14.0285714285714,24.6857142857143,0,40.2142857142857,46.3471428571429,NA,186,19,14,0,0,111,167,97
2020,30,73,"Nigde",37.9667,34.6833,13,23.6,0,43.0428571428571,47.7028571428571,NA,190,37,25,15,8,142,153,117
2020,31,73,"Nigde",37.9667,34.6833,14.5428571428571,24.6428571428571,0,36.8714285714286,47.0942857142857,NA,150,1,0,0,0,127,149,127
2020,32,73,"Nigde",37.9667,34.6833,13.7714285714286,23.3571428571429,0,31.2857142857143,41.69,NA,146,7,4,0,0,107,139,103
2020,33,73,"Nigde",37.9667,34.6833,15.5714285714286,21.4857142857143,0,36.0714285714286,43.25,NA,183,0,0,0,0,83,183,83
2020,34,73,"Nigde",37.9667,34.6833,14.8,20.8714285714286,0,36.1,43.9171428571429,NA,197,4,5,29,21,97,193,92
2020,35,73,"Nigde",37.9667,34.6833,12.4857142857143,23.0285714285714,0,25.2857142857143,45.9057142857143,30.9875,164,8,10,3,2,157,156,147
2020,36,73,"Nigde",37.9667,34.6833,14.8857142857143,24.7857142857143,0.285714285714286,31.5285714285714,74.6228571428571,35.7914285714286,179,37,21,1,0,112,142,91
2020,37,73,"Nigde",37.9667,34.6833,14.0285714285714,21.9142857142857,0,41.2428571428571,64.304,29.05,193,34,30,31,3,91,159,61
2020,38,73,"Nigde",37.9667,34.6833,11.4571428571429,21.9,0,39,66.8,34.63,235,40,45,37,39,157,195,112
2020,39,73,"Nigde",37.9667,34.6833,11.4,19.4142857142857,0,47.0142857142857,67.8928571428571,35.2014285714286,220,30,14,3,3,129,190,115
2020,40,73,"Nigde",37.9667,34.6833,14.0714285714286,18.2714285714286,0.178857142857143,42.2571428571429,66.6214285714286,30.9628571428571,187,7,3,0,0,154,180,151
2020,41,73,"Nigde",37.9667,34.6833,14.1142857142857,19.0857142857143,0,31.0857142857143,77.4128571428571,33.5814285714286,182,63,42,0,0,127,119,85
2020,42,73,"Nigde",37.9667,34.6833,11.2,17.1142857142857,0,40.1,82.7985714285714,44.7185714285714,177,71,31,0,0,111,106,80
2020,43,73,"Nigde",37.9667,34.6833,13.7714285714286,15.8571428571429,0.0142857142857143,46.6571428571429,68.0257142857143,31.9514285714286,194,48,58,0,0,161,146,103
2020,44,73,"Nigde",37.9667,34.6833,15.6142857142857,14.6857142857143,0,46.9285714285714,64.8128571428571,30.89,255,78,74,0,0,233,177,159
2020,45,73,"Nigde",37.9667,34.6833,13.5142857142857,8.11428571428571,6.69085714285714,76.3285714285714,30.86,23.8357142857143,156,17,16,5,3,103,139,87
2020,46,73,"Nigde",37.9667,34.6833,10.6857142857143,6.7,0,68.8285714285714,55.2357142857143,37.4042857142857,208,106,45,0,0,109,102,64
2020,47,73,"Nigde",37.9667,34.6833,10.9428571428571,4.84285714285714,0.114285714285714,69.8285714285714,47.7214285714286,34.6614285714286,173,51,23,0,0,83,122,60
2020,48,73,"Nigde",37.9667,34.6833,11.9714285714286,1.42857142857143,0,63.6285714285714,55.5928571428571,35.4571428571429,199,33,81,0,0,262,166,181
2020,49,73,"Nigde",37.9667,34.6833,10.1714285714286,4.94285714285714,0.0571428571428571,67.2857142857143,48.9,38.0542857142857,207,107,56,0,0,116,100,60
2020,50,73,"Nigde",37.9667,34.6833,15.1,5.84285714285714,1.84314285714286,71.4428571428572,43.7457142857143,32.9442857142857,181,107,56,0,0,98,74,42
2020,51,73,"Nigde",37.9667,34.6833,11.4857142857143,4.17142857142857,1.19928571428571,77.0428571428571,37.1914285714286,25.6071428571429,171,64,26,0,0,90,107,64
2020,52,73,"Nigde",37.9667,34.6833,12.5285714285714,1.31428571428571,0.0721428571428571,69.3,53.2685714285714,33.5371428571429,203,41,7,18,14,113,162,106
2020,53,73,"Nigde",37.9667,34.6833,11.65,4.3,0,60.425,58.2325,40.6825,122,110,111,0,0,111,12,0
2017,1,74,"Stadyum",40.9839,37.8767,15.9,8.81428571428571,4.38242857142857,53.7428571428571,77.6957142857143,NA,563,0,0,24,83,847,563,847
2017,2,74,"Stadyum",40.9839,37.8767,14.3857142857143,5.71428571428571,2.01371428571429,64.5714285714286,73.2557142857143,NA,757,107,328,153,138,1214,650,886
2017,3,74,"Stadyum",40.9839,37.8767,12.7285714285714,6.6,0.163285714285714,68.2142857142857,65.9714285714286,NA,762,0,0,451,1002,1449,762,1449
2017,4,74,"Stadyum",40.9839,37.8767,13.2857142857143,3.24285714285714,5.08571428571429,71.9428571428571,48.9142857142857,NA,639,37,134,431,593,889,602,755
2017,5,74,"Stadyum",40.9839,37.8767,15.9428571428571,3.25714285714286,3.11857142857143,63.0428571428571,51.4242857142857,NA,588,0,0,175,352,1163,588,1163
2017,6,74,"Stadyum",40.9839,37.8767,15.4857142857143,7.41428571428571,0.100857142857143,65.7714285714286,53.2671428571429,NA,736,0,0,383,849,1519,736,1519
2017,7,74,"Stadyum",40.9839,37.8767,16.3857142857143,2.18571428571429,5.593,70.4571428571429,41.8828571428571,NA,492,68,66,342,575,717,424,651
2017,8,74,"Stadyum",40.9839,37.8767,18.5142857142857,9.67142857142857,0.630571428571429,57.9428571428571,55.7828571428571,NA,739,0,0,134,295,1747,739,1747
2017,9,74,"Stadyum",40.9839,37.8767,13.1142857142857,9.42857142857143,1.902,71.3,74.6857142857143,NA,574,214,393,133,139,866,360,473
2017,10,74,"Stadyum",40.9839,37.8767,11.3,11.1714285714286,0.0285714285714286,64.2142857142857,91.8685714285714,NA,712,235,333,0,0,1043,477,710
2017,11,74,"Stadyum",40.9839,37.8767,13.7142857142857,7.88571428571429,4.53328571428571,79,52.5057142857143,NA,525,80,88,220,304,725,445,637
2017,12,74,"Stadyum",40.9839,37.8767,11.5571428571429,7.57142857142857,2.16771428571429,73.1142857142857,73.2357142857143,NA,589,240,529,81,166,1077,349,548
2017,13,74,"Stadyum",40.9839,37.8767,14.9714285714286,8.54285714285714,2.10085714285714,75.2714285714286,73.2557142857143,NA,574,175,330,101,184,887,399,557
2017,14,74,"Stadyum",40.9839,37.8767,11.9714285714286,9.92857142857143,2.44228571428571,75.6,67.0671428571429,NA,639,338,787,128,264,1336,301,549
2017,15,74,"Stadyum",40.9839,37.8767,9.98571428571429,9.81428571428571,2.21014285714286,80.5142857142857,52.772,NA,587,361,880,0,0,1187,226,307
2017,16,74,"Stadyum",40.9839,37.8767,16.7714285714286,11.5285714285714,2.09157142857143,74.7428571428571,55.44,NA,717,307,272,199,329,920,410,648
2017,17,74,"Stadyum",40.9839,37.8767,9.71428571428572,10.6571428571429,0.486857142857143,73.4285714285714,56.4257142857143,NA,731,296,486,17,34,1478,435,992
2017,18,74,"Stadyum",40.9839,37.8767,8.38571428571429,14.5428571428571,1.501,79.5142857142857,57.78,NA,506,53,68,250,504,923,453,855
2017,19,74,"Stadyum",40.9839,37.8767,15.6428571428571,16.1857142857143,1.91757142857143,74.2714285714286,50.8642857142857,NA,471,156,352,214,358,966,315,614
2017,20,74,"Stadyum",40.9839,37.8767,12.1285714285714,13.8428571428571,5.148,82.4428571428571,42.5314285714286,NA,472,0,0,256,644,1205,472,1205
2017,21,74,"Stadyum",40.9839,37.8767,11.6142857142857,14.5,0.589571428571429,83.2714285714286,43.9857142857143,NA,448,38,22,6,5,849,410,827
2017,22,74,"Stadyum",40.9839,37.8767,11.1857142857143,18.0714285714286,0.657857142857143,77.7857142857143,46.9542857142857,NA,522,0,0,100,158,1015,522,1015
2017,23,74,"Stadyum",40.9839,37.8767,12.3428571428571,19.9428571428571,2.28914285714286,79.5285714285714,47.2071428571429,NA,578,75,121,105,303,1388,503,1267
2017,24,74,"Stadyum",40.9839,37.8767,15.0285714285714,19.2428571428571,0.0605714285714286,75.4428571428572,49.675,NA,552,72,113,230,514,1139,480,1026
2017,25,74,"Stadyum",40.9839,37.8767,16.4428571428571,20.7571428571429,5.08342857142857,74.5571428571429,40.4833333333333,NA,584,98,213,342,589,1041,486,828
2017,26,74,"Stadyum",40.9839,37.8767,8.55714285714286,23.0857142857143,0.0428571428571429,76.6285714285714,39.0814285714286,NA,564,61,99,0,0,971,503,872
2017,27,74,"Stadyum",40.9839,37.8767,13.1142857142857,22.0857142857143,1.30071428571429,75.7428571428571,42.9257142857143,NA,511,6,1,271,292,642,505,641
2017,28,74,"Stadyum",40.9839,37.8767,9.68571428571429,22.4,0.271428571428571,74.4714285714286,42.5,NA,481,111,145,9,25,864,370,719
2017,29,74,"Stadyum",40.9839,37.8767,14.2857142857143,23.8571428571429,0.458857142857143,75.3,51.17,NA,532,0,0,404,889,1272,532,1272
2017,30,74,"Stadyum",40.9839,37.8767,13.4571428571429,24.4714285714286,0.157857142857143,71.2428571428571,NA,NA,531,154,269,266,464,928,377,659
2017,31,74,"Stadyum",40.9839,37.8767,8.82857142857143,24.1571428571429,0.430571428571429,77.9,49.362,NA,559,0,0,451,896,1047,559,1047
2017,32,74,"Stadyum",40.9839,37.8767,11.2285714285714,25.9142857142857,0.0287142857142857,77.8571428571429,61.1285714285714,NA,567,0,0,201,371,1092,567,1092
2017,33,74,"Stadyum",40.9839,37.8767,15.3,25.1,2.79814285714286,79.1571428571429,45.0557142857143,NA,596,0,0,236,711,1199,596,1199
2017,34,74,"Stadyum",40.9839,37.8767,11.9714285714286,22.7285714285714,4.78728571428571,77.4428571428571,32.55,NA,601,0,0,469,802,1280,601,1280
2017,35,74,"Stadyum",40.9839,37.8767,13.8142857142857,21.8714285714286,0.16,72.5285714285714,NA,NA,493,117,313,334,673,1014,376,701
2017,36,74,"Stadyum",40.9839,37.8767,14.0285714285714,21.9142857142857,1.156,71.6714285714286,37.5,NA,507,283,582,157,396,1321,224,739
2017,37,74,"Stadyum",40.9839,37.8767,9.87142857142857,23.3,0.0714285714285714,71.3428571428571,58.8385714285714,NA,589,234,375,151,381,1138,355,763
2017,38,74,"Stadyum",40.9839,37.8767,11,22.1571428571429,8.44271428571428,79.6142857142857,56.3957142857143,NA,671,223,218,218,583,1312,448,1094
2017,39,74,"Stadyum",40.9839,37.8767,14.4571428571429,19.4285714285714,1.38642857142857,75.7,49.4957142857143,NA,782,0,0,597,1397,1630,782,1630
2017,40,74,"Stadyum",40.9839,37.8767,15.0142857142857,17.2142857142857,2.75071428571429,61.1428571428571,44.6785714285714,NA,543,29,145,284,534,1137,514,992
2017,41,74,"Stadyum",40.9839,37.8767,12.7571428571429,15.1142857142857,8.22871428571429,78.2,35.0942857142857,NA,487,0,0,355,641,843,487,843
2017,42,74,"Stadyum",40.9839,37.8767,9.35714285714286,14.9285714285714,1.12857142857143,74.0571428571428,53.5842857142857,NA,530,216,354,143,215,815,314,461
2017,43,74,"Stadyum",40.9839,37.8767,13.4571428571429,16.7285714285714,1.21514285714286,73.8714285714286,70.0528571428571,NA,506,13,88,108,225,919,493,831
2017,44,74,"Stadyum",40.9839,37.8767,13.2714285714286,12.4857142857143,2.51657142857143,69.0714285714286,46.4985714285714,NA,561,237,496,112,221,1102,324,606
2017,45,74,"Stadyum",40.9839,37.8767,7.72857142857143,13.7428571428571,0.629714285714286,80.1714285714286,59.3371428571429,NA,577,383,505,0,0,829,194,324
2017,46,74,"Stadyum",40.9839,37.8767,11.0142857142857,15.2428571428571,0.0857142857142857,67.8571428571429,81.9557142857143,NA,587,162,269,96,158,1085,425,816
2017,47,74,"Stadyum",40.9839,37.8767,20,10.1142857142857,4.34328571428571,62.2285714285714,55.3328571428571,NA,418,0,0,244,407,804,418,804
2017,48,74,"Stadyum",40.9839,37.8767,13.4285714285714,12.7142857142857,1.54471428571429,60,58.1385714285714,NA,386,16,22,0,0,619,370,597
2017,49,74,"Stadyum",40.9839,37.8767,17.4285714285714,10.3142857142857,7.21257142857143,59.7,48.5471428571429,NA,407,0,0,256,393,645,407,645
2017,50,74,"Stadyum",40.9839,37.8767,12.5428571428571,11.1285714285714,0.00571428571428572,62.7571428571429,68.0614285714286,NA,346,43,81,0,0,442,303,361
2017,51,74,"Stadyum",40.9839,37.8767,14.4142857142857,9.65714285714286,13.8685714285714,82.2142857142857,40.95,NA,386,65,47,101,120,349,321,302
2017,52,74,"Stadyum",40.9839,37.8767,15.075,10.6125,0.175,58.2,77.69375,NA,528,0,0,152,105,507,528,507
2018,1,74,"Stadyum",40.9839,37.8767,13.775,9.825,2.880625,70.7,60.92625,NA,618,84,137,276,379,914,534,777
2018,2,74,"Stadyum",40.9839,37.8767,14.8571428571429,8.95714285714286,5.20157142857143,74.6571428571429,52.1742857142857,NA,624,170,174,149,659,1309,454,1135
2018,3,74,"Stadyum",40.9839,37.8767,21.2285714285714,8.38571428571429,3.76471428571429,67.6714285714286,60.71,NA,639,19,174,268,141,655,620,481
2018,4,74,"Stadyum",40.9839,37.8767,14.2428571428571,5.98571428571429,12.9625714285714,78.5,48.9971428571429,NA,604,4,0,433,478,764,600,764
2018,5,74,"Stadyum",40.9839,37.8767,13.8571428571429,9.81428571428571,0.171428571428571,58.7714285714286,72.5428571428571,NA,670,3,1,218,179,819,667,818
2018,6,74,"Stadyum",40.9839,37.8767,15.3714285714286,10.0142857142857,1.94257142857143,77.4285714285714,70.7471428571429,NA,704,324,451,183,306,1022,380,571
2018,7,74,"Stadyum",40.9839,37.8767,14.5428571428571,9.08571428571429,3.91914285714286,78.0571428571428,49.2485714285714,NA,478,76,106,56,84,557,402,451
2018,8,74,"Stadyum",40.9839,37.8767,12.1571428571429,8.18571428571429,1.92542857142857,85.3,47.4257142857143,NA,711,391,747,0,0,1321,320,574
2018,9,74,"Stadyum",40.9839,37.8767,18.6142857142857,8.78571428571428,6.825,73.8428571428571,59.9,NA,621,182,256,176,277,956,439,700
2018,10,74,"Stadyum",40.9839,37.8767,15.1285714285714,10.5142857142857,4.044,77.2142857142857,69.8728571428571,NA,556,152,344,70,134,1330,404,986
2018,11,74,"Stadyum",40.9839,37.8767,14.2428571428571,11.8428571428571,1.34485714285714,73.8857142857143,58.7728571428571,NA,551,150,390,92,139,1426,401,1036
2018,12,74,"Stadyum",40.9839,37.8767,17.8285714285714,12.4428571428571,3.30214285714286,77.0142857142857,68.18,NA,425,187,389,67,216,1187,238,798
2018,13,74,"Stadyum",40.9839,37.8767,15.3285714285714,11.5428571428571,2.18385714285714,77.9857142857143,NA,NA,356,177,180,73,112,428,179,248
2018,14,74,"Stadyum",40.9839,37.8767,11.4,11.3571428571429,3.45542857142857,73.4285714285714,54.198,NA,407,120,112,85,48,486,287,374
2018,15,74,"Stadyum",40.9839,37.8767,11.9,11.8,0.0144285714285714,84.0714285714286,56.2757142857143,NA,374,7,7,86,85,450,367,443
2018,16,74,"Stadyum",40.9839,37.8767,11.9857142857143,11.6571428571429,1.90442857142857,72.7285714285714,48.5685714285714,NA,411,123,152,277,414,648,288,496
2018,17,74,"Stadyum",40.9839,37.8767,10.3,14.2714285714286,0,75.9714285714286,49.0085714285714,NA,419,115,237,115,168,652,304,415
2018,18,74,"Stadyum",40.9839,37.8767,7.25714285714286,15.5428571428571,0.600428571428571,89.1285714285714,42.1585714285714,NA,303,164,251,0,0,474,139,223
2018,19,74,"Stadyum",40.9839,37.8767,10.5428571428571,16.2571428571429,4.141,83.7,36.6628571428571,NA,275,0,0,58,75,467,275,467
2018,20,74,"Stadyum",40.9839,37.8767,9.27142857142857,17.8285714285714,0.029,78.2571428571429,40.8414285714286,NA,204,133,219,15,5,306,71,87
2018,21,74,"Stadyum",40.9839,37.8767,9.92857142857143,20.2857142857143,0.570571428571429,81.6714285714286,38.8971428571429,NA,252,36,41,10,12,281,216,240
2018,22,74,"Stadyum",40.9839,37.8767,15.0571428571429,19.8857142857143,7.96914285714286,73.8857142857143,39.1157142857143,NA,249,0,0,226,390,427,249,427
2018,23,74,"Stadyum",40.9839,37.8767,8.85714285714286,20.9428571428571,0.0857142857142857,75.7714285714286,38.3942857142857,NA,267,32,45,9,32,812,235,767
2018,24,74,"Stadyum",40.9839,37.8767,14.4857142857143,22.6,3.85385714285714,75.6714285714286,39.83,NA,267,52,27,106,322,448,215,421
2018,25,74,"Stadyum",40.9839,37.8767,11.6857142857143,22.6,2.97028571428571,79.3571428571429,35.648,NA,358,0,0,118,187,518,358,518
2018,26,74,"Stadyum",40.9839,37.8767,11.0142857142857,23.7142857142857,0.176,84.0142857142857,34.7271428571429,NA,355,116,241,107,133,587,239,346
2018,27,74,"Stadyum",40.9839,37.8767,13.6142857142857,22.6714285714286,2.43128571428571,79.4714285714286,35.38,NA,342,38,56,236,244,418,304,362
2018,28,74,"Stadyum",40.9839,37.8767,16.2571428571429,24.5285714285714,11.3828571428571,79.6142857142857,35.5971428571429,NA,286,13,28,153,342,585,273,557
2018,29,74,"Stadyum",40.9839,37.8767,11.1714285714286,23.8571428571429,0.772142857142857,75.4142857142857,30.9028571428571,NA,260,24,13,158,553,756,236,743
2018,30,74,"Stadyum",40.9839,37.8767,12.6857142857143,25.1857142857143,0.714,80.0571428571429,31.5014285714286,NA,265,34,139,67,219,822,231,683
2018,31,74,"Stadyum",40.9839,37.8767,13.6857142857143,25.4142857142857,4.20985714285714,77.0142857142857,34.75,NA,267,0,0,264,498,499,267,499
2018,32,74,"Stadyum",40.9839,37.8767,19.1857142857143,24.3571428571429,1.29942857142857,71.1285714285714,33.23,NA,297,0,0,293,399,403,297,403
2018,33,74,"Stadyum",40.9839,37.8767,11.5714285714286,23.7285714285714,0.727142857142857,73.5857142857143,35.9871428571429,NA,216,0,0,139,209,332,216,332
2018,34,74,"Stadyum",40.9839,37.8767,14.0285714285714,24.3714285714286,0.2,71.3428571428571,42.0814285714286,NA,144,42,43,81,133,227,102,184
2018,35,74,"Stadyum",40.9839,37.8767,14.2428571428571,24.7142857142857,0.157142857142857,77.0571428571429,43.5414285714286,NA,201,12,16,95,208,314,189,298
2018,36,74,"Stadyum",40.9839,37.8767,12.6714285714286,23.6714285714286,3.54957142857143,76.7857142857143,38.345,NA,341,103,84,133,154,370,238,286
2018,37,74,"Stadyum",40.9839,37.8767,10.2428571428571,21.4571428571429,4.96814285714286,81.3714285714286,34.0857142857143,NA,241,49,68,119,271,419,192,351
2018,38,74,"Stadyum",40.9839,37.8767,11.1428571428571,20.0857142857143,2.92857142857143,74.8571428571429,34.8528571428571,NA,189,0,0,73,196,344,189,344
2018,39,74,"Stadyum",40.9839,37.8767,12.4,18.4428571428571,5.92742857142857,79.6857142857143,33.0242857142857,NA,180,95,165,28,52,353,85,188
2018,40,74,"Stadyum",40.9839,37.8767,11.4857142857143,18.5571428571429,3.43842857142857,79.3714285714286,33.7414285714286,NA,191,107,164,78,157,341,84,177
2018,41,74,"Stadyum",40.9839,37.8767,9.47142857142857,18.6571428571429,2.71485714285714,86.8571428571429,38.8885714285714,NA,187,0,0,58,262,422,187,422
2018,42,74,"Stadyum",40.9839,37.8767,7.65714285714286,19.1714285714286,0.944857142857143,85.5285714285714,62.3257142857143,NA,168,95,119,10,11,381,73,262
2018,43,74,"Stadyum",40.9839,37.8767,12.0857142857143,16.3428571428571,11.857,71.6285714285714,38.0185714285714,NA,187,52,122,54,73,402,135,280
2018,44,74,"Stadyum",40.9839,37.8767,7.85714285714286,16.7,0,70.4,49.2685714285714,NA,196,0,0,115,159,264,196,264
2018,45,74,"Stadyum",40.9839,37.8767,8.78571428571429,15.5857142857143,0.0855714285714286,73.9,51.9185714285714,NA,231,69,153,48,79,473,162,320
2018,46,74,"Stadyum",40.9839,37.8767,14.7714285714286,10.5714285714286,8.98114285714286,74.5,36.0185714285714,NA,230,13,39,108,216,465,217,426
2018,47,74,"Stadyum",40.9839,37.8767,11.9285714285714,12.1,5.59971428571429,80.3571428571429,46.2014285714286,NA,270,48,14,61,126,499,222,485
2018,48,74,"Stadyum",40.9839,37.8767,12.8571428571429,13.6714285714286,6.04885714285714,73.7571428571429,44.8828571428571,NA,245,35,23,67,95,201,210,178
2018,49,74,"Stadyum",40.9839,37.8767,11.9571428571429,10.2857142857143,1.946,78.3,44.3371428571429,NA,257,45,68,65,158,420,212,352
2018,50,74,"Stadyum",40.9839,37.8767,9.4,10.8857142857143,7.49557142857143,63.7142857142857,50.6828571428571,NA,256,0,0,48,12,305,256,305
2018,51,74,"Stadyum",40.9839,37.8767,9.82857142857143,11.2571428571429,2.57157142857143,75.5571428571428,61.6485714285714,NA,250,9,18,60,87,248,241,230
2018,52,74,"Stadyum",40.9839,37.8767,11.9,7.01428571428571,6.74671428571428,68.4285714285714,37.1814285714286,NA,244,0,0,126,87,273,244,273
2019,1,74,"Stadyum",40.9839,37.8767,12.7375,9.1,3.802375,73.775,45.5725,NA,343,43,142,215,586,784,300,642
2019,2,74,"Stadyum",40.9839,37.8767,15.4571428571429,7.24285714285714,9.50585714285714,64.6571428571429,49.1014285714286,NA,255,0,0,99,110,208,255,208
2019,3,74,"Stadyum",40.9839,37.8767,16.0857142857143,6.85714285714286,5.22728571428571,67.3285714285714,53.4742857142857,NA,192,18,28,33,16,198,174,170
2019,4,74,"Stadyum",40.9839,37.8767,14.4714285714286,10.6571428571429,0.179285714285714,62.2142857142857,73.954,NA,308,54,47,51,44,314,254,267
2019,5,74,"Stadyum",40.9839,37.8767,10.3857142857143,9.8,0.428714285714286,68.3,65.6671428571428,NA,253,50,64,33,30,143,203,79
2019,6,74,"Stadyum",40.9839,37.8767,11.3428571428571,8.65714285714286,2.01857142857143,79.3428571428571,48.3942857142857,NA,276,7,11,41,14,127,269,116
2019,7,74,"Stadyum",40.9839,37.8767,10.9285714285714,8.32857142857143,2.25742857142857,71.3142857142857,38.8357142857143,NA,325,0,0,138,60,234,325,234
2019,8,74,"Stadyum",40.9839,37.8767,16.6714285714286,8.18571428571429,2.41157142857143,73.8857142857143,57.9428571428571,NA,305,19,4,111,83,219,286,215
2019,9,74,"Stadyum",40.9839,37.8767,13.4428571428571,6.92857142857143,6.411,72.0571428571429,40.9628571428571,NA,331,0,0,282,260,310,331,310
2019,10,74,"Stadyum",40.9839,37.8767,11.8285714285714,9.62857142857143,1.75542857142857,63.8428571428571,46.6528571428571,NA,359,6,23,81,70,252,353,229
2019,11,74,"Stadyum",40.9839,37.8767,13.9285714285714,9.95714285714286,2.21471428571429,76.4,43.0414285714286,NA,373,37,7,31,110,400,336,393
2019,12,74,"Stadyum",40.9839,37.8767,12.5714285714286,7.94285714285714,0.814285714285714,72.8571428571429,42.2414285714286,NA,343,0,0,242,114,416,343,416
2019,13,74,"Stadyum",40.9839,37.8767,10.2,6.84285714285714,0.386142857142857,71.3571428571429,35.0171428571429,NA,256,40,4,53,79,194,216,190
2019,14,74,"Stadyum",40.9839,37.8767,10.3285714285714,8.88571428571429,0.642428571428571,82.6142857142857,51.6257142857143,NA,365,134,79,126,62,208,231,129
2019,15,74,"Stadyum",40.9839,37.8767,11.6,14.5857142857143,1.76914285714286,69.4285714285714,46.93,NA,359,42,6,127,120,183,317,177
2019,16,74,"Stadyum",40.9839,37.8767,13.5,9.78571428571429,9.71485714285714,79.1,25.3085714285714,NA,318,0,0,189,106,208,318,208
2019,17,74,"Stadyum",40.9839,37.8767,8.24285714285714,11.2428571428571,2.22514285714286,77.2,39.3628571428571,NA,412,180,115,79,20,313,232,198
2019,18,74,"Stadyum",40.9839,37.8767,10.1857142857143,16.5857142857143,2.341,70.5714285714286,42.8271428571429,NA,523,1,0,77,55,353,522,353
2019,19,74,"Stadyum",40.9839,37.8767,14.1,16.2428571428571,5.92085714285714,76.1714285714286,32.58,NA,452,134,78,97,116,386,318,308
2019,20,74,"Stadyum",40.9839,37.8767,9.17142857142857,16.4571428571429,2.36728571428571,85.1285714285714,31.5733333333333,NA,454,58,63,127,98,389,396,326
2019,21,74,"Stadyum",40.9839,37.8767,10.6142857142857,18.3857142857143,0.514857142857143,84.2,NA,NA,457,185,161,69,22,413,272,252
2019,22,74,"Stadyum",40.9839,37.8767,8.48571428571429,19.7285714285714,0,75.7571428571429,35.41,NA,453,0,0,0,0,323,453,323
2019,23,74,"Stadyum",40.9839,37.8767,8.57142857142857,22.0571428571429,0.871285714285714,81,37.1528571428571,NA,378,0,0,162,264,532,378,532
2019,24,74,"Stadyum",40.9839,37.8767,11.2285714285714,22.6142857142857,0.657571428571429,83.8428571428571,34.0571428571429,NA,378,0,0,208,116,244,378,244
2019,25,74,"Stadyum",40.9839,37.8767,16.9714285714286,24.1428571428571,6.15514285714286,76.9714285714286,34.0257142857143,NA,306,0,0,51,109,325,306,325
2019,26,74,"Stadyum",40.9839,37.8767,16.2,23.7857142857143,2.99857142857143,71.8571428571429,34.32,NA,377,0,0,204,153,342,377,342
2019,27,74,"Stadyum",40.9839,37.8767,10.2428571428571,22.4571428571429,0.0868571428571429,70,32.5885714285714,NA,456,49,75,134,61,222,407,147
2019,28,74,"Stadyum",40.9839,37.8767,15.7,22.4428571428571,5.35642857142857,74.8571428571429,31.615,NA,398,114,106,189,118,421,284,315
2019,29,74,"Stadyum",40.9839,37.8767,13.9571428571429,22.5428571428571,6.90828571428571,76.2571428571429,NA,NA,453,109,21,260,122,203,344,182
2019,30,74,"Stadyum",40.9839,37.8767,14.9142857142857,23.2714285714286,3.34385714285714,74.5285714285714,29.224,NA,456,0,0,273,238,335,456,335
2019,31,74,"Stadyum",40.9839,37.8767,12.8,24.4142857142857,3.78585714285714,75.6571428571429,33.5257142857143,NA,334,67,60,16,23,375,267,315
2019,32,74,"Stadyum",40.9839,37.8767,12.3714285714286,22.0857142857143,8.391,74.3571428571429,34.1285714285714,NA,346,0,0,248,242,395,346,395
2019,33,74,"Stadyum",40.9839,37.8767,12.5428571428571,23.9571428571429,0.841857142857143,74.3285714285714,36.4757142857143,NA,337,0,0,198,320,531,337,531
2019,34,74,"Stadyum",40.9839,37.8767,12.3285714285714,23.2428571428571,4.33885714285714,82.4142857142857,42.6942857142857,NA,299,0,0,290,339,345,299,345
2019,35,74,"Stadyum",40.9839,37.8767,11.6285714285714,23.1285714285714,0.086,79.5285714285714,44.3,NA,307,0,0,274,380,415,307,415
2019,36,74,"Stadyum",40.9839,37.8767,15.3714285714286,22.5714285714286,0.614285714285714,72.4714285714286,39.4157142857143,NA,171,0,0,151,63,67,171,67
2019,37,74,"Stadyum",40.9839,37.8767,13.9142857142857,21.9571428571429,1.75671428571429,73.6,32.3757142857143,NA,218,0,0,64,19,55,218,55
2019,38,74,"Stadyum",40.9839,37.8767,12.3285714285714,19.1142857142857,8.38371428571429,75.9571428571429,34.8957142857143,NA,266,35,4,149,59,91,231,87
2019,39,74,"Stadyum",40.9839,37.8767,10.3142857142857,19.4,3.21242857142857,77.4,35.79,NA,237,78,32,39,15,79,159,47
2019,40,74,"Stadyum",40.9839,37.8767,11.3714285714286,20.1142857142857,1.75942857142857,76.3714285714286,44.2085714285714,NA,241,176,79,34,7,111,65,32
2019,41,74,"Stadyum",40.9839,37.8767,12.4571428571429,17.7428571428571,3.42642857142857,78.4571428571429,38.7642857142857,NA,416,131,187,157,202,448,285,261
2019,42,74,"Stadyum",40.9839,37.8767,7.04285714285714,18.5285714285714,9.44,82.2714285714286,48.8428571428571,NA,356,136,123,0,0,408,220,285
2019,43,74,"Stadyum",40.9839,37.8767,8.65714285714286,17.1571428571429,7.051,87.1285714285714,51.156,NA,306,46,68,147,167,300,260,232
2019,44,74,"Stadyum",40.9839,37.8767,12.5571428571429,14.2142857142857,14.9587142857143,80.7571428571429,37.1971428571429,NA,350,50,34,131,108,250,300,216
2019,45,74,"Stadyum",40.9839,37.8767,11.2571428571429,16.5,0,62.8142857142857,40.4742857142857,NA,417,47,81,0,0,328,370,247
2019,46,74,"Stadyum",40.9839,37.8767,8.42857142857143,15.4857142857143,0,69.3142857142857,62.4242857142857,NA,401,76,76,87,103,337,325,261
2019,47,74,"Stadyum",40.9839,37.8767,8.51428571428571,12.3142857142857,0.171428571428571,75.2857142857143,61.8742857142857,NA,391,165,130,133,123,339,226,209
2019,48,74,"Stadyum",40.9839,37.8767,11.2714285714286,14.8571428571429,5.77314285714286,65.1285714285714,62.1757142857143,NA,320,2,1,115,127,251,318,250
2019,49,74,"Stadyum",40.9839,37.8767,9.78571428571429,8.54285714285714,11.2432857142857,71.2142857142857,38.2742857142857,NA,393,50,38,226,186,274,343,236
2019,50,74,"Stadyum",40.9839,37.8767,8.95714285714286,12.2142857142857,0.171428571428571,60.0428571428571,56.5514285714286,NA,218,50,26,44,7,119,168,93
2019,51,74,"Stadyum",40.9839,37.8767,7.45714285714286,11.5,3.66828571428571,63.6,57.3314285714286,NA,361,4,11,89,63,488,357,477
2019,52,74,"Stadyum",40.9839,37.8767,11.0857142857143,13.2571428571429,7.32157142857143,59.5857142857143,51.6814285714286,NA,279,0,0,127,77,281,279,281
2020,1,74,"Stadyum",40.9839,37.8767,6.96,7.86,6.2238,77.02,37.606,NA,160,0,0,49,28,126,160,126
2020,2,74,"Stadyum",40.9839,37.8767,10.2857142857143,8.7,7.88128571428571,70.4142857142857,46.0642857142857,NA,240,1,0,124,83,173,239,173
2020,3,74,"Stadyum",40.9839,37.8767,13.1285714285714,7.08571428571429,5.01,73.1714285714286,38.3314285714286,NA,270,74,125,131,177,382,196,257
2020,4,74,"Stadyum",40.9839,37.8767,14.2,6.14285714285714,5.15785714285714,68.5285714285714,35.4471428571429,NA,358,56,83,288,206,295,302,212
2020,5,74,"Stadyum",40.9839,37.8767,11.6857142857143,9.92857142857143,9.308,60.9,50.5285714285714,NA,331,66,61,152,90,272,265,211
2020,6,74,"Stadyum",40.9839,37.8767,20.9285714285714,9.04285714285714,17.6297142857143,65.6,29.9314285714286,NA,343,0,0,143,88,267,343,267
2020,7,74,"Stadyum",40.9839,37.8767,20.3142857142857,5.08571428571429,10.0432857142857,62.9285714285714,41.1314285714286,NA,341,3,0,89,85,338,338,338
2020,8,74,"Stadyum",40.9839,37.8767,11.1428571428571,7.68571428571429,0.257714285714286,78,49.9928571428571,NA,283,25,5,38,14,187,258,182
2020,9,74,"Stadyum",40.9839,37.8767,18.5285714285714,9.62857142857143,4.67257142857143,69.1857142857143,49.0528571428571,NA,393,143,167,118,139,528,250,361
2020,10,74,"Stadyum",40.9839,37.8767,8.42857142857143,13.1428571428571,0,57.6142857142857,52.378,NA,205,40,69,87,62,210,165,141
2020,11,74,"Stadyum",40.9839,37.8767,10.0285714285714,12.9428571428571,1.92885714285714,74.9142857142857,NA,NA,115,0,0,40,39,94,115,94
2020,12,74,"Stadyum",40.9839,37.8767,10.5285714285714,5.91428571428571,7.11485714285714,81.5,33.006,NA,117,11,10,76,96,118,106,108
2020,13,74,"Stadyum",40.9839,37.8767,10.0857142857143,9.47142857142857,1.62857142857143,81.8714285714286,42.8985714285714,NA,136,8,2,58,32,92,128,90
2020,14,74,"Stadyum",40.9839,37.8767,11.3857142857143,10.5571428571429,4.369,76.0285714285714,48.6216666666667,NA,155,15,17,68,50,121,140,104
2020,15,74,"Stadyum",40.9839,37.8767,13.5714285714286,10.0142857142857,0.128428571428571,71.5571428571428,NA,NA,133,0,0,98,108,118,133,118
2020,16,74,"Stadyum",40.9839,37.8767,14.8142857142857,11.1285714285714,1.64371428571429,73.5,28.65,NA,141,58,21,24,33,106,83,85
2020,17,74,"Stadyum",40.9839,37.8767,12.5714285714286,10.7,2.18742857142857,72.4285714285714,NA,NA,137,19,9,64,59,123,118,114
2020,18,74,"Stadyum",40.9839,37.8767,10.3571428571429,13.7714285714286,0.589285714285714,76.8285714285714,36.6166666666667,NA,146,23,22,21,11,164,123,142
2020,19,74,"Stadyum",40.9839,37.8767,11.6857142857143,14.1428571428571,3.66228571428571,74.3714285714286,29.9671428571429,NA,137,33,21,45,68,157,104,136
2020,20,74,"Stadyum",40.9839,37.8767,11.7428571428571,18.5,0,67.3714285714286,47.7671428571429,NA,164,92,71,36,29,164,72,93
2020,21,74,"Stadyum",40.9839,37.8767,14.8714285714286,17.7,4.35842857142857,67.1285714285714,43.4728571428571,NA,146,5,0,64,51,96,141,96
2020,22,74,"Stadyum",40.9839,37.8767,9.52857142857143,15.7571428571429,1.31385714285714,72.3571428571429,22.014,NA,118,0,0,42,47,100,118,100
2020,23,74,"Stadyum",40.9839,37.8767,8.1,18.4571428571429,2.02728571428571,81.3285714285714,27.77,NA,112,23,4,6,5,70,89,66
2020,24,74,"Stadyum",40.9839,37.8767,12,20.9428571428571,4.453,79.3,37.67,NA,140,22,42,19,13,150,118,108
2020,25,74,"Stadyum",40.9839,37.8767,9.72857142857143,21.7714285714286,3.401,78.4428571428571,33.0933333333333,NA,137,66,25,39,40,108,71,83
2020,26,74,"Stadyum",40.9839,37.8767,17.7714285714286,22.9,0.0714285714285714,77.3142857142857,38.3528571428571,NA,173,18,1,92,84,133,155,132
2020,27,74,"Stadyum",40.9839,37.8767,9.98571428571429,23.8428571428571,0.128714285714286,72.1857142857143,52.3642857142857,NA,113,0,0,58,36,113,113,113
2020,28,74,"Stadyum",40.9839,37.8767,14.2,24.4714285714286,2.01728571428571,76.7571428571429,44.5266666666667,NA,164,0,0,104,79,122,164,122
2020,29,74,"Stadyum",40.9839,37.8767,11.8428571428571,23.4142857142857,0.721428571428571,76.5428571428571,45.7485714285714,NA,186,26,22,81,34,111,160,89
2020,30,74,"Stadyum",40.9839,37.8767,13.2,24.4571428571429,0.209,70.9,42.64,NA,190,0,0,92,91,142,190,142
2020,31,74,"Stadyum",40.9839,37.8767,12.9714285714286,24.9714285714286,1.14242857142857,69.5142857142857,31.3457142857143,NA,150,0,0,28,40,127,150,127
2020,32,74,"Stadyum",40.9839,37.8767,9.1,24.2,0.0142857142857143,70.2428571428571,26.3628571428571,NA,146,4,11,26,8,107,142,96
2020,33,74,"Stadyum",40.9839,37.8767,15.9285714285714,23.3,8.77342857142857,71.3571428571429,29.8914285714286,NA,183,0,0,156,71,83,183,83
2020,34,74,"Stadyum",40.9839,37.8767,11.0714285714286,23.2714285714286,10.55,67.0714285714286,28.1471428571429,NA,197,0,0,111,63,97,197,97
2020,35,74,"Stadyum",40.9839,37.8767,9.57142857142857,22.8428571428571,0.0571428571428571,72.8857142857143,31.02,NA,164,39,23,5,9,157,125,134
2020,36,74,"Stadyum",40.9839,37.8767,9.62857142857143,24.2142857142857,0.471428571428571,77.3,42.8371428571429,NA,179,33,6,27,17,112,146,106
2020,37,74,"Stadyum",40.9839,37.8767,10.2857142857143,23.2571428571429,13.997,79.3571428571429,39.7528571428571,NA,193,17,6,72,40,91,176,85
2020,38,74,"Stadyum",40.9839,37.8767,14.4,22.3428571428571,1.11271428571429,77.5571428571428,44.7671428571429,NA,235,0,0,160,98,157,235,157
2020,39,74,"Stadyum",40.9839,37.8767,9.8,21.8142857142857,1.40157142857143,77.5428571428571,40.8614285714286,NA,220,46,11,74,63,129,174,118
2020,40,74,"Stadyum",40.9839,37.8767,11.5714285714286,21.2714285714286,1.07857142857143,77.3857142857143,40.3514285714286,NA,187,35,42,123,109,154,152,112
2020,41,74,"Stadyum",40.9839,37.8767,8.91428571428571,20.1571428571429,0.2,70.3571428571429,43.24,NA,182,73,58,9,5,127,109,69
2020,42,74,"Stadyum",40.9839,37.8767,9.55714285714286,20.6571428571429,0.0857142857142857,75.4571428571429,53.01,NA,177,84,25,61,61,111,93,86
2020,43,74,"Stadyum",40.9839,37.8767,10.1428571428571,17.8857142857143,2.176,77.7285714285714,39.2066666666667,NA,194,105,91,22,18,161,89,70
2020,44,74,"Stadyum",40.9839,37.8767,11.1142857142857,18.7142857142857,2.37471428571429,74.8,61.0414285714286,NA,255,32,31,116,37,233,223,202
2020,45,74,"Stadyum",40.9839,37.8767,14.0285714285714,15.1285714285714,11.1162857142857,79.4,35.04,NA,156,43,29,61,37,103,113,74
2020,46,74,"Stadyum",40.9839,37.8767,8.11428571428571,13.3285714285714,3.97114285714286,74.3428571428571,44.092,NA,208,78,48,31,29,109,130,61
2020,47,74,"Stadyum",40.9839,37.8767,11.7428571428571,11.0857142857143,15.2708571428571,77.6428571428571,32.0828571428571,NA,173,27,1,115,51,83,146,82
2020,48,74,"Stadyum",40.9839,37.8767,10.8142857142857,10.0714285714286,4.18571428571429,68.8285714285714,43.1385714285714,NA,199,0,0,32,13,262,199,262
2020,49,74,"Stadyum",40.9839,37.8767,10.1571428571429,11.5857142857143,0.019,72.6285714285714,64.0857142857143,NA,207,33,36,31,28,116,174,80
2020,50,74,"Stadyum",40.9839,37.8767,12.7,12.7142857142857,1.15657142857143,64.9428571428572,65.32,NA,181,4,2,0,0,98,177,96
2020,51,74,"Stadyum",40.9839,37.8767,10.8571428571429,11.5142857142857,0.329714285714286,72.4571428571429,54.0085714285714,NA,171,25,24,48,26,90,146,66
2020,52,74,"Stadyum",40.9839,37.8767,13.5142857142857,9.37142857142857,4.80814285714286,64.2285714285714,38.81,NA,203,0,0,85,50,113,203,113
2020,53,74,"Stadyum",40.9839,37.8767,7.8,12.875,0,46.875,49.6433333333333,NA,122,6,2,48,26,111,116,109
2017,1,75,"Osmaniye",37.0742,36.2473,19.0142857142857,8.77142857142857,9.872,75.4857142857143,80.8371428571429,NA,563,176,229,1,0,847,387,618
2017,2,75,"Osmaniye",37.0742,36.2473,17.8571428571429,7.17142857142857,4.942,69.2428571428571,123.387142857143,NA,757,116,143,169,317,1214,641,1071
2017,3,75,"Osmaniye",37.0742,36.2473,14.5,8.12857142857143,0,60.8571428571429,147.368571428571,NA,762,16,22,41,87,1449,746,1427
2017,4,75,"Osmaniye",37.0742,36.2473,20.9571428571429,6.44285714285714,3.88057142857143,53.1714285714286,78.5814285714286,NA,639,118,94,68,160,889,521,795
2017,5,75,"Osmaniye",37.0742,36.2473,18.9428571428571,5,0.0142857142857143,48.7428571428571,97.0157142857143,NA,588,60,109,105,238,1163,528,1054
2017,6,75,"Osmaniye",37.0742,36.2473,17.6857142857143,12.3142857142857,0.0568571428571429,55.8571428571429,95.6157142857143,NA,736,468,792,6,3,1519,268,727
2017,7,75,"Osmaniye",37.0742,36.2473,14.5571428571429,6.15714285714286,0,41.9285714285714,60.1628571428571,NA,492,179,248,82,151,717,313,469
2017,8,75,"Osmaniye",37.0742,36.2473,13.9571428571429,11.2857142857143,0.002,51.6142857142857,92.8728571428571,NA,739,244,440,0,0,1747,495,1307
2017,9,75,"Osmaniye",37.0742,36.2473,16.9285714285714,14.6,1.09414285714286,55.4428571428571,83.9785714285714,NA,574,368,567,0,0,866,206,299
2017,10,75,"Osmaniye",37.0742,36.2473,22.6571428571429,15.7142857142857,2.33528571428571,56.4428571428571,99.8185714285714,NA,712,399,556,0,0,1043,313,487
2017,11,75,"Osmaniye",37.0742,36.2473,18.4285714285714,11.3285714285714,8.09057142857143,72.6857142857143,42.2428571428571,NA,525,127,202,56,99,725,398,523
2017,12,75,"Osmaniye",37.0742,36.2473,20.3142857142857,15.0857142857143,0.0152857142857143,60.6285714285714,46.1442857142857,NA,589,81,220,0,0,1077,508,857
2017,13,75,"Osmaniye",37.0742,36.2473,19.4857142857143,16.0428571428571,0.964142857142857,65.6,46.9485714285714,NA,574,133,189,89,121,887,441,698
2017,14,75,"Osmaniye",37.0742,36.2473,21.4,17.2428571428571,3.70542857142857,61.8714285714286,42.4285714285714,NA,639,154,250,77,187,1336,485,1086
2017,15,75,"Osmaniye",37.0742,36.2473,19.8142857142857,16.2571428571429,14.6924285714286,63.9285714285714,37.4514285714286,NA,587,145,174,92,101,1187,442,1013
2017,16,75,"Osmaniye",37.0742,36.2473,19.8428571428571,18.1571428571429,0,63.4142857142857,51.6885714285714,NA,717,80,42,178,242,920,637,878
2017,17,75,"Osmaniye",37.0742,36.2473,14.8,20.1,0,44.9428571428571,57.9857142857143,NA,731,181,513,126,196,1478,550,965
2017,18,75,"Osmaniye",37.0742,36.2473,21.0857142857143,19.7714285714286,0.419285714285714,73.7285714285714,59.9514285714286,NA,506,0,0,261,368,923,506,923
2017,19,75,"Osmaniye",37.0742,36.2473,17.4142857142857,21.7714285714286,0,61.7285714285714,52.2914285714286,NA,471,0,0,161,231,966,471,966
2017,20,75,"Osmaniye",37.0742,36.2473,17.7285714285714,20.8571428571429,18.721,64.6857142857143,34.67,NA,472,50,40,166,332,1205,422,1165
2017,21,75,"Osmaniye",37.0742,36.2473,16.7,19.5714285714286,7.69714285714286,73.9857142857143,32.21,NA,448,47,39,173,265,849,401,810
2017,22,75,"Osmaniye",37.0742,36.2473,19.2714285714286,22.1714285714286,0.045,68.3714285714286,38.1028571428571,NA,522,0,0,327,664,1015,522,1015
2017,23,75,"Osmaniye",37.0742,36.2473,19.5857142857143,25.2142857142857,0,67.2428571428571,52.0171428571429,NA,578,0,0,271,511,1388,578,1388
2017,24,75,"Osmaniye",37.0742,36.2473,19.3428571428571,24.3714285714286,0.717571428571429,72.7428571428571,54.0585714285714,NA,552,4,6,239,337,1139,548,1133
2017,25,75,"Osmaniye",37.0742,36.2473,21.6571428571429,24.6,1.714,69.2285714285714,36.0171428571429,NA,584,4,5,189,257,1041,580,1036
2017,26,75,"Osmaniye",37.0742,36.2473,15.2571428571429,28.8285714285714,0,59.4,52.5457142857143,NA,564,77,102,318,445,971,487,869
2017,27,75,"Osmaniye",37.0742,36.2473,22.0571428571429,28.7714285714286,0,60.3714285714286,55.5914285714286,NA,511,0,0,239,258,642,511,642
2017,28,75,"Osmaniye",37.0742,36.2473,17.6571428571429,28.6571428571429,0,66.8857142857143,52.0714285714286,NA,481,0,0,240,317,864,481,864
2017,29,75,"Osmaniye",37.0742,36.2473,19.8571428571429,29.1857142857143,0,68.9142857142857,54.8842857142857,NA,532,0,0,198,409,1272,532,1272
2017,30,75,"Osmaniye",37.0742,36.2473,25.9428571428571,29.2142857142857,0,63.5857142857143,51.6328571428571,NA,531,0,0,252,279,928,531,928
2017,31,75,"Osmaniye",37.0742,36.2473,20.8571428571429,29.2714285714286,0,67.3,51.8757142857143,NA,559,0,0,145,149,1047,559,1047
2017,32,75,"Osmaniye",37.0742,36.2473,20.3714285714286,29.9428571428571,0.0142857142857143,67.5571428571428,53.86,NA,567,1,1,192,243,1092,566,1091
2017,33,75,"Osmaniye",37.0742,36.2473,20.4142857142857,29.0571428571429,0,70.9571428571429,55.0314285714286,NA,596,0,0,237,300,1199,596,1199
2017,34,75,"Osmaniye",37.0742,36.2473,19.8,28.7571428571429,0,67.6428571428571,68.1671428571429,NA,601,0,0,170,184,1280,601,1280
2017,35,75,"Osmaniye",37.0742,36.2473,20.0428571428571,28.3714285714286,0,68.1,53.7214285714286,NA,493,0,0,175,240,1014,493,1014
2017,36,75,"Osmaniye",37.0742,36.2473,18.7571428571429,26.9571428571429,0.428142857142857,53.5571428571429,58.4128571428571,NA,507,8,24,159,327,1321,499,1297
2017,37,75,"Osmaniye",37.0742,36.2473,19.1857142857143,27.7571428571429,0,67.3142857142857,75.4385714285714,NA,589,0,0,196,119,1138,589,1138
2017,38,75,"Osmaniye",37.0742,36.2473,19.5428571428571,27.0857142857143,0.000714285714285714,68.8428571428571,64.14,NA,671,1,0,160,172,1312,670,1312
2017,39,75,"Osmaniye",37.0742,36.2473,20.6571428571429,24.5285714285714,0.450428571428571,65.9,54.1414285714286,NA,782,2,1,287,463,1630,780,1629
2017,40,75,"Osmaniye",37.0742,36.2473,14.5428571428571,21.6142857142857,1.42271428571429,45.3714285714286,48.4828571428571,NA,543,0,0,140,352,1137,543,1137
2017,41,75,"Osmaniye",37.0742,36.2473,14.1857142857143,20.4285714285714,3.69514285714286,54.2714285714286,52.48,NA,487,14,3,139,167,843,473,840
2017,42,75,"Osmaniye",37.0742,36.2473,15.5142857142857,20.8428571428571,0,41.1857142857143,60.62,NA,530,55,93,161,237,815,475,722
2017,43,75,"Osmaniye",37.0742,36.2473,21.0571428571429,20.0857142857143,6.70014285714286,65.0571428571428,74.3242857142857,NA,506,71,199,44,45,919,435,720
2017,44,75,"Osmaniye",37.0742,36.2473,16.6857142857143,16.0714285714286,6.64042857142857,73.7285714285714,47.8485714285714,NA,561,65,185,48,48,1102,496,917
2017,45,75,"Osmaniye",37.0742,36.2473,8.74285714285714,15.6142857142857,0.286428571428571,72.1571428571429,75.3557142857143,NA,577,312,318,22,55,829,265,511
2017,46,75,"Osmaniye",37.0742,36.2473,15.6714285714286,17.8714285714286,0.000285714285714286,57.2857142857143,131.144285714286,NA,587,402,671,0,0,1085,185,414
2017,47,75,"Osmaniye",37.0742,36.2473,19.5142857142857,11.5571428571429,4.54,63.0857142857143,104.168571428571,NA,418,95,202,58,48,804,323,602
2017,48,75,"Osmaniye",37.0742,36.2473,13,12.6285714285714,4.56714285714286,76.7285714285714,105.265714285714,NA,386,89,106,1,0,619,297,513
2017,49,75,"Osmaniye",37.0742,36.2473,15.8571428571429,9.35714285714286,2.429,66.9285714285714,110.692857142857,NA,407,28,17,36,64,645,379,628
2017,50,75,"Osmaniye",37.0742,36.2473,10.5428571428571,11.6857142857143,0.0142857142857143,74.4,149.454285714286,NA,346,40,34,18,21,442,306,408
2017,51,75,"Osmaniye",37.0742,36.2473,17.7,13.9857142857143,5.46057142857143,72.4428571428571,194.344285714286,NA,386,133,100,15,10,349,253,249
2017,52,75,"Osmaniye",37.0742,36.2473,15.3,11.375,2.8605,72.225,117.11875,NA,528,237,173,1,0,507,291,334
2018,1,75,"Osmaniye",37.0742,36.2473,20.3625,9.975,4.6755,75.025,78.52625,NA,618,155,307,17,43,914,463,607
2018,2,75,"Osmaniye",37.0742,36.2473,18.4428571428571,11.0571428571429,0.157571428571429,65.7714285714286,138.85,NA,624,342,624,0,0,1309,282,685
2018,3,75,"Osmaniye",37.0742,36.2473,12.6857142857143,9.52857142857143,12.1187142857143,76.5,85.4914285714286,NA,639,416,346,0,0,655,223,309
2018,4,75,"Osmaniye",37.0742,36.2473,16.9142857142857,9.72857142857143,2.34214285714286,78.9714285714286,96.2414285714286,NA,604,234,269,113,88,764,370,495
2018,5,75,"Osmaniye",37.0742,36.2473,7.7,9.41428571428571,0.0142857142857143,71.3428571428571,119.204285714286,NA,670,260,196,27,68,819,410,623
2018,6,75,"Osmaniye",37.0742,36.2473,13.0857142857143,13.0571428571429,0.0427142857142857,65.9428571428571,162.222857142857,NA,704,98,66,21,23,1022,606,956
2018,7,75,"Osmaniye",37.0742,36.2473,19.9571428571429,13.2285714285714,2.12942857142857,72.3142857142857,62.3342857142857,NA,478,272,273,2,0,557,206,284
2018,8,75,"Osmaniye",37.0742,36.2473,15.6,12.7857142857143,5.12442857142857,67.4,75.2028571428571,NA,711,515,912,0,0,1321,196,409
2018,9,75,"Osmaniye",37.0742,36.2473,13.4571428571429,12.6857142857143,4.92471428571429,82.9428571428571,74.4628571428571,NA,621,124,195,319,509,956,497,761
2018,10,75,"Osmaniye",37.0742,36.2473,18.4857142857143,15.4571428571429,0.342714285714286,74.2285714285714,106.552857142857,NA,556,0,0,145,359,1330,556,1330
2018,11,75,"Osmaniye",37.0742,36.2473,18.8714285714286,15.0857142857143,2.39728571428571,76.3,51.3042857142857,NA,551,31,68,268,781,1426,520,1358
2018,12,75,"Osmaniye",37.0742,36.2473,20.3714285714286,17.5714285714286,1.38014285714286,65.7857142857143,104.088333333333,NA,425,103,245,46,186,1187,322,942
2018,13,75,"Osmaniye",37.0742,36.2473,16.6,17.0428571428571,1.44642857142857,64.7571428571429,38.775,NA,356,109,125,62,16,428,247,303
2018,14,75,"Osmaniye",37.0742,36.2473,16.6428571428571,18.4428571428571,0,46.7428571428571,51.2114285714286,NA,407,14,6,54,195,486,393,480
2018,15,75,"Osmaniye",37.0742,36.2473,17.0142857142857,17.7285714285714,5.29585714285714,81.4857142857143,51.1271428571429,NA,374,45,35,190,99,450,329,415
2018,16,75,"Osmaniye",37.0742,36.2473,16.9,18.2571428571429,0.292,57.6142857142857,57.2028571428571,NA,411,52,111,61,103,648,359,537
2018,17,75,"Osmaniye",37.0742,36.2473,17.7428571428571,21.2142857142857,0.128714285714286,61.4857142857143,70.0928571428571,NA,419,112,235,135,161,652,307,417
2018,18,75,"Osmaniye",37.0742,36.2473,19.6142857142857,23.8,2.56328571428571,59.0714285714286,79.7371428571429,NA,303,115,67,65,164,474,188,407
2018,19,75,"Osmaniye",37.0742,36.2473,18.8285714285714,18.9571428571429,3.85871428571429,78.9,44.4783333333333,NA,275,23,4,114,162,467,252,463
2018,20,75,"Osmaniye",37.0742,36.2473,17.4857142857143,24.0571428571429,0.142714285714286,58.9428571428571,52.7166666666667,NA,204,0,0,127,153,306,204,306
2018,21,75,"Osmaniye",37.0742,36.2473,18.6714285714286,24.9571428571429,0,61.8142857142857,72.9671428571429,NA,252,1,1,143,160,281,251,280
2018,22,75,"Osmaniye",37.0742,36.2473,17.3428571428571,22.9142857142857,5.188,73.6857142857143,56.3385714285714,NA,249,17,11,122,197,427,232,416
2018,23,75,"Osmaniye",37.0742,36.2473,18.8142857142857,26.4857142857143,0,65.0571428571428,43.7766666666667,NA,267,0,0,113,338,812,267,812
2018,24,75,"Osmaniye",37.0742,36.2473,21.0428571428571,24.6,9.126,74.7714285714286,NA,NA,267,0,0,92,51,448,267,448
2018,25,75,"Osmaniye",37.0742,36.2473,24.1142857142857,24.7857142857143,3.79514285714286,74.4571428571429,34.442,NA,358,0,0,264,312,518,358,518
2018,26,75,"Osmaniye",37.0742,36.2473,20.8714285714286,26.2714285714286,0.000285714285714286,70.9285714285714,40.53,NA,355,1,0,219,334,587,354,587
2018,27,75,"Osmaniye",37.0742,36.2473,18.7428571428571,27.6714285714286,0,73.1428571428571,45.4671428571429,NA,342,0,0,220,190,418,342,418
2018,28,75,"Osmaniye",37.0742,36.2473,21.2,28.1,0,72.1285714285714,49.3966666666667,NA,286,0,0,80,137,585,286,585
2018,29,75,"Osmaniye",37.0742,36.2473,23.8428571428571,28,0.0875714285714286,70.0142857142857,46.3785714285714,NA,260,0,0,83,346,756,260,756
2018,30,75,"Osmaniye",37.0742,36.2473,23.8571428571429,28,0.177571428571429,70.5285714285714,43.67,NA,265,0,0,82,430,822,265,822
2018,31,75,"Osmaniye",37.0742,36.2473,24.3571428571429,28.5714285714286,0.00885714285714286,72.3714285714286,46.7242857142857,NA,267,0,0,57,135,499,267,499
2018,32,75,"Osmaniye",37.0742,36.2473,23.5285714285714,28.9571428571429,0.00214285714285714,62.9428571428571,44.7671428571429,NA,297,0,0,91,179,403,297,403
2018,33,75,"Osmaniye",37.0742,36.2473,22.7714285714286,28.2142857142857,0,68,47.5,NA,216,0,0,125,175,332,216,332
2018,34,75,"Osmaniye",37.0742,36.2473,21.9571428571429,28.6,0,69.8,49.4428571428571,NA,144,0,0,46,50,227,144,227
2018,35,75,"Osmaniye",37.0742,36.2473,21.3428571428571,28.5714285714286,0.00414285714285714,68.7571428571429,51.2828571428571,NA,201,0,0,84,61,314,201,314
2018,36,75,"Osmaniye",37.0742,36.2473,21.4857142857143,26.9428571428571,0.0111428571428571,69.3142857142857,42.5114285714286,NA,341,4,20,52,26,370,337,350
2018,37,75,"Osmaniye",37.0742,36.2473,16.9857142857143,26.4714285714286,0.003,59.2142857142857,41.954,NA,241,60,112,37,58,419,181,307
2018,38,75,"Osmaniye",37.0742,36.2473,18.0142857142857,27.1,0,59.5428571428571,49.63,NA,189,4,17,48,44,344,185,327
2018,39,75,"Osmaniye",37.0742,36.2473,17.3714285714286,25.9428571428571,0.043,62.4571428571429,50.4185714285714,NA,180,3,4,56,82,353,177,349
2018,40,75,"Osmaniye",37.0742,36.2473,22.2,24.3857142857143,0.000428571428571429,50.3142857142857,40.5928571428571,NA,191,6,30,76,134,341,185,311
2018,41,75,"Osmaniye",37.0742,36.2473,13.7571428571429,23.1857142857143,0.216285714285714,58.5857142857143,90.8914285714286,NA,187,12,34,29,16,422,175,388
2018,42,75,"Osmaniye",37.0742,36.2473,15.3428571428571,23.5142857142857,1.32114285714286,55.2285714285714,180.766,NA,168,83,181,0,0,381,85,200
2018,43,75,"Osmaniye",37.0742,36.2473,18.1571428571429,18.1857142857143,11.3197142857143,64.6571428571429,48.3933333333333,NA,187,38,9,39,158,402,149,393
2018,44,75,"Osmaniye",37.0742,36.2473,14.6428571428571,18.5857142857143,0,50.0571428571429,69.12,NA,196,14,3,13,10,264,182,261
2018,45,75,"Osmaniye",37.0742,36.2473,14.2428571428571,17.4428571428571,1.07242857142857,66.4857142857143,43.5428571428571,NA,231,124,209,5,3,473,107,264
2018,46,75,"Osmaniye",37.0742,36.2473,7.37142857142857,12.8285714285714,1.59742857142857,71.5,59.396,NA,230,97,222,37,74,465,133,243
2018,47,75,"Osmaniye",37.0742,36.2473,14.2428571428571,14.9142857142857,5.61042857142857,76.7428571428571,97.93,NA,270,130,103,57,195,499,140,396
2018,48,75,"Osmaniye",37.0742,36.2473,17.7857142857143,14.6857142857143,0.0772857142857143,79.6,86.22,NA,245,32,5,18,39,201,213,196
2018,49,75,"Osmaniye",37.0742,36.2473,18.1142857142857,13.7857142857143,1.86128571428571,76.8571428571429,71.6571428571429,NA,257,33,20,41,203,420,224,400
2018,50,75,"Osmaniye",37.0742,36.2473,17.9142857142857,11.9428571428571,11.949,76.7142857142857,82.6,NA,256,55,64,3,7,305,201,241
2018,51,75,"Osmaniye",37.0742,36.2473,17.1285714285714,11.5857142857143,3.77885714285714,81.6,100.356666666667,NA,250,63,59,17,30,248,187,189
2018,52,75,"Osmaniye",37.0742,36.2473,14.9142857142857,9.08571428571429,5.88171428571429,74.7857142857143,73.9928571428571,NA,244,67,22,33,11,273,177,251
2019,1,75,"Osmaniye",37.0742,36.2473,20.7,9.9625,23.688375,85.2625,64.375,NA,343,59,127,6,1,784,284,657
2019,2,75,"Osmaniye",37.0742,36.2473,16.6285714285714,7.11428571428571,4.42642857142857,69.7571428571429,87.6785714285714,NA,255,160,66,0,0,208,95,142
2019,3,75,"Osmaniye",37.0742,36.2473,14.8,7.35714285714286,9.88085714285714,69.5857142857143,90.45,NA,192,132,96,15,6,198,60,102
2019,4,75,"Osmaniye",37.0742,36.2473,18.4142857142857,11.5428571428571,0.763428571428571,61.2,124.85,NA,308,207,70,0,0,314,101,244
2019,5,75,"Osmaniye",37.0742,36.2473,13.2,10.8285714285714,5.069,76.3285714285714,70.93,NA,253,130,48,12,2,143,123,95
2019,6,75,"Osmaniye",37.0742,36.2473,23.5,11.1428571428571,3.00671428571429,66.9428571428572,71.7485714285714,NA,276,114,36,58,20,127,162,91
2019,7,75,"Osmaniye",37.0742,36.2473,19.3285714285714,10.4428571428571,0.345428571428571,76.1428571428571,62.6928571428571,NA,325,33,13,92,141,234,292,221
2019,8,75,"Osmaniye",37.0742,36.2473,14.3285714285714,11.3,1.13985714285714,76.1857142857143,65.3866666666667,NA,305,39,16,92,89,219,266,203
2019,9,75,"Osmaniye",37.0742,36.2473,16.0714285714286,10.5142857142857,4.58271428571429,73.9,50.24,NA,331,67,57,86,28,310,264,253
2019,10,75,"Osmaniye",37.0742,36.2473,14.4428571428571,11.5857142857143,0.503142857142857,71.6285714285714,63.1685714285714,NA,359,41,7,83,34,252,318,245
2019,11,75,"Osmaniye",37.0742,36.2473,18.0428571428571,13.1714285714286,7.27314285714286,81.2,52.1571428571429,NA,373,124,114,62,43,400,249,286
2019,12,75,"Osmaniye",37.0742,36.2473,15.5714285714286,14.8428571428571,0,58.7571428571429,52.9528571428571,NA,343,0,0,99,33,416,343,416
2019,13,75,"Osmaniye",37.0742,36.2473,20.9428571428571,12.6428571428571,8.23257142857143,77.7857142857143,41.4014285714286,NA,256,6,4,43,7,194,250,190
2019,14,75,"Osmaniye",37.0742,36.2473,15.5,14.8714285714286,1.491,79.1714285714286,44.7571428571429,NA,365,166,93,59,24,208,199,115
2019,15,75,"Osmaniye",37.0742,36.2473,17.7285714285714,17.9142857142857,0.989,68.8714285714286,60.7285714285714,NA,359,4,1,102,36,183,355,182
2019,16,75,"Osmaniye",37.0742,36.2473,16,13.0142857142857,3.31642857142857,80.9,30.9528571428571,NA,318,0,0,73,46,208,318,208
2019,17,75,"Osmaniye",37.0742,36.2473,17.1428571428571,17.4142857142857,0,54.1857142857143,44.6328571428571,NA,412,1,0,191,106,313,411,313
2019,18,75,"Osmaniye",37.0742,36.2473,17.4857142857143,21.0714285714286,0.000285714285714286,57.6857142857143,59.22,NA,523,96,38,138,90,353,427,315
2019,19,75,"Osmaniye",37.0742,36.2473,18.8714285714286,19.7714285714286,0.342714285714286,62.2285714285714,40.08,NA,452,66,48,114,95,386,386,338
2019,20,75,"Osmaniye",37.0742,36.2473,16.9285714285714,25.3857142857143,0,50.6857142857143,50.4528571428571,NA,454,0,0,285,247,389,454,389
2019,21,75,"Osmaniye",37.0742,36.2473,15.5428571428571,24.1714285714286,0.0427142857142857,58.0714285714286,49.4114285714286,NA,457,0,0,318,321,413,457,413
2019,22,75,"Osmaniye",37.0742,36.2473,14.5428571428571,27.1142857142857,0,53.6857142857143,64.7657142857143,NA,453,0,0,382,229,323,453,323
2019,23,75,"Osmaniye",37.0742,36.2473,16.9,25.9428571428571,0.284571428571429,59.8142857142857,54.4185714285714,NA,378,0,0,262,305,532,378,532
2019,24,75,"Osmaniye",37.0742,36.2473,20.6142857142857,24.9714285714286,0.0387142857142857,70.3285714285714,42.62,NA,378,0,0,253,166,244,378,244
2019,25,75,"Osmaniye",37.0742,36.2473,19.4142857142857,25.1,8.12114285714286,77.1571428571429,39.2542857142857,NA,306,0,0,219,184,325,306,325
2019,26,75,"Osmaniye",37.0742,36.2473,18.6571428571429,28.3714285714286,2.134,69.9,45.06,NA,377,1,0,199,96,342,376,342
2019,27,75,"Osmaniye",37.0742,36.2473,19.8142857142857,27.1714285714286,0,63.8714285714286,40.57,NA,456,0,0,296,159,222,456,222
2019,28,75,"Osmaniye",37.0742,36.2473,21.3285714285714,27.4,0.178285714285714,71.8428571428571,54.17,NA,398,0,0,288,299,421,398,421
2019,29,75,"Osmaniye",37.0742,36.2473,17.8285714285714,26.3142857142857,7.57271428571429,73.0142857142857,41.2857142857143,NA,453,0,0,313,135,203,453,203
2019,30,75,"Osmaniye",37.0742,36.2473,17.7285714285714,28.0571428571429,0,70.1857142857143,53.1842857142857,NA,456,0,0,340,224,335,456,335
2019,31,75,"Osmaniye",37.0742,36.2473,20.0571428571429,28.4285714285714,0,72.1285714285714,58.93,NA,334,0,0,166,171,375,334,375
2019,32,75,"Osmaniye",37.0742,36.2473,19.4142857142857,28.4,0.000285714285714286,66.8857142857143,52.5985714285714,NA,346,0,0,229,231,395,346,395
2019,33,75,"Osmaniye",37.0742,36.2473,19.3,28.4428571428571,2.30585714285714,72.5571428571429,52.0214285714286,NA,337,1,0,142,280,531,336,531
2019,34,75,"Osmaniye",37.0742,36.2473,18.6857142857143,28.1857142857143,0.00171428571428571,62.4285714285714,48.5428571428571,NA,299,0,0,191,300,345,299,345
2019,35,75,"Osmaniye",37.0742,36.2473,17.9714285714286,28.9857142857143,0.000714285714285714,70.2714285714286,64.8557142857143,NA,307,0,0,204,283,415,307,415
2019,36,75,"Osmaniye",37.0742,36.2473,20.6714285714286,27.5857142857143,1.70828571428571,66.9285714285714,54.0171428571429,NA,171,0,0,115,24,67,171,67
2019,37,75,"Osmaniye",37.0742,36.2473,20.5142857142857,26.7714285714286,0.162714285714286,62.1428571428571,50.8071428571429,NA,218,0,0,135,22,55,218,55
2019,38,75,"Osmaniye",37.0742,36.2473,20.4142857142857,25.1,0.175,52.6,48.2585714285714,NA,266,0,0,128,44,91,266,91
2019,39,75,"Osmaniye",37.0742,36.2473,15.7,24.5142857142857,0.000285714285714286,58.4857142857143,49.7614285714286,NA,237,0,0,198,55,79,237,79
2019,40,75,"Osmaniye",37.0742,36.2473,19.0857142857143,24.4285714285714,1.46657142857143,66.5428571428571,57.2583333333333,NA,241,0,0,141,69,111,241,111
2019,41,75,"Osmaniye",37.0742,36.2473,13.6571428571429,23.8571428571429,0.147142857142857,58.0571428571429,58.61,NA,416,4,2,149,289,448,412,446
2019,42,75,"Osmaniye",37.0742,36.2473,17.8714285714286,24.3714285714286,0.457285714285714,54.1428571428571,73.0785714285714,NA,356,15,20,157,229,408,341,388
2019,43,75,"Osmaniye",37.0742,36.2473,14.2857142857143,21.5857142857143,0.843571428571429,57.7,38.44,NA,306,31,35,48,86,300,275,265
2019,44,75,"Osmaniye",37.0742,36.2473,15.2428571428571,18,4.15371428571429,73,28.9142857142857,NA,350,32,39,98,86,250,318,211
2019,45,75,"Osmaniye",37.0742,36.2473,10.7142857142857,18.7571428571429,0,53.3,52.4885714285714,NA,417,0,0,150,147,328,417,328
2019,46,75,"Osmaniye",37.0742,36.2473,14.6714285714286,19.2,0.00114285714285714,42.5857142857143,66.4971428571429,NA,401,94,49,27,29,337,307,288
2019,47,75,"Osmaniye",37.0742,36.2473,13.4571428571429,13.5285714285714,0,46.4571428571429,72.282,NA,391,5,7,32,37,339,386,332
2019,48,75,"Osmaniye",37.0742,36.2473,15.4142857142857,14.7285714285714,5.67285714285714,71.4428571428571,73.5142857142857,NA,320,60,19,35,36,251,260,232
2019,49,75,"Osmaniye",37.0742,36.2473,14.0857142857143,11.1714285714286,4.08314285714286,71.6285714285714,58.7071428571429,NA,393,3,3,20,7,274,390,271
2019,50,75,"Osmaniye",37.0742,36.2473,21.3285714285714,12.0714285714286,2.44928571428571,73.9714285714286,44.3114285714286,NA,218,28,9,7,3,119,190,110
2019,51,75,"Osmaniye",37.0742,36.2473,10.3,10.7285714285714,0,76.1142857142857,140.317142857143,NA,361,52,79,6,15,488,309,409
2019,52,75,"Osmaniye",37.0742,36.2473,21.0857142857143,10.1,8.06285714285714,84.6571428571429,64.57,NA,279,41,73,44,21,281,238,208
2020,1,75,"Osmaniye",37.0742,36.2473,16.58,9.1,1.9174,80.34,59.51,NA,160,40,42,13,7,126,120,84
2020,2,75,"Osmaniye",37.0742,36.2473,18.7285714285714,9.07142857142857,0.150857142857143,69.9571428571429,72.0114285714286,NA,240,26,14,28,23,173,214,159
2020,3,75,"Osmaniye",37.0742,36.2473,16.5142857142857,8.54285714285714,0.157714285714286,66.3714285714286,90.6685714285714,NA,270,36,74,17,9,382,234,308
2020,4,75,"Osmaniye",37.0742,36.2473,18.6,6.61428571428571,0.000285714285714286,55.6285714285714,79.8266666666667,NA,358,0,0,48,27,295,358,295
2020,5,75,"Osmaniye",37.0742,36.2473,14.6285714285714,9.18571428571429,9.85857142857143,72.1857142857143,77.6857142857143,NA,331,11,2,114,85,272,320,270
2020,6,75,"Osmaniye",37.0742,36.2473,17.0285714285714,8.92857142857143,5.73,70.2571428571429,63.006,NA,343,95,114,52,9,267,248,153
2020,7,75,"Osmaniye",37.0742,36.2473,21.4571428571429,5.25714285714286,0.143,54.9,65.3414285714286,NA,341,13,4,11,1,338,328,334
2020,8,75,"Osmaniye",37.0742,36.2473,17.1142857142857,11.6428571428571,2.70785714285714,72.3857142857143,57.1371428571429,NA,283,51,16,17,0,187,232,171
2020,9,75,"Osmaniye",37.0742,36.2473,13.1,12.3857142857143,3.36642857142857,72.2428571428571,49.6271428571429,NA,393,52,113,161,154,528,341,415
2020,10,75,"Osmaniye",37.0742,36.2473,14.9857142857143,15.0571428571429,0.000714285714285714,65.8,41.832,NA,205,25,2,36,49,210,180,208
2020,11,75,"Osmaniye",37.0742,36.2473,24.1714285714286,17.4857142857143,0.0265714285714286,62.2142857142857,49.215,NA,115,15,16,2,0,94,100,78
2020,12,75,"Osmaniye",37.0742,36.2473,15.6428571428571,10.4,4.931,78.0857142857143,24.932,NA,117,12,8,47,58,118,105,110
2020,13,75,"Osmaniye",37.0742,36.2473,23.2,15.1285714285714,8.17457142857143,73.7285714285714,40.505,NA,136,24,20,13,3,92,112,72
2020,14,75,"Osmaniye",37.0742,36.2473,21.7571428571429,14.6428571428571,9.75214285714286,73.5285714285714,28.655,NA,155,42,29,17,9,121,113,92
2020,15,75,"Osmaniye",37.0742,36.2473,16.9857142857143,15.3142857142857,2.87985714285714,79.5857142857143,28.876,NA,133,0,0,31,22,118,133,118
2020,16,75,"Osmaniye",37.0742,36.2473,15.4857142857143,18.3714285714286,0.0431428571428571,59.7,35.4214285714286,NA,141,2,1,41,41,106,139,105
2020,17,75,"Osmaniye",37.0742,36.2473,17.5285714285714,17.3428571428571,2.31228571428571,70.6571428571429,45.97,NA,137,0,0,87,46,123,137,123
2020,18,75,"Osmaniye",37.0742,36.2473,18.0428571428571,17.4571428571429,6.45842857142857,80.7571428571429,26.03,NA,146,3,2,36,22,164,143,162
2020,19,75,"Osmaniye",37.0742,36.2473,20.2571428571429,18.6,1.43342857142857,74.4142857142857,21.3575,NA,137,13,17,34,76,157,124,140
2020,20,75,"Osmaniye",37.0742,36.2473,15.2285714285714,24.9,0,55.1142857142857,28.628,NA,164,0,0,70,100,164,164,164
2020,21,75,"Osmaniye",37.0742,36.2473,20.5714285714286,26.0857142857143,7.54885714285714,45.7571428571429,31.7814285714286,NA,146,0,0,88,55,96,146,96
2020,22,75,"Osmaniye",37.0742,36.2473,18.9857142857143,20.9571428571429,0.000142857142857143,59.6142857142857,22.4928571428571,NA,118,0,0,59,38,100,118,100
2020,23,75,"Osmaniye",37.0742,36.2473,18.8,23.2714285714286,0.0144285714285714,58.9571428571429,30.4885714285714,NA,112,2,0,65,53,70,110,70
2020,24,75,"Osmaniye",37.0742,36.2473,20.6142857142857,23.5142857142857,0.000714285714285714,68.7571428571429,33.7742857142857,NA,140,0,0,64,69,150,140,150
2020,25,75,"Osmaniye",37.0742,36.2473,21.9,23.9857142857143,0.581571428571429,72.8571428571429,30.0114285714286,NA,137,0,0,80,47,108,137,108
2020,26,75,"Osmaniye",37.0742,36.2473,21.2142857142857,25.7,0,72.1142857142857,33.1214285714286,NA,173,0,0,75,30,133,173,133
2020,27,75,"Osmaniye",37.0742,36.2473,17.8714285714286,27.8857142857143,0,69.7571428571429,44.62,NA,113,1,0,28,46,113,112,113
2020,28,75,"Osmaniye",37.0742,36.2473,20.1,27.9428571428571,0,74.1,40.2016666666667,NA,164,0,0,67,24,122,164,122
2020,29,75,"Osmaniye",37.0742,36.2473,19.1285714285714,28.5142857142857,0.000142857142857143,71.6714285714286,NA,NA,186,3,1,59,24,111,183,110
2020,30,75,"Osmaniye",37.0742,36.2473,16.9428571428571,29.3,0,70.1714285714286,NA,NA,190,0,0,80,44,142,190,142
2020,31,75,"Osmaniye",37.0742,36.2473,17.3,29.8285714285714,0,71.1,NA,NA,150,3,0,49,17,127,147,127
2020,32,75,"Osmaniye",37.0742,36.2473,21.2,29.0428571428571,0.00542857142857143,70.3285714285714,NA,NA,146,0,0,45,42,107,146,107
2020,33,75,"Osmaniye",37.0742,36.2473,24.1,28.2714285714286,1.13928571428571,62.4857142857143,NA,NA,183,0,0,79,18,83,183,83
2020,34,75,"Osmaniye",37.0742,36.2473,21.8571428571429,28.1285714285714,0.711285714285714,60.5142857142857,NA,NA,197,1,0,103,26,97,196,97
2020,35,75,"Osmaniye",37.0742,36.2473,16.4428571428571,28.7,0,58.8428571428571,NA,NA,164,2,9,63,30,157,162,148
2020,36,75,"Osmaniye",37.0742,36.2473,16.7428571428571,30.1142857142857,0.000142857142857143,56.4857142857143,NA,NA,179,3,0,79,41,112,176,112
2020,37,75,"Osmaniye",37.0742,36.2473,17.5,29.4571428571429,0,54.8714285714286,NA,NA,193,0,0,85,34,91,193,91
2020,38,75,"Osmaniye",37.0742,36.2473,15.8285714285714,28.1857142857143,0,70.5142857142857,NA,NA,235,0,0,98,39,157,235,157
2020,39,75,"Osmaniye",37.0742,36.2473,18.2142857142857,26.5285714285714,0.00457142857142857,68.1571428571429,NA,NA,220,0,0,119,61,129,220,129
2020,40,75,"Osmaniye",37.0742,36.2473,18.4285714285714,25.5428571428571,0.341428571428571,64.2857142857143,NA,NA,187,0,0,121,80,154,187,154
2020,41,75,"Osmaniye",37.0742,36.2473,16.1,25.5,0,41.0428571428571,NA,NA,182,0,0,79,56,127,182,127
2020,42,75,"Osmaniye",37.0742,36.2473,14.0857142857143,23.7428571428571,0,66.8857142857143,NA,NA,177,0,0,94,62,111,177,111
2020,43,75,"Osmaniye",37.0742,36.2473,11.7285714285714,23.4857142857143,1.84957142857143,53.7571428571429,NA,NA,194,1,0,22,10,161,193,161
2020,44,75,"Osmaniye",37.0742,36.2473,12.7142857142857,22.2285714285714,0,55.3428571428571,NA,NA,255,15,11,8,5,233,240,222
2020,45,75,"Osmaniye",37.0742,36.2473,16.4285714285714,17.9571428571429,3.47085714285714,69.0857142857143,NA,NA,156,2,2,24,12,103,154,101
2020,46,75,"Osmaniye",37.0742,36.2473,10.6714285714286,16.3857142857143,0,56.5428571428571,NA,NA,208,5,1,26,12,109,203,108
2020,47,75,"Osmaniye",37.0742,36.2473,15.1714285714286,14.4142857142857,0.429428571428571,59.3142857142857,NA,NA,173,21,0,18,5,83,152,83
2020,48,75,"Osmaniye",37.0742,36.2473,16.3285714285714,12.1571428571429,0.528714285714286,55.1571428571429,NA,NA,199,7,2,10,9,262,192,260
2020,49,75,"Osmaniye",37.0742,36.2473,13.4285714285714,12.9571428571429,0.430857142857143,64.9142857142857,NA,NA,207,8,9,35,13,116,199,107
2020,50,75,"Osmaniye",37.0742,36.2473,17.4428571428571,13.5285714285714,0.0754285714285714,63.7714285714286,86.5,NA,181,8,3,13,24,98,173,95
2020,51,75,"Osmaniye",37.0742,36.2473,20.2142857142857,12.9,3.72985714285714,69.6714285714286,75.05,NA,171,15,4,43,23,90,156,86
2020,52,75,"Osmaniye",37.0742,36.2473,16.5428571428571,9.74285714285714,0.00285714285714286,55.2428571428571,97.2657142857143,NA,203,2,0,40,17,113,201,113
2020,53,75,"Osmaniye",37.0742,36.2473,10.275,10.225,0,56.925,140.69,NA,122,0,0,37,20,111,122,111
2017,1,76,"Rize",41.0201,40.5234,26.7714285714286,9.85714285714286,0.0142857142857143,60.2428571428571,24.4971428571429,12.15,563,0,0,152,320,847,563,847
2017,2,76,"Rize",41.0201,40.5234,23.8714285714286,6.84285714285714,7.36771428571429,71.7857142857143,23.0171428571429,13.4714285714286,757,0,0,423,662,1214,757,1214
2017,3,76,"Rize",41.0201,40.5234,19.3571428571429,7.35714285714286,5.75342857142857,73.0571428571428,26.4785714285714,11.8571428571429,762,18,45,540,1100,1449,744,1404
2017,4,76,"Rize",41.0201,40.5234,20.6857142857143,3.68571428571429,15.55,80.5857142857143,21.3114285714286,9.8375,639,0,0,474,641,889,639,889
2017,5,76,"Rize",41.0201,40.5234,22.4714285714286,2.78571428571429,20.2504285714286,74.1857142857143,21.1657142857143,11.484,588,0,0,345,828,1163,588,1163
2017,6,76,"Rize",41.0201,40.5234,22.7285714285714,7.75714285714286,4.78257142857143,71.3571428571429,21.9871428571429,14.102,736,0,0,493,1018,1519,736,1519
2017,7,76,"Rize",41.0201,40.5234,20.1142857142857,2.91428571428571,13.4951428571429,73.7714285714286,18.7228571428571,10.8275,492,0,0,353,602,717,492,717
2017,8,76,"Rize",41.0201,40.5234,29.1142857142857,10.3,4.612,62.2571428571429,37.8371428571429,19.8,739,63,153,309,719,1747,676,1594
2017,9,76,"Rize",41.0201,40.5234,15.8714285714286,9.87142857142857,2.45571428571429,76.8857142857143,61.1485714285714,NA,574,345,593,12,7,866,229,273
2017,10,76,"Rize",41.0201,40.5234,20.4285714285714,13.1,0,60.7,72.7628571428571,23.5725,712,223,350,4,2,1043,489,693
2017,11,76,"Rize",41.0201,40.5234,14.6285714285714,8.67142857142857,4.86971428571429,81.2,30.33,9.305,525,19,20,210,295,725,506,705
2017,12,76,"Rize",41.0201,40.5234,12.2142857142857,7.78571428571429,1.27071428571429,76.2571428571429,29.9242857142857,9.32,589,248,296,81,166,1077,341,781
2017,13,76,"Rize",41.0201,40.5234,14.5857142857143,9.15714285714286,3.88414285714286,77.8714285714286,38.8042857142857,10.6085714285714,574,179,286,81,125,887,395,601
2017,14,76,"Rize",41.0201,40.5234,20.1285714285714,10.5142857142857,4.71285714285714,79.1,42.1414285714286,13.0728571428571,639,260,638,139,298,1336,379,698
2017,15,76,"Rize",41.0201,40.5234,17.9857142857143,10.8714285714286,3.08485714285714,78.2714285714286,35.36,13.45,587,110,376,304,459,1187,477,811
2017,16,76,"Rize",41.0201,40.5234,30.4428571428571,13.0857142857143,4.68414285714286,73.2,34.8228571428571,11.6442857142857,717,260,196,275,399,920,457,724
2017,17,76,"Rize",41.0201,40.5234,13.8142857142857,12.1857142857143,3.66985714285714,69.0857142857143,31.0171428571429,10.5328571428571,731,384,713,265,529,1478,347,765
2017,18,76,"Rize",41.0201,40.5234,14.2857142857143,15.1142857142857,0.585857142857143,82.8,40.05,9.51428571428571,506,153,260,163,290,923,353,663
2017,19,76,"Rize",41.0201,40.5234,25.6285714285714,17.5714285714286,7.62514285714286,72.8714285714286,25.47,10.2066666666667,471,159,366,170,277,966,312,600
2017,20,76,"Rize",41.0201,40.5234,18.2714285714286,14.6571428571429,13.6651428571429,88.6,13.6614285714286,8.3,472,279,623,136,488,1205,193,582
2017,21,76,"Rize",41.0201,40.5234,12.2285714285714,15.8,5.698,82.0714285714286,15.3428571428571,9.13142857142857,448,192,322,204,479,849,256,527
2017,22,76,"Rize",41.0201,40.5234,17.2428571428571,19.3142857142857,0.371285714285714,76.4285714285714,21.0985714285714,10.2414285714286,522,186,468,130,180,1015,336,547
2017,23,76,"Rize",41.0201,40.5234,15.1428571428571,21.1571428571429,2.22814285714286,80.3714285714286,16.2214285714286,8.80142857142857,578,138,208,69,218,1388,440,1180
2017,24,76,"Rize",41.0201,40.5234,16.4285714285714,20.0571428571429,8.49614285714286,76.6714285714286,11.9685714285714,7.84,552,63,159,398,826,1139,489,980
2017,25,76,"Rize",41.0201,40.5234,13.8142857142857,21.4571428571429,5.44228571428571,76.7142857142857,12.9014285714286,6.74857142857143,584,167,335,417,706,1041,417,706
2017,26,76,"Rize",41.0201,40.5234,10.6857142857143,24.8428571428571,0,74.8,13.4214285714286,5.19714285714286,564,360,651,42,17,971,204,320
2017,27,76,"Rize",41.0201,40.5234,20.3714285714286,23.8857142857143,3.555,71.2714285714286,17.5557142857143,5.09142857142857,511,90,165,355,397,642,421,477
2017,28,76,"Rize",41.0201,40.5234,13,24.7571428571429,0,69.8428571428571,19.7514285714286,5.34,481,50,127,149,307,864,431,737
2017,29,76,"Rize",41.0201,40.5234,15.4,25.3142857142857,2.98385714285714,77.1142857142857,22.0685714285714,6.54142857142857,532,66,180,462,1083,1272,466,1092
2017,30,76,"Rize",41.0201,40.5234,15.9714285714286,25.7714285714286,9.137,70.9714285714286,31.5142857142857,7.62571428571429,531,100,206,346,542,928,431,722
2017,31,76,"Rize",41.0201,40.5234,11.9714285714286,25.9857142857143,0.528571428571429,75.8142857142857,31.3957142857143,7.12285714285714,559,65,104,395,706,1047,494,943
2017,32,76,"Rize",41.0201,40.5234,14.5857142857143,28.1857142857143,0.613857142857143,77.1,28.44,5.44,567,0,0,500,970,1092,567,1092
2017,33,76,"Rize",41.0201,40.5234,17.2,27.6142857142857,14.0771428571429,74.7285714285714,19.4057142857143,4.50714285714286,596,0,0,589,1185,1199,596,1199
2017,34,76,"Rize",41.0201,40.5234,23.2428571428571,24.6714285714286,13.0212857142857,77.6857142857143,15.1357142857143,4.40428571428571,601,0,0,504,1120,1280,601,1280
2017,35,76,"Rize",41.0201,40.5234,15.1428571428571,23.4428571428571,14.2912857142857,78.7,12.6414285714286,4.51428571428571,493,52,190,355,620,1014,441,824
2017,36,76,"Rize",41.0201,40.5234,15.1428571428571,23.2428571428571,1.88485714285714,75.9142857142857,14.2685714285714,5.89857142857143,507,0,0,280,839,1321,507,1321
2017,37,76,"Rize",41.0201,40.5234,10.4285714285714,25.1285714285714,0.0857142857142857,68.8142857142857,44.5642857142857,7.49714285714286,589,0,0,130,319,1138,589,1138
2017,38,76,"Rize",41.0201,40.5234,15.6142857142857,23.9428571428571,4.427,80.7,38.5114285714286,6.40142857142857,671,0,0,396,922,1312,671,1312
2017,39,76,"Rize",41.0201,40.5234,18.5428571428571,21.0714285714286,17.3891428571429,80.2,19.7542857142857,6.17285714285714,782,0,0,733,1514,1630,782,1630
2017,40,76,"Rize",41.0201,40.5234,16.9428571428571,18.1857142857143,20.7585714285714,66.9428571428571,18.11,7.24857142857143,543,0,0,243,351,1137,543,1137
2017,41,76,"Rize",41.0201,40.5234,22.7428571428571,16.6571428571429,19.4492857142857,78.4142857142857,11.19,6.31714285714286,487,0,0,376,608,843,487,843
2017,42,76,"Rize",41.0201,40.5234,13.8571428571429,16.0857142857143,3.78442857142857,74.5571428571428,24.0642857142857,8.56142857142857,530,3,25,191,240,815,527,790
2017,43,76,"Rize",41.0201,40.5234,19.8571428571429,18.6428571428571,4.18428571428571,70.7285714285714,41.5842857142857,10.8657142857143,506,0,0,244,307,919,506,919
2017,44,76,"Rize",41.0201,40.5234,22.2714285714286,12.9571428571429,14.5211428571429,76.9714285714286,16.2185714285714,9.66285714285714,561,0,0,299,512,1102,561,1102
2017,45,76,"Rize",41.0201,40.5234,12.7428571428571,15.1285714285714,0.600142857142857,80.1285714285714,31.9428571428571,10.9471428571429,577,0,0,339,323,829,577,829
2017,46,76,"Rize",41.0201,40.5234,18.0142857142857,16.1714285714286,0.0428571428571429,69.7142857142857,43.7214285714286,12.8185714285714,587,0,0,163,223,1085,587,1085
2017,47,76,"Rize",41.0201,40.5234,25,10.4285714285714,18.121,66.4714285714286,54.1933333333333,9.97142857142857,418,0,0,350,589,804,418,804
2017,48,76,"Rize",41.0201,40.5234,18.6285714285714,12.7571428571429,2.84185714285714,63.7285714285714,37.3742857142857,15.9914285714286,386,0,0,52,109,619,386,619
2017,49,76,"Rize",41.0201,40.5234,27,10.9142857142857,16.9207142857143,67.8285714285714,43.12,11.4942857142857,407,0,0,272,394,645,407,645
2017,50,76,"Rize",41.0201,40.5234,13.3,11.0285714285714,3.46957142857143,70.6571428571429,43.9471428571429,18.1228571428571,346,0,0,42,81,442,346,442
2017,51,76,"Rize",41.0201,40.5234,20.9285714285714,11.4428571428571,10.4541428571429,82.2142857142857,29.3483333333333,10.5728571428571,386,0,0,287,260,349,386,349
2017,52,76,"Rize",41.0201,40.5234,23.3875,11.7625,2.874125,60.6625,67.4725,16.35125,528,0,0,280,199,507,528,507
2018,1,76,"Rize",41.0201,40.5234,17.1625,10.1875,13.34375,76.65,31.7114285714286,13.20875,618,0,0,370,403,914,618,914
2018,2,76,"Rize",41.0201,40.5234,23.0142857142857,10.2714285714286,4.15528571428571,72.6285714285714,31.6916666666667,13.28,624,0,0,374,860,1309,624,1309
2018,3,76,"Rize",41.0201,40.5234,22.7571428571429,9.01428571428571,9.709,71.1571428571429,45.945,12.9071428571429,639,1,0,269,167,655,638,655
2018,4,76,"Rize",41.0201,40.5234,19,7.87142857142857,9.96928571428571,76.9285714285714,31.49,9.70428571428571,604,0,0,522,643,764,604,764
2018,5,76,"Rize",41.0201,40.5234,15.4,9.88571428571429,5.48257142857143,64.9142857142857,38.7057142857143,13.7228571428571,670,9,31,299,195,819,661,788
2018,6,76,"Rize",41.0201,40.5234,20.0857142857143,10.9142857142857,2.028,80.0428571428571,34.3857142857143,13.3257142857143,704,21,11,183,306,1022,683,1011
2018,7,76,"Rize",41.0201,40.5234,15.6571428571429,10,6.299,82.0571428571429,25.5016666666667,11.4528571428571,478,11,48,210,272,557,467,509
2018,8,76,"Rize",41.0201,40.5234,13.0428571428571,9.57142857142857,0.614285714285714,82.8142857142857,20.75,8.97857142857143,711,184,494,103,202,1321,527,827
2018,9,76,"Rize",41.0201,40.5234,33.6428571428571,10.1,10.4811428571429,74.9142857142857,26.6014285714286,13.2914285714286,621,8,7,113,203,956,613,949
2018,10,76,"Rize",41.0201,40.5234,24.7,11.6,10.3237142857143,78.8857142857143,25.7471428571429,13.5042857142857,556,180,344,240,605,1330,376,986
2018,11,76,"Rize",41.0201,40.5234,13.8142857142857,12.6142857142857,6.26971428571429,77.6428571428571,28.2366666666667,12.3742857142857,551,91,229,215,410,1426,460,1197
2018,12,76,"Rize",41.0201,40.5234,23.8142857142857,14.8142857142857,4.42657142857143,71.1285714285714,NA,11.5985714285714,425,53,57,156,366,1187,372,1130
2018,13,76,"Rize",41.0201,40.5234,17.9714285714286,12.8285714285714,2.78514285714286,78.4857142857143,55.915,11.0685714285714,356,61,102,184,211,428,295,326
2018,14,76,"Rize",41.0201,40.5234,19.3571428571429,13.2142857142857,4.09828571428571,66.1142857142857,40.7271428571429,10.2357142857143,407,84,98,219,309,486,323,388
2018,15,76,"Rize",41.0201,40.5234,11.7142857142857,12.8571428571429,0.357,84.2142857142857,36.9685714285714,7.49857142857143,374,94,83,98,82,450,280,367
2018,16,76,"Rize",41.0201,40.5234,13.5571428571429,12.9142857142857,3.56971428571429,72.8,29.8142857142857,8.40571428571429,411,71,166,90,171,648,340,482
2018,17,76,"Rize",41.0201,40.5234,13.3428571428571,16.2285714285714,0,70.7285714285714,32.6571428571429,11.1525,419,133,285,162,223,652,286,367
2018,18,76,"Rize",41.0201,40.5234,14.2857142857143,17.2,0.0714285714285714,88.2,32.2457142857143,15.9571428571429,303,190,261,37,70,474,113,213
2018,19,76,"Rize",41.0201,40.5234,17.2,18.1428571428571,6.81128571428571,81.7714285714286,23.9814285714286,17.8557142857143,275,0,0,214,356,467,275,467
2018,20,76,"Rize",41.0201,40.5234,13.3,19.7,0.0448571428571429,77.4714285714286,32.2871428571429,25.3485714285714,204,112,204,15,5,306,92,102
2018,21,76,"Rize",41.0201,40.5234,14.6428571428571,21.7857142857143,2.85614285714286,81.6285714285714,25.8442857142857,19.0928571428571,252,8,41,138,124,281,244,240
2018,22,76,"Rize",41.0201,40.5234,15.3571428571429,21.5714285714286,10.7521428571429,76.4285714285714,25.8428571428571,17.8814285714286,249,0,0,192,327,427,249,427
2018,23,76,"Rize",41.0201,40.5234,14.5857142857143,22.7142857142857,0.0714285714285714,74.8714285714286,22.4985714285714,23.0328571428571,267,52,218,99,343,812,215,594
2018,24,76,"Rize",41.0201,40.5234,14.8857142857143,24.6714285714286,0.329,71.5,21.6771428571429,23.0714285714286,267,0,0,183,241,448,267,448
2018,25,76,"Rize",41.0201,40.5234,16.6428571428571,24.9142857142857,2.11371428571429,73.7,13.55,18.712,358,0,0,353,496,518,358,518
2018,26,76,"Rize",41.0201,40.5234,13.7714285714286,26.0571428571429,6.51028571428571,81.6857142857143,14.2157142857143,13.0833333333333,355,124,241,196,282,587,231,346
2018,27,76,"Rize",41.0201,40.5234,19.5571428571429,24.4714285714286,1.83014285714286,74.2,26.1171428571429,NA,342,0,0,276,276,418,342,418
2018,28,76,"Rize",41.0201,40.5234,15.6571428571429,25.6142857142857,7.05328571428571,79.2285714285714,20.1814285714286,8.6,286,40,73,232,475,585,246,512
2018,29,76,"Rize",41.0201,40.5234,20.3285714285714,25.2714285714286,0.685714285714286,68.9714285714286,15.255,12.3328571428571,260,15,10,210,700,756,245,746
2018,30,76,"Rize",41.0201,40.5234,13,27.2714285714286,3.98471428571429,75.6142857142857,NA,13.1528571428571,265,34,139,177,381,822,231,683
2018,31,76,"Rize",41.0201,40.5234,19,26.4142857142857,15.6331428571429,76.3285714285714,25.125,12.4585714285714,267,0,0,253,490,499,267,499
2018,32,76,"Rize",41.0201,40.5234,17.2,25.7,2.47057142857143,69.3571428571429,22.71,11.2857142857143,297,0,0,289,392,403,297,403
2018,33,76,"Rize",41.0201,40.5234,15.3571428571429,25.5285714285714,0,67.9857142857143,23.3828571428571,11.2771428571429,216,0,0,201,310,332,216,332
2018,34,76,"Rize",41.0201,40.5234,11.7142857142857,25.7571428571429,5.19728571428571,74.7142857142857,24.97,10.3342857142857,144,3,1,90,146,227,141,226
2018,35,76,"Rize",41.0201,40.5234,13.5571428571429,26.7,1.42771428571429,73.3857142857143,28.57,11.7514285714286,201,0,0,134,229,314,201,314
2018,36,76,"Rize",41.0201,40.5234,26.4857142857143,25.3857142857143,9.98171428571428,70.2285714285714,29.6214285714286,12.7742857142857,341,6,7,261,263,370,335,363
2018,37,76,"Rize",41.0201,40.5234,17.5142857142857,22.9285714285714,13.2392857142857,78.6857142857143,27.7457142857143,13.91,241,7,21,162,189,419,234,398
2018,38,76,"Rize",41.0201,40.5234,16.4285714285714,21.6571428571429,2.18571428571429,74.6428571428571,32.44,13.3614285714286,189,0,0,180,288,344,189,344
2018,39,76,"Rize",41.0201,40.5234,22.2285714285714,20.2428571428571,13.0798571428571,77.4428571428571,NA,11.9428571428571,180,0,0,111,222,353,180,353
2018,40,76,"Rize",41.0201,40.5234,21.4428571428571,20.2428571428571,10.967,73.5142857142857,23.705,11.2457142857143,191,0,0,111,179,341,191,341
2018,41,76,"Rize",41.0201,40.5234,11.7142857142857,20.9142857142857,2.87214285714286,83.0571428571429,33.4242857142857,12.6828571428571,187,0,0,170,307,422,187,422
2018,42,76,"Rize",41.0201,40.5234,13,20.8428571428571,0.142714285714286,81.8,51.6285714285714,13.1285714285714,168,0,0,91,105,381,168,381
2018,43,76,"Rize",41.0201,40.5234,22.2714285714286,16.5428571428571,20.1474285714286,79.5142857142857,29.3457142857143,14.1342857142857,187,0,0,87,97,402,187,402
2018,44,76,"Rize",41.0201,40.5234,13.0428571428571,16.6428571428571,0,76.7714285714286,46.52,21.0014285714286,196,0,0,108,102,264,196,264
2018,45,76,"Rize",41.0201,40.5234,14.5857142857143,15.8571428571429,1.25671428571429,75.2142857142857,41.1971428571429,17.0614285714286,231,0,0,158,183,473,231,473
2018,46,76,"Rize",41.0201,40.5234,23.0857142857143,11.7571428571429,21.362,75.7571428571429,30.9185714285714,18.4128571428571,230,0,0,202,378,465,230,465
2018,47,76,"Rize",41.0201,40.5234,18.6,13.0428571428571,9.038,80.4285714285714,33.11,21.8614285714286,270,0,0,142,146,499,270,499
2018,48,76,"Rize",41.0201,40.5234,26.0428571428571,14.9,13.4081428571429,74.5857142857143,33.4842857142857,21.7714285714286,245,0,0,111,80,201,245,201
2018,49,76,"Rize",41.0201,40.5234,17.5142857142857,11.0714285714286,18.0885714285714,80.8571428571429,25.6742857142857,21.8828571428571,257,0,0,159,242,420,257,420
2018,50,76,"Rize",41.0201,40.5234,16.1857142857143,11.2857142857143,8.56985714285714,70.1285714285714,31.0728571428571,26.5314285714286,256,0,0,84,79,305,256,305
2018,51,76,"Rize",41.0201,40.5234,16.2285714285714,11.6714285714286,3.312,78.5571428571428,53.1714285714286,31.9814285714286,250,0,0,108,92,248,250,248
2018,52,76,"Rize",41.0201,40.5234,25.1428571428571,7.2,11.6522857142857,76.1142857142857,24.7,20.2671428571429,244,0,0,153,87,273,244,273
2019,1,76,"Rize",41.0201,40.5234,17.1375,9.9875,4.999,77.6375,47.1433333333333,31.0275,343,0,0,208,276,784,343,784
2019,2,76,"Rize",41.0201,40.5234,28.4428571428571,7.77142857142857,6.88157142857143,74.1571428571429,31.9557142857143,25.8971428571429,255,0,0,160,142,208,255,208
2019,3,76,"Rize",41.0201,40.5234,20.5571428571429,7.75714285714286,7.39614285714286,67.8428571428571,31.6457142857143,26.2671428571429,192,0,0,77,46,198,192,198
2019,4,76,"Rize",41.0201,40.5234,21.2,11.9142857142857,0.713857142857143,57.1571428571429,60.22,33.9785714285714,308,0,0,116,61,314,308,314
2019,5,76,"Rize",41.0201,40.5234,18.7428571428571,10.4142857142857,1.67057142857143,70.9428571428571,60.7085714285714,28.5928571428571,253,23,48,123,58,143,230,95
2019,6,76,"Rize",41.0201,40.5234,9.92857142857143,9.25714285714286,1.44257142857143,82.6285714285714,40.3628571428571,29.46,276,25,15,86,45,127,251,112
2019,7,76,"Rize",41.0201,40.5234,17.9857142857143,8.31428571428571,6.31014285714286,78.6857142857143,31.0442857142857,20.0871428571429,325,2,17,168,153,234,323,217
2019,8,76,"Rize",41.0201,40.5234,18.8,8.35714285714286,0.485428571428571,76.7428571428571,45.4028571428571,24.1785714285714,305,37,16,182,175,219,268,203
2019,9,76,"Rize",41.0201,40.5234,17.7285714285714,7.12857142857143,9.23757142857143,79.3285714285714,21.6157142857143,NA,331,0,0,149,145,310,331,310
2019,10,76,"Rize",41.0201,40.5234,20.9857142857143,10.1285714285714,3.01242857142857,65.0571428571429,39.4528571428571,NA,359,26,43,97,77,252,333,209
2019,11,76,"Rize",41.0201,40.5234,20.4,11.4142857142857,4.61214285714286,78.3714285714286,33.39,NA,373,37,26,213,290,400,336,374
2019,12,76,"Rize",41.0201,40.5234,13.9714285714286,8.1,2.85571428571429,76.4,29.25,NA,343,0,0,227,99,416,343,416
2019,13,76,"Rize",41.0201,40.5234,11.3285714285714,7.38571428571429,1.62771428571429,75.1,NA,NA,256,0,0,157,73,194,256,194
2019,14,76,"Rize",41.0201,40.5234,11.5857142857143,9.44285714285714,2.85614285714286,87.1571428571429,NA,NA,365,229,111,29,13,208,136,97
2019,15,76,"Rize",41.0201,40.5234,17.6142857142857,15.3714285714286,0.485714285714286,68.7,NA,NA,359,90,57,209,92,183,269,126
2019,16,76,"Rize",41.0201,40.5234,17.6428571428571,10.2857142857143,16.3505714285714,88,15.5766666666667,NA,318,27,24,249,150,208,291,184
2019,17,76,"Rize",41.0201,40.5234,9.72857142857143,11.8428571428571,0.471285714285714,79,27.8685714285714,NA,412,257,179,62,58,313,155,134
2019,18,76,"Rize",41.0201,40.5234,16.8714285714286,17.2714285714286,2.05785714285714,71.8142857142857,39.0814285714286,NA,523,155,71,176,88,353,368,282
2019,19,76,"Rize",41.0201,40.5234,17.2285714285714,17.4142857142857,2.12742857142857,76.4,33.9585714285714,NA,452,69,75,197,188,386,383,311
2019,20,76,"Rize",41.0201,40.5234,13.6714285714286,18.6714285714286,0.471142857142857,79.9571428571429,25.8328571428571,NA,454,291,257,58,63,389,163,132
2019,21,76,"Rize",41.0201,40.5234,16.9857142857143,20.1285714285714,1.05671428571429,81.5142857142857,32.8642857142857,NA,457,57,67,281,162,413,400,346
2019,22,76,"Rize",41.0201,40.5234,9.62857142857143,21.0857142857143,0,74.8714285714286,30.5014285714286,NA,453,337,261,60,17,323,116,62
2019,23,76,"Rize",41.0201,40.5234,12.7428571428571,23.8285714285714,6.01042857142857,85.8142857142857,26.9557142857143,NA,378,48,40,232,288,532,330,492
2019,24,76,"Rize",41.0201,40.5234,11.3428571428571,24.9285714285714,0.771142857142857,81.2,29.4728571428571,14.0983333333333,378,0,0,316,211,244,378,244
2019,25,76,"Rize",41.0201,40.5234,17.1857142857143,25.6571428571429,8.91771428571429,76.5,22.5728571428571,24.435,306,0,0,302,323,325,306,325
2019,26,76,"Rize",41.0201,40.5234,11.9714285714286,24.7142857142857,7.868,76.7428571428571,27.1042857142857,21.4771428571429,377,0,0,310,266,342,377,342
2019,27,76,"Rize",41.0201,40.5234,16.9428571428571,23.6142857142857,6.09771428571429,70.7428571428571,23.3057142857143,18.8371428571429,456,0,0,401,145,222,456,222
2019,28,76,"Rize",41.0201,40.5234,21.6,24.2,6.38271428571429,73.3142857142857,21.3514285714286,18.8428571428571,398,0,0,337,394,421,398,421
2019,29,76,"Rize",41.0201,40.5234,12.2285714285714,23.8571428571429,1.58614285714286,77.5857142857143,26.2442857142857,18.25,453,55,19,309,129,203,398,184
2019,30,76,"Rize",41.0201,40.5234,9.24285714285714,24.0571428571429,3.86914285714286,78.6857142857143,27.2185714285714,17.4914285714286,456,0,0,391,278,335,456,335
2019,31,76,"Rize",41.0201,40.5234,12.5,25.5857142857143,3.13028571428571,77.4857142857143,24.5457142857143,16.3185714285714,334,54,55,231,242,375,280,320
2019,32,76,"Rize",41.0201,40.5234,16.0142857142857,23.3,17.4184285714286,72.5428571428571,27.5275,17.5957142857143,346,0,0,280,336,395,346,395
2019,33,76,"Rize",41.0201,40.5234,13.9285714285714,25.1,4.04014285714286,76.7857142857143,24.6528571428571,14.4042857142857,337,0,0,248,404,531,337,531
2019,34,76,"Rize",41.0201,40.5234,14.2,24.8428571428571,4.88271428571429,80.4714285714286,20.9214285714286,17.0914285714286,299,0,0,288,339,345,299,345
2019,35,76,"Rize",41.0201,40.5234,12.6571428571429,24.9714285714286,20.7315714285714,81.5,22.0385714285714,16.4814285714286,307,0,0,304,413,415,307,415
2019,36,76,"Rize",41.0201,40.5234,16.1714285714286,23.6428571428571,23.7561428571429,74.6428571428571,22,17.9728571428571,171,0,0,165,41,67,171,67
2019,37,76,"Rize",41.0201,40.5234,13.5285714285714,23.0142857142857,7.38128571428572,74.9285714285714,19.1871428571429,16.7028571428571,218,0,0,211,51,55,218,55
2019,38,76,"Rize",41.0201,40.5234,21.2142857142857,20.7142857142857,13.1642857142857,76.2142857142857,22.86,23.4066666666667,266,0,0,174,82,91,266,91
2019,39,76,"Rize",41.0201,40.5234,14.3285714285714,20.6,14.3635714285714,74.7,NA,NA,237,0,0,87,16,79,237,79
2019,40,76,"Rize",41.0201,40.5234,17.0857142857143,21.5285714285714,2.15714285714286,73.7285714285714,NA,23.425,241,0,0,75,32,111,241,111
2019,41,76,"Rize",41.0201,40.5234,19.3571428571429,19.0142857142857,11.393,79.8142857142857,NA,18.9585714285714,416,0,0,258,298,448,416,448
2019,42,76,"Rize",41.0201,40.5234,10.0428571428571,19.2857142857143,1,83.8,NA,25.6585714285714,356,38,25,75,72,408,318,383
2019,43,76,"Rize",41.0201,40.5234,14.0285714285714,18.5142857142857,18.8378571428571,84.7428571428571,NA,24.5,306,0,0,295,277,300,306,300
2019,44,76,"Rize",41.0201,40.5234,17.7,15.4428571428571,25.6204285714286,79.4285714285714,NA,NA,350,0,0,274,201,250,350,250
2019,45,76,"Rize",41.0201,40.5234,9.61428571428571,16.3285714285714,0,63.7571428571429,NA,53.128,417,0,0,0,0,328,417,328
2019,46,76,"Rize",41.0201,40.5234,11.4714285714286,16.2714285714286,0,68.3285714285714,NA,49.1485714285714,401,0,0,65,47,337,401,337
2019,47,76,"Rize",41.0201,40.5234,15.1,13.7,0,73.8428571428571,NA,38.7614285714286,391,0,0,307,230,339,391,339
2019,48,76,"Rize",41.0201,40.5234,17.8857142857143,14.7571428571429,8.89642857142857,70.6142857142857,NA,40.9671428571429,320,0,0,191,187,251,320,251
2019,49,76,"Rize",41.0201,40.5234,16.7857142857143,8.55714285714286,18.192,77.1,NA,32.3357142857143,393,0,0,312,197,274,393,274
2019,50,76,"Rize",41.0201,40.5234,14.6857142857143,12.3285714285714,0,64.9571428571429,NA,47.3271428571429,218,0,0,78,25,119,218,119
2019,51,76,"Rize",41.0201,40.5234,12.2,10.8857142857143,2.08457142857143,70.2,NA,45.9314285714286,361,4,11,111,72,488,357,477
2019,52,76,"Rize",41.0201,40.5234,19.4714285714286,14.1571428571429,0.585285714285714,56.8857142857143,NA,38.0457142857143,279,0,0,146,108,281,279,281
2020,1,76,"Rize",41.0201,40.5234,17.38,8.32,23.0314,82.28,NA,30.434,160,0,0,90,75,126,160,126
2020,2,76,"Rize",41.0201,40.5234,20.7428571428571,9.02857142857143,8.20957142857143,75.0714285714286,NA,38.71,240,0,0,131,105,173,240,173
2020,3,76,"Rize",41.0201,40.5234,15.4142857142857,7.41428571428571,6.85385714285714,75.9142857142857,NA,36.47,270,0,0,222,331,382,270,382
2020,4,76,"Rize",41.0201,40.5234,19.8571428571429,6.2,13.6782857142857,72.0714285714286,NA,34.3442857142857,358,0,0,338,287,295,358,295
2020,5,76,"Rize",41.0201,40.5234,20.1142857142857,9.65714285714286,7.35285714285714,67.4857142857143,NA,45.1528571428571,331,0,0,114,72,272,331,272
2020,6,76,"Rize",41.0201,40.5234,33.3285714285714,9.01428571428571,22.7057142857143,71.3,NA,40.4414285714286,343,1,1,268,189,267,342,266
2020,7,76,"Rize",41.0201,40.5234,21.9857142857143,5.1,38.2184285714286,65.9,NA,45.0628571428571,341,0,0,202,234,338,341,338
2020,8,76,"Rize",41.0201,40.5234,13.8142857142857,7.9,2.65571428571429,81.8714285714286,NA,40.2271428571429,283,3,2,124,43,187,280,185
2020,9,76,"Rize",41.0201,40.5234,25.3571428571429,10.0142857142857,9.894,70.6,NA,38.71,393,40,34,230,333,528,353,494
2020,10,76,"Rize",41.0201,40.5234,14.8857142857143,12.5571428571429,0,62.9571428571429,NA,48.8528571428571,205,34,27,18,19,210,171,183
2020,11,76,"Rize",41.0201,40.5234,21.4,13.6428571428571,2.52771428571429,76.2571428571429,NA,40.6871428571429,115,25,7,42,57,94,90,87
2020,12,76,"Rize",41.0201,40.5234,12.4714285714286,6.91428571428571,10.8671428571429,80.6571428571429,NA,27.0714285714286,117,6,4,83,86,118,111,114
2020,13,76,"Rize",41.0201,40.5234,12.0142857142857,10.1,1.78542857142857,88.8142857142857,29.93,21.5714285714286,136,33,32,66,31,92,103,60
2020,14,76,"Rize",41.0201,40.5234,16.6428571428571,11.0571428571429,10.8234285714286,83,36.7357142857143,18.9542857142857,155,4,4,125,91,121,151,117
2020,15,76,"Rize",41.0201,40.5234,11.9142857142857,10.5,0.471285714285714,78.3285714285714,32.0228571428571,16.0085714285714,133,16,9,72,99,118,117,109
2020,16,76,"Rize",41.0201,40.5234,16.4857142857143,12.1428571428571,2.57014285714286,73.6571428571429,35.4471428571429,19.9442857142857,141,53,24,58,57,106,88,82
2020,17,76,"Rize",41.0201,40.5234,18.5857142857143,11.0142857142857,8.52528571428572,77.1,28.2,22.22,137,44,28,75,79,123,93,95
2020,18,76,"Rize",41.0201,40.5234,16.9,14.5857142857143,0.728571428571429,81.7,34.1385714285714,NA,146,62,107,51,35,164,84,57
2020,19,76,"Rize",41.0201,40.5234,18.2285714285714,14.3714285714286,15.5071428571429,80.2285714285714,17.2657142857143,NA,137,0,0,66,56,157,137,157
2020,20,76,"Rize",41.0201,40.5234,18.5428571428571,18.6714285714286,0.0142857142857143,68.3285714285714,41.5128571428571,NA,164,105,96,44,55,164,59,68
2020,21,76,"Rize",41.0201,40.5234,21.9428571428571,17.4857142857143,8.76742857142857,74.8285714285714,42.4171428571429,NA,146,47,30,71,39,96,99,66
2020,22,76,"Rize",41.0201,40.5234,17.7142857142857,16.0714285714286,1.97128571428571,79.6428571428571,26.4914285714286,NA,118,53,31,26,41,100,65,69
2020,23,76,"Rize",41.0201,40.5234,15.3142857142857,19.7,0.943142857142857,77.4,31.3257142857143,NA,112,39,18,18,3,70,73,52
2020,24,76,"Rize",41.0201,40.5234,17.4571428571429,22.7285714285714,2.34142857142857,75.0571428571429,41.5385714285714,15.9233333333333,140,1,0,48,69,150,139,150
2020,25,76,"Rize",41.0201,40.5234,16.1285714285714,23.4857142857143,9.10914285714286,75.1285714285714,35.3642857142857,15.3614285714286,137,30,18,68,52,108,107,90
2020,26,76,"Rize",41.0201,40.5234,15.3142857142857,24.0857142857143,1.88485714285714,74.7428571428571,27.8266666666667,14.4675,173,14,19,114,73,133,159,114
2020,27,76,"Rize",41.0201,40.5234,14.5857142857143,25.7142857142857,0.199857142857143,72.7714285714286,32.305,13.985,113,0,0,82,64,113,113,113
2020,28,76,"Rize",41.0201,40.5234,21.9714285714286,25.5714285714286,9.12357142857143,74.1571428571429,26.3457142857143,14,164,0,0,162,120,122,164,122
2020,29,76,"Rize",41.0201,40.5234,15.3571428571429,25.1714285714286,7.467,75.9428571428572,30.8957142857143,13.2142857142857,186,3,1,107,44,111,183,110
2020,30,76,"Rize",41.0201,40.5234,15.8714285714286,25.3857142857143,2.92657142857143,73.0285714285714,33.9266666666667,14.91,190,0,0,131,105,142,190,142
2020,31,76,"Rize",41.0201,40.5234,15.8714285714286,25.2,4.92585714285714,76.4571428571429,31.19,14.3642857142857,150,0,0,120,103,127,150,127
2020,32,76,"Rize",41.0201,40.5234,11.4428571428571,25.7714285714286,2.62685714285714,68.2285714285714,20.8166666666667,12.58,146,30,14,94,63,107,116,93
2020,33,76,"Rize",41.0201,40.5234,18.7857142857143,24.5142857142857,12.1068571428571,69.9,26.44,14.6842857142857,183,0,0,173,79,83,183,83
2020,34,76,"Rize",41.0201,40.5234,19.3571428571429,23.8285714285714,18.8047142857143,71.3,23.7714285714286,14.1742857142857,197,0,0,186,92,97,197,97
2020,35,76,"Rize",41.0201,40.5234,15.8714285714286,24.8142857142857,0,69.8571428571429,27.46,13.6314285714286,164,0,0,113,108,157,164,157
2020,36,76,"Rize",41.0201,40.5234,14.8857142857143,25.0142857142857,2.87,80.3714285714286,39.1928571428571,17.3142857142857,179,2,0,150,93,112,177,112
2020,37,76,"Rize",41.0201,40.5234,14.8428571428571,24.9,2.08471428571429,74.9428571428572,34.2471428571429,15.6628571428571,193,0,0,135,61,91,193,91
2020,38,76,"Rize",41.0201,40.5234,16.1714285714286,24.0285714285714,11.3522857142857,77.8428571428571,44.7157142857143,15.0542857142857,235,0,0,219,150,157,235,157
2020,39,76,"Rize",41.0201,40.5234,14.8857142857143,23.8571428571429,0.0714285714285714,73.0571428571429,31.9957142857143,15.47,220,11,9,143,90,129,209,120
2020,40,76,"Rize",41.0201,40.5234,15.8714285714286,23.0285714285714,6.54157142857143,77.6142857142857,40.9528571428571,15.0371428571429,187,6,6,121,92,154,181,148
2020,41,76,"Rize",41.0201,40.5234,15.1,21.9142857142857,1.81314285714286,69.5857142857143,25.9416666666667,27.0325,182,0,0,72,52,127,182,127
2020,42,76,"Rize",41.0201,40.5234,12.7857142857143,21.6428571428571,0.142714285714286,75.7,40.0185714285714,24.3028571428571,177,0,0,73,63,111,177,111
2020,43,76,"Rize",41.0201,40.5234,15.6142857142857,18.5571428571429,12.3222857142857,78.2571428571429,21.8785714285714,22.2657142857143,194,0,0,93,88,161,194,161
2020,44,76,"Rize",41.0201,40.5234,18.2714285714286,19.6285714285714,0.0287142857142857,76.9,46.5714285714286,32.0942857142857,255,0,0,153,128,233,255,233
2020,45,76,"Rize",41.0201,40.5234,16.3857142857143,15.7285714285714,22.0951428571429,85.2285714285714,14.3371428571429,18.8228571428571,156,0,0,119,74,103,156,103
2020,46,76,"Rize",41.0201,40.5234,19.3428571428571,14.0714285714286,6.44,72.8142857142857,17.1757142857143,21.3928571428571,208,0,0,153,72,109,208,109
2020,47,76,"Rize",41.0201,40.5234,19.6,11.9428571428571,20.4795714285714,79.3428571428571,13.2828571428571,20.0728571428571,173,0,0,156,76,83,173,83
2020,48,76,"Rize",41.0201,40.5234,17.2,10.4428571428571,6.72514285714286,68.9,20.5957142857143,27.8228571428571,199,0,0,88,70,262,199,262
2020,49,76,"Rize",41.0201,40.5234,14.8857142857143,12.1571428571429,0.586285714285714,75.9428571428572,37.04,33.3785714285714,207,0,0,100,47,116,207,116
2020,50,76,"Rize",41.0201,40.5234,23.5142857142857,13.4428571428571,1.014,60.6142857142857,40.7985714285714,39.8385714285714,181,0,0,101,28,98,181,98
2020,51,76,"Rize",41.0201,40.5234,24.1285714285714,12.7142857142857,7.62385714285714,71.2285714285714,30.0614285714286,29.3657142857143,171,1,0,82,39,90,170,90
2020,52,76,"Rize",41.0201,40.5234,18.7285714285714,8.74285714285714,18.5898571428571,70.3714285714286,16.0514285714286,29.25,203,0,0,97,63,113,203,113
2020,53,76,"Rize",41.0201,40.5234,7.6,10.825,0,59.525,49.63,54.31,122,0,0,0,0,111,122,111
2017,1,77,"Sakarya",40.7789,30.4033,17.7,4.14285714285714,2.77442857142857,71.8857142857143,34.5728571428571,NA,563,0,0,200,326,847,563,847
2017,2,77,"Sakarya",40.7789,30.4033,16.6571428571429,5.14285714285714,1.43057142857143,69.5428571428571,51.54,NA,757,73,61,269,568,1214,684,1153
2017,3,77,"Sakarya",40.7789,30.4033,8.78571428571429,5.08571428571429,3.712,92.0714285714286,44.42,NA,762,0,0,348,589,1449,762,1449
2017,4,77,"Sakarya",40.7789,30.4033,11.6,2.45714285714286,0.844285714285714,84.6714285714286,55.32,NA,639,114,73,193,285,889,525,816
2017,5,77,"Sakarya",40.7789,30.4033,13.6571428571429,5.91428571428571,0.342714285714286,60.4857142857143,61.1014285714286,NA,588,82,184,0,0,1163,506,979
2017,6,77,"Sakarya",40.7789,30.4033,12.4428571428571,8.57142857142857,0.285857142857143,74.5142857142857,41.3557142857143,NA,736,0,0,116,253,1519,736,1519
2017,7,77,"Sakarya",40.7789,30.4033,10.6714285714286,4.02857142857143,0.799285714285714,72.8428571428571,45.8042857142857,NA,492,93,129,111,169,717,399,588
2017,8,77,"Sakarya",40.7789,30.4033,15.0571428571429,11.4857142857143,0.999714285714286,66.9285714285714,49.9657142857143,NA,739,3,1,60,193,1747,736,1746
2017,9,77,"Sakarya",40.7789,30.4033,12.2142857142857,10.2428571428571,0.0145714285714286,78.1,47.7585714285714,NA,574,0,0,252,295,866,574,866
2017,10,77,"Sakarya",40.7789,30.4033,11.6857142857143,11.9428571428571,0.143142857142857,71.6,36.7442857142857,NA,712,0,0,218,352,1043,712,1043
2017,11,77,"Sakarya",40.7789,30.4033,12.4428571428571,7.42857142857143,4.04257142857143,81.9571428571429,28.7585714285714,NA,525,0,0,319,465,725,525,725
2017,12,77,"Sakarya",40.7789,30.4033,13.4714285714286,10.6714285714286,0.143285714285714,76.0571428571429,30.2685714285714,NA,589,0,0,132,278,1077,589,1077
2017,13,77,"Sakarya",40.7789,30.4033,13.5142857142857,9.14285714285714,0.885571428571428,77.7285714285714,25.8814285714286,NA,574,0,0,106,234,887,574,887
2017,14,77,"Sakarya",40.7789,30.4033,10.9142857142857,10.7428571428571,2.45428571428571,81.3571428571429,27.1128571428571,NA,639,0,0,121,301,1336,639,1336
2017,15,77,"Sakarya",40.7789,30.4033,12.2142857142857,12.6285714285714,0.0287142857142857,68.0857142857143,63.7714285714286,NA,587,0,0,13,46,1187,587,1187
2017,16,77,"Sakarya",40.7789,30.4033,15.0571428571429,11.5142857142857,6.34214285714286,76.5142857142857,56.1728571428571,NA,717,0,0,244,436,920,717,920
2017,17,77,"Sakarya",40.7789,30.4033,12.7428571428571,15.3,1.19914285714286,60.8428571428571,88.2471428571429,NA,731,0,0,173,316,1478,731,1478
2017,18,77,"Sakarya",40.7789,30.4033,11.6857142857143,16.1571428571429,1.94228571428571,80.0142857142857,73.6757142857143,NA,506,0,0,77,234,923,506,923
2017,19,77,"Sakarya",40.7789,30.4033,11.1428571428571,19.0428571428571,3.36985714285714,74.4571428571429,74.4442857142857,NA,471,0,0,107,168,966,471,966
2017,20,77,"Sakarya",40.7789,30.4033,13.2428571428571,16,1.11357142857143,79.0428571428571,43.1071428571429,NA,472,0,0,73,306,1205,472,1205
2017,21,77,"Sakarya",40.7789,30.4033,12.7285714285714,16.9285714285714,1.79785714285714,77.2428571428571,38.7385714285714,NA,448,0,0,111,317,849,448,849
2017,22,77,"Sakarya",40.7789,30.4033,12.2142857142857,20.8571428571429,1.48714285714286,77.9142857142857,47.7442857142857,NA,522,0,0,102,144,1015,522,1015
2017,23,77,"Sakarya",40.7789,30.4033,9.64285714285714,21.0428571428571,3.70228571428571,83.3428571428571,45.2871428571429,NA,578,0,0,97,241,1388,578,1388
2017,24,77,"Sakarya",40.7789,30.4033,11.7142857142857,21.0285714285714,1.28628571428571,75.4857142857143,52.3185714285714,NA,552,0,0,167,315,1139,552,1139
2017,25,77,"Sakarya",40.7789,30.4033,11.7571428571429,21.3571428571429,10.9114285714286,79.6285714285714,46.0628571428571,NA,584,0,0,347,558,1041,584,1041
2017,26,77,"Sakarya",40.7789,30.4033,11.0285714285714,25.7142857142857,0,72.0714285714286,47.0471428571429,NA,564,44,36,63,84,971,520,935
2017,27,77,"Sakarya",40.7789,30.4033,13.3,22.7285714285714,1.175,76.1571428571429,34.8157142857143,NA,511,0,0,83,116,642,511,642
2017,28,77,"Sakarya",40.7789,30.4033,12.9857142857143,23.6142857142857,0,76.0714285714286,37.19,NA,481,0,0,0,0,864,481,864
2017,29,77,"Sakarya",40.7789,30.4033,15.0428571428571,23.7142857142857,3.77442857142857,80.5571428571428,36.7871428571429,NA,532,0,0,133,306,1272,532,1272
2017,30,77,"Sakarya",40.7789,30.4033,11.7142857142857,25.7571428571429,1.91342857142857,70.9142857142857,51.4742857142857,NA,531,56,71,46,67,928,475,857
2017,31,77,"Sakarya",40.7789,30.4033,12.4571428571429,25.7285714285714,0.570571428571429,77.7428571428571,44.0014285714286,NA,559,0,0,107,294,1047,559,1047
2017,32,77,"Sakarya",40.7789,30.4033,14.0142857142857,26.9285714285714,0,79.3428571428571,64.0057142857143,NA,567,0,0,42,154,1092,567,1092
2017,33,77,"Sakarya",40.7789,30.4033,11.9714285714286,24.7142857142857,2.88314285714286,80.3714285714286,79.1142857142857,NA,596,0,0,221,513,1199,596,1199
2017,34,77,"Sakarya",40.7789,30.4033,14.2857142857143,21.9857142857143,5.81242857142857,79.2285714285714,68.9942857142857,NA,601,0,0,22,55,1280,601,1280
2017,35,77,"Sakarya",40.7789,30.4033,12.7285714285714,20.3428571428571,0.0434285714285714,74.3857142857143,61.2971428571429,NA,493,11,13,0,0,1014,482,1001
2017,36,77,"Sakarya",40.7789,30.4033,10.3857142857143,20.7142857142857,1.85514285714286,75.1142857142857,73.6214285714286,NA,507,0,0,127,457,1321,507,1321
2017,37,77,"Sakarya",40.7789,30.4033,10.9428571428571,24.5,0,74.0857142857143,99.5814285714286,NA,589,0,0,141,287,1138,589,1138
2017,38,77,"Sakarya",40.7789,30.4033,11.9571428571429,22.2857142857143,1.00085714285714,74.2571428571429,93.3,NA,671,70,148,178,455,1312,601,1164
2017,39,77,"Sakarya",40.7789,30.4033,10.0714285714286,18.1428571428571,2.80114285714286,85.7571428571429,79.3528571428571,NA,782,0,0,196,328,1630,782,1630
2017,40,77,"Sakarya",40.7789,30.4033,9.81428571428571,16.2857142857143,2.71185714285714,75.6857142857143,87.0314285714286,NA,543,55,107,171,279,1137,488,1030
2017,41,77,"Sakarya",40.7789,30.4033,8.74285714285714,13.7285714285714,0.858,78.2857142857143,87.28,NA,487,46,100,60,95,843,441,743
2017,42,77,"Sakarya",40.7789,30.4033,7.71428571428571,16.3428571428571,0.0571428571428571,78.5857142857143,117.6,NA,530,0,0,169,186,815,530,815
2017,43,77,"Sakarya",40.7789,30.4033,8.54285714285714,15.0714285714286,7.51457142857143,88.5714285714286,74.5114285714286,NA,506,32,35,254,594,919,474,884
2017,44,77,"Sakarya",40.7789,30.4033,8.42857142857143,9.74285714285714,0.716,77.9285714285714,101.971428571429,NA,561,118,225,194,328,1102,443,877
2017,45,77,"Sakarya",40.7789,30.4033,8.97142857142857,12.6571428571429,0.600428571428571,82.2571428571429,115.108571428571,NA,577,0,0,122,150,829,577,829
2017,46,77,"Sakarya",40.7789,30.4033,9.05714285714286,14.2142857142857,0.000142857142857143,81.4142857142857,139.132857142857,NA,587,110,135,53,100,1085,477,950
2017,47,77,"Sakarya",40.7789,30.4033,10.0714285714286,9.41428571428571,2.65814285714286,83.7571428571429,109.292857142857,NA,418,125,238,133,167,804,293,566
2017,48,77,"Sakarya",40.7789,30.4033,14.5,15.4571428571429,2.14528571428571,59.7571428571429,69.2328571428571,NA,386,10,40,67,116,619,376,579
2017,49,77,"Sakarya",40.7789,30.4033,15.5714285714286,9.68571428571429,6.40328571428571,71.1,67.71,NA,407,0,0,66,111,645,407,645
2017,50,77,"Sakarya",40.7789,30.4033,15.8285714285714,14.1857142857143,0,62.7714285714286,97.1614285714286,NA,346,0,0,0,0,442,346,442
2017,51,77,"Sakarya",40.7789,30.4033,9.57142857142857,6.14285714285714,9.174,92.6285714285714,48.7685714285714,NA,386,39,37,286,232,349,347,312
2017,52,77,"Sakarya",40.7789,30.4033,16.375,10.0625,1.499375,65.7875,55.21125,NA,528,0,0,39,39,507,528,507
2018,1,77,"Sakarya",40.7789,30.4033,11.075,8.8625,0.599625,79.475,92.34625,50.05,618,21,38,123,151,914,597,876
2018,2,77,"Sakarya",40.7789,30.4033,13.6857142857143,9.25714285714286,1.85728571428571,80.0714285714286,72.5428571428571,NA,624,1,1,55,62,1309,623,1308
2018,3,77,"Sakarya",40.7789,30.4033,15.8571428571429,7.98571428571429,3.28471428571429,69.4142857142857,44.2557142857143,NA,639,0,0,164,159,655,639,655
2018,4,77,"Sakarya",40.7789,30.4033,10.6428571428571,3.91428571428571,2.65842857142857,84.8857142857143,56.0814285714286,NA,604,0,0,205,298,764,604,764
2018,5,77,"Sakarya",40.7789,30.4033,14.4428571428571,10.8428571428571,0.143285714285714,65.7285714285714,100.185714285714,NA,670,0,0,108,69,819,670,819
2018,6,77,"Sakarya",40.7789,30.4033,10.5857142857143,9.88571428571429,2.4,85.1142857142857,62.1157142857143,NA,704,0,0,181,136,1022,704,1022
2018,7,77,"Sakarya",40.7789,30.4033,10.6142857142857,7.88571428571429,0.114857142857143,83.5857142857143,41.74,NA,478,1,1,214,269,557,477,556
2018,8,77,"Sakarya",40.7789,30.4033,11.1428571428571,7.45714285714286,3.51328571428571,90.9857142857143,46.895,NA,711,0,0,58,58,1321,711,1321
2018,9,77,"Sakarya",40.7789,30.4033,13.7857142857143,7.67142857142857,4.26028571428571,82.5571428571429,40.63,NA,621,0,0,225,342,956,621,956
2018,10,77,"Sakarya",40.7789,30.4033,11.9,12.1,3.91242857142857,81.5285714285714,70.4314285714286,NA,556,40,92,161,212,1330,516,1238
2018,11,77,"Sakarya",40.7789,30.4033,16.0857142857143,15.9714285714286,1.77257142857143,62.1428571428571,63.9628571428571,NA,551,0,0,0,0,1426,551,1426
2018,12,77,"Sakarya",40.7789,30.4033,11.8428571428571,10.4142857142857,1.172,85.7,45.895,NA,425,0,0,211,812,1187,425,1187
2018,13,77,"Sakarya",40.7789,30.4033,12.6857142857143,13.8,3.85657142857143,71.7571428571429,53.72,NA,356,0,0,110,190,428,356,428
2018,14,77,"Sakarya",40.7789,30.4033,12.4285714285714,13.7714285714286,0.287714285714286,69.2857142857143,56.2171428571429,NA,407,0,0,74,68,486,407,486
2018,15,77,"Sakarya",40.7789,30.4033,10.6571428571429,14.0428571428571,0.143142857142857,82.4571428571429,50.2571428571429,NA,374,0,0,21,43,450,374,450
2018,16,77,"Sakarya",40.7789,30.4033,10.6714285714286,13.7571428571429,1.028,74.8285714285714,55.48,NA,411,0,0,5,14,648,411,648
2018,17,77,"Sakarya",40.7789,30.4033,13.2142857142857,19.0857142857143,0,63.6285714285714,56.3228571428571,NA,419,0,0,6,0,652,419,652
2018,18,77,"Sakarya",40.7789,30.4033,9.9,15.8571428571429,1.85857142857143,87.4714285714286,36.2716666666667,NA,303,0,0,69,169,474,303,474
2018,19,77,"Sakarya",40.7789,30.4033,11.9142857142857,16.7142857142857,11.3441428571429,86.5,31.5371428571429,NA,275,0,0,169,242,467,275,467
2018,20,77,"Sakarya",40.7789,30.4033,11.6714285714286,22.3142857142857,0.0574285714285714,63.7142857142857,52.39,NA,204,5,6,28,43,306,199,300
2018,21,77,"Sakarya",40.7789,30.4033,12.2,20.6285714285714,5.74971428571429,84.2714285714286,48.93,NA,252,0,0,51,116,281,252,281
2018,22,77,"Sakarya",40.7789,30.4033,12.9714285714286,19.7285714285714,0.629428571428571,80.3571428571429,52.5385714285714,NA,249,0,0,30,85,427,249,427
2018,23,77,"Sakarya",40.7789,30.4033,12.7,23.3428571428571,0.773428571428571,71.7571428571429,60.8314285714286,NA,267,0,0,69,279,812,267,812
2018,24,77,"Sakarya",40.7789,30.4033,12.7142857142857,23.5142857142857,9.98314285714286,70.7714285714286,45.0642857142857,NA,267,29,21,13,27,448,238,427
2018,25,77,"Sakarya",40.7789,30.4033,11.6857142857143,22.7857142857143,5.31314285714286,82.4142857142857,52.4314285714286,NA,358,0,0,70,96,518,358,518
2018,26,77,"Sakarya",40.7789,30.4033,12.2,23.9,0.745857142857143,76.0428571428571,48.71,NA,355,0,0,98,158,587,355,587
2018,27,77,"Sakarya",40.7789,30.4033,13.7571428571429,24.7571428571429,0,67.2285714285714,49.9385714285714,NA,342,0,0,0,0,418,342,418
2018,28,77,"Sakarya",40.7789,30.4033,11.9142857142857,25.0714285714286,2.71428571428571,78.7,48.5457142857143,NA,286,0,0,57,115,585,286,585
2018,29,77,"Sakarya",40.7789,30.4033,11.1,24.3428571428571,12.6247142857143,77.2857142857143,53.31,NA,260,116,312,42,103,756,144,444
2018,30,77,"Sakarya",40.7789,30.4033,10.6714285714286,25.0285714285714,3.15142857142857,77.7,42.9771428571429,NA,265,0,0,108,472,822,265,822
2018,31,77,"Sakarya",40.7789,30.4033,14.7857142857143,26.2142857142857,0.00328571428571429,79.5714285714286,44.2128571428571,NA,267,0,0,0,0,499,267,499
2018,32,77,"Sakarya",40.7789,30.4033,15.8142857142857,25.4857142857143,0.00114285714285714,71.4428571428571,44.5771428571429,NA,297,0,0,0,0,403,297,403
2018,33,77,"Sakarya",40.7789,30.4033,14.0571428571429,25.1142857142857,0.0601428571428571,74.4,43.5285714285714,NA,216,0,0,19,24,332,216,332
2018,34,77,"Sakarya",40.7789,30.4033,14.2857142857143,24.1714285714286,0.0142857142857143,77.4142857142857,41.2728571428571,NA,144,0,0,0,0,227,144,227
2018,35,77,"Sakarya",40.7789,30.4033,13.2571428571429,25.5571428571429,0.856428571428572,78.0714285714286,45.2971428571429,NA,201,0,0,8,15,314,201,314
2018,36,77,"Sakarya",40.7789,30.4033,11.9714285714286,23.3,2.51471428571429,79.9,60.4942857142857,NA,341,40,35,73,85,370,301,335
2018,37,77,"Sakarya",40.7789,30.4033,10.5142857142857,19.7571428571429,2.745,82.5285714285714,66.1,NA,241,55,79,79,141,419,186,340
2018,38,77,"Sakarya",40.7789,30.4033,14.6,20.5571428571429,0.242857142857143,75.5285714285714,58.5,NA,189,0,0,5,4,344,189,344
2018,39,77,"Sakarya",40.7789,30.4033,13.2285714285714,18.2714285714286,1.80114285714286,76.3142857142857,66.7271428571429,NA,180,0,0,33,46,353,180,353
2018,40,77,"Sakarya",40.7789,30.4033,12,18.2857142857143,4.13857142857143,76.1571428571429,75.4328571428571,NA,191,0,0,87,150,341,191,341
2018,41,77,"Sakarya",40.7789,30.4033,11.4857142857143,17.7571428571429,0.600714285714286,82.9714285714286,75.9357142857143,NA,187,0,0,25,92,422,187,422
2018,42,77,"Sakarya",40.7789,30.4033,7.98571428571429,18.7571428571429,1.172,85.9285714285714,87.6885714285714,33.9,168,0,0,87,300,381,168,381
2018,43,77,"Sakarya",40.7789,30.4033,12.9428571428571,14.9857142857143,2.31614285714286,69.8571428571429,77.1071428571429,37.3071428571429,187,4,5,65,112,402,183,397
2018,44,77,"Sakarya",40.7789,30.4033,7.65714285714286,16,0,71.9285714285714,122.657142857143,47.098,196,78,106,6,3,264,118,158
2018,45,77,"Sakarya",40.7789,30.4033,10.8714285714286,14.7571428571429,0.000142857142857143,80.4571428571429,77.5371428571429,36.21,231,0,0,29,81,473,231,473
2018,46,77,"Sakarya",40.7789,30.4033,8.15714285714286,10.3,3.34128571428571,82.2428571428571,60.574,38.04,230,23,32,48,63,465,207,433
2018,47,77,"Sakarya",40.7789,30.4033,9.74285714285714,11.7571428571429,2.49985714285714,81.7,70.5257142857143,33.46,270,0,0,53,197,499,270,499
2018,48,77,"Sakarya",40.7789,30.4033,13.9571428571429,11,6.59614285714286,76.7142857142857,45.15,29.8671428571429,245,0,0,60,53,201,245,201
2018,49,77,"Sakarya",40.7789,30.4033,9.74285714285714,8.07142857142857,2.77214285714286,74.1714285714286,88.07,39.9157142857143,257,0,0,98,180,420,257,420
2018,50,77,"Sakarya",40.7789,30.4033,14.4714285714286,9.2,3.14371428571429,72.0857142857143,51.9614285714286,44.36,256,21,49,69,105,305,235,256
2018,51,77,"Sakarya",40.7789,30.4033,9.51428571428571,7.78571428571429,7.42428571428571,81.7142857142857,62.5214285714286,35.14,250,0,0,80,91,248,250,248
2018,52,77,"Sakarya",40.7789,30.4033,12.1428571428571,4.75714285714286,11.2757142857143,76.8285714285714,44.0471428571429,40.1714285714286,244,33,55,81,88,273,211,218
2019,1,77,"Sakarya",40.7789,30.4033,7.75,4.6125,6.327375,81.575,59.31375,42.02,343,45,119,217,351,784,298,665
2019,2,77,"Sakarya",40.7789,30.4033,12.7571428571429,5.18571428571429,3.656,70.7857142857143,34.8328571428571,33.79,255,0,0,122,125,208,255,208
2019,3,77,"Sakarya",40.7789,30.4033,13.9428571428571,6.9,5.027,66.5571428571429,49.9685714285714,43.2128571428571,192,1,0,54,45,198,191,198
2019,4,77,"Sakarya",40.7789,30.4033,12.2142857142857,11.1,0.742428571428571,63,42.1942857142857,38.6,308,49,128,90,69,314,259,186
2019,5,77,"Sakarya",40.7789,30.4033,13.9714285714286,12.2857142857143,0.286428571428571,56.5428571428571,44.1371428571429,43.46,253,45,18,0,0,143,208,125
2019,6,77,"Sakarya",40.7789,30.4033,10.0571428571429,8.28571428571429,3.91342857142857,74.3714285714286,45.09,35.0342857142857,276,43,13,85,43,127,233,114
2019,7,77,"Sakarya",40.7789,30.4033,12.1714285714286,7.21428571428571,2.97128571428571,71.4857142857143,42.3714285714286,32.7328571428571,325,0,0,11,4,234,325,234
2019,8,77,"Sakarya",40.7789,30.4033,10.6428571428571,6.54285714285714,1.22971428571429,74.1857142857143,87.7342857142857,50.1171428571429,305,0,0,167,133,219,305,219
2019,9,77,"Sakarya",40.7789,30.4033,11.9428571428571,6.6,2.54114285714286,70.2571428571429,39.9471428571429,34.99,331,0,0,72,79,310,331,310
2019,10,77,"Sakarya",40.7789,30.4033,11.6,11.9,0.372428571428571,56.1,80.2642857142857,55.6014285714286,359,0,0,108,34,252,359,252
2019,11,77,"Sakarya",40.7789,30.4033,12.7142857142857,10.9,4.35528571428571,65.1857142857143,42.9028571428571,34.59,373,0,0,117,138,400,373,400
2019,12,77,"Sakarya",40.7789,30.4033,14,10.5571428571429,0,61.8428571428571,53.6228571428571,34.1242857142857,343,14,23,4,4,416,329,393
2019,13,77,"Sakarya",40.7789,30.4033,16.4285714285714,8.28571428571429,0,61.1571428571429,43.9114285714286,28.7142857142857,256,0,0,11,15,194,256,194
2019,14,77,"Sakarya",40.7789,30.4033,11.6714285714286,10.0285714285714,0,70.9571428571429,53.0485714285714,25.8042857142857,365,0,0,84,91,208,365,208
2019,15,77,"Sakarya",40.7789,30.4033,13.4428571428571,14.3428571428571,6.08128571428571,70.9,49.19,42.9871428571429,359,1,0,82,44,183,358,183
2019,16,77,"Sakarya",40.7789,30.4033,11.3571428571429,8.97142857142857,4.36914285714286,72.2857142857143,34.3057142857143,32.3128571428571,318,0,0,125,132,208,318,208
2019,17,77,"Sakarya",40.7789,30.4033,10.9428571428571,13.6714285714286,0.0285714285714286,63.2571428571429,52.41,33.3171428571429,412,0,0,9,24,313,412,313
2019,18,77,"Sakarya",40.7789,30.4033,12.9571428571429,19.2,0.914857142857143,56.1,53.6728571428571,42.6685714285714,523,86,27,193,211,353,437,326
2019,19,77,"Sakarya",40.7789,30.4033,11.4,16.0857142857143,1.25971428571429,66.6142857142857,33.31,33.7242857142857,452,70,80,248,225,386,382,306
2019,20,77,"Sakarya",40.7789,30.4033,11.6857142857143,19.1285714285714,1.31571428571429,70.0857142857143,38.6842857142857,31.4085714285714,454,0,0,121,99,389,454,389
2019,21,77,"Sakarya",40.7789,30.4033,11.6571428571429,22.4,1.34171428571429,59.1857142857143,36.73,35.5457142857143,457,31,53,147,158,413,426,360
2019,22,77,"Sakarya",40.7789,30.4033,11.4428571428571,23.9571428571429,0.286142857142857,61.3571428571429,39.8714285714286,34.8171428571429,453,0,0,0,0,323,453,323
2019,23,77,"Sakarya",40.7789,30.4033,14,22.1285714285714,0.00185714285714286,71.3714285714286,27.2142857142857,19.89,378,0,0,6,13,532,378,532
2019,24,77,"Sakarya",40.7789,30.4033,10.8571428571429,22.9285714285714,9.292,73.9571428571429,28.7971428571429,33.4371428571429,378,66,33,124,54,244,312,211
2019,25,77,"Sakarya",40.7789,30.4033,10.6571428571429,24,3.97285714285714,71.8,29.9742857142857,35.6957142857143,306,0,0,98,121,325,306,325
2019,26,77,"Sakarya",40.7789,30.4033,14.2857142857143,24.7,0.572,63.9428571428571,24.6057142857143,23.2071428571429,377,0,0,8,15,342,377,342
2019,27,77,"Sakarya",40.7789,30.4033,13.2428571428571,24.3571428571429,0,63.4428571428571,24.0214285714286,22.8242857142857,456,0,0,16,8,222,456,222
2019,28,77,"Sakarya",40.7789,30.4033,11.1714285714286,22.5,7.06942857142857,66.1714285714286,20.5757142857143,28.4657142857143,398,0,0,142,146,421,398,421
2019,29,77,"Sakarya",40.7789,30.4033,12.9714285714286,22.2714285714286,8.42328571428571,69.9285714285714,19.1571428571429,24.2228571428571,453,0,0,106,8,203,453,203
2019,30,77,"Sakarya",40.7789,30.4033,13.4857142857143,23.6714285714286,0.0858571428571429,67.9571428571429,22.7857142857143,24.1285714285714,456,0,0,12,11,335,456,335
2019,31,77,"Sakarya",40.7789,30.4033,12.1571428571429,25.6428571428571,0.286,65.9428571428572,23.7142857142857,25.2157142857143,334,28,39,20,10,375,306,336
2019,32,77,"Sakarya",40.7789,30.4033,14.8,23.2714285714286,0.044,65.4428571428572,22.985,27.2057142857143,346,0,0,4,5,395,346,395
2019,33,77,"Sakarya",40.7789,30.4033,11.6285714285714,22.9142857142857,16.6337142857143,78.7571428571429,24.755,18.4628571428571,337,55,131,58,92,531,282,400
2019,34,77,"Sakarya",40.7789,30.4033,12.7428571428571,22.6142857142857,5.12785714285714,80.1285714285714,NA,27.75,299,0,0,132,123,345,299,345
2019,35,77,"Sakarya",40.7789,30.4033,14.8,23.0285714285714,0,76.8714285714286,NA,24.7342857142857,307,0,0,0,0,415,307,415
2019,36,77,"Sakarya",40.7789,30.4033,14.5428571428571,21.8571428571429,0,75.2142857142857,37.88,28.9185714285714,171,0,0,0,0,67,171,67
2019,37,77,"Sakarya",40.7789,30.4033,14.5285714285714,21.1571428571429,0.0581428571428571,73.9714285714286,38.9571428571429,29.0828571428571,218,0,0,0,0,55,218,55
2019,38,77,"Sakarya",40.7789,30.4033,11.6571428571429,18.3571428571429,1.206,70.3714285714286,37.1228571428571,35.6114285714286,266,0,0,98,42,91,266,91
2019,39,77,"Sakarya",40.7789,30.4033,9.58571428571429,18.1285714285714,0.371714285714286,74.7285714285714,44.9828571428571,37.9942857142857,237,0,0,71,30,79,237,79
2019,40,77,"Sakarya",40.7789,30.4033,11.5571428571429,19.6285714285714,2.40385714285714,70.4285714285714,62.1314285714286,42.4314285714286,241,0,0,68,33,111,241,111
2019,41,77,"Sakarya",40.7789,30.4033,10.1428571428571,16.1,1.65642857142857,77.8571428571429,43.6228571428571,36.8114285714286,416,0,0,133,221,448,416,448
2019,42,77,"Sakarya",40.7789,30.4033,7.41428571428571,17.9,0,78.2857142857143,85.5571428571429,40.13,356,0,0,31,83,408,356,408
2019,43,77,"Sakarya",40.7789,30.4033,11.9142857142857,16.9142857142857,0.0144285714285714,77,60.9242857142857,37.26,306,0,0,0,0,300,306,300
2019,44,77,"Sakarya",40.7789,30.4033,10.0571428571429,13.6428571428571,1.089,77.4,51.96,37.7728571428571,350,1,1,68,40,250,349,249
2019,45,77,"Sakarya",40.7789,30.4033,12.4428571428571,17.1285714285714,0.0144285714285714,65.8571428571429,81.7185714285714,54.3157142857143,417,0,0,16,18,328,417,328
2019,46,77,"Sakarya",40.7789,30.4033,7.71428571428571,15.6,0.0142857142857143,71.7285714285714,104.101428571429,60.9585714285714,401,0,0,101,85,337,401,337
2019,47,77,"Sakarya",40.7789,30.4033,7.7,11.6857142857143,0.199571428571429,74.3285714285714,114.305714285714,49.7414285714286,391,107,86,133,156,339,284,253
2019,48,77,"Sakarya",40.7789,30.4033,12.6714285714286,12.5571428571429,6.51442857142857,78.4714285714286,62.8342857142857,34.4585714285714,320,66,43,89,92,251,254,208
2019,49,77,"Sakarya",40.7789,30.4033,11.3285714285714,6.68571428571429,1.31442857142857,75.6571428571429,49.8485714285714,30.5585714285714,393,65,55,0,0,274,328,219
2019,50,77,"Sakarya",40.7789,30.4033,9.78571428571429,9.65714285714286,0.143285714285714,72.6714285714286,84.5671428571429,39.73,218,59,36,16,17,119,159,83
2019,51,77,"Sakarya",40.7789,30.4033,14.9571428571429,10.1142857142857,0,66.7142857142857,74.5771428571429,37.1,361,0,0,0,0,488,361,488
2019,52,77,"Sakarya",40.7789,30.4033,11.4,8.71428571428571,4.71628571428571,77.1857142857143,26.8257142857143,24.0957142857143,279,0,0,230,215,281,279,281
2020,1,77,"Sakarya",40.7789,30.4033,8.26,4.42,3.5996,81.52,64.362,30.268,160,53,28,35,19,126,107,98
2020,2,77,"Sakarya",40.7789,30.4033,10.9,4.95714285714286,6.40057142857143,80.4857142857143,56.0528571428571,27.5271428571429,240,82,20,34,57,173,158,153
2020,3,77,"Sakarya",40.7789,30.4033,11.2571428571429,5.7,1.08428571428571,80.7571428571429,56.4983333333333,20.8066666666667,270,0,0,69,128,382,270,382
2020,4,77,"Sakarya",40.7789,30.4033,13.5142857142857,4.32857142857143,1.05928571428571,73.6428571428571,43.7214285714286,30.8657142857143,358,0,0,134,79,295,358,295
2020,5,77,"Sakarya",40.7789,30.4033,14.9,8.87142857142857,3.199,71.5571428571428,45.12,32.9414285714286,331,0,0,40,26,272,331,272
2020,6,77,"Sakarya",40.7789,30.4033,15.9142857142857,7.71428571428571,4.03128571428571,73.0142857142857,30.6671428571429,20.79,343,0,0,143,111,267,343,267
2020,7,77,"Sakarya",40.7789,30.4033,15.6285714285714,6.91428571428571,3.88257142857143,70.9285714285714,41.2028571428571,26.7314285714286,341,2,0,43,26,338,339,338
2020,8,77,"Sakarya",40.7789,30.4033,9.9,6.67142857142857,2.327,78.3,60.8214285714286,29.2028571428571,283,2,1,51,23,187,281,186
2020,9,77,"Sakarya",40.7789,30.4033,16.8857142857143,10.3428571428571,1.02957142857143,63.9571428571429,47.5985714285714,25.2433333333333,393,0,0,8,22,528,393,528
2020,10,77,"Sakarya",40.7789,30.4033,13.8428571428571,14.2285714285714,0.6,60.8428571428571,63.595,25.8575,205,0,0,81,49,210,205,210
2020,11,77,"Sakarya",40.7789,30.4033,13,11.5714285714286,0.600857142857143,72.3428571428571,59.0814285714286,20.3925,115,0,0,65,62,94,115,94
2020,12,77,"Sakarya",40.7789,30.4033,12.7142857142857,5.71428571428571,3.41557142857143,75,43.1957142857143,19.56,117,13,17,14,12,118,104,101
2020,13,77,"Sakarya",40.7789,30.4033,12.3,8.62857142857143,3.865,84.0714285714286,40.1214285714286,NA,136,0,0,27,29,92,136,92
2020,14,77,"Sakarya",40.7789,30.4033,11.7714285714286,9.14285714285714,2.60428571428571,83.2142857142857,42.4514285714286,16.67,155,0,0,33,28,121,155,121
2020,15,77,"Sakarya",40.7789,30.4033,14.5857142857143,9.02857142857143,5.20971428571429,71.6142857142857,39.5342857142857,5.47,133,0,0,47,26,118,133,118
2020,16,77,"Sakarya",40.7789,30.4033,12.8714285714286,12.2571428571429,0.888571428571429,66.8714285714286,45.474,7.41,141,0,0,47,35,106,141,106
2020,17,77,"Sakarya",40.7789,30.4033,18.5428571428571,10.3142857142857,0.132428571428571,73.7285714285714,29.1857142857143,5.34,137,0,0,37,18,123,137,123
2020,18,77,"Sakarya",40.7789,30.4033,13.7285714285714,15.2142857142857,1.14457142857143,71.0142857142857,32.9357142857143,6.07333333333333,146,20,16,54,47,164,126,148
2020,19,77,"Sakarya",40.7789,30.4033,12.1714285714286,13.2142857142857,7.57485714285714,78.3571428571429,31.0042857142857,2.76428571428571,137,27,68,71,70,157,110,89
2020,20,77,"Sakarya",40.7789,30.4033,13.6285714285714,20.2857142857143,0,71.7142857142857,54.1428571428571,6.65,164,27,22,44,35,164,137,142
2020,21,77,"Sakarya",40.7789,30.4033,14.4857142857143,16.6428571428571,3.96057142857143,79.6428571428571,39.6516666666667,3.67666666666667,146,0,0,68,51,96,146,96
2020,22,77,"Sakarya",40.7789,30.4033,12.7857142857143,14.6571428571429,2.49957142857143,81.7571428571429,20.7828571428571,3.89571428571429,118,2,5,55,54,100,116,95
2020,23,77,"Sakarya",40.7789,30.4033,12.4714285714286,18.4714285714286,5.343,76.5,30.9414285714286,5.21142857142857,112,4,1,42,42,70,108,69
2020,24,77,"Sakarya",40.7789,30.4033,13.2,21.1285714285714,2.34228571428571,75.8571428571429,30.6557142857143,4.80857142857143,140,0,0,50,20,150,140,150
2020,25,77,"Sakarya",40.7789,30.4033,10.6285714285714,22,11.8497142857143,77.5,24.25,3.84857142857143,137,0,0,76,59,108,137,108
2020,26,77,"Sakarya",40.7789,30.4033,9.85714285714286,22.4428571428571,1.14042857142857,77.1428571428571,19.2757142857143,2.77714285714286,173,0,0,37,41,133,173,133
2020,27,77,"Sakarya",40.7789,30.4033,9.65714285714286,26.3142857142857,0,66.7,25.818,2.72,113,0,0,3,7,113,113,113
2020,28,77,"Sakarya",40.7789,30.4033,11.5714285714286,24.6714285714286,0.00214285714285714,71.9857142857143,23.2483333333333,5.80571428571429,164,0,0,1,0,122,164,122
2020,29,77,"Sakarya",40.7789,30.4033,10.0857142857143,22.6285714285714,0.0578571428571429,74.8571428571429,26.605,12.215,186,0,0,12,14,111,186,111
2020,30,77,"Sakarya",40.7789,30.4033,11.4571428571429,24.6714285714286,0,71.0428571428571,33.46,18.3628571428571,190,0,0,1,0,142,190,142
2020,31,77,"Sakarya",40.7789,30.4033,12.4857142857143,24.6571428571429,0,71.1428571428571,28.955,21.3966666666667,150,0,0,1,0,127,150,127
2020,32,77,"Sakarya",40.7789,30.4033,10.4142857142857,25.2571428571429,0,69.9142857142857,29.1442857142857,20.2271428571429,146,0,0,15,8,107,146,107
2020,33,77,"Sakarya",40.7789,30.4033,13.2571428571429,25.8285714285714,0,62.1285714285714,30.5428571428571,18.1242857142857,183,0,0,0,0,83,183,83
2020,34,77,"Sakarya",40.7789,30.4033,10.3857142857143,25.2428571428571,0.000285714285714286,63.2857142857143,33.6328571428571,16.0228571428571,197,0,0,80,53,97,197,97
2020,35,77,"Sakarya",40.7789,30.4033,9.65714285714286,24.4285714285714,0,67.1857142857143,37.5642857142857,12.9042857142857,164,0,0,4,2,157,164,157
2020,36,77,"Sakarya",40.7789,30.4033,9.34285714285714,24.3857142857143,0.713142857142857,72.9571428571429,35.9728571428571,14.6885714285714,179,0,0,48,40,112,179,112
2020,37,77,"Sakarya",40.7789,30.4033,10.9285714285714,24.1285714285714,0.000285714285714286,73.3285714285714,43.3771428571429,16.78,193,0,0,0,0,91,193,91
2020,38,77,"Sakarya",40.7789,30.4033,11.7714285714286,23.8285714285714,0,71.0285714285714,41.26,13.2728571428571,235,0,0,6,7,157,235,157
2020,39,77,"Sakarya",40.7789,30.4033,7.84285714285714,23.3142857142857,0.029,63.6,55.8785714285714,18.2285714285714,220,0,0,80,40,129,220,129
2020,40,77,"Sakarya",40.7789,30.4033,8.55714285714286,20.8428571428571,1.00071428571429,64.9857142857143,56.0028571428571,26.79,187,0,0,98,91,154,187,154
2020,41,77,"Sakarya",40.7789,30.4033,8.94285714285714,22.3285714285714,3.899,66.3857142857143,77.2283333333333,36.28,182,52,28,22,7,127,130,99
2020,42,77,"Sakarya",40.7789,30.4033,7.68571428571429,20.9,1.99742857142857,68,60.3414285714286,34.4542857142857,177,0,0,68,25,111,177,111
2020,43,77,"Sakarya",40.7789,30.4033,5.31428571428571,17.8571428571429,2.01385714285714,79.7142857142857,60.35,28.7457142857143,194,0,0,64,33,161,194,161
2020,44,77,"Sakarya",40.7789,30.4033,10.7,17.6571428571429,1.46185714285714,77.9571428571429,60.01,28.8228571428571,255,0,0,128,129,233,255,233
2020,45,77,"Sakarya",40.7789,30.4033,4.71428571428571,13.1571428571429,2.66871428571429,78.4142857142857,64.6528571428571,29.7971428571429,156,2,1,25,17,103,154,102
2020,46,77,"Sakarya",40.7789,30.4033,6.38571428571429,13.5714285714286,1.78471428571429,81.3571428571429,65.07,27.56,208,0,0,24,8,109,208,109
2020,47,77,"Sakarya",40.7789,30.4033,10.4,10.9571428571429,0.000714285714285714,77.2714285714286,67.8785714285714,28.3257142857143,173,0,0,11,3,83,173,83
2020,48,77,"Sakarya",40.7789,30.4033,10.5428571428571,8.67142857142857,0,71.2571428571429,85.4257142857143,33.8785714285714,199,35,14,0,0,262,164,248
2020,49,77,"Sakarya",40.7789,30.4033,7.07142857142857,10.1714285714286,2.71014285714286,82.7571428571429,117.213333333333,27.7785714285714,207,13,3,62,35,116,194,113
2020,50,77,"Sakarya",40.7789,30.4033,11.4428571428571,13.1285714285714,0.0621428571428571,67.9428571428571,92.5014285714286,29.5328571428571,181,113,78,24,8,98,68,20
2020,51,77,"Sakarya",40.7789,30.4033,7.48571428571429,10.9428571428571,5.68885714285714,86.5714285714286,41.4857142857143,22.3414285714286,171,0,0,82,48,90,171,90
2020,52,77,"Sakarya",40.7789,30.4033,12.0714285714286,10.4142857142857,0.408142857142857,73.0428571428571,38.19,24.59,203,52,9,20,15,113,151,104
2020,53,77,"Sakarya",40.7789,30.4033,14.725,12.675,0.4995,63.15,82.795,NA,122,0,0,0,0,111,122,111
2017,1,78,"Atakum",41.2867,36.33,24.9,8.97142857142857,4.41257142857143,46.1285714285714,36.4614285714286,29.7275,563,0,0,384,567,847,563,847
2017,2,78,"Atakum",41.2867,36.33,18.1857142857143,6.72857142857143,0.421,50.8857142857143,36.9942857142857,48.125,757,0,0,625,815,1214,757,1214
2017,3,78,"Atakum",41.2867,36.33,12.5285714285714,7.22857142857143,0.456142857142857,67.7714285714286,43.95,45.8957142857143,762,1,0,303,482,1449,761,1449
2017,4,78,"Atakum",41.2867,36.33,13.7857142857143,3.62857142857143,1.78014285714286,71.3285714285714,32.08,41.6542857142857,639,0,0,222,245,889,639,889
2017,5,78,"Atakum",41.2867,36.33,18.0571428571429,4.21428571428571,6.59928571428571,57.4285714285714,29.9528571428571,32.6314285714286,588,0,0,382,580,1163,588,1163
2017,6,78,"Atakum",41.2867,36.33,16.9571428571429,8.74285714285714,0,60.9714285714286,58.9228571428571,27.6028571428571,736,0,0,327,525,1519,736,1519
2017,7,78,"Atakum",41.2867,36.33,15,3.4,1.75814285714286,63.0142857142857,46.6514285714286,49.1028571428571,492,0,0,219,276,717,492,717
2017,8,78,"Atakum",41.2867,36.33,17.0285714285714,11.1714285714286,0.138142857142857,55.5,49.4128571428571,46.2171428571429,739,130,292,415,975,1747,609,1455
2017,9,78,"Atakum",41.2867,36.33,12.1571428571429,10,0.330428571428571,68.6142857142857,62.6857142857143,52.2685714285714,574,216,393,145,181,866,358,473
2017,10,78,"Atakum",41.2867,36.33,9.98571428571429,10.8142857142857,0.0567142857142857,70.8285714285714,77.9257142857143,87.4828571428571,712,300,397,147,205,1043,412,646
2017,11,78,"Atakum",41.2867,36.33,12.6285714285714,8.42857142857143,5.65414285714286,77.1714285714286,39.7685714285714,60.2371428571429,525,170,164,121,277,725,355,561
2017,12,78,"Atakum",41.2867,36.33,9.98571428571429,7.98571428571429,0.142428571428571,70.1428571428571,50.2171428571429,72.4942857142857,589,332,509,0,0,1077,257,568
2017,13,78,"Atakum",41.2867,36.33,11.6714285714286,8.78571428571428,1.76742857142857,72.6571428571429,49.9414285714286,64.6457142857143,574,177,305,0,0,887,397,582
2017,14,78,"Atakum",41.2867,36.33,11,9.48571428571429,2.867,76.2428571428571,49.83,67.8671428571429,639,361,774,73,141,1336,278,562
2017,15,78,"Atakum",41.2867,36.33,10.9,10.1857142857143,3.04485714285714,77.6714285714286,38.9057142857143,62.1571428571429,587,299,696,51,21,1187,288,491
2017,16,78,"Atakum",41.2867,36.33,14.7571428571429,11.2714285714286,4.14114285714286,74.6857142857143,46.7942857142857,61.82,717,339,337,102,273,920,378,583
2017,17,78,"Atakum",41.2867,36.33,11.0714285714286,10.5571428571429,0.870857142857143,67.6714285714286,44.0942857142857,68.3171428571429,731,405,1001,97,111,1478,326,477
2017,18,78,"Atakum",41.2867,36.33,8.55714285714286,14.4,2.612,78.1714285714286,61.3028571428571,52.3028571428571,506,295,586,0,0,923,211,337
2017,19,78,"Atakum",41.2867,36.33,11.9571428571429,16.8571428571429,0.294857142857143,67.9714285714286,41.1142857142857,35.0528571428571,471,211,444,64,109,966,260,522
2017,20,78,"Atakum",41.2867,36.33,11.7428571428571,14.5571428571429,1.02671428571429,76.0857142857143,26.695,20.8175,472,125,274,40,82,1205,347,931
2017,21,78,"Atakum",41.2867,36.33,9.4,14.7285714285714,2.563,79.7571428571429,23.604,23.406,448,262,496,0,0,849,186,353
2017,22,78,"Atakum",41.2867,36.33,11.1142857142857,19,0.139,73.0285714285714,32.3816666666667,22.2733333333333,522,298,706,0,0,1015,224,309
2017,23,78,"Atakum",41.2867,36.33,12.8428571428571,20.3,3.14328571428571,76.6714285714286,30.1733333333333,28.4416666666667,578,302,667,0,0,1388,276,721
2017,24,78,"Atakum",41.2867,36.33,14.4571428571429,19.8285714285714,0.811714285714286,70.2714285714286,27.4628571428571,24.7371428571429,552,140,231,0,0,1139,412,908
2017,25,78,"Atakum",41.2867,36.33,12.0857142857143,21.4714285714286,1.90214285714286,69.2142857142857,27.1614285714286,24.6228571428571,584,98,160,52,188,1041,486,881
2017,26,78,"Atakum",41.2867,36.33,11.9428571428571,23.1857142857143,0.014,71.3142857142857,38.1775,30.9875,564,525,927,0,0,971,39,44
2017,27,78,"Atakum",41.2867,36.33,15.9857142857143,23.4285714285714,0.0584285714285714,64.1142857142857,25.288,18.768,511,193,271,0,0,642,318,371
2017,28,78,"Atakum",41.2867,36.33,13.2571428571429,23.3714285714286,0,65.3857142857143,24.3585714285714,23.05,481,278,575,0,0,864,203,289
2017,29,78,"Atakum",41.2867,36.33,15.8714285714286,24.8142857142857,0.000857142857142857,66.0857142857143,33.7457142857143,16.2914285714286,532,79,186,7,2,1272,453,1086
2017,30,78,"Atakum",41.2867,36.33,12.0571428571429,25.2857142857143,0.0285714285714286,63.1857142857143,38.06,25.1571428571429,531,392,686,0,0,928,139,242
2017,31,78,"Atakum",41.2867,36.33,15.0428571428571,25.5285714285714,0,67.6857142857143,36.9033333333333,19.73,559,234,432,0,0,1047,325,615
2017,32,78,"Atakum",41.2867,36.33,15.4428571428571,26.9285714285714,0,66.8714285714286,49.7128571428571,19.9928571428571,567,254,375,0,0,1092,313,717
2017,33,78,"Atakum",41.2867,36.33,13.2571428571429,25.9428571428571,0.0142857142857143,68.2142857142857,36.1914285714286,18.4514285714286,596,234,445,0,0,1199,362,754
2017,34,78,"Atakum",41.2867,36.33,14.0285714285714,24.3571428571429,1.42857142857143,61.0714285714286,24.8942857142857,23.1871428571429,601,133,171,10,14,1280,468,1109
2017,35,78,"Atakum",41.2867,36.33,13.5142857142857,22.6857142857143,0.171428571428571,58.3428571428571,23.6728571428571,15.9657142857143,493,72,77,22,31,1014,421,937
2017,36,78,"Atakum",41.2867,36.33,13.2571428571429,22.0714285714286,1.85714285714286,63.3857142857143,24.1814285714286,38.1614285714286,507,110,427,101,238,1321,397,894
2017,37,78,"Atakum",41.2867,36.33,11.4,24.1142857142857,0,62.9285714285714,54.7357142857143,61.1514285714286,589,196,458,0,0,1138,393,680
2017,38,78,"Atakum",41.2867,36.33,12.0142857142857,22.9,0,65.0428571428571,43.4842857142857,47.8428571428571,671,224,356,180,303,1312,447,956
2017,39,78,"Atakum",41.2867,36.33,12.1714285714286,19.9428571428571,2.67142857142857,65.7,35.74,37.8871428571429,782,0,0,52,194,1630,782,1630
2017,40,78,"Atakum",41.2867,36.33,14.0285714285714,17.4714285714286,1.21428571428571,51.4428571428571,35.0828571428571,56.2128571428571,543,0,0,301,581,1137,543,1137
2017,41,78,"Atakum",41.2867,36.33,11.4571428571429,15.5857142857143,1.72857142857143,65.7714285714286,24.8,52.5985714285714,487,0,0,118,232,843,487,843
2017,42,78,"Atakum",41.2867,36.33,7.68571428571429,15.7714285714286,1.04285714285714,64.4,48.79,67.4133333333333,530,0,0,463,737,815,530,815
2017,43,78,"Atakum",41.2867,36.33,11.7142857142857,17.3571428571429,0.2,65.5857142857143,50.0457142857143,51.6375,506,1,2,127,257,919,505,917
2017,44,78,"Atakum",41.2867,36.33,12.4714285714286,12.1285714285714,0.614285714285714,57.2428571428571,32.3471428571429,61.1471428571429,561,0,0,489,957,1102,561,1102
2017,45,78,"Atakum",41.2867,36.33,10.7714285714286,14.3285714285714,2.82642857142857,72.0571428571429,49.8685714285714,79.6842857142857,577,118,157,197,321,829,459,672
2017,46,78,"Atakum",41.2867,36.33,14.8428571428571,16.5428571428571,0,58.7571428571429,70.4771428571429,75.6428571428571,587,50,146,298,440,1085,537,939
2017,47,78,"Atakum",41.2867,36.33,16.7142857142857,10.2857142857143,3.861,60.0714285714286,28.6342857142857,50.8766666666667,418,0,0,261,444,804,418,804
2017,48,78,"Atakum",41.2867,36.33,18.4142857142857,15.1857142857143,0.000428571428571429,47.3714285714286,40.5357142857143,68.26,386,0,0,274,422,619,386,619
2017,49,78,"Atakum",41.2867,36.33,26.3857142857143,11.5142857142857,2.77414285714286,51.0285714285714,25.1628571428571,44.9242857142857,407,0,0,299,444,645,407,645
2017,50,78,"Atakum",41.2867,36.33,17.7714285714286,13.2428571428571,0.869571428571428,55.7142857142857,48.91,92.8228571428571,346,13,16,295,334,442,333,426
2017,51,78,"Atakum",41.2867,36.33,13.1714285714286,9.08571428571429,13.8487142857143,77.8,20.3957142857143,65.49,386,0,0,192,156,349,386,349
2017,52,78,"Atakum",41.2867,36.33,19.85,11.7625,0.816375,44.4,40.26375,69.6442857142857,528,0,0,489,457,507,528,507
2018,1,78,"Atakum",41.2867,36.33,14.6125,10.4875,5.384375,63.6125,27.0971428571429,68.378,618,0,0,499,725,914,618,914
2018,2,78,"Atakum",41.2867,36.33,14.5428571428571,8.92857142857143,6.08171428571429,75,35.8533333333333,68.5328571428571,624,87,119,155,743,1309,537,1190
2018,3,78,"Atakum",41.2867,36.33,18.1142857142857,9.1,3.14371428571429,58.1857142857143,24.64,69.532,639,0,0,507,379,655,639,655
2018,4,78,"Atakum",41.2867,36.33,16.1571428571429,6.17142857142857,5.83185714285714,69.4285714285714,28.48,62.2057142857143,604,0,0,177,289,764,604,764
2018,5,78,"Atakum",41.2867,36.33,17.1428571428571,11.9857142857143,0.0145714285714286,48.8142857142857,36.3157142857143,71.1042857142857,670,0,0,618,715,819,670,819
2018,6,78,"Atakum",41.2867,36.33,13.9571428571429,10.9285714285714,0.350857142857143,73.0714285714286,51.6771428571429,88.2657142857143,704,168,233,188,262,1022,536,789
2018,7,78,"Atakum",41.2867,36.33,10.1285714285714,9.2,0.572,75.3142857142857,33.9814285714286,75.48,478,2,1,114,113,557,476,556
2018,8,78,"Atakum",41.2867,36.33,11.1571428571429,8.08571428571429,2.92628571428571,81.8142857142857,38.2085714285714,74.4314285714286,711,243,356,4,10,1321,468,965
2018,9,78,"Atakum",41.2867,36.33,19.7142857142857,9.15714285714286,5.51971428571429,68.8857142857143,37.7528571428571,85.9814285714286,621,86,143,246,344,956,535,813
2018,10,78,"Atakum",41.2867,36.33,13.4285714285714,11.0571428571429,3.224,71.0571428571428,46.0514285714286,79.3642857142857,556,49,22,179,515,1330,507,1308
2018,11,78,"Atakum",41.2867,36.33,14.2142857142857,13.1285714285714,1.84928571428571,66.2714285714286,44.6771428571429,NA,551,124,500,216,504,1426,427,926
2018,12,78,"Atakum",41.2867,36.33,13.1857142857143,11.0142857142857,4.10014285714286,82.2142857142857,52.5528571428571,NA,425,268,820,0,0,1187,157,367
2018,13,78,"Atakum",41.2867,36.33,14.9714285714286,12.6571428571429,1.35371428571429,71.0142857142857,60.0928571428571,60.0875,356,55,57,111,113,428,301,371
2018,14,78,"Atakum",41.2867,36.33,11.7142857142857,11.4142857142857,0.301285714285714,70.8142857142857,40.2985714285714,92.1028571428571,407,176,300,165,124,486,231,186
2018,15,78,"Atakum",41.2867,36.33,12.2571428571429,11.4285714285714,0.000428571428571429,80.0714285714286,50.4971428571429,63.9328571428571,374,169,124,15,31,450,205,326
2018,16,78,"Atakum",41.2867,36.33,12.3571428571429,12.2714285714286,0.436714285714286,65.2,43.47,71.7225,411,124,202,117,202,648,287,446
2018,17,78,"Atakum",41.2867,36.33,8.52857142857143,14.8285714285714,0,65.9142857142857,NA,NA,419,225,369,59,96,652,194,283
2018,18,78,"Atakum",41.2867,36.33,9.18571428571429,15.4428571428571,0.339714285714286,83.1,47.308,42.75,303,302,441,0,0,474,1,33
2018,19,78,"Atakum",41.2867,36.33,11.4714285714286,16.3857142857143,1.59485714285714,76.2142857142857,29.4828571428571,60.6114285714286,275,161,344,0,0,467,114,123
2018,20,78,"Atakum",41.2867,36.33,11.7428571428571,17.9428571428571,0.526142857142857,73.4142857142857,38.8971428571429,83.9114285714286,204,127,183,0,0,306,77,123
2018,21,78,"Atakum",41.2867,36.33,9.21428571428572,20.4,0.0307142857142857,75.5,30.9485714285714,59.3785714285714,252,232,213,0,0,281,20,68
2018,22,78,"Atakum",41.2867,36.33,13.8285714285714,20.8857142857143,0.087,65.1571428571429,38.1871428571429,30.0414285714286,249,0,0,0,0,427,249,427
2018,23,78,"Atakum",41.2867,36.33,11.1571428571429,21.6142857142857,0.141,65.2714285714286,38.4042857142857,29.3342857142857,267,175,495,0,0,812,92,317
2018,24,78,"Atakum",41.2867,36.33,15.2571428571429,23.6714285714286,1.12614285714286,64.8428571428571,33.8228571428571,21.6257142857143,267,104,126,23,9,448,163,322
2018,25,78,"Atakum",41.2867,36.33,13.9142857142857,23.2428571428571,3.11428571428571,69.4857142857143,29.6442857142857,22.2014285714286,358,200,258,0,0,518,158,260
2018,26,78,"Atakum",41.2867,36.33,15.4428571428571,24.6142857142857,0.00885714285714286,69.5857142857143,36.81,21.4371428571429,355,255,467,0,0,587,100,120
2018,27,78,"Atakum",41.2867,36.33,14.5857142857143,24.1142857142857,0.201285714285714,63.6428571428571,30.304,21.3457142857143,342,78,110,0,0,418,264,308
2018,28,78,"Atakum",41.2867,36.33,14.6,26.0142857142857,3.10242857142857,64.0428571428571,37.0385714285714,16.89,286,91,172,0,0,585,195,413
2018,29,78,"Atakum",41.2867,36.33,13.4714285714286,24.8,0.875285714285714,62.9,25.77,23.6185714285714,260,104,351,0,0,756,156,405
2018,30,78,"Atakum",41.2867,36.33,14.7,25.9142857142857,0.752,69.3714285714286,29.5314285714286,23.4314285714286,265,197,470,0,0,822,68,352
2018,31,78,"Atakum",41.2867,36.33,13.5428571428571,27.1428571428571,0,62.5,37.3542857142857,15.7185714285714,267,53,215,1,3,499,214,284
2018,32,78,"Atakum",41.2867,36.33,16.9142857142857,25.8428571428571,9.378,58.6714285714286,35.5285714285714,16.5866666666667,297,0,0,38,26,403,297,403
2018,33,78,"Atakum",41.2867,36.33,12.6285714285714,24.8142857142857,0.014,61.6714285714286,32.4342857142857,29.5571428571429,216,75,144,3,10,332,141,188
2018,34,78,"Atakum",41.2867,36.33,12.8,24.9571428571429,0,61.8285714285714,39.7057142857143,26.9757142857143,144,80,151,10,12,227,64,76
2018,35,78,"Atakum",41.2867,36.33,13.0142857142857,25.6571428571429,0,65.2714285714286,38.4814285714286,31.9457142857143,201,32,29,0,0,314,169,285
2018,36,78,"Atakum",41.2867,36.33,16.4,24.5285714285714,3.68714285714286,65.7857142857143,40.17,33.2757142857143,341,132,115,100,115,370,209,255
2018,37,78,"Atakum",41.2867,36.33,16.0571428571429,21.8714285714286,3.61985714285714,71.8571428571429,26.0485714285714,36.9757142857143,241,115,191,57,136,419,126,228
2018,38,78,"Atakum",41.2867,36.33,14.1428571428571,20.0714285714286,1.21428571428571,68.4857142857143,28.04,40.45,189,67,118,74,129,344,122,226
2018,39,78,"Atakum",41.2867,36.33,19.5285714285714,18.5,2.102,68.9142857142857,34.7671428571429,42.6442857142857,180,34,91,55,123,353,146,262
2018,40,78,"Atakum",41.2867,36.33,12.1285714285714,19.5142857142857,0.483,66.3857142857143,27.8185714285714,27.0742857142857,191,14,35,38,79,341,177,306
2018,41,78,"Atakum",41.2867,36.33,7.87142857142857,18.9142857142857,1.85942857142857,75.3,40.1928571428571,28.5557142857143,187,12,4,55,138,422,175,418
2018,42,78,"Atakum",41.2867,36.33,10.9714285714286,19.9571428571429,1.524,76.7714285714286,66.2014285714286,30.6914285714286,168,114,306,11,7,381,54,75
2018,43,78,"Atakum",41.2867,36.33,13.6857142857143,16.2142857142857,6.17185714285714,62.7714285714286,36.2557142857143,25.2585714285714,187,0,0,135,307,402,187,402
2018,44,78,"Atakum",41.2867,36.33,8.47142857142857,16.0571428571429,0,67.1,49.7914285714286,33.316,196,0,0,189,252,264,196,264
2018,45,78,"Atakum",41.2867,36.33,11.8142857142857,15.0285714285714,0.281285714285714,71.9857142857143,39.9857142857143,31.11,231,77,166,124,270,473,154,307
2018,46,78,"Atakum",41.2867,36.33,12.1571428571429,10.4857142857143,4.249,68.5571428571429,23.5557142857143,22.255,230,0,0,149,290,465,230,465
2018,47,78,"Atakum",41.2867,36.33,12.0857142857143,12.2,4.59285714285714,73.8857142857143,NA,NA,270,69,52,159,376,499,201,447
2018,48,78,"Atakum",41.2867,36.33,14.9857142857143,13.4571428571429,1.678,65.3571428571429,NA,NA,245,0,0,108,61,201,245,201
2018,49,78,"Atakum",41.2867,36.33,12.6142857142857,10.2428571428571,1.32557142857143,68.3571428571429,27.1666666666667,26.405,257,0,0,68,110,420,257,420
2018,50,78,"Atakum",41.2867,36.33,18.5142857142857,11.0714285714286,1.113,54.4285714285714,23.7533333333333,28.9433333333333,256,0,0,240,257,305,256,305
2018,51,78,"Atakum",41.2867,36.33,10.4285714285714,11.1857142857143,1.06628571428571,75.1571428571429,45.258,30.075,250,5,11,94,106,248,245,237
2018,52,78,"Atakum",41.2867,36.33,17.2,7,5.66814285714286,57.7857142857143,NA,NA,244,0,0,236,257,273,244,273
2019,1,78,"Atakum",41.2867,36.33,13.2,8.1625,4.806125,71.5375,19.055,43.94,343,0,0,201,339,784,343,784
2019,2,78,"Atakum",41.2867,36.33,19.0142857142857,6.88571428571429,3.57742857142857,57.9285714285714,NA,NA,255,31,10,146,114,208,224,198
2019,3,78,"Atakum",41.2867,36.33,21.9857142857143,7.74285714285714,0.682857142857143,54.8142857142857,NA,NA,192,0,0,141,91,198,192,198
2019,4,78,"Atakum",41.2867,36.33,18.0428571428571,11.9,1.158,50.0428571428571,NA,NA,308,51,44,230,130,314,257,270
2019,5,78,"Atakum",41.2867,36.33,18.9428571428571,11.6571428571429,0.185,55.4428571428571,NA,NA,253,30,11,171,104,143,223,132
2019,6,78,"Atakum",41.2867,36.33,12.4142857142857,9.57142857142857,1.64114285714286,70.5285714285714,NA,NA,276,0,0,122,38,127,276,127
2019,7,78,"Atakum",41.2867,36.33,15.1,8.68571428571429,1.09885714285714,66.8714285714286,29.2366666666667,22.9866666666667,325,26,6,80,60,234,299,228
2019,8,78,"Atakum",41.2867,36.33,13.8,7.58571428571429,1.42671428571429,72.6285714285714,52.9657142857143,34.2585714285714,305,31,7,49,14,219,274,212
2019,9,78,"Atakum",41.2867,36.33,14.4857142857143,6.54285714285714,0.854,68.8285714285714,34.9014285714286,28.5185714285714,331,27,11,73,93,310,304,299
2019,10,78,"Atakum",41.2867,36.33,17.0714285714286,10.2714285714286,1.14071428571429,58.7285714285714,39.3514285714286,39.1528571428571,359,0,0,203,96,252,359,252
2019,11,78,"Atakum",41.2867,36.33,15.8285714285714,10.5142857142857,2.662,67.8142857142857,38.7885714285714,29.54,373,61,48,129,149,400,312,352
2019,12,78,"Atakum",41.2867,36.33,11.6428571428571,7.62857142857143,0.406,68.7857142857143,32.7771428571429,30.5785714285714,343,1,0,76,47,416,342,416
2019,13,78,"Atakum",41.2867,36.33,14.2,7.01428571428571,0.118571428571429,65.4,26.3357142857143,28.9657142857143,256,88,48,0,0,194,168,146
2019,14,78,"Atakum",41.2867,36.33,11.5,9.41428571428571,0.0145714285714286,74.8571428571429,45.3285714285714,30.57,365,211,133,0,0,208,154,75
2019,15,78,"Atakum",41.2867,36.33,12.3857142857143,14.9428571428571,2.57557142857143,65.7142857142857,35.9257142857143,33.0628571428571,359,118,32,135,44,183,241,151
2019,16,78,"Atakum",41.2867,36.33,12.1285714285714,9.37142857142857,6.97814285714286,79.4571428571429,18.8728571428571,23.1757142857143,318,115,98,33,14,208,203,110
2019,17,78,"Atakum",41.2867,36.33,10.5142857142857,11.2714285714286,0.0171428571428571,76.1,34.8485714285714,32.2914285714286,412,310,243,57,54,313,102,70
2019,18,78,"Atakum",41.2867,36.33,11.6,16.3285714285714,0.760857142857143,72.4857142857143,42.5714285714286,29.26,523,167,81,269,214,353,356,272
2019,19,78,"Atakum",41.2867,36.33,11.2285714285714,15.3857142857143,3.75828571428571,82.9857142857143,32.3628571428571,23.3528571428571,452,341,288,0,0,386,111,98
2019,20,78,"Atakum",41.2867,36.33,14.1,16.6285714285714,0.953857142857143,83.7428571428571,32.6314285714286,24.8671428571429,454,269,228,62,28,389,185,161
2019,21,78,"Atakum",41.2867,36.33,9.85714285714286,18.8142857142857,3.45185714285714,81.5428571428571,54.945,26.065,457,250,238,81,31,413,207,175
2019,22,78,"Atakum",41.2867,36.33,7,19.5285714285714,0,78.4142857142857,38.4014285714286,NA,453,368,212,0,0,323,85,111
2019,23,78,"Atakum",41.2867,36.33,11.2,22.3857142857143,0.342,80.1,28.9585714285714,NA,378,310,395,0,0,532,68,137
2019,24,78,"Atakum",41.2867,36.33,11.5142857142857,23.8571428571429,2.247,82.1857142857143,35.7525,NA,378,311,214,0,0,244,67,30
2019,25,78,"Atakum",41.2867,36.33,13.7428571428571,24.8857142857143,8.89185714285714,78.4142857142857,38.6128571428571,NA,306,74,38,0,0,325,232,287
2019,26,78,"Atakum",41.2867,36.33,12.5285714285714,24.5,0.481142857142857,68.6714285714286,37.4985714285714,NA,377,135,185,5,1,342,242,157
2019,27,78,"Atakum",41.2867,36.33,13.0571428571429,23.3,0.0438571428571429,68.9857142857143,28.5285714285714,NA,456,314,179,0,0,222,142,43
2019,28,78,"Atakum",41.2867,36.33,15.1857142857143,22.9857142857143,3.39385714285714,70.5142857142857,22.8942857142857,NA,398,63,84,2,1,421,335,337
2019,29,78,"Atakum",41.2867,36.33,13.5285714285714,23.3857142857143,1.959,71.9428571428572,27.8214285714286,NA,453,135,78,5,4,203,318,125
2019,30,78,"Atakum",41.2867,36.33,15.4285714285714,24.6857142857143,0.00128571428571429,69.8428571428571,35.6183333333333,NA,456,136,100,0,0,335,320,235
2019,31,78,"Atakum",41.2867,36.33,14.7571428571429,24.8857142857143,0.995428571428571,72.3,31.3057142857143,NA,334,124,131,0,0,375,210,244
2019,32,78,"Atakum",41.2867,36.33,14.1,23.1857142857143,0.02,69.1857142857143,22.6028571428571,NA,346,165,164,0,0,395,181,231
2019,33,78,"Atakum",41.2867,36.33,13.9,24.5857142857143,0.981428571428571,72.3142857142857,34.5142857142857,NA,337,79,122,4,13,531,258,409
2019,34,78,"Atakum",41.2867,36.33,10.0285714285714,24.2285714285714,0.751857142857143,77.7571428571429,43.1966666666667,NA,299,12,3,11,7,345,287,342
2019,35,78,"Atakum",41.2867,36.33,13.0285714285714,24.3714285714286,0,71.3285714285714,39.0516666666667,NA,307,4,21,44,18,415,303,394
2019,36,78,"Atakum",41.2867,36.33,14.1428571428571,23.2,0.142857142857143,68.5857142857143,34.6157142857143,NA,171,0,0,9,25,67,171,67
2019,37,78,"Atakum",41.2867,36.33,14.4571428571429,23.0285714285714,0.0544285714285714,70.5714285714286,26.0085714285714,NA,218,54,6,1,0,55,164,49
2019,38,78,"Atakum",41.2867,36.33,13.2,19.7714285714286,1.78228571428571,67.4,27.7514285714286,NA,266,91,51,39,6,91,175,40
2019,39,78,"Atakum",41.2867,36.33,12.5142857142857,19.2857142857143,1.75571428571429,79.5857142857143,25.1328571428571,NA,237,80,33,0,0,79,157,46
2019,40,78,"Atakum",41.2867,36.33,11.6714285714286,20.3571428571429,3.34571428571429,74.1285714285714,39.9071428571429,NA,241,2,1,140,72,111,239,110
2019,41,78,"Atakum",41.2867,36.33,12.3428571428571,17.5714285714286,0.275,77.3428571428571,23.7228571428571,NA,416,1,0,55,63,448,415,448
2019,42,78,"Atakum",41.2867,36.33,9.78571428571429,19.0142857142857,0.0184285714285714,83.2857142857143,41.7257142857143,NA,356,163,160,0,0,408,193,248
2019,43,78,"Atakum",41.2867,36.33,10.3428571428571,17.5,0.747857142857143,83.4428571428571,40.7342857142857,NA,306,35,28,50,23,300,271,272
2019,44,78,"Atakum",41.2867,36.33,13.4285714285714,14.0857142857143,15.7918571428571,80.3428571428571,31.26,NA,350,138,102,159,112,250,212,148
2019,45,78,"Atakum",41.2867,36.33,16.9142857142857,18.1714285714286,0,56.9571428571429,46.0742857142857,58.715,417,0,0,382,265,328,417,328
2019,46,78,"Atakum",41.2867,36.33,10.6714285714286,15.8142857142857,0,66.2142857142857,75.4342857142857,NA,401,0,0,329,265,337,401,337
2019,47,78,"Atakum",41.2867,36.33,8.47142857142857,12.6,0,76.8142857142857,57.56,NA,391,0,0,382,328,339,391,339
2019,48,78,"Atakum",41.2867,36.33,15.2428571428571,14.9571428571429,3.146,64.4714285714286,48.9942857142857,NA,320,0,0,223,135,251,320,251
2019,49,78,"Atakum",41.2867,36.33,16.2142857142857,8.11428571428571,2.87,66.7428571428571,22.9571428571429,NA,393,53,29,221,139,274,340,245
2019,50,78,"Atakum",41.2867,36.33,15.3571428571429,12.4285714285714,0.0321428571428571,61,41.4457142857143,NA,218,0,0,168,114,119,218,119
2019,51,78,"Atakum",41.2867,36.33,12.3428571428571,12.0142857142857,1.14057142857143,66.9142857142857,51.4214285714286,48.69,361,0,0,355,483,488,361,488
2019,52,78,"Atakum",41.2867,36.33,16.0571428571429,12.4428571428571,4.807,66.2428571428571,25.5285714285714,41.08,279,0,0,177,206,281,279,281
2020,1,78,"Atakum",41.2867,36.33,9.02,7.5,2.9374,78.98,21.604,37.47,160,0,0,98,56,126,160,126
2020,2,78,"Atakum",41.2867,36.33,12.8857142857143,8.04285714285714,7.17771428571429,75.1714285714286,36.1928571428571,40.4985714285714,240,0,0,191,127,173,240,173
2020,3,78,"Atakum",41.2867,36.33,13.5285714285714,7.11428571428571,1.31871428571429,78.3,25.1957142857143,38.8416666666667,270,42,96,135,195,382,228,286
2020,4,78,"Atakum",41.2867,36.33,19.2285714285714,6.88571428571429,2.46485714285714,62.0142857142857,19.4042857142857,24.626,358,0,0,255,223,295,358,295
2020,5,78,"Atakum",41.2867,36.33,18.1857142857143,10.5428571428571,3.16157142857143,60.0142857142857,33.7985714285714,33.865,331,0,0,261,210,272,331,272
2020,6,78,"Atakum",41.2867,36.33,24.1285714285714,8.82857142857143,4.39771428571429,69.1857142857143,18.8428571428571,34.0433333333333,343,0,0,176,160,267,343,267
2020,7,78,"Atakum",41.2867,36.33,20.8428571428571,6.24285714285714,0.881714285714286,62.1,24.65,26.9625,341,0,0,212,218,338,341,338
2020,8,78,"Atakum",41.2867,36.33,9.87142857142857,7.55714285714286,1.41057142857143,78.8857142857143,39.69,32.7475,283,65,77,89,37,187,218,110
2020,9,78,"Atakum",41.2867,36.33,22.5,11.9571428571429,0.867142857142857,59.8714285714286,29.6285714285714,15.09,393,0,0,153,187,528,393,528
2020,10,78,"Atakum",41.2867,36.33,14.9285714285714,14.1142857142857,0,60.9285714285714,45.0442857142857,28.9814285714286,205,20,17,165,182,210,185,193
2020,11,78,"Atakum",41.2867,36.33,14.5571428571429,12.4,0.440285714285714,79.0571428571429,57.4471428571429,35.795,115,39,39,18,7,94,76,55
2020,12,78,"Atakum",41.2867,36.33,13.1428571428571,6.57142857142857,5.433,78.8,25.2271428571429,7.71,117,16,7,26,17,118,101,111
2020,13,78,"Atakum",41.2867,36.33,9.97142857142857,9.57142857142857,0.141857142857143,86.3,29.0414285714286,NA,136,53,55,0,0,92,83,37
2020,14,78,"Atakum",41.2867,36.33,8.22857142857143,10.4285714285714,2.42757142857143,84.4571428571429,42.3985714285714,5.275,155,40,33,8,16,121,115,88
2020,15,78,"Atakum",41.2867,36.33,14.7142857142857,9.98571428571429,0.367857142857143,70.2285714285714,37.6014285714286,4.77,133,14,6,0,0,118,119,112
2020,16,78,"Atakum",41.2867,36.33,11.6714285714286,10.9142857142857,1.102,76.5857142857143,30.5971428571429,7.17,141,46,38,0,0,106,95,68
2020,17,78,"Atakum",41.2867,36.33,12.2571428571429,10.7714285714286,1.05485714285714,76.1571428571429,25.7057142857143,NA,137,60,38,13,8,123,77,85
2020,18,78,"Atakum",41.2867,36.33,10.4428571428571,13.3714285714286,1.37557142857143,82.9428571428571,28.3483333333333,7.25,146,123,146,17,5,164,23,18
2020,19,78,"Atakum",41.2867,36.33,11.2714285714286,14.2857142857143,0.54,79.8857142857143,19.4114285714286,3.92,137,56,47,3,5,157,81,110
2020,20,78,"Atakum",41.2867,36.33,11.1285714285714,18.5428571428571,0,73.2714285714286,31.225,12.345,164,79,48,0,0,164,85,116
2020,21,78,"Atakum",41.2867,36.33,15.3571428571429,16.7285714285714,3.13885714285714,79.0142857142857,NA,NA,146,74,41,6,12,96,72,55
2020,22,78,"Atakum",41.2867,36.33,12.3142857142857,16.1857142857143,0.58,75.2285714285714,13.16,NA,118,64,32,19,12,100,54,68
2020,23,78,"Atakum",41.2867,36.33,12.5,18.3857142857143,1.89042857142857,82.0714285714286,14.11,NA,112,64,42,13,9,70,48,28
2020,24,78,"Atakum",41.2867,36.33,11.6428571428571,21.6142857142857,1.36571428571429,77.3428571428571,NA,NA,140,106,123,3,2,150,34,27
2020,25,78,"Atakum",41.2867,36.33,11.2142857142857,22.7571428571429,0.608714285714286,76.5857142857143,29.9275,1.52,137,60,62,0,0,108,77,46
2020,26,78,"Atakum",41.2867,36.33,14.6142857142857,23.8571428571429,0.464428571428571,73.5285714285714,31.7585714285714,13.258,173,66,45,0,0,133,107,88
2020,27,78,"Atakum",41.2867,36.33,10.5142857142857,24.4142857142857,0.014,68.9,31.4071428571429,20.5314285714286,113,86,106,0,0,113,27,7
2020,28,78,"Atakum",41.2867,36.33,15.0714285714286,25.5571428571429,0.000428571428571429,71.9142857142857,36.4714285714286,NA,164,69,51,0,0,122,95,71
2020,29,78,"Atakum",41.2867,36.33,14.6142857142857,24.4857142857143,0.110285714285714,72.5428571428571,26.9771428571429,NA,186,86,68,0,0,111,100,43
2020,30,78,"Atakum",41.2867,36.33,14.8857142857143,25.1428571428571,0.0432857142857143,70.8857142857143,33.0714285714286,NA,190,49,33,0,0,142,141,109
2020,31,78,"Atakum",41.2867,36.33,13.8142857142857,25.1428571428571,0.097,72.0857142857143,26.5157142857143,7.875,150,23,3,9,7,127,127,124
2020,32,78,"Atakum",41.2867,36.33,15.2714285714286,24.8285714285714,0.08,68.3428571428571,24.5814285714286,11.2914285714286,146,105,90,1,1,107,41,17
2020,33,78,"Atakum",41.2867,36.33,16.2428571428571,24.9714285714286,0.000857142857142857,61.4,28.61,19.7857142857143,183,34,24,1,1,83,149,59
2020,34,78,"Atakum",41.2867,36.33,14.2142857142857,23.9714285714286,3.15014285714286,67.5428571428571,31.8,18.442,197,8,5,1,0,97,189,92
2020,35,78,"Atakum",41.2867,36.33,12.0285714285714,23.2857142857143,0.00171428571428571,73.6285714285714,26.1028571428571,7.82,164,107,117,0,0,157,57,40
2020,36,78,"Atakum",41.2867,36.33,9.42857142857143,24.2,0.0702857142857143,75.8285714285714,31.8542857142857,NA,179,94,59,0,0,112,85,53
2020,37,78,"Atakum",41.2867,36.33,11.5142857142857,23.8571428571429,0.140571428571429,74.2,34.3371428571429,NA,193,101,51,0,0,91,92,40
2020,38,78,"Atakum",41.2867,36.33,15,22.9857142857143,1.92942857142857,74.5142857142857,39.9485714285714,NA,235,45,47,10,2,157,190,110
2020,39,78,"Atakum",41.2867,36.33,12.8571428571429,22.7428571428571,0.100714285714286,72.4571428571429,38.3357142857143,10.1725,220,34,14,44,27,129,186,115
2020,40,78,"Atakum",41.2867,36.33,14.3857142857143,21.7714285714286,1.16857142857143,76.0142857142857,32.2457142857143,14.1842857142857,187,22,24,2,0,154,165,130
2020,41,78,"Atakum",41.2867,36.33,13.4428571428571,20.7142857142857,0.0281428571428571,72.3285714285714,35.9542857142857,20.7757142857143,182,28,19,31,17,127,154,108
2020,42,78,"Atakum",41.2867,36.33,10.4428571428571,21.1571428571429,0,73.0714285714286,51.3042857142857,26.8628571428571,177,0,0,74,34,111,177,111
2020,43,78,"Atakum",41.2867,36.33,9.61428571428571,17.6571428571429,6.501,78.8142857142857,36.3057142857143,23.1614285714286,194,0,0,70,39,161,194,161
2020,44,78,"Atakum",41.2867,36.33,10.2857142857143,18.9428571428571,0.0575714285714286,72.7857142857143,56.0714285714286,31.3857142857143,255,0,0,177,204,233,255,233
2020,45,78,"Atakum",41.2867,36.33,16.9428571428571,15.5142857142857,1.34485714285714,71.4571428571429,29.2157142857143,31.4928571428571,156,0,0,65,42,103,156,103
2020,46,78,"Atakum",41.2867,36.33,11.7428571428571,13.2285714285714,2.93785714285714,76.9142857142857,32.2642857142857,27.0357142857143,208,0,0,149,75,109,208,109
2020,47,78,"Atakum",41.2867,36.33,8.7,10.9285714285714,12.5731428571429,79.1714285714286,23.0671428571429,29.9842857142857,173,0,0,136,79,83,173,83
2020,48,78,"Atakum",41.2867,36.33,15.1857142857143,10.3857142857143,1.27242857142857,63.7571428571429,25.1328571428571,29.4971428571429,199,0,0,144,215,262,199,262
2020,49,78,"Atakum",41.2867,36.33,9.41428571428571,11.7142857142857,0.524,71.6428571428571,57.8442857142857,28.7857142857143,207,16,4,139,69,116,191,112
2020,50,78,"Atakum",41.2867,36.33,12.8285714285714,13.1857142857143,0.313571428571429,65.2142857142857,50.0957142857143,30.0085714285714,181,0,0,129,43,98,181,98
2020,51,78,"Atakum",41.2867,36.33,9.04285714285714,11.7142857142857,1.25785714285714,77.6285714285714,38.9257142857143,26.8914285714286,171,35,22,91,39,90,136,68
2020,52,78,"Atakum",41.2867,36.33,16.8285714285714,10.2714285714286,1.60871428571429,61.9714285714286,25.174,25.7285714285714,203,0,0,113,64,113,203,113
2020,53,78,"Atakum",41.2867,36.33,19.15,15.35,0,40.5,54.1,33.215,122,0,0,80,74,111,122,111
2017,1,79,"Sanliurfa",37.1671,38.7955,20.1285714285714,4.75714285714286,0.426857142857143,77.2285714285714,88.0471428571429,NA,563,353,546,1,0,847,210,301
2017,2,79,"Sanliurfa",37.1671,38.7955,19.4,4.14285714285714,0.186142857142857,67.7,114.534285714286,NA,757,280,411,11,9,1214,477,803
2017,3,79,"Sanliurfa",37.1671,38.7955,16.9857142857143,6.21428571428571,0,56.3714285714286,123.311428571429,NA,762,218,455,45,116,1449,544,994
2017,4,79,"Sanliurfa",37.1671,38.7955,20.6857142857143,3.77142857142857,0.546,57.4,97.8016666666667,NA,639,363,440,27,53,889,276,449
2017,5,79,"Sanliurfa",37.1671,38.7955,18.0571428571429,1.68571428571429,0.150714285714286,58.3,NA,NA,588,213,526,29,32,1163,375,637
2017,6,79,"Sanliurfa",37.1671,38.7955,13.3142857142857,7.04285714285714,0.029,66.5428571428571,NA,NA,736,267,553,15,10,1519,469,966
2017,7,79,"Sanliurfa",37.1671,38.7955,22.2142857142857,3.68571428571429,0.000285714285714286,39.3285714285714,NA,NA,492,150,237,19,32,717,342,480
2017,8,79,"Sanliurfa",37.1671,38.7955,12.8714285714286,10.1857142857143,0,39.2142857142857,93.068,NA,739,7,51,225,405,1747,732,1696
2017,9,79,"Sanliurfa",37.1671,38.7955,16.7571428571429,11.8,5.35257142857143,58.9,110.822857142857,NA,574,332,600,8,1,866,242,266
2017,10,79,"Sanliurfa",37.1671,38.7955,21.2142857142857,13.5714285714286,0.106857142857143,50.7571428571429,79.5285714285714,NA,712,238,310,5,11,1043,474,733
2017,11,79,"Sanliurfa",37.1671,38.7955,20.7142857142857,9.07142857142857,2.40614285714286,72.8714285714286,37.3585714285714,NA,525,6,5,175,173,725,519,720
2017,12,79,"Sanliurfa",37.1671,38.7955,21.8,11.5857142857143,0.00185714285714286,50.6285714285714,37.7457142857143,NA,589,268,461,113,159,1077,321,616
2017,13,79,"Sanliurfa",37.1671,38.7955,16.1571428571429,13.4285714285714,1.09271428571429,64.5285714285714,47.2014285714286,NA,574,275,460,145,204,887,299,427
2017,14,79,"Sanliurfa",37.1671,38.7955,18.8714285714286,14.0142857142857,1.33742857142857,53.9428571428571,57.7571428571429,NA,639,140,398,157,249,1336,499,938
2017,15,79,"Sanliurfa",37.1671,38.7955,20,14.0285714285714,3.44214285714286,58.3714285714286,45.0857142857143,NA,587,167,140,155,402,1187,420,1047
2017,16,79,"Sanliurfa",37.1671,38.7955,20.1857142857143,16.8714285714286,4.941,60.2,61.5128571428571,NA,717,117,306,205,134,920,600,614
2017,17,79,"Sanliurfa",37.1671,38.7955,19.1857142857143,18.4142857142857,0.0981428571428571,33.6142857142857,36.334,NA,731,145,311,49,175,1478,586,1167
2017,18,79,"Sanliurfa",37.1671,38.7955,16.4714285714286,18.3857142857143,0.0627142857142857,60.5857142857143,56.3285714285714,NA,506,140,143,123,231,923,366,780
2017,19,79,"Sanliurfa",37.1671,38.7955,19.1571428571429,23.4714285714286,0.000142857142857143,36.3,57.26,NA,471,13,45,242,428,966,458,921
2017,20,79,"Sanliurfa",37.1671,38.7955,26.1142857142857,22.3571428571429,0.163571428571429,39.1428571428571,45.6528571428571,NA,472,11,20,171,562,1205,461,1185
2017,21,79,"Sanliurfa",37.1671,38.7955,18.9714285714286,20.1142857142857,1.01985714285714,48.2428571428571,37.81,NA,448,51,170,117,297,849,397,679
2017,22,79,"Sanliurfa",37.1671,38.7955,20.1285714285714,24.5571428571429,0,32.9857142857143,31.91,NA,522,72,124,162,249,1015,450,891
2017,23,79,"Sanliurfa",37.1671,38.7955,22.4428571428571,29.0285714285714,0.000142857142857143,28.0714285714286,45.39,NA,578,79,181,188,577,1388,499,1207
2017,24,79,"Sanliurfa",37.1671,38.7955,20.2,26.8571428571429,0.001,33.7428571428571,31.1028571428571,NA,552,0,0,254,551,1139,552,1139
2017,25,79,"Sanliurfa",37.1671,38.7955,21.0714285714286,26.9714285714286,0,33.2142857142857,27.1228571428571,NA,584,6,2,216,442,1041,578,1039
2017,26,79,"Sanliurfa",37.1671,38.7955,24.5857142857143,33.1857142857143,0,22.8571428571429,42.4928571428571,NA,564,160,243,162,371,971,404,728
2017,27,79,"Sanliurfa",37.1671,38.7955,25.5714285714286,32.8571428571429,0,24.6857142857143,46.6828571428571,NA,511,11,18,238,249,642,500,624
2017,28,79,"Sanliurfa",37.1671,38.7955,19.3285714285714,33.3714285714286,0,18.3,38.1257142857143,NA,481,2,10,145,282,864,479,854
2017,29,79,"Sanliurfa",37.1671,38.7955,19.4142857142857,33.0428571428571,0,30.7142857142857,58.3342857142857,NA,532,30,151,346,812,1272,502,1121
2017,30,79,"Sanliurfa",37.1671,38.7955,22.5571428571429,32.0857142857143,0,26.2857142857143,47.8528571428571,NA,531,0,0,281,576,928,531,928
2017,31,79,"Sanliurfa",37.1671,38.7955,21.5,32.5,0,31.6285714285714,59.0357142857143,NA,559,55,85,309,583,1047,504,962
2017,32,79,"Sanliurfa",37.1671,38.7955,17.9142857142857,32.9285714285714,0,31.9571428571429,66.3014285714286,NA,567,94,154,167,325,1092,473,938
2017,33,79,"Sanliurfa",37.1671,38.7955,22.3428571428571,30.4571428571429,0,43.1142857142857,68.3742857142857,NA,596,1,0,454,801,1199,595,1199
2017,34,79,"Sanliurfa",37.1671,38.7955,16.2142857142857,30.7857142857143,0,36.8428571428571,75.4585714285714,NA,601,6,2,315,613,1280,595,1278
2017,35,79,"Sanliurfa",37.1671,38.7955,14.1571428571429,29.5714285714286,0,36.3428571428571,64.3885714285714,NA,493,87,132,246,384,1014,406,882
2017,36,79,"Sanliurfa",37.1671,38.7955,16.4428571428571,29.2428571428571,0,24.6285714285714,62.51,NA,507,1,0,250,897,1321,506,1321
2017,37,79,"Sanliurfa",37.1671,38.7955,17,31.4714285714286,0,20.5857142857143,92.6814285714286,NA,589,185,170,136,378,1138,404,968
2017,38,79,"Sanliurfa",37.1671,38.7955,17.4857142857143,27.9142857142857,0,34.5,110.75,NA,671,228,355,334,622,1312,443,957
2017,39,79,"Sanliurfa",37.1671,38.7955,18.4142857142857,25.2,0.00142857142857143,37.1142857142857,61.46,NA,782,242,421,230,541,1630,540,1209
2017,40,79,"Sanliurfa",37.1671,38.7955,16.4142857142857,20.3,0,30.2,71.4342857142857,NA,543,158,241,98,244,1137,385,896
2017,41,79,"Sanliurfa",37.1671,38.7955,14.3428571428571,20.2571428571429,0.0324285714285714,35.7142857142857,61.1414285714286,NA,487,15,18,129,264,843,472,825
2017,42,79,"Sanliurfa",37.1671,38.7955,15.4285714285714,19.7,0,26.5142857142857,55.8916666666667,NA,530,33,22,116,179,815,497,793
2017,43,79,"Sanliurfa",37.1671,38.7955,16.7857142857143,18.6571428571429,1.42057142857143,47.2428571428571,124.85,NA,506,149,431,84,138,919,357,488
2017,44,79,"Sanliurfa",37.1671,38.7955,18.5142857142857,14.1571428571429,1.84357142857143,67.0285714285714,37.85,NA,561,185,402,131,252,1102,376,700
2017,45,79,"Sanliurfa",37.1671,38.7955,14.6,14.8428571428571,0.368,56.0142857142857,68.3814285714286,NA,577,93,84,135,368,829,484,745
2017,46,79,"Sanliurfa",37.1671,38.7955,16.2571428571429,15.0142857142857,0.0707142857142857,47.4142857142857,82.7142857142857,NA,587,313,490,19,50,1085,274,595
2017,47,79,"Sanliurfa",37.1671,38.7955,19.1,8.21428571428572,1.59,61.4,77.8466666666667,NA,418,171,344,35,38,804,247,460
2017,48,79,"Sanliurfa",37.1671,38.7955,16.8428571428571,9.55714285714286,0.540428571428571,67.9571428571429,87.7171428571429,NA,386,76,168,5,6,619,310,451
2017,49,79,"Sanliurfa",37.1671,38.7955,19.5714285714286,7.74285714285714,0.290285714285714,56.3142857142857,104.057142857143,NA,407,150,190,18,13,645,257,455
2017,50,79,"Sanliurfa",37.1671,38.7955,14.6714285714286,9.71428571428571,0.000857142857142857,54.6142857142857,129.787142857143,NA,346,97,46,26,59,442,249,396
2017,51,79,"Sanliurfa",37.1671,38.7955,18.6857142857143,10.2714285714286,0.393571428571429,68.9857142857143,276.981428571429,NA,386,278,244,0,0,349,108,105
2017,52,79,"Sanliurfa",37.1671,38.7955,18.725,8.5875,0.127125,61.525,128.12,NA,528,263,285,66,32,507,265,222
2018,1,79,"Sanliurfa",37.1671,38.7955,21.075,7.25,1.753125,72.175,72.585,NA,618,56,51,12,70,914,562,863
2018,2,79,"Sanliurfa",37.1671,38.7955,18.8714285714286,8.37142857142857,0.000142857142857143,50.7142857142857,126.845714285714,NA,624,410,424,8,6,1309,214,885
2018,3,79,"Sanliurfa",37.1671,38.7955,24.5857142857143,6.25714285714286,9.693,78.4,111.176,NA,639,75,88,13,181,655,564,567
2018,4,79,"Sanliurfa",37.1671,38.7955,22,6.48571428571429,10.425,86.3142857142857,94.6942857142857,NA,604,283,349,6,9,764,321,415
2018,5,79,"Sanliurfa",37.1671,38.7955,11.8,7.42857142857143,0,62.6285714285714,89.3785714285714,NA,670,140,144,198,290,819,530,675
2018,6,79,"Sanliurfa",37.1671,38.7955,13.3,10.6857142857143,0.000428571428571429,55.1285714285714,105.115714285714,NA,704,397,475,2,0,1022,307,547
2018,7,79,"Sanliurfa",37.1671,38.7955,21.4,9.32857142857143,8.45457142857143,73.6571428571429,58.9842857142857,NA,478,197,249,76,117,557,281,308
2018,8,79,"Sanliurfa",37.1671,38.7955,14.4714285714286,9.2,3.46671428571429,76.0857142857143,57.2142857142857,NA,711,196,395,66,164,1321,515,926
2018,9,79,"Sanliurfa",37.1671,38.7955,16.1714285714286,9.48571428571429,3.79928571428571,83.6,70.8414285714286,NA,621,255,387,54,88,956,366,569
2018,10,79,"Sanliurfa",37.1671,38.7955,18.9714285714286,13.4285714285714,0.0984285714285714,60.1,81.8342857142857,NA,556,89,171,143,484,1330,467,1159
2018,11,79,"Sanliurfa",37.1671,38.7955,13.7714285714286,13.7428571428571,0.00442857142857143,57.0428571428571,37.62,NA,551,1,1,318,791,1426,550,1425
2018,12,79,"Sanliurfa",37.1671,38.7955,30.9571428571429,16.4571428571429,0,47.1857142857143,94.4571428571429,NA,425,50,353,172,341,1187,375,834
2018,13,79,"Sanliurfa",37.1671,38.7955,18.2857142857143,15.9857142857143,0.492,47.7142857142857,72.2785714285714,NA,356,33,60,105,130,428,323,368
2018,14,79,"Sanliurfa",37.1671,38.7955,20.9428571428571,18.4285714285714,0,26.8857142857143,32.9585714285714,NA,407,74,77,55,35,486,333,409
2018,15,79,"Sanliurfa",37.1671,38.7955,23.0857142857143,17.7857142857143,3.11885714285714,54.8428571428571,41.3842857142857,NA,374,137,226,56,49,450,237,224
2018,16,79,"Sanliurfa",37.1671,38.7955,19.4142857142857,18.5571428571429,1.98385714285714,37.9714285714286,43.3714285714286,NA,411,15,5,225,352,648,396,643
2018,17,79,"Sanliurfa",37.1671,38.7955,16.5142857142857,19.7857142857143,0.359,44.8714285714286,56.8757142857143,NA,419,200,287,44,83,652,219,365
2018,18,79,"Sanliurfa",37.1671,38.7955,22.6428571428571,20.9714285714286,0.428,55.6857142857143,44.9085714285714,NA,303,134,139,11,27,474,169,335
2018,19,79,"Sanliurfa",37.1671,38.7955,14.7142857142857,15.9571428571429,7.09371428571429,81.2142857142857,37.25,NA,275,80,99,71,94,467,195,368
2018,20,79,"Sanliurfa",37.1671,38.7955,14.6714285714286,23.9285714285714,0.0237142857142857,40.9142857142857,32.2128571428571,NA,204,42,37,19,43,306,162,269
2018,21,79,"Sanliurfa",37.1671,38.7955,20.3,25.1714285714286,1.27885714285714,40.0142857142857,60.8442857142857,NA,252,60,17,76,100,281,192,264
2018,22,79,"Sanliurfa",37.1671,38.7955,18.4714285714286,22.9142857142857,1.40757142857143,52.2571428571429,44.3242857142857,NA,249,13,13,80,220,427,236,414
2018,23,79,"Sanliurfa",37.1671,38.7955,18.6,27.0714285714286,0.486571428571429,33.5857142857143,42.3457142857143,NA,267,7,15,90,339,812,260,797
2018,24,79,"Sanliurfa",37.1671,38.7955,18.4571428571429,26.6428571428571,0.339,42.1285714285714,53.4614285714286,NA,267,25,22,94,102,448,242,426
2018,25,79,"Sanliurfa",37.1671,38.7955,27.8,27.6714285714286,0,41.4428571428571,35.2657142857143,NA,358,0,0,327,435,518,358,518
2018,26,79,"Sanliurfa",37.1671,38.7955,27.9,29.7428571428571,0,35.7,55.3625,NA,355,0,0,313,493,587,355,587
2018,27,79,"Sanliurfa",37.1671,38.7955,18.4,32.1571428571429,0,28.6571428571429,63.4366666666667,NA,342,5,2,198,230,418,337,416
2018,28,79,"Sanliurfa",37.1671,38.7955,20.9,31.4714285714286,0,35.9714285714286,62.3828571428571,NA,286,33,67,147,223,585,253,518
2018,29,79,"Sanliurfa",37.1671,38.7955,23.8857142857143,30.5428571428571,0,29.3571428571429,40.3142857142857,NA,260,1,2,84,210,756,259,754
2018,30,79,"Sanliurfa",37.1671,38.7955,25.9428571428571,30.4285714285714,0,36.7857142857143,50.4114285714286,NA,265,0,0,188,663,822,265,822
2018,31,79,"Sanliurfa",37.1671,38.7955,22.3714285714286,31.6142857142857,0,39.2571428571429,26.8328571428571,NA,267,1,1,116,161,499,266,498
2018,32,79,"Sanliurfa",37.1671,38.7955,25.2285714285714,31,0,33.8285714285714,26.9785714285714,NA,297,0,0,126,205,403,297,403
2018,33,79,"Sanliurfa",37.1671,38.7955,23.7285714285714,31.6857142857143,0,28.5142857142857,32.5271428571429,NA,216,0,0,81,203,332,216,332
2018,34,79,"Sanliurfa",37.1671,38.7955,23.6142857142857,31.2714285714286,0,37.0285714285714,25.1728571428571,NA,144,2,0,77,101,227,142,227
2018,35,79,"Sanliurfa",37.1671,38.7955,14.5714285714286,30.2857142857143,0,36.8571428571429,26.6928571428571,NA,201,20,61,40,114,314,181,253
2018,36,79,"Sanliurfa",37.1671,38.7955,19.4857142857143,28.2714285714286,0.012,37.8428571428571,23.1085714285714,NA,341,41,52,179,174,370,300,318
2018,37,79,"Sanliurfa",37.1671,38.7955,21.7,25.9142857142857,0.356571428571429,41.9571428571429,27.5257142857143,NA,241,86,118,54,77,419,155,301
2018,38,79,"Sanliurfa",37.1671,38.7955,19.1,27.4428571428571,0,26.2428571428571,47.6785714285714,NA,189,28,2,59,135,344,161,342
2018,39,79,"Sanliurfa",37.1671,38.7955,17.3,26.9428571428571,0,30.2428571428571,64.68,NA,180,8,35,89,205,353,172,318
2018,40,79,"Sanliurfa",37.1671,38.7955,17.2714285714286,24.6857142857143,0,27.4857142857143,60.3728571428571,NA,191,11,13,63,126,341,180,328
2018,41,79,"Sanliurfa",37.1671,38.7955,19.9714285714286,22.7142857142857,0.941,43.6285714285714,130.707142857143,NA,187,78,98,18,69,422,109,324
2018,42,79,"Sanliurfa",37.1671,38.7955,20.2571428571429,21.7,1.90514285714286,48.1285714285714,116.846666666667,NA,168,86,92,11,52,381,82,289
2018,43,79,"Sanliurfa",37.1671,38.7955,22.9857142857143,15,3.158,73.6285714285714,61.3342857142857,NA,187,36,150,41,74,402,151,252
2018,44,79,"Sanliurfa",37.1671,38.7955,18.1428571428571,17.4285714285714,0.863,41.4,62.0542857142857,NA,196,62,47,31,68,264,134,217
2018,45,79,"Sanliurfa",37.1671,38.7955,12.8,13.1142857142857,5.85214285714286,79.1714285714286,51.2328571428571,NA,231,42,53,33,149,473,189,420
2018,46,79,"Sanliurfa",37.1671,38.7955,16.5571428571429,10.9428571428571,3.01314285714286,68.7857142857143,60.8171428571429,NA,230,62,121,26,99,465,168,344
2018,47,79,"Sanliurfa",37.1671,38.7955,14.1857142857143,11.1714285714286,0.962714285714286,76.7571428571429,86.8657142857143,NA,270,60,86,41,276,499,210,413
2018,48,79,"Sanliurfa",37.1671,38.7955,21.6428571428571,10.4714285714286,12.1174285714286,91.7571428571429,63.2814285714286,NA,245,72,112,2,0,201,173,89
2018,49,79,"Sanliurfa",37.1671,38.7955,17.3714285714286,9.62857142857143,4.68714285714286,90.7714285714286,69.1885714285714,NA,257,138,273,2,11,420,119,147
2018,50,79,"Sanliurfa",37.1671,38.7955,24.3428571428571,8.48571428571429,4.923,81.7285714285714,70.1814285714286,NA,256,106,147,31,29,305,150,158
2018,51,79,"Sanliurfa",37.1671,38.7955,19.9285714285714,7.82857142857143,10.1948571428571,86.0857142857143,74.92,NA,250,77,46,22,81,248,173,202
2018,52,79,"Sanliurfa",37.1671,38.7955,25.9714285714286,4.94285714285714,16.9132857142857,84.3857142857143,60.2385714285714,NA,244,81,138,20,64,273,163,135
2019,1,79,"Sanliurfa",37.1671,38.7955,27.8125,6.15,8.74275,92.2375,65.83,NA,343,123,205,9,13,784,220,579
2019,2,79,"Sanliurfa",37.1671,38.7955,22.4857142857143,2.94285714285714,6.88785714285714,79.0857142857143,69.6985714285714,NA,255,66,32,69,28,208,189,176
2019,3,79,"Sanliurfa",37.1671,38.7955,22.4428571428571,3.81428571428571,2.41742857142857,73.9,86.0971428571429,NA,192,51,38,17,55,198,141,160
2019,4,79,"Sanliurfa",37.1671,38.7955,21.1142857142857,6.05714285714286,0,74.7285714285714,163.977142857143,NA,308,139,195,2,6,314,169,119
2019,5,79,"Sanliurfa",37.1671,38.7955,22.0714285714286,7.68571428571429,3.88771428571429,75.4142857142857,84.53,NA,253,19,13,39,62,143,234,130
2019,6,79,"Sanliurfa",37.1671,38.7955,22.2857142857143,6.57142857142857,5.87085714285714,75.7,66.3785714285714,NA,276,208,70,3,1,127,68,57
2019,7,79,"Sanliurfa",37.1671,38.7955,15.2571428571429,6.71428571428571,4.85985714285714,78.0142857142857,63.8357142857143,NA,325,74,22,26,121,234,251,212
2019,8,79,"Sanliurfa",37.1671,38.7955,17.1428571428571,8.37142857142857,0.601857142857143,66.5571428571429,68.4633333333333,NA,305,65,32,22,62,219,240,187
2019,9,79,"Sanliurfa",37.1671,38.7955,19.4428571428571,7.57142857142857,5.02014285714286,72.6285714285714,42.28,NA,331,44,91,63,53,310,287,219
2019,10,79,"Sanliurfa",37.1671,38.7955,23.0857142857143,9.32857142857143,2.08271428571429,64.2714285714286,45.7471428571429,NA,359,66,15,112,140,252,293,237
2019,11,79,"Sanliurfa",37.1671,38.7955,31.7142857142857,10.0285714285714,10.6672857142857,77.9428571428572,42.1457142857143,NA,373,106,175,57,56,400,267,225
2019,12,79,"Sanliurfa",37.1671,38.7955,23.1142857142857,11.4428571428571,3.37285714285714,56.4714285714286,37.4671428571429,NA,343,103,43,53,34,416,240,373
2019,13,79,"Sanliurfa",37.1671,38.7955,20.9714285714286,9.48571428571429,7.14471428571429,86.7571428571429,26.1814285714286,NA,256,73,22,25,64,194,183,172
2019,14,79,"Sanliurfa",37.1671,38.7955,16.9142857142857,11.2428571428571,6.489,83.9714285714286,15.985,NA,365,134,93,100,23,208,231,115
2019,15,79,"Sanliurfa",37.1671,38.7955,18.5,15.3714285714286,0.223,65.3,14.7828571428571,NA,359,69,29,108,46,183,290,154
2019,16,79,"Sanliurfa",37.1671,38.7955,17.9571428571429,10.4428571428571,7.95485714285714,83.0285714285714,11.906,NA,318,31,17,195,101,208,287,191
2019,17,79,"Sanliurfa",37.1671,38.7955,13.9142857142857,15.1714285714286,0,47.6714285714286,NA,NA,412,127,114,68,77,313,285,199
2019,18,79,"Sanliurfa",37.1671,38.7955,17.4142857142857,18.5857142857143,0.699714285714286,59.2285714285714,14.7575,NA,523,171,192,202,82,353,352,161
2019,19,79,"Sanliurfa",37.1671,38.7955,18.9857142857143,18.5571428571429,0.228142857142857,53.5285714285714,11.8685714285714,NA,452,183,156,185,162,386,269,230
2019,20,79,"Sanliurfa",37.1671,38.7955,17.5285714285714,25.8142857142857,0,34.4857142857143,16.8171428571429,NA,454,331,257,80,73,389,123,132
2019,21,79,"Sanliurfa",37.1671,38.7955,21.8,26.3857142857143,0.280285714285714,31.8428571428571,14.872,NA,457,1,0,214,96,413,456,413
2019,22,79,"Sanliurfa",37.1671,38.7955,17.2714285714286,29.7714285714286,0,22.5,19.34,NA,453,252,151,6,3,323,201,172
2019,23,79,"Sanliurfa",37.1671,38.7955,24.0714285714286,29.4,0.984285714285714,26.3142857142857,17.6742857142857,NA,378,6,3,279,397,532,372,529
2019,24,79,"Sanliurfa",37.1671,38.7955,19.8142857142857,27.6142857142857,0.715571428571429,38.4142857142857,13.5,NA,378,48,36,157,77,244,330,208
2019,25,79,"Sanliurfa",37.1671,38.7955,21.6857142857143,27.6714285714286,0.00142857142857143,44.3142857142857,12.8914285714286,NA,306,2,1,270,288,325,304,324
2019,26,79,"Sanliurfa",37.1671,38.7955,21.8714285714286,32.4857142857143,0,25.8714285714286,15.5557142857143,NA,377,0,0,111,79,342,377,342
2019,27,79,"Sanliurfa",37.1671,38.7955,24.5285714285714,30.3428571428571,0,26.7714285714286,14.7742857142857,NA,456,27,14,198,69,222,429,208
2019,28,79,"Sanliurfa",37.1671,38.7955,27.3285714285714,30.5857142857143,0.000142857142857143,29.0285714285714,12.002,NA,398,0,0,119,130,421,398,421
2019,29,79,"Sanliurfa",37.1671,38.7955,20.5571428571429,29.3,0,37.2,15.6057142857143,NA,453,0,0,306,133,203,453,203
2019,30,79,"Sanliurfa",37.1671,38.7955,21.9714285714286,31.4142857142857,0.000142857142857143,30.5428571428571,24.0428571428571,NA,456,1,0,198,159,335,455,335
2019,31,79,"Sanliurfa",37.1671,38.7955,22.5714285714286,31.8857142857143,0,34.3142857142857,31.3914285714286,NA,334,8,5,200,246,375,326,370
2019,32,79,"Sanliurfa",37.1671,38.7955,21.1,32.4285714285714,0,22.3857142857143,28.79,NA,346,0,0,40,55,395,346,395
2019,33,79,"Sanliurfa",37.1671,38.7955,23.6428571428571,32.7,0,31.8285714285714,27.9116666666667,NA,337,88,122,145,285,531,249,409
2019,34,79,"Sanliurfa",37.1671,38.7955,17.9142857142857,30.2,0.000428571428571429,36.2,19.9071428571429,NA,299,77,112,81,103,345,222,233
2019,35,79,"Sanliurfa",37.1671,38.7955,20.2714285714286,31,0.00514285714285714,31.8,21.95,NA,307,133,157,117,150,415,174,258
2019,36,79,"Sanliurfa",37.1671,38.7955,19.0714285714286,28.9428571428571,0,29.6142857142857,18.4328571428571,NA,171,0,0,54,39,67,171,67
2019,37,79,"Sanliurfa",37.1671,38.7955,21.3,27.9,0.028,26.4571428571429,24.096,NA,218,86,24,14,10,55,132,31
2019,38,79,"Sanliurfa",37.1671,38.7955,20,25.5428571428571,0,35.0571428571429,59.26,NA,266,2,1,127,51,91,264,90
2019,39,79,"Sanliurfa",37.1671,38.7955,13.4285714285714,24.8,0,33.5142857142857,64.99,NA,237,19,6,88,36,79,218,73
2019,40,79,"Sanliurfa",37.1671,38.7955,19.5,25.4571428571429,0,34.5,79.0914285714286,NA,241,28,4,167,84,111,213,107
2019,41,79,"Sanliurfa",37.1671,38.7955,17.1,24.9142857142857,0,33.2,78.4728571428572,NA,416,70,16,130,231,448,346,432
2019,42,79,"Sanliurfa",37.1671,38.7955,19.0428571428571,23.3714285714286,0.735,39.8714285714286,78.47,NA,356,58,17,95,204,408,298,391
2019,43,79,"Sanliurfa",37.1671,38.7955,17.4428571428571,18.3285714285714,2.966,59.5428571428571,50.7185714285714,NA,306,79,37,61,130,300,227,263
2019,44,79,"Sanliurfa",37.1671,38.7955,15.3285714285714,15.2714285714286,3.16742857142857,64.4714285714286,34.6385714285714,NA,350,45,38,131,104,250,305,212
2019,45,79,"Sanliurfa",37.1671,38.7955,14.9857142857143,16.6285714285714,0,40.4142857142857,51.2985714285714,NA,417,75,28,83,127,328,342,300
2019,46,79,"Sanliurfa",37.1671,38.7955,16.3714285714286,16.1,0,29.7428571428571,75.9328571428571,NA,401,179,109,38,84,337,222,228
2019,47,79,"Sanliurfa",37.1671,38.7955,12.9714285714286,12.3,0,31.3714285714286,91.5771428571429,NA,391,122,83,88,63,339,269,256
2019,48,79,"Sanliurfa",37.1671,38.7955,17.4285714285714,11.2285714285714,1.38714285714286,67.8285714285714,80.9414285714286,NA,320,72,67,4,2,251,248,184
2019,49,79,"Sanliurfa",37.1671,38.7955,20.1428571428571,7.9,20.5528571428571,74.7142857142857,38.4314285714286,NA,393,205,140,13,8,274,188,134
2019,50,79,"Sanliurfa",37.1671,38.7955,22.5,7.01428571428571,15.0144285714286,96.0571428571429,27.165,NA,218,153,109,0,0,119,65,10
2019,51,79,"Sanliurfa",37.1671,38.7955,15.8857142857143,10.5285714285714,0,60.2142857142857,56.8385714285714,NA,361,62,109,21,23,488,299,379
2019,52,79,"Sanliurfa",37.1671,38.7955,29.4857142857143,7.02857142857143,6.298,88.7285714285714,39.2885714285714,NA,279,114,149,0,0,281,165,132
2020,1,79,"Sanliurfa",37.1671,38.7955,19.7,4.9,10.0808,95.14,24.042,NA,160,74,84,14,9,126,86,42
2020,2,79,"Sanliurfa",37.1671,38.7955,24.5428571428571,5.82857142857143,0.0467142857142857,75.8714285714286,32.3442857142857,NA,240,70,65,22,21,173,170,108
2020,3,79,"Sanliurfa",37.1671,38.7955,21.0714285714286,5.02857142857143,1.37342857142857,63.4285714285714,59.49,NA,270,117,240,10,14,382,153,142
2020,4,79,"Sanliurfa",37.1671,38.7955,19.6571428571429,4.92857142857143,2.31771428571429,58.5142857142857,49.0142857142857,NA,358,104,94,19,10,295,254,201
2020,5,79,"Sanliurfa",37.1671,38.7955,21.0285714285714,6.4,2.283,65.9857142857143,68.6457142857143,NA,331,134,152,11,5,272,197,120
2020,6,79,"Sanliurfa",37.1671,38.7955,31.9142857142857,4.9,1.507,74.4285714285714,48.2242857142857,NA,343,30,31,35,4,267,313,236
2020,7,79,"Sanliurfa",37.1671,38.7955,19.8571428571429,0.0142857142857142,1.69028571428571,63.4857142857143,24.53,NA,341,127,91,19,3,338,214,247
2020,8,79,"Sanliurfa",37.1671,38.7955,22.1,8.88571428571429,0.661571428571429,75.9571428571429,66.7633333333333,NA,283,160,70,44,27,187,123,117
2020,9,79,"Sanliurfa",37.1671,38.7955,16.3,10.6857142857143,0.0337142857142857,58.8714285714286,48.0085714285714,NA,393,60,52,3,1,528,333,476
2020,10,79,"Sanliurfa",37.1671,38.7955,18.0857142857143,13.1571428571429,0.0914285714285714,48.7714285714286,37.5985714285714,NA,205,57,42,16,17,210,148,168
2020,11,79,"Sanliurfa",37.1671,38.7955,25,14.6428571428571,4.26785714285714,62.5857142857143,27.4542857142857,NA,115,59,48,8,1,94,56,46
2020,12,79,"Sanliurfa",37.1671,38.7955,21.4285714285714,9.72857142857143,12.3962857142857,78.8142857142857,13.6385714285714,NA,117,52,70,18,11,118,65,48
2020,13,79,"Sanliurfa",37.1671,38.7955,24.5142857142857,12.5285714285714,0.952285714285714,71.6285714285714,13.3442857142857,NA,136,57,47,12,8,92,79,45
2020,14,79,"Sanliurfa",37.1671,38.7955,20.3142857142857,11.2714285714286,9.95,75.6857142857143,8.95,NA,155,42,25,47,38,121,113,96
2020,15,79,"Sanliurfa",37.1671,38.7955,18.3714285714286,14.9857142857143,0.860142857142857,61.7714285714286,NA,NA,133,52,21,17,15,118,81,97
2020,16,79,"Sanliurfa",37.1671,38.7955,18.1,17.8714285714286,0.00814285714285714,44.0285714285714,NA,NA,141,17,6,72,54,106,124,100
2020,17,79,"Sanliurfa",37.1671,38.7955,18.5428571428571,17.2571428571429,2.17485714285714,56.6857142857143,NA,NA,137,11,40,42,51,123,126,83
2020,18,79,"Sanliurfa",37.1671,38.7955,17.1285714285714,16.8571428571429,3.34342857142857,59.8285714285714,NA,NA,146,13,48,71,50,164,133,116
2020,19,79,"Sanliurfa",37.1671,38.7955,20.2,17.9142857142857,0.239857142857143,57.1428571428571,NA,NA,137,11,0,43,36,157,126,157
2020,20,79,"Sanliurfa",37.1671,38.7955,19.0142857142857,24.9142857142857,0,33.8857142857143,22.4466666666667,NA,164,14,1,62,86,164,150,163
2020,21,79,"Sanliurfa",37.1671,38.7955,25.7857142857143,25.5285714285714,1.83628571428571,34.6428571428571,20.8542857142857,NA,146,7,2,55,40,96,139,94
2020,22,79,"Sanliurfa",37.1671,38.7955,22.8571428571429,21.5714285714286,0.0105714285714286,43.7714285714286,9.47,NA,118,37,22,45,34,100,81,78
2020,23,79,"Sanliurfa",37.1671,38.7955,18.4714285714286,24.9,0,31.8,15.88,NA,112,21,4,65,40,70,91,66
2020,24,79,"Sanliurfa",37.1671,38.7955,22.8142857142857,27.3714285714286,0.000285714285714286,32.9,21.5766666666667,NA,140,32,52,72,46,150,108,98
2020,25,79,"Sanliurfa",37.1671,38.7955,22.5,27.2,0.0585714285714286,36.6571428571429,NA,NA,137,0,0,60,57,108,137,108
2020,26,79,"Sanliurfa",37.1671,38.7955,23.8428571428571,29.9285714285714,0,31.3571428571429,NA,NA,173,0,0,77,78,133,173,133
2020,27,79,"Sanliurfa",37.1671,38.7955,23.9,31.9285714285714,0,24.5428571428571,23.4,NA,113,7,4,23,41,113,106,109
2020,28,79,"Sanliurfa",37.1671,38.7955,25.8857142857143,32.6571428571429,0,28.1,16.95,NA,164,20,2,55,51,122,144,120
2020,29,79,"Sanliurfa",37.1671,38.7955,20.5285714285714,32.2285714285714,0,29.6142857142857,14.1842857142857,NA,186,26,6,50,34,111,160,105
2020,30,79,"Sanliurfa",37.1671,38.7955,19.5857142857143,33.4428571428571,0,28.2571428571429,16.9666666666667,NA,190,51,21,35,41,142,139,121
2020,31,79,"Sanliurfa",37.1671,38.7955,18.7285714285714,34.2428571428571,0.000714285714285714,21.7285714285714,17.3785714285714,NA,150,18,17,33,39,127,132,110
2020,32,79,"Sanliurfa",37.1671,38.7955,24,32.8428571428571,0,24.5571428571429,12.6685714285714,NA,146,0,0,57,42,107,146,107
2020,33,79,"Sanliurfa",37.1671,38.7955,21.7714285714286,30.4857142857143,0,30.8285714285714,13.025,NA,183,0,0,78,30,83,183,83
2020,34,79,"Sanliurfa",37.1671,38.7955,21.4857142857143,29.7428571428571,0.000571428571428571,31,13.3916666666667,NA,197,0,0,114,70,97,197,97
2020,35,79,"Sanliurfa",37.1671,38.7955,18.7,30.8285714285714,0,22.7142857142857,19.0257142857143,NA,164,1,0,64,57,157,163,157
2020,36,79,"Sanliurfa",37.1671,38.7955,19.1142857142857,33.4714285714286,0,18.0857142857143,25.0757142857143,NA,179,28,24,38,16,112,151,88
2020,37,79,"Sanliurfa",37.1671,38.7955,19.9571428571429,30.9714285714286,0,23.8428571428571,19.6585714285714,NA,193,47,9,53,26,91,146,82
2020,38,79,"Sanliurfa",37.1671,38.7955,15.4857142857143,29.5142857142857,0,31.6142857142857,19.1085714285714,NA,235,0,0,147,88,157,235,157
2020,39,79,"Sanliurfa",37.1671,38.7955,14.7857142857143,26.7428571428571,0,42.1142857142857,56.0228571428571,NA,220,17,9,112,44,129,203,120
2020,40,79,"Sanliurfa",37.1671,38.7955,17.4142857142857,26.4,0,32.0857142857143,62.6128571428571,NA,187,0,0,84,70,154,187,154
2020,41,79,"Sanliurfa",37.1671,38.7955,15.4142857142857,23.4285714285714,0,22.2142857142857,66.0471428571429,NA,182,52,30,25,21,127,130,97
2020,42,79,"Sanliurfa",37.1671,38.7955,12.9428571428571,24.5714285714286,0,26.9857142857143,95.3342857142857,NA,177,37,9,46,35,111,140,102
2020,43,79,"Sanliurfa",37.1671,38.7955,14.5571428571429,23.4857142857143,0,29.1857142857143,91.95,NA,194,32,65,44,30,161,162,96
2020,44,79,"Sanliurfa",37.1671,38.7955,16.6714285714286,21.9142857142857,0,23.7,172.125,NA,255,169,153,0,0,233,86,80
2020,45,79,"Sanliurfa",37.1671,38.7955,20.0285714285714,14.6285714285714,10.2171428571429,71.7142857142857,51.6414285714286,NA,156,60,18,10,6,103,96,85
2020,46,79,"Sanliurfa",37.1671,38.7955,14.3714285714286,14.3857142857143,0,53.0714285714286,62.2142857142857,NA,208,57,10,45,34,109,151,99
2020,47,79,"Sanliurfa",37.1671,38.7955,14.7857142857143,10.8857142857143,1.09114285714286,70.2285714285714,67.2285714285714,NA,173,51,24,27,17,83,122,59
2020,48,79,"Sanliurfa",37.1671,38.7955,21.6857142857143,9.91428571428571,1.15314285714286,57.3428571428571,68.1357142857143,NA,199,66,82,26,26,262,133,180
2020,49,79,"Sanliurfa",37.1671,38.7955,19.5142857142857,9.57142857142857,1.40228571428571,72.7142857142857,72.7971428571429,NA,207,73,41,29,17,116,134,75
2020,50,79,"Sanliurfa",37.1671,38.7955,18.7571428571429,8.51428571428571,0.352714285714286,65.5571428571429,72.5585714285714,NA,181,91,32,16,35,98,90,66
2020,51,79,"Sanliurfa",37.1671,38.7955,21.6714285714286,9.15714285714286,1.12814285714286,75.8714285714286,67.4714285714286,NA,171,46,24,22,9,90,125,66
2020,52,79,"Sanliurfa",37.1671,38.7955,19.0714285714286,5.7,0.129142857142857,57.3142857142857,74.6928571428571,NA,203,45,8,42,22,113,158,105
2020,53,79,"Sanliurfa",37.1671,38.7955,14,8.825,0,48.825,117.95,NA,122,26,4,27,13,111,96,107
2017,1,80,"Siirt",37.9333,41.9333,10.1714285714286,2.64285714285714,0.742714285714286,77.8428571428571,85.2528571428571,NA,563,214,364,147,204,847,349,483
2017,2,80,"Siirt",37.9333,41.9333,11.7428571428571,2.47142857142857,0.0142857142857143,71.9857142857143,125.921666666667,NA,757,217,423,186,234,1214,540,791
2017,3,80,"Siirt",37.9333,41.9333,10.9428571428571,2.75714285714286,0,69.4857142857143,141.765,NA,762,449,793,98,183,1449,313,656
2017,4,80,"Siirt",37.9333,41.9333,14.0714285714286,1.34285714285714,5.32928571428571,76.7571428571429,66.93,NA,639,221,373,283,332,889,418,516
2017,5,80,"Siirt",37.9333,41.9333,13.0428571428571,-5.08571428571429,1.35714285714286,81.5857142857143,83.3685714285714,NA,588,135,187,258,738,1163,453,976
2017,6,80,"Siirt",37.9333,41.9333,9.11428571428571,0.1,0.713857142857143,87.1714285714286,127.067142857143,NA,736,402,805,126,251,1519,334,714
2017,7,80,"Siirt",37.9333,41.9333,14.8428571428571,0.3,3.85314285714286,67.8428571428571,64.7642857142857,NA,492,380,485,0,0,717,112,232
2017,8,80,"Siirt",37.9333,41.9333,12.2,5.4,0.0571428571428571,59.5857142857143,102.082857142857,NA,739,479,1075,195,597,1747,260,672
2017,9,80,"Siirt",37.9333,41.9333,14.5857142857143,9.15714285714286,4.02842857142857,71.6285714285714,85.0028571428571,NA,574,432,677,11,13,866,142,189
2017,10,80,"Siirt",37.9333,41.9333,19.3285714285714,11.2714285714286,0.885142857142857,54.8571428571429,65.8457142857143,NA,712,244,339,80,82,1043,468,704
2017,11,80,"Siirt",37.9333,41.9333,17.2857142857143,7.28571428571429,16.78,84.5714285714286,48.0242857142857,NA,525,253,273,128,174,725,272,452
2017,12,80,"Siirt",37.9333,41.9333,15.4571428571429,7.47142857142857,4.62542857142857,73.0142857142857,48.8733333333333,NA,589,182,285,89,128,1077,407,792
2017,13,80,"Siirt",37.9333,41.9333,20.9285714285714,12.0285714285714,6.12514285714286,71.3571428571429,46.0885714285714,NA,574,202,334,151,237,887,372,553
2017,14,80,"Siirt",37.9333,41.9333,15.7285714285714,11.3571428571429,6.33814285714286,71.8571428571429,42.7371428571429,NA,639,123,242,216,458,1336,516,1094
2017,15,80,"Siirt",37.9333,41.9333,12.8857142857143,12.1857142857143,8.567,76.3857142857143,44.7757142857143,NA,587,123,458,206,273,1187,464,729
2017,16,80,"Siirt",37.9333,41.9333,16.0857142857143,15.1,4.98442857142857,70.4714285714286,55.05,NA,717,496,728,89,92,920,221,192
2017,17,80,"Siirt",37.9333,41.9333,16.4428571428571,15.2714285714286,1.14171428571429,57.2714285714286,47.6228571428571,NA,731,31,80,395,674,1478,700,1398
2017,18,80,"Siirt",37.9333,41.9333,15.6142857142857,15.1857142857143,6.99614285714286,77.9714285714286,48.3957142857143,NA,506,337,602,79,130,923,169,321
2017,19,80,"Siirt",37.9333,41.9333,13.9571428571429,19.3428571428571,1.65542857142857,63.1857142857143,73.16,NA,471,215,455,160,316,966,256,511
2017,20,80,"Siirt",37.9333,41.9333,15.8428571428571,19.8857142857143,3.45428571428571,56.4714285714286,49.215,NA,472,173,676,154,187,1205,299,529
2017,21,80,"Siirt",37.9333,41.9333,16.2,18.0571428571429,2.913,61.7285714285714,38.898,NA,448,253,496,180,334,849,195,353
2017,22,80,"Siirt",37.9333,41.9333,14.0571428571429,21.1857142857143,0,50.1285714285714,41.7614285714286,NA,522,173,328,124,143,1015,349,687
2017,23,80,"Siirt",37.9333,41.9333,13.5285714285714,25.2857142857143,0,44.4428571428571,45.4785714285714,NA,578,265,673,158,332,1388,313,715
2017,24,80,"Siirt",37.9333,41.9333,14.7142857142857,24.4285714285714,0,41.9142857142857,37.8928571428571,NA,552,15,89,370,722,1139,537,1050
2017,25,80,"Siirt",37.9333,41.9333,15.8571428571429,24.9571428571429,0,42.4714285714286,37.9528571428571,NA,584,53,72,401,650,1041,531,969
2017,26,80,"Siirt",37.9333,41.9333,14,29.5714285714286,0,34.7142857142857,53.6457142857143,NA,564,482,776,0,0,971,82,195
2017,27,80,"Siirt",37.9333,41.9333,13.5714285714286,29.4142857142857,0,35.8571428571429,57.7085714285714,NA,511,190,246,121,141,642,321,396
2017,28,80,"Siirt",37.9333,41.9333,17.2,29.4,0,34.9428571428571,53.5014285714286,NA,481,195,364,42,62,864,286,500
2017,29,80,"Siirt",37.9333,41.9333,13.8857142857143,29.9285714285714,0,34.0428571428571,56.5,NA,532,161,391,144,327,1272,371,881
2017,30,80,"Siirt",37.9333,41.9333,12.4857142857143,29.2285714285714,0,35.2714285714286,59.0057142857143,NA,531,93,140,243,416,928,438,788
2017,31,80,"Siirt",37.9333,41.9333,13.0142857142857,29.8428571428571,0,36.0571428571429,58.9014285714286,NA,559,372,654,147,208,1047,187,393
2017,32,80,"Siirt",37.9333,41.9333,14.5857142857143,30.1285714285714,0,32.2285714285714,56.4,NA,567,9,17,275,412,1092,558,1075
2017,33,80,"Siirt",37.9333,41.9333,15.6714285714286,29.5714285714286,0.0571428571428571,35.5857142857143,63.1628571428571,NA,596,227,482,85,185,1199,369,717
2017,34,80,"Siirt",37.9333,41.9333,12.4857142857143,28.1714285714286,0,33.9428571428571,62.6557142857143,NA,601,361,638,84,116,1280,240,642
2017,35,80,"Siirt",37.9333,41.9333,14.0285714285714,26.9428571428571,0,32.7142857142857,57.9157142857143,NA,493,142,251,285,621,1014,351,763
2017,36,80,"Siirt",37.9333,41.9333,13.9428571428571,25.2857142857143,0,30.9142857142857,52.1914285714286,NA,507,289,629,127,307,1321,218,692
2017,37,80,"Siirt",37.9333,41.9333,13.2571428571429,25.6285714285714,0,27.1571428571429,67.1114285714286,NA,589,475,861,2,0,1138,114,277
2017,38,80,"Siirt",37.9333,41.9333,13.7,25.7571428571429,0,30.4142857142857,89.9828571428571,NA,671,173,353,321,564,1312,498,959
2017,39,80,"Siirt",37.9333,41.9333,13.6142857142857,22.4571428571429,0,36.5,81.8242857142857,NA,782,194,379,149,153,1630,588,1251
2017,40,80,"Siirt",37.9333,41.9333,16.1285714285714,17.6142857142857,0.0857142857142857,40.7714285714286,46.4714285714286,NA,543,279,534,67,223,1137,264,603
2017,41,80,"Siirt",37.9333,41.9333,13.4142857142857,17.2571428571429,0,42.3285714285714,73.5342857142857,NA,487,239,281,173,376,843,248,562
2017,42,80,"Siirt",37.9333,41.9333,13.0285714285714,14.8,0,36.4571428571429,63.9842857142857,NA,530,251,327,62,103,815,279,488
2017,43,80,"Siirt",37.9333,41.9333,15.3142857142857,16.4714285714286,1.59928571428571,45.1142857142857,81.02,NA,506,288,438,5,7,919,218,481
2017,44,80,"Siirt",37.9333,41.9333,12.4142857142857,12.9142857142857,6.36714285714286,73.7142857142857,56.3842857142857,NA,561,188,461,194,297,1102,373,641
2017,45,80,"Siirt",37.9333,41.9333,11.9714285714286,12.9285714285714,1.79814285714286,80.6,55.84,NA,577,210,223,21,35,829,367,606
2017,46,80,"Siirt",37.9333,41.9333,13,10.9428571428571,1.24271428571429,68.2142857142857,74.08,NA,587,415,695,18,57,1085,172,390
2017,47,80,"Siirt",37.9333,41.9333,13.9285714285714,7.44285714285714,4.70985714285714,71.9714285714286,31.914,NA,418,204,421,170,296,804,214,383
2017,48,80,"Siirt",37.9333,41.9333,12.4571428571429,7.17142857142857,0.485714285714286,78.9142857142857,75.0014285714286,NA,386,275,422,0,0,619,111,197
2017,49,80,"Siirt",37.9333,41.9333,15.9714285714286,4.57142857142857,4.99814285714286,73.5428571428571,60.4371428571429,NA,407,304,475,0,0,645,103,170
2017,50,80,"Siirt",37.9333,41.9333,10.8142857142857,4.28571428571429,0,74.2428571428571,99.7985714285714,NA,346,209,296,0,0,442,137,146
2017,51,80,"Siirt",37.9333,41.9333,18.2714285714286,9.38571428571429,3.113,80.2571428571429,64.8957142857143,NA,386,251,236,0,0,349,135,113
2017,52,80,"Siirt",37.9333,41.9333,12.0875,7.025,0.62475,80.0375,73.82375,NA,528,333,397,10,10,507,195,110
2018,1,80,"Siirt",37.9333,41.9333,12.5375,5.925,4.048,84.525,47.5014285714286,NA,618,299,357,112,168,914,319,557
2018,2,80,"Siirt",37.9333,41.9333,12.0571428571429,4.3,0.285714285714286,72.3714285714286,83.9057142857143,NA,624,602,1282,0,0,1309,22,27
2018,3,80,"Siirt",37.9333,41.9333,20.1857142857143,5.01428571428571,4.75442857142857,87.1571428571429,50.3385714285714,NA,639,352,340,96,41,655,287,315
2018,4,80,"Siirt",37.9333,41.9333,18.1142857142857,6.3,1.26042857142857,81.8428571428571,70.965,NA,604,585,733,0,0,764,19,31
2018,5,80,"Siirt",37.9333,41.9333,10.7285714285714,4.02857142857143,0,68.8428571428571,NA,NA,670,284,385,211,158,819,386,434
2018,6,80,"Siirt",37.9333,41.9333,12.1285714285714,7.62857142857143,0.0142857142857143,66.6428571428571,NA,NA,704,328,413,0,0,1022,376,609
2018,7,80,"Siirt",37.9333,41.9333,14.6714285714286,8.4,5.71214285714286,83.9428571428572,NA,NA,478,272,294,77,75,557,206,263
2018,8,80,"Siirt",37.9333,41.9333,15.4,8.24285714285714,3.92628571428571,82.5571428571429,NA,NA,711,547,1047,62,163,1321,164,274
2018,9,80,"Siirt",37.9333,41.9333,13.8142857142857,9.61428571428571,9.549,82.6142857142857,NA,NA,621,392,608,93,156,956,229,348
2018,10,80,"Siirt",37.9333,41.9333,16.5571428571429,11.3,1.14171428571429,75.5571428571429,NA,NA,556,217,500,66,116,1330,339,830
2018,11,80,"Siirt",37.9333,41.9333,14.5,11.1285714285714,5.17114285714286,67.8857142857143,NA,NA,551,188,416,215,486,1426,363,1010
2018,12,80,"Siirt",37.9333,41.9333,17.4142857142857,14.9,0,53.2428571428571,NA,NA,425,276,859,21,16,1187,149,328
2018,13,80,"Siirt",37.9333,41.9333,16.3,13.4857142857143,1.37014285714286,64.4285714285714,NA,NA,356,118,187,63,77,428,238,241
2018,14,80,"Siirt",37.9333,41.9333,13.2428571428571,14.3714285714286,0,49.9285714285714,NA,NA,407,68,49,137,90,486,339,437
2018,15,80,"Siirt",37.9333,41.9333,16.5714285714286,15.5,13.4788571428571,70.2714285714286,26.18,NA,374,153,255,51,56,450,221,195
2018,16,80,"Siirt",37.9333,41.9333,16.3,15,0.171285714285714,57.6,26.8914285714286,NA,411,290,405,0,0,648,121,243
2018,17,80,"Siirt",37.9333,41.9333,15.7285714285714,16.0714285714286,1.18485714285714,64.5,27.8342857142857,NA,419,211,398,137,178,652,208,254
2018,18,80,"Siirt",37.9333,41.9333,14.2285714285714,17.7857142857143,7.25257142857143,74.4857142857143,23.7642857142857,NA,303,120,236,63,101,474,183,238
2018,19,80,"Siirt",37.9333,41.9333,15.1,15,11.6925714285714,85.2428571428571,17.1042857142857,NA,275,130,273,0,0,467,145,194
2018,20,80,"Siirt",37.9333,41.9333,11.9714285714286,19.9,2.88457142857143,63.0857142857143,25.66,NA,204,6,3,11,19,306,198,303
2018,21,80,"Siirt",37.9333,41.9333,15.4285714285714,22.7,5.68457142857143,55.9,46.3628571428571,NA,252,117,132,25,21,281,135,149
2018,22,80,"Siirt",37.9333,41.9333,21.2285714285714,23.0285714285714,4.26857142857143,54.3571428571429,49.2942857142857,NA,249,89,121,96,187,427,160,306
2018,23,80,"Siirt",37.9333,41.9333,13.3142857142857,24.4857142857143,0.0142857142857143,45.8285714285714,28.0557142857143,NA,267,61,119,57,211,812,206,693
2018,24,80,"Siirt",37.9333,41.9333,21.7714285714286,25.8285714285714,1.05714285714286,43.1142857142857,50.15,NA,267,60,34,148,151,448,207,414
2018,25,80,"Siirt",37.9333,41.9333,14.2857142857143,27.0714285714286,0.0285714285714286,38.8428571428571,39.7214285714286,NA,358,20,12,298,366,518,338,506
2018,26,80,"Siirt",37.9333,41.9333,14.1428571428571,29.3857142857143,0,34.6,50.04,NA,355,64,59,93,147,587,291,528
2018,27,80,"Siirt",37.9333,41.9333,15.1571428571429,30.9,0,30.6714285714286,69.7028571428571,NA,342,0,0,236,289,418,342,418
2018,28,80,"Siirt",37.9333,41.9333,14.0857142857143,30.6142857142857,0.0142857142857143,32.8571428571429,75.6485714285714,NA,286,36,61,166,294,585,250,524
2018,29,80,"Siirt",37.9333,41.9333,13.1857142857143,28.8,0.0998571428571428,34.9571428571429,62.1985714285714,NA,260,6,8,198,488,756,254,748
2018,30,80,"Siirt",37.9333,41.9333,12.3,29.4857142857143,0,33.8571428571429,68.5542857142857,NA,265,0,0,116,413,822,265,822
2018,31,80,"Siirt",37.9333,41.9333,14.6,30.6,0.228285714285714,36.1285714285714,69.6671428571429,NA,267,64,118,173,306,499,203,381
2018,32,80,"Siirt",37.9333,41.9333,13.0285714285714,30.0142857142857,0,32.5428571428571,47.2328571428571,NA,297,0,0,225,323,403,297,403
2018,33,80,"Siirt",37.9333,41.9333,12.7428571428571,29.9857142857143,0,31.9,55.8585714285714,NA,216,0,0,141,243,332,216,332
2018,34,80,"Siirt",37.9333,41.9333,12.2857142857143,29.8,0,31.6428571428571,50.4566666666667,NA,144,36,23,46,70,227,108,204
2018,35,80,"Siirt",37.9333,41.9333,13.3428571428571,29.1142857142857,0,31.5857142857143,56.1033333333333,NA,201,22,11,113,197,314,179,303
2018,36,80,"Siirt",37.9333,41.9333,15.6571428571429,26.9142857142857,0.142857142857143,33.4857142857143,60.8785714285714,NA,341,86,102,167,149,370,255,268
2018,37,80,"Siirt",37.9333,41.9333,14.2142857142857,25.4142857142857,0,37.0285714285714,68.9742857142857,NA,241,54,98,120,160,419,187,321
2018,38,80,"Siirt",37.9333,41.9333,12.8714285714286,24.8428571428571,0,32.3142857142857,52.8842857142857,NA,189,91,103,30,47,344,98,241
2018,39,80,"Siirt",37.9333,41.9333,12,23.7428571428571,0,30.0714285714286,44.7414285714286,NA,180,107,129,32,66,353,73,224
2018,40,80,"Siirt",37.9333,41.9333,12.4857142857143,22.8142857142857,0,34.3285714285714,44.8328571428571,NA,191,55,37,59,85,341,136,304
2018,41,80,"Siirt",37.9333,41.9333,13.7714285714286,21.1,2.799,53.0857142857143,138.18,NA,187,89,158,10,99,422,98,264
2018,42,80,"Siirt",37.9333,41.9333,15.8714285714286,20.1142857142857,1.05671428571429,54.0714285714286,59.5071428571429,NA,168,131,307,0,0,381,37,74
2018,43,80,"Siirt",37.9333,41.9333,14.2857142857143,14.6571428571429,19.2635714285714,80.2714285714286,41.7271428571429,NA,187,54,41,74,107,402,133,361
2018,44,80,"Siirt",37.9333,41.9333,8.38571428571429,13.7857142857143,0.0285714285714286,65.5285714285714,42.945,NA,196,104,74,20,34,264,92,190
2018,45,80,"Siirt",37.9333,41.9333,9.17142857142857,11.8428571428571,3.48471428571429,84.9285714285714,38.038,NA,231,108,242,44,109,473,123,231
2018,46,80,"Siirt",37.9333,41.9333,12.4142857142857,10.2,8.823,83.2857142857143,42.3128571428571,NA,230,37,74,124,204,465,193,391
2018,47,80,"Siirt",37.9333,41.9333,10.4285714285714,8.55714285714286,4.72571428571429,90.5714285714286,62.5842857142857,NA,270,146,54,30,18,499,124,445
2018,48,80,"Siirt",37.9333,41.9333,14.5857142857143,9.8,10.0524285714286,90.4428571428571,48.2285714285714,NA,245,150,124,64,28,201,95,77
2018,49,80,"Siirt",37.9333,41.9333,12.4571428571429,8.54285714285714,5.23842857142857,89.1714285714286,46.6814285714286,NA,257,181,324,9,21,420,76,96
2018,50,80,"Siirt",37.9333,41.9333,14.9142857142857,7.31428571428571,10.1937142857143,81.6,40.7714285714286,NA,256,136,94,45,22,305,120,211
2018,51,80,"Siirt",37.9333,41.9333,13.6857142857143,6.84285714285714,1.342,89.5142857142857,61.9042857142857,NA,250,165,166,45,47,248,85,82
2018,52,80,"Siirt",37.9333,41.9333,18.9857142857143,5.07142857142857,8.63628571428572,83.2714285714286,56.245,NA,244,98,69,29,18,273,146,204
2019,1,80,"Siirt",37.9333,41.9333,15.4625,5.95,2.7735,82.5375,43.5,NA,343,216,544,89,148,784,127,240
2019,2,80,"Siirt",37.9333,41.9333,18.1714285714286,1.82857142857143,7.35242857142857,78.9714285714286,27.62,NA,255,113,52,31,19,208,142,156
2019,3,80,"Siirt",37.9333,41.9333,14.4142857142857,3.34285714285714,2.685,81.5857142857143,NA,NA,192,7,10,95,122,198,185,188
2019,4,80,"Siirt",37.9333,41.9333,10.6285714285714,5.54285714285714,0.456714285714286,77.5142857142857,NA,NA,308,151,84,51,62,314,157,230
2019,5,80,"Siirt",37.9333,41.9333,12.4285714285714,6.11428571428571,7.82414285714286,83.4571428571429,30.8033333333333,NA,253,110,43,64,30,143,143,100
2019,6,80,"Siirt",37.9333,41.9333,11.4428571428571,5.11428571428571,5.27,78.8,49.5228571428571,NA,276,112,47,3,2,127,164,80
2019,7,80,"Siirt",37.9333,41.9333,14.5,5.18571428571429,2.25685714285714,78.0857142857143,44.2071428571429,NA,325,216,67,81,123,234,109,167
2019,8,80,"Siirt",37.9333,41.9333,11.4714285714286,5.74285714285714,0.314285714285714,70.3857142857143,42.8157142857143,NA,305,218,141,0,0,219,87,78
2019,9,80,"Siirt",37.9333,41.9333,15.6714285714286,5.58571428571429,14.9331428571429,78.3285714285714,26.1285714285714,NA,331,107,95,92,44,310,224,215
2019,10,80,"Siirt",37.9333,41.9333,12.4571428571429,7.68571428571429,2.57057142857143,74.7,27.3242857142857,NA,359,179,57,55,113,252,180,195
2019,11,80,"Siirt",37.9333,41.9333,19.2428571428571,9.58571428571429,5.09842857142857,75.5,31.6285714285714,NA,373,239,328,8,28,400,134,72
2019,12,80,"Siirt",37.9333,41.9333,14.8714285714286,7.75714285714286,10.1644285714286,67.8571428571429,24.3014285714286,NA,343,107,25,43,34,416,236,391
2019,13,80,"Siirt",37.9333,41.9333,16.3714285714286,9.2,12.7651428571429,87.8428571428571,22.8942857142857,NA,256,163,86,26,22,194,93,108
2019,14,80,"Siirt",37.9333,41.9333,14.9714285714286,10.7714285714286,8.385,84.6428571428571,21.59,NA,365,346,181,0,0,208,19,27
2019,15,80,"Siirt",37.9333,41.9333,13.8428571428571,13.4714285714286,3.28557142857143,74.5428571428571,NA,NA,359,242,91,9,15,183,117,92
2019,16,80,"Siirt",37.9333,41.9333,17.4285714285714,10.8,17.0335714285714,81.5,NA,NA,318,110,85,55,13,208,208,123
2019,17,80,"Siirt",37.9333,41.9333,11.2714285714286,11.5428571428571,2.42628571428571,68.0142857142857,NA,NA,412,208,75,72,63,313,204,238
2019,18,80,"Siirt",37.9333,41.9333,17.4857142857143,15.3714285714286,11.6207142857143,74.5571428571429,31.615,NA,523,430,193,66,39,353,93,160
2019,19,80,"Siirt",37.9333,41.9333,12.7714285714286,17.3142857142857,0.371428571428571,65.6857142857143,32.3028571428571,NA,452,254,213,76,72,386,198,173
2019,20,80,"Siirt",37.9333,41.9333,11.9285714285714,21.6428571428571,0,55.8714285714286,39.1242857142857,NA,454,185,128,97,90,389,269,261
2019,21,80,"Siirt",37.9333,41.9333,12.8428571428571,21.9571428571429,0,52,45.19,NA,457,212,83,8,14,413,245,330
2019,22,80,"Siirt",37.9333,41.9333,13.0285714285714,24.7428571428571,0,39.6857142857143,31.4942857142857,NA,453,225,181,35,25,323,228,142
2019,23,80,"Siirt",37.9333,41.9333,13.4714285714286,26.7285714285714,0,39.6142857142857,47.9871428571429,NA,378,257,458,48,29,532,121,74
2019,24,80,"Siirt",37.9333,41.9333,17.7428571428571,26.6,0.128571428571429,38.8571428571429,39.1928571428571,NA,378,167,84,207,156,244,211,160
2019,25,80,"Siirt",37.9333,41.9333,14.7428571428571,26.6142857142857,0.0144285714285714,42.5142857142857,37.6071428571429,NA,306,47,30,204,261,325,259,295
2019,26,80,"Siirt",37.9333,41.9333,14.4857142857143,29.3,0,35.8285714285714,42.8185714285714,NA,377,201,134,162,180,342,176,208
2019,27,80,"Siirt",37.9333,41.9333,15.6,28.2428571428571,0,30.4142857142857,38.205,NA,456,104,110,79,25,222,352,112
2019,28,80,"Siirt",37.9333,41.9333,13.5285714285714,28.5,0,37.0285714285714,33.4342857142857,NA,398,0,0,293,271,421,398,421
2019,29,80,"Siirt",37.9333,41.9333,13.8428571428571,27.7,0,41.8571428571429,42.3928571428571,NA,453,0,0,168,62,203,453,203
2019,30,80,"Siirt",37.9333,41.9333,13.2142857142857,28.9,0,38.0142857142857,43.8828571428571,NA,456,4,2,256,202,335,452,333
2019,31,80,"Siirt",37.9333,41.9333,12.4285714285714,29.7714285714286,0,35.9,44.1028571428571,NA,334,213,249,67,81,375,121,126
2019,32,80,"Siirt",37.9333,41.9333,12.5857142857143,29.1714285714286,0,34.7714285714286,40.9028571428571,NA,346,0,0,107,114,395,346,395
2019,33,80,"Siirt",37.9333,41.9333,14.3142857142857,30.3714285714286,0,39.1428571428571,48.1814285714286,NA,337,137,206,109,220,531,200,325
2019,34,80,"Siirt",37.9333,41.9333,12.6428571428571,28.3428571428571,0,40.0285714285714,42.9842857142857,NA,299,91,67,123,148,345,208,278
2019,35,80,"Siirt",37.9333,41.9333,14.8,27.6857142857143,0.371142857142857,38.6428571428571,42.4314285714286,NA,307,140,158,157,244,415,167,257
2019,36,80,"Siirt",37.9333,41.9333,11.1571428571429,25.9142857142857,0,37.2285714285714,42.044,NA,171,13,1,80,16,67,158,66
2019,37,80,"Siirt",37.9333,41.9333,13.4714285714286,24.1857142857143,0,36.0285714285714,45.6233333333333,NA,218,92,8,57,16,55,126,47
2019,38,80,"Siirt",37.9333,41.9333,15.6,23.0428571428571,0,38.7857142857143,46.3314285714286,NA,266,32,7,99,16,91,234,84
2019,39,80,"Siirt",37.9333,41.9333,12.8571428571429,21.5142857142857,0,38.4857142857143,52.3728571428571,NA,237,111,41,79,25,79,126,38
2019,40,80,"Siirt",37.9333,41.9333,13.4714285714286,21.7285714285714,0,38.5857142857143,59.9528571428571,NA,241,122,43,74,38,111,119,68
2019,41,80,"Siirt",37.9333,41.9333,13.0857142857143,21.8142857142857,0,41.3714285714286,70.9914285714286,NA,416,314,349,61,83,448,102,99
2019,42,80,"Siirt",37.9333,41.9333,11,19.3142857142857,0.485285714285714,42.2142857142857,45.99,NA,356,159,156,63,71,408,197,252
2019,43,80,"Siirt",37.9333,41.9333,10.4285714285714,16.1857142857143,3.37114285714286,66.3428571428571,32.6971428571429,NA,306,163,219,54,18,300,143,81
2019,44,80,"Siirt",37.9333,41.9333,11.2142857142857,13.2142857142857,11.8902857142857,80.7571428571429,25.1228571428571,NA,350,137,135,127,51,250,213,115
2019,45,80,"Siirt",37.9333,41.9333,7.01428571428571,11.2428571428571,0,68.6428571428571,54.34,NA,417,93,70,148,98,328,324,258
2019,46,80,"Siirt",37.9333,41.9333,8.2,10.7285714285714,0,63.8428571428571,61.82,NA,401,265,236,10,15,337,136,101
2019,47,80,"Siirt",37.9333,41.9333,11.1714285714286,6.95714285714286,0,53.7428571428571,62.0671428571429,NA,391,261,241,53,26,339,130,98
2019,48,80,"Siirt",37.9333,41.9333,13.2714285714286,9.57142857142857,4.76728571428571,76.8428571428571,55.63,NA,320,234,164,0,0,251,86,87
2019,49,80,"Siirt",37.9333,41.9333,10.9428571428571,7.68571428571429,1.689,87.6714285714286,40.7185714285714,NA,393,199,111,121,97,274,194,163
2019,50,80,"Siirt",37.9333,41.9333,13.6857142857143,6.91428571428571,4.68385714285714,92.4571428571429,45.0014285714286,NA,218,214,117,0,0,119,4,2
2019,51,80,"Siirt",37.9333,41.9333,8.6,5.91428571428571,0,78.9857142857143,79.1442857142857,NA,361,238,401,63,17,488,123,87
2019,52,80,"Siirt",37.9333,41.9333,19.7285714285714,7.92857142857143,3.15657142857143,71.7428571428571,50.0542857142857,NA,279,145,129,0,0,281,134,152
2020,1,80,"Siirt",37.9333,41.9333,11.36,4.66,2.7204,89.64,34.18,NA,160,125,98,0,0,126,35,28
2020,2,80,"Siirt",37.9333,41.9333,12.7285714285714,4.52857142857143,0.714142857142857,80.9714285714286,41.8571428571429,NA,240,173,114,54,34,173,67,59
2020,3,80,"Siirt",37.9333,41.9333,12.6714285714286,2.44285714285714,3.19928571428571,79.2,51.6871428571429,NA,270,136,196,98,79,382,134,186
2020,4,80,"Siirt",37.9333,41.9333,13.1428571428571,2,5.56757142857143,79.6,51.0428571428571,NA,358,191,178,110,97,295,167,117
2020,5,80,"Siirt",37.9333,41.9333,15.4285714285714,2.98571428571429,8.42571428571429,80.8571428571429,55.8614285714286,NA,331,215,149,0,0,272,116,123
2020,6,80,"Siirt",37.9333,41.9333,17.2,3.42857142857143,15.3447142857143,80.2857142857143,48.24,NA,343,211,177,45,21,267,132,90
2020,7,80,"Siirt",37.9333,41.9333,14.0285714285714,-2.04285714285714,2.52642857142857,79.8714285714286,54.16,NA,341,121,65,125,135,338,220,273
2020,8,80,"Siirt",37.9333,41.9333,13.2428571428571,7.58571428571429,5.627,84.1571428571429,52.7628571428571,NA,283,143,79,39,14,187,140,108
2020,9,80,"Siirt",37.9333,41.9333,15.2285714285714,8.34285714285714,7.64057142857143,71.8142857142857,34.6157142857143,NA,393,344,509,46,15,528,49,19
2020,10,80,"Siirt",37.9333,41.9333,15.6571428571429,10.2142857142857,0.0142857142857143,65.4857142857143,38.1785714285714,NA,205,120,85,40,69,210,85,125
2020,11,80,"Siirt",37.9333,41.9333,17.1571428571429,13.5571428571429,1.27142857142857,61.0428571428571,39.7571428571429,NA,115,92,70,0,0,94,23,24
2020,12,80,"Siirt",37.9333,41.9333,21.4714285714286,9.02857142857143,19.1441428571429,83.4428571428572,18.4925,NA,117,38,62,0,0,118,79,56
2020,13,80,"Siirt",37.9333,41.9333,16.3714285714286,11.2857142857143,11.1395714285714,78.0857142857143,29.1233333333333,NA,136,78,66,34,9,92,58,26
2020,14,80,"Siirt",37.9333,41.9333,14.7571428571429,10.1714285714286,11.9357142857143,81.8428571428571,18.4771428571429,NA,155,63,31,25,29,121,92,90
2020,15,80,"Siirt",37.9333,41.9333,12.4857142857143,13.0285714285714,2.05642857142857,70.5857142857143,25.6085714285714,NA,133,57,37,1,0,118,76,81
2020,16,80,"Siirt",37.9333,41.9333,14.2428571428571,14.0571428571429,1.143,63.9571428571429,26.7857142857143,NA,141,77,59,8,3,106,64,47
2020,17,80,"Siirt",37.9333,41.9333,19.5857142857143,15.2857142857143,10.9371428571429,73.7428571428571,25.2014285714286,NA,137,77,69,23,27,123,60,54
2020,18,80,"Siirt",37.9333,41.9333,12.3428571428571,14.5857142857143,1.17185714285714,70.3571428571429,17.8228571428571,NA,146,31,30,69,53,164,115,134
2020,19,80,"Siirt",37.9333,41.9333,13.2285714285714,16.3285714285714,3.10128571428571,71.4142857142857,26.5585714285714,NA,137,25,29,76,101,157,112,128
2020,20,80,"Siirt",37.9333,41.9333,9.61428571428571,19.9714285714286,0.171285714285714,58.8428571428571,31.4085714285714,NA,164,24,7,19,39,164,140,157
2020,21,80,"Siirt",37.9333,41.9333,13.5142857142857,22.8,0.318857142857143,48.3142857142857,39.3957142857143,NA,146,57,34,34,31,96,89,62
2020,22,80,"Siirt",37.9333,41.9333,12.1285714285714,19.7571428571429,1.28485714285714,56.8857142857143,18.05,NA,118,8,28,63,39,100,110,72
2020,23,80,"Siirt",37.9333,41.9333,13.0285714285714,22.2571428571429,0,44.6142857142857,NA,NA,112,35,16,51,37,70,77,54
2020,24,80,"Siirt",37.9333,41.9333,13.1142857142857,25.2285714285714,0,40.0142857142857,NA,NA,140,42,56,56,76,150,98,94
2020,25,80,"Siirt",37.9333,41.9333,13.3,25.2714285714286,0,42.5142857142857,NA,NA,137,0,0,98,100,108,137,108
2020,26,80,"Siirt",37.9333,41.9333,11.8142857142857,26.7428571428571,0.285428571428571,38.3857142857143,38.994,NA,173,59,14,13,6,133,114,119
2020,27,80,"Siirt",37.9333,41.9333,19.3,28.2,0.528142857142857,39.0285714285714,28.7214285714286,NA,113,88,52,0,0,113,25,61
2020,28,80,"Siirt",37.9333,41.9333,13.4285714285714,29.7,0,38.3857142857143,31.1842857142857,NA,164,53,43,64,48,122,111,79
2020,29,80,"Siirt",37.9333,41.9333,13.5571428571429,29.0285714285714,0.285428571428571,38.5571428571429,33.0957142857143,NA,186,88,43,30,11,111,98,68
2020,30,80,"Siirt",37.9333,41.9333,12.8571428571429,30.5857142857143,0,32.2714285714286,47.6457142857143,NA,190,11,11,88,60,142,179,131
2020,31,80,"Siirt",37.9333,41.9333,14.0142857142857,30.8714285714286,0,34.2857142857143,43.1828571428571,NA,150,43,52,42,29,127,107,75
2020,32,80,"Siirt",37.9333,41.9333,10.3142857142857,29.4571428571429,0,35.7571428571429,28.4957142857143,NA,146,45,23,12,24,107,101,84
2020,33,80,"Siirt",37.9333,41.9333,13.2428571428571,28.7142857142857,0,37.4571428571429,39.5271428571429,NA,183,20,3,83,27,83,163,80
2020,34,80,"Siirt",37.9333,41.9333,12.3714285714286,26.8857142857143,0.570857142857143,38.1142857142857,42.2742857142857,NA,197,115,47,57,20,97,82,50
2020,35,80,"Siirt",37.9333,41.9333,11.5857142857143,26.8428571428571,0,36.1428571428571,30.44,NA,164,84,55,16,20,157,80,102
2020,36,80,"Siirt",37.9333,41.9333,12.6285714285714,28.0714285714286,0,31.8714285714286,45.49,NA,179,149,86,0,0,112,30,26
2020,37,80,"Siirt",37.9333,41.9333,11.4714285714286,27.3142857142857,0,31.2714285714286,50.8214285714286,NA,193,36,4,70,18,91,157,87
2020,38,80,"Siirt",37.9333,41.9333,11.4428571428571,25.6857142857143,0,32.3,51.5271428571429,NA,235,152,94,1,1,157,83,63
2020,39,80,"Siirt",37.9333,41.9333,12.0285714285714,24.1857142857143,0,39.4,55.0671428571429,NA,220,96,30,0,0,129,124,99
2020,40,80,"Siirt",37.9333,41.9333,11.8857142857143,22.7857142857143,0,36.9285714285714,51.65,NA,187,64,20,37,12,154,123,134
2020,41,80,"Siirt",37.9333,41.9333,11.5285714285714,19.1571428571429,0,36.4142857142857,37.1057142857143,NA,182,65,38,65,53,127,117,89
2020,42,80,"Siirt",37.9333,41.9333,10.2714285714286,19.5142857142857,0,34.0571428571429,54.1571428571429,NA,177,95,51,0,0,111,82,60
2020,43,80,"Siirt",37.9333,41.9333,9.91428571428571,18.0714285714286,0,38.6285714285714,56.29,NA,194,85,52,0,0,161,109,109
2020,44,80,"Siirt",37.9333,41.9333,12.7571428571429,18.2857142857143,0,31.2142857142857,78.3857142857143,NA,255,116,135,0,0,233,139,98
2020,45,80,"Siirt",37.9333,41.9333,16.3428571428571,14.5714285714286,8.266,73.4714285714286,40.65,NA,156,32,18,30,21,103,124,85
2020,46,80,"Siirt",37.9333,41.9333,6.68571428571429,11.5428571428571,0.0857142857142857,73.5571428571429,45.3528571428571,NA,208,46,33,34,16,109,162,76
2020,47,80,"Siirt",37.9333,41.9333,9.6,8.94285714285714,0.314285714285714,77.2428571428571,51.03,NA,173,31,22,34,28,83,142,61
2020,48,80,"Siirt",37.9333,41.9333,10.5,7.45714285714286,0.271285714285714,72.6142857142857,55.9371428571429,NA,199,51,27,47,34,262,148,235
2020,49,80,"Siirt",37.9333,41.9333,9.4,6.7,0.143142857142857,77.8285714285714,71.0514285714286,NA,207,76,25,35,48,116,131,91
2020,50,80,"Siirt",37.9333,41.9333,11.8428571428571,6.11428571428571,0.785857142857143,83.7857142857143,57.86,NA,181,102,45,24,38,98,79,53
2020,51,80,"Siirt",37.9333,41.9333,14.1,7.51428571428571,0.486857142857143,83.1,49.69,NA,171,75,36,47,43,90,96,54
2020,52,80,"Siirt",37.9333,41.9333,9.51428571428571,2.58571428571429,4.14157142857143,77.8714285714286,45.6028571428571,NA,203,72,41,26,12,113,131,72
2020,53,80,"Siirt",37.9333,41.9333,8.85,4.2,0,72.775,93.7075,NA,122,22,15,8,5,111,100,96
2017,1,81,"Sinop",42.0231,35.1531,25.2428571428571,6.8,0.642857142857143,70.7285714285714,66.7642857142857,NA,563,0,0,128,207,847,563,847
2017,2,81,"Sinop",42.0231,35.1531,26.2857142857143,5.51428571428571,1.82857142857143,75.7571428571429,61.8633333333333,NA,757,207,478,266,311,1214,550,736
2017,3,81,"Sinop",42.0231,35.1531,21.8,5.42857142857143,1.81428571428571,87.5285714285714,46.3414285714286,NA,762,19,51,197,304,1449,743,1398
2017,4,81,"Sinop",42.0231,35.1531,29.1571428571429,3.08571428571429,2.88571428571429,86.7571428571429,40.8628571428571,NA,639,111,173,409,543,889,528,716
2017,5,81,"Sinop",42.0231,35.1531,21.7142857142857,3.22857142857143,1.27142857142857,75.2857142857143,75.8957142857143,NA,588,0,0,109,245,1163,588,1163
2017,6,81,"Sinop",42.0231,35.1531,21.9571428571429,5.7,0.285714285714286,82.1714285714286,66.8485714285714,NA,736,105,297,115,320,1519,631,1222
2017,7,81,"Sinop",42.0231,35.1531,26.3142857142857,3.08571428571429,1.02857142857143,76.1285714285714,39.0825,NA,492,73,66,246,449,717,419,651
2017,8,81,"Sinop",42.0231,35.1531,22.5428571428571,8.35714285714286,0.6,77.4142857142857,56.6666666666667,NA,739,0,0,322,746,1747,739,1747
2017,9,81,"Sinop",42.0231,35.1531,22.1142857142857,7.44285714285714,0.385714285714286,92.5571428571428,49.5828571428571,NA,574,366,646,203,198,866,208,220
2017,10,81,"Sinop",42.0231,35.1531,16.6142857142857,9.87142857142857,0.0714285714285714,81.5857142857143,70.7185714285714,NA,712,422,578,96,169,1043,290,465
2017,11,81,"Sinop",42.0231,35.1531,22.8857142857143,7.27142857142857,5,92.4,41.9842857142857,NA,525,74,63,381,529,725,451,662
2017,12,81,"Sinop",42.0231,35.1531,19.2714285714286,7.94285714285714,0.628571428571429,84.4857142857143,49.3714285714286,NA,589,246,430,140,211,1077,343,647
2017,13,81,"Sinop",42.0231,35.1531,18.8,7.97142857142857,0.585714285714286,88.9142857142857,48.6828571428571,NA,574,0,0,269,457,887,574,887
2017,14,81,"Sinop",42.0231,35.1531,20.9571428571429,9.47142857142857,0.9,92.3285714285714,53.9342857142857,NA,639,276,647,363,689,1336,363,689
2017,15,81,"Sinop",42.0231,35.1531,18.4714285714286,9.64285714285714,1.62857142857143,82.7714285714286,45.3357142857143,NA,587,130,330,191,221,1187,457,857
2017,16,81,"Sinop",42.0231,35.1531,31.7857142857143,10.2714285714286,3.58571428571429,77.5714285714286,44.6642857142857,NA,717,125,132,450,565,920,592,788
2017,17,81,"Sinop",42.0231,35.1531,21.6714285714286,11.1571428571429,0.142857142857143,75.8428571428571,48.0528571428571,NA,731,544,1289,97,111,1478,187,189
2017,18,81,"Sinop",42.0231,35.1531,18.8285714285714,13.3714285714286,1.4,85.5428571428571,60.95,NA,506,180,324,248,546,923,326,599
2017,19,81,"Sinop",42.0231,35.1531,22.2428571428571,15.3,0.371428571428571,78.6857142857143,47.9885714285714,NA,471,151,313,228,464,966,320,653
2017,20,81,"Sinop",42.0231,35.1531,21.4714285714286,13.8142857142857,0.871428571428571,84.6142857142857,31.9557142857143,NA,472,0,0,262,667,1205,472,1205
2017,21,81,"Sinop",42.0231,35.1531,14.8,14.6285714285714,2.55714285714286,84.4285714285714,28.5028571428571,NA,448,106,268,230,417,849,342,581
2017,22,81,"Sinop",42.0231,35.1531,19.7,18.3285714285714,0.714285714285714,80.0857142857143,38.9171428571429,NA,522,131,385,250,404,1015,391,630
2017,23,81,"Sinop",42.0231,35.1531,21.3142857142857,19.5857142857143,2.87142857142857,82.7285714285714,36.4814285714286,NA,578,201,363,321,847,1388,377,1025
2017,24,81,"Sinop",42.0231,35.1531,20.6428571428571,19.7,1.65714285714286,77.0571428571429,34.0971428571429,NA,552,203,390,299,682,1139,349,749
2017,25,81,"Sinop",42.0231,35.1531,24.7142857142857,21.1857142857143,3.54285714285714,79.1428571428571,39.9485714285714,NA,584,93,145,464,824,1041,491,896
2017,26,81,"Sinop",42.0231,35.1531,18.3,23.5714285714286,0,79.7714285714286,45.3842857142857,NA,564,324,657,20,59,971,240,314
2017,27,81,"Sinop",42.0231,35.1531,23.2,22.9571428571429,0.185714285714286,71.6285714285714,44.56,NA,511,108,197,283,251,642,403,445
2017,28,81,"Sinop",42.0231,35.1531,15.3857142857143,23.4428571428571,0.0857142857142857,72.0857142857143,40.4757142857143,NA,481,148,273,170,217,864,333,591
2017,29,81,"Sinop",42.0231,35.1531,20.7285714285714,23.9285714285714,0.457142857142857,78.9142857142857,68.2871428571429,NA,532,0,0,365,865,1272,532,1272
2017,30,81,"Sinop",42.0231,35.1531,21.1285714285714,24.6428571428571,0.0142857142857143,74.5285714285714,48.52,NA,531,222,437,309,491,928,309,491
2017,31,81,"Sinop",42.0231,35.1531,22.3857142857143,24.7428571428571,0,77.3285714285714,46.3114285714286,NA,559,0,0,391,689,1047,559,1047
2017,32,81,"Sinop",42.0231,35.1531,18.9428571428571,26.5428571428571,0,76.7428571428571,56.7728571428571,NA,567,0,0,567,1092,1092,567,1092
2017,33,81,"Sinop",42.0231,35.1531,19.3285714285714,25.7142857142857,0.0428571428571429,75.5714285714286,46.4471428571429,NA,596,0,0,466,1049,1199,596,1199
2017,34,81,"Sinop",42.0231,35.1531,21.3857142857143,23.8857142857143,1.77142857142857,68.6142857142857,38.7414285714286,NA,601,77,142,218,432,1280,524,1138
2017,35,81,"Sinop",42.0231,35.1531,21.3714285714286,21.8,3.32857142857143,72.7428571428571,34.8871428571429,NA,493,116,313,375,701,1014,377,701
2017,36,81,"Sinop",42.0231,35.1531,25.5142857142857,22.1,3.35714285714286,75.3714285714286,32.6385714285714,NA,507,285,759,200,519,1321,222,562
2017,37,81,"Sinop",42.0231,35.1531,19.6285714285714,24.0571428571429,0,77.2,49.0814285714286,NA,589,365,700,151,381,1138,224,438
2017,38,81,"Sinop",42.0231,35.1531,19.3571428571429,22.4857142857143,0.371428571428571,77.2285714285714,47.7928571428571,NA,671,387,617,284,695,1312,284,695
2017,39,81,"Sinop",42.0231,35.1531,18.0142857142857,19.1714285714286,0.657142857142857,73.2428571428571,75.3314285714286,NA,782,310,569,111,481,1630,472,1061
2017,40,81,"Sinop",42.0231,35.1531,19.8571428571429,16.4428571428571,0.242857142857143,70.0714285714286,46.7671428571429,NA,543,106,321,173,363,1137,437,816
2017,41,81,"Sinop",42.0231,35.1531,22.9857142857143,15.2857142857143,1.67142857142857,74.4285714285714,33.1442857142857,NA,487,0,0,458,785,843,487,843
2017,42,81,"Sinop",42.0231,35.1531,19.0714285714286,16.0571428571429,0.385714285714286,81.2,48.22,NA,530,22,59,291,417,815,508,756
2017,43,81,"Sinop",42.0231,35.1531,18.9857142857143,15.9857142857143,0.771428571428571,81.1571428571429,50.4042857142857,NA,506,16,21,216,502,919,490,898
2017,44,81,"Sinop",42.0231,35.1531,22.4714285714286,11.2142857142857,4.6,73.4571428571429,54.7585714285714,NA,561,94,224,236,381,1102,467,878
2017,45,81,"Sinop",42.0231,35.1531,16.2857142857143,13.7428571428571,1.28571428571429,84.5142857142857,51.42,NA,577,210,224,243,388,829,367,605
2017,46,81,"Sinop",42.0231,35.1531,20.1285714285714,14.7285714285714,0.128571428571429,81.2285714285714,62.1957142857143,NA,587,185,404,240,436,1085,402,681
2017,47,81,"Sinop",42.0231,35.1531,29.0571428571429,9.38571428571429,6.52857142857143,77.6142857142857,49.2542857142857,NA,418,57,135,311,486,804,361,669
2017,48,81,"Sinop",42.0231,35.1531,16.8285714285714,12.8142857142857,0.4,73.0428571428571,62.9628571428571,NA,386,1,1,52,109,619,385,618
2017,49,81,"Sinop",42.0231,35.1531,30.4714285714286,9.77142857142857,5.9,75.4857142857143,57.1828571428571,NA,407,0,0,268,485,645,407,645
2017,50,81,"Sinop",42.0231,35.1531,16.3142857142857,11.5142857142857,0.0857142857142857,73.7857142857143,86.7,NA,346,0,0,0,0,442,346,442
2017,51,81,"Sinop",42.0231,35.1531,22.6714285714286,7.85714285714286,12.8714285714286,83.9428571428571,36.7557142857143,NA,386,52,30,164,157,349,334,319
2017,52,81,"Sinop",42.0231,35.1531,21.8,10.2375,0.6625,71.275,74.18,NA,528,0,0,182,121,507,528,507
2018,1,81,"Sinop",42.0231,35.1531,19.3,9.3625,1.3375,80.425,39.4825,NA,618,15,41,371,486,914,603,873
2018,2,81,"Sinop",42.0231,35.1531,24.1142857142857,7.68571428571429,3.85714285714286,85.8571428571429,40.58,NA,624,187,285,90,191,1309,437,1024
2018,3,81,"Sinop",42.0231,35.1531,29.2142857142857,7.3,2.31428571428571,74.8285714285714,51.5314285714286,NA,639,10,5,194,117,655,629,650
2018,4,81,"Sinop",42.0231,35.1531,27.2857142857143,5.32857142857143,1.34285714285714,76.7714285714286,42.96,NA,604,11,15,314,400,764,593,749
2018,5,81,"Sinop",42.0231,35.1531,20.4,9.44285714285714,0.114285714285714,72.0571428571428,66.8833333333333,NA,670,0,0,206,169,819,670,819
2018,6,81,"Sinop",42.0231,35.1531,28.1142857142857,9.28571428571428,1.15714285714286,86.4571428571429,52.4557142857143,NA,704,296,343,120,199,1022,408,679
2018,7,81,"Sinop",42.0231,35.1531,25.4142857142857,8.21428571428571,0.2,81.9428571428572,44.5614285714286,NA,478,84,119,280,301,557,394,438
2018,8,81,"Sinop",42.0231,35.1531,21.8285714285714,7.01428571428571,5.41428571428571,86.9285714285714,32.5657142857143,NA,711,503,916,0,0,1321,208,405
2018,9,81,"Sinop",42.0231,35.1531,32.6714285714286,7.3,3.11428571428571,79.0428571428571,46.39,NA,621,202,293,158,260,956,419,663
2018,10,81,"Sinop",42.0231,35.1531,23.1857142857143,9.32857142857143,4.47142857142857,83.7285714285714,58.5485714285714,NA,556,29,61,138,334,1330,527,1269
2018,11,81,"Sinop",42.0231,35.1531,19.3857142857143,11.8714285714286,2.28571428571429,77.7571428571429,56.2571428571429,NA,551,90,211,67,99,1426,461,1215
2018,12,81,"Sinop",42.0231,35.1531,27.2428571428571,8.91428571428571,3.75714285714286,88.8285714285714,45.865,NA,425,107,203,99,262,1187,318,984
2018,13,81,"Sinop",42.0231,35.1531,24.6857142857143,10.5714285714286,3.5,82.9285714285714,47.92,NA,356,70,120,100,151,428,286,308
2018,14,81,"Sinop",42.0231,35.1531,22.6571428571429,10.5857142857143,0.442857142857143,79.8142857142857,46.864,NA,407,107,116,112,88,486,300,370
2018,15,81,"Sinop",42.0231,35.1531,13.8571428571429,10.1142857142857,0,90.2285714285714,38.8942857142857,NA,374,92,102,80,200,450,282,348
2018,16,81,"Sinop",42.0231,35.1531,25.0857142857143,11.6142857142857,0.171428571428571,75.9428571428571,42.8614285714286,NA,411,139,234,219,371,648,272,414
2018,17,81,"Sinop",42.0231,35.1531,16.5,14.8285714285714,0,74.9857142857143,44.5371428571429,NA,419,76,93,61,96,652,343,559
2018,18,81,"Sinop",42.0231,35.1531,13.3428571428571,14.5714285714286,0.1,89.9571428571429,29.1728571428571,NA,303,198,345,0,0,474,105,129
2018,19,81,"Sinop",42.0231,35.1531,15.1142857142857,15.4285714285714,1.82857142857143,83.1857142857143,30.6671428571429,NA,275,36,37,49,98,467,239,430
2018,20,81,"Sinop",42.0231,35.1531,19.2,18.0142857142857,0.314285714285714,79.9571428571429,38.0466666666667,NA,204,92,128,8,4,306,112,178
2018,21,81,"Sinop",42.0231,35.1531,16.2142857142857,19.3714285714286,0,85.6428571428571,29.5957142857143,NA,252,27,61,76,64,281,225,220
2018,22,81,"Sinop",42.0231,35.1531,22.2142857142857,19.4142857142857,0.628571428571429,79.8571428571429,36.1314285714286,NA,249,0,0,187,365,427,249,427
2018,23,81,"Sinop",42.0231,35.1531,14.6,21.1857142857143,0,75.3142857142857,32.3314285714286,NA,267,85,246,40,131,812,182,566
2018,24,81,"Sinop",42.0231,35.1531,17.5,22.4285714285714,0.542857142857143,76.4285714285714,27.5228571428571,NA,267,106,132,39,199,448,161,316
2018,25,81,"Sinop",42.0231,35.1531,17.1571428571429,22.7285714285714,0.0285714285714286,78.8714285714286,27.66,NA,358,0,0,290,421,518,358,518
2018,26,81,"Sinop",42.0231,35.1531,19.2857142857143,23.9142857142857,2.88571428571429,76.0714285714286,30.2733333333333,NA,355,124,241,101,113,587,231,346
2018,27,81,"Sinop",42.0231,35.1531,16.5142857142857,24.1428571428571,0.142857142857143,70.2428571428571,25.3328571428571,NA,342,46,80,140,189,418,296,338
2018,28,81,"Sinop",42.0231,35.1531,24.7857142857143,25.7857142857143,0.828571428571429,77.6428571428571,32.1414285714286,NA,286,40,73,195,413,585,246,512
2018,29,81,"Sinop",42.0231,35.1531,19.4,25.0142857142857,0.685714285714286,74.0571428571428,24.4857142857143,NA,260,0,0,231,739,756,260,756
2018,30,81,"Sinop",42.0231,35.1531,18.2,26.0714285714286,0.942857142857143,76.9714285714286,23.2214285714286,NA,265,19,43,63,42,822,246,779
2018,31,81,"Sinop",42.0231,35.1531,22.9285714285714,27.0428571428571,0.2,74.3857142857143,33.26,NA,267,0,0,164,253,499,267,499
2018,32,81,"Sinop",42.0231,35.1531,22.2571428571429,25.9714285714286,3.75714285714286,69.8428571428571,46.0714285714286,NA,297,0,0,169,201,403,297,403
2018,33,81,"Sinop",42.0231,35.1531,17.7857142857143,26.1857142857143,0.0428571428571429,67.7428571428571,39.5028571428571,NA,216,41,83,141,188,332,175,249
2018,34,81,"Sinop",42.0231,35.1531,16.2857142857143,25.8142857142857,0,73.8571428571429,45.9428571428571,NA,144,51,77,76,104,227,93,150
2018,35,81,"Sinop",42.0231,35.1531,17.4285714285714,26.3,0.371428571428571,77.6571428571429,43.2685714285714,NA,201,23,24,103,210,314,178,290
2018,36,81,"Sinop",42.0231,35.1531,23.3428571428571,24.9285714285714,5.3,74.3857142857143,54.1085714285714,NA,341,62,61,236,283,370,279,309
2018,37,81,"Sinop",42.0231,35.1531,25.4142857142857,22.7857142857143,3.84285714285714,75.4857142857143,37.0628571428571,NA,241,58,112,183,307,419,183,307
2018,38,81,"Sinop",42.0231,35.1531,16.8142857142857,21.4285714285714,0.728571428571429,71.5714285714286,37.0242857142857,NA,189,28,80,107,156,344,161,264
2018,39,81,"Sinop",42.0231,35.1531,25.2714285714286,19.4428571428571,2.4,74.0714285714286,36.3357142857143,NA,180,82,193,71,123,353,98,160
2018,40,81,"Sinop",42.0231,35.1531,23.4285714285714,19.6285714285714,1.21428571428571,73.7285714285714,32.7514285714286,NA,191,85,146,87,163,341,106,195
2018,41,81,"Sinop",42.0231,35.1531,13,19.1428571428571,1.94285714285714,83.8857142857143,44.0128571428571,NA,187,24,15,69,298,422,163,407
2018,42,81,"Sinop",42.0231,35.1531,12.7714285714286,19.8571428571429,3.01428571428571,87.1428571428571,52.9171428571429,NA,168,88,149,27,139,381,80,232
2018,43,81,"Sinop",42.0231,35.1531,22.3428571428571,16.6714285714286,7.57142857142857,77.4142857142857,48.1228571428571,NA,187,0,0,133,317,402,187,402
2018,44,81,"Sinop",42.0231,35.1531,11.2428571428571,17.0857142857143,0,85.1285714285714,36.4614285714286,NA,196,67,90,0,0,264,129,174
2018,45,81,"Sinop",42.0231,35.1531,14.9285714285714,16.3,0.728571428571429,82.8142857142857,34.46,NA,231,158,322,30,73,473,73,151
2018,46,81,"Sinop",42.0231,35.1531,24.1285714285714,11.6142857142857,4.48571428571429,79.6,29.4914285714286,NA,230,35,76,141,238,465,195,389
2018,47,81,"Sinop",42.0231,35.1531,21.2285714285714,12.6428571428571,2.55714285714286,79.2857142857143,39.5257142857143,NA,270,65,38,37,55,499,205,461
2018,48,81,"Sinop",42.0231,35.1531,21.1571428571429,12.6428571428571,2.77142857142857,78.9142857142857,42.64,NA,245,15,17,25,29,201,230,184
2018,49,81,"Sinop",42.0231,35.1531,21.5714285714286,10.8857142857143,2.02857142857143,80.2142857142857,NA,NA,257,54,79,114,274,420,203,341
2018,50,81,"Sinop",42.0231,35.1531,20.9857142857143,10.8428571428571,3.82857142857143,74.8571428571429,38.62,NA,256,45,63,97,140,305,211,242
2018,51,81,"Sinop",42.0231,35.1531,22.3714285714286,11.2,2.67142857142857,84.5857142857143,37.7314285714286,NA,250,40,59,86,134,248,210,189
2018,52,81,"Sinop",42.0231,35.1531,24.2428571428571,7.7,6.08571428571429,74.1,34.2775,NA,244,0,0,224,261,273,244,273
2019,1,81,"Sinop",42.0231,35.1531,23.725,8.175,2.7625,77.225,39.36,NA,343,18,90,117,245,784,325,694
2019,2,81,"Sinop",42.0231,35.1531,29.3,7.4,1.77142857142857,68.1857142857143,32.4033333333333,NA,255,0,0,149,145,208,255,208
2019,3,81,"Sinop",42.0231,35.1531,23.8,7.91428571428571,2.72857142857143,72.3142857142857,NA,NA,192,16,1,50,42,198,176,197
2019,4,81,"Sinop",42.0231,35.1531,19.8571428571429,11.0714285714286,0.114285714285714,67.0142857142857,NA,NA,308,4,2,129,119,314,304,312
2019,5,81,"Sinop",42.0231,35.1531,17.5142857142857,11.0428571428571,1.6,70.2571428571429,38.3366666666667,NA,253,42,59,40,25,143,211,84
2019,6,81,"Sinop",42.0231,35.1531,19.2285714285714,9.07142857142857,1.82857142857143,78.1285714285714,38.34,NA,276,61,25,144,91,127,215,102
2019,7,81,"Sinop",42.0231,35.1531,23.8857142857143,8.47142857142857,0.485714285714286,71.9857142857143,45.1914285714286,NA,325,14,96,132,73,234,311,138
2019,8,81,"Sinop",42.0231,35.1531,22.3428571428571,7.98571428571429,0.342857142857143,75.7857142857143,46.2628571428571,NA,305,2,2,107,119,219,303,217
2019,9,81,"Sinop",42.0231,35.1531,26.6285714285714,6.74285714285714,2.84285714285714,73.2428571428571,38.5883333333333,NA,331,24,5,250,281,310,307,305
2019,10,81,"Sinop",42.0231,35.1531,17.7571428571429,10.3571428571429,1.1,68.6857142857143,NA,NA,359,12,9,160,146,252,347,243
2019,11,81,"Sinop",42.0231,35.1531,18.7142857142857,10.0714285714286,2.68571428571429,72.2142857142857,NA,NA,373,126,41,68,95,400,247,359
2019,12,81,"Sinop",42.0231,35.1531,23.2857142857143,9.01428571428571,1.14285714285714,71.5,NA,NA,343,51,279,171,95,416,292,137
2019,13,81,"Sinop",42.0231,35.1531,21.0571428571429,8.04285714285714,0.0571428571428571,66.6857142857143,33.786,NA,256,104,68,76,92,194,152,126
2019,14,81,"Sinop",42.0231,35.1531,23.0428571428571,10.1857142857143,0.114285714285714,76.0857142857143,41.8614285714286,NA,365,211,133,79,51,208,154,75
2019,15,81,"Sinop",42.0231,35.1531,16.8,14.1142857142857,4.75714285714286,74.8857142857143,36.4928571428571,NA,359,109,57,6,8,183,250,126
2019,16,81,"Sinop",42.0231,35.1531,28.6571428571429,10.1714285714286,0.514285714285714,76.9428571428572,32.62,NA,318,0,0,300,199,208,318,208
2019,17,81,"Sinop",42.0231,35.1531,18.3285714285714,12.3142857142857,0,75.1142857142857,35.43,NA,412,266,231,91,63,313,146,82
2019,18,81,"Sinop",42.0231,35.1531,18.0571428571429,16.8,0.971428571428571,69.8571428571428,42.8914285714286,NA,523,21,6,153,77,353,502,347
2019,19,81,"Sinop",42.0231,35.1531,19.1142857142857,15.5285714285714,1.58571428571429,78.0428571428571,32.5757142857143,NA,452,51,33,212,214,386,401,353
2019,20,81,"Sinop",42.0231,35.1531,21.5428571428571,17.1714285714286,0.0428571428571429,77.8857142857143,33.7714285714286,NA,454,228,179,8,17,389,226,210
2019,21,81,"Sinop",42.0231,35.1531,19.8285714285714,19.5428571428571,0.842857142857143,74.0571428571429,37.214,NA,457,23,35,201,218,413,434,378
2019,22,81,"Sinop",42.0231,35.1531,16.1857142857143,20.4428571428571,0.0571428571428571,75.8,38.4971428571429,NA,453,185,98,61,17,323,268,225
2019,23,81,"Sinop",42.0231,35.1531,18.2428571428571,22.6428571428571,0.142857142857143,78.5571428571429,34.3585714285714,NA,378,51,41,147,221,532,327,491
2019,24,81,"Sinop",42.0231,35.1531,18.9428571428571,24.2857142857143,0.528571428571429,77.9857142857143,36.0828571428571,NA,378,0,0,274,151,244,378,244
2019,25,81,"Sinop",42.0231,35.1531,23.5,25.6,0.128571428571429,76.2571428571429,41.07,NA,306,0,0,306,325,325,306,325
2019,26,81,"Sinop",42.0231,35.1531,23.4285714285714,24.9571428571429,1.8,67.8857142857143,41.6785714285714,NA,377,0,0,267,292,342,377,342
2019,27,81,"Sinop",42.0231,35.1531,17.1285714285714,24.7142857142857,0,64.0142857142857,35.9842857142857,NA,456,119,90,68,45,222,337,132
2019,28,81,"Sinop",42.0231,35.1531,21.4,23.7714285714286,3.37142857142857,68.3,30.2328571428571,NA,398,46,25,262,253,421,352,396
2019,29,81,"Sinop",42.0231,35.1531,19.5428571428571,23.8428571428571,0.657142857142857,70.8857142857143,32.1242857142857,NA,453,55,19,341,179,203,398,184
2019,30,81,"Sinop",42.0231,35.1531,22.5714285714286,25.0142857142857,0.6,69.3714285714286,36.3728571428571,NA,456,88,46,322,235,335,368,289
2019,31,81,"Sinop",42.0231,35.1531,21.3428571428571,25.7,0.0142857142857143,69.5,36.5085714285714,NA,334,100,71,119,104,375,234,304
2019,32,81,"Sinop",42.0231,35.1531,16.3,24.1,0.0285714285714286,64.9857142857143,29.92,NA,346,190,171,92,128,395,156,224
2019,33,81,"Sinop",42.0231,35.1531,21.5142857142857,24.5285714285714,1.71428571428571,72.7857142857143,35.7571428571429,NA,337,91,127,153,299,531,246,404
2019,34,81,"Sinop",42.0231,35.1531,24.3285714285714,24.3,1.41428571428571,78.0857142857143,41.5557142857143,NA,299,0,0,299,345,345,299,345
2019,35,81,"Sinop",42.0231,35.1531,20.0714285714286,24.4,0,75.1428571428571,51.1428571428571,NA,307,0,0,307,415,415,307,415
2019,36,81,"Sinop",42.0231,35.1531,21.2428571428571,23.2857142857143,1.9,70.5571428571429,44.9928571428571,NA,171,0,0,171,67,67,171,67
2019,37,81,"Sinop",42.0231,35.1531,16,22.4857142857143,0.1,71.3857142857143,36.8228571428571,NA,218,2,0,130,44,55,216,55
2019,38,81,"Sinop",42.0231,35.1531,21.9142857142857,19.2714285714286,4.24285714285714,66.0714285714286,34.2585714285714,NA,266,0,0,117,57,91,266,91
2019,39,81,"Sinop",42.0231,35.1531,18.6428571428571,19.1714285714286,1.78571428571429,77.3571428571429,27.7014285714286,NA,237,96,45,33,9,79,141,34
2019,40,81,"Sinop",42.0231,35.1531,22.5857142857143,19.7,7.05714285714286,83.2142857142857,37.52,NA,241,35,25,142,49,111,206,86
2019,41,81,"Sinop",42.0231,35.1531,27.5,17.4857142857143,1.45714285714286,77.1142857142857,29.9042857142857,NA,416,191,219,63,111,448,225,229
2019,42,81,"Sinop",42.0231,35.1531,12.6,18.2857142857143,0.114285714285714,86.1857142857143,40.1571428571429,NA,356,250,309,41,53,408,106,99
2019,43,81,"Sinop",42.0231,35.1531,15.1857142857143,17.1,0.342857142857143,83.0142857142857,43.3828571428571,NA,306,28,46,146,135,300,278,254
2019,44,81,"Sinop",42.0231,35.1531,21.3714285714286,13.9714285714286,10.0571428571429,76.4142857142857,38.9557142857143,NA,350,116,83,90,75,250,234,167
2019,45,81,"Sinop",42.0231,35.1531,14.6428571428571,17.2142857142857,0,71.4428571428572,45.6428571428571,NA,417,23,28,0,0,328,394,300
2019,46,81,"Sinop",42.0231,35.1531,18.8285714285714,15.8,0,82.9714285714286,53.0642857142857,NA,401,186,159,105,96,337,215,178
2019,47,81,"Sinop",42.0231,35.1531,14.6857142857143,12.6857142857143,0.3,83.1142857142857,61.28,NA,391,192,153,0,0,339,199,186
2019,48,81,"Sinop",42.0231,35.1531,21.4857142857143,13.4857142857143,0.814285714285714,77.9857142857143,49.3442857142857,NA,320,44,30,139,144,251,276,221
2019,49,81,"Sinop",42.0231,35.1531,23.1428571428571,8.45714285714286,4,70.6571428571429,37.22,NA,393,96,52,73,67,274,297,222
2019,50,81,"Sinop",42.0231,35.1531,19.8,11.6428571428571,0.8,77.7571428571429,41.2814285714286,NA,218,39,28,57,24,119,179,91
2019,51,81,"Sinop",42.0231,35.1531,17.1857142857143,11.5857142857143,0,74.2142857142857,54.1371428571429,NA,361,2,0,104,62,488,359,488
2019,52,81,"Sinop",42.0231,35.1531,27.9857142857143,10.9,5.97142857142857,76.6857142857143,36.1457142857143,NA,279,38,80,189,127,281,241,201
2020,1,81,"Sinop",42.0231,35.1531,16.14,7.34,7.1,81.1,33.324,NA,160,0,0,99,94,126,160,126
2020,2,81,"Sinop",42.0231,35.1531,26.1285714285714,8.2,5.21428571428571,79.7142857142857,42.75,NA,240,48,31,114,79,173,192,142
2020,3,81,"Sinop",42.0231,35.1531,18.2428571428571,7.18571428571429,0.357142857142857,76.1285714285714,41.5942857142857,NA,270,123,207,64,104,382,147,175
2020,4,81,"Sinop",42.0231,35.1531,32.9714285714286,6.48571428571429,1.82857142857143,73.1571428571429,40.4885714285714,NA,358,0,0,240,136,295,358,295
2020,5,81,"Sinop",42.0231,35.1531,21.0857142857143,8.97142857142857,2.22857142857143,76.0857142857143,39.1383333333333,NA,331,0,0,149,128,272,331,272
2020,6,81,"Sinop",42.0231,35.1531,35.7142857142857,7.74285714285714,5.4,71.1285714285714,42.5242857142857,NA,343,12,12,194,114,267,331,255
2020,7,81,"Sinop",42.0231,35.1531,26.3428571428571,6.17142857142857,2.77142857142857,73.0571428571428,37.2928571428571,NA,341,47,90,196,138,338,294,248
2020,8,81,"Sinop",42.0231,35.1531,18.3285714285714,7.01428571428571,1.9,82.6428571428571,42,NA,283,100,79,175,90,187,183,108
2020,9,81,"Sinop",42.0231,35.1531,31.6285714285714,9.7,0.685714285714286,68.2285714285714,42.3342857142857,NA,393,45,107,150,158,528,348,421
2020,10,81,"Sinop",42.0231,35.1531,20.0285714285714,12.4857142857143,0,66.7285714285714,44.3957142857143,NA,205,46,57,18,20,210,159,153
2020,11,81,"Sinop",42.0231,35.1531,22.5857142857143,11.5857142857143,0.514285714285714,78.4857142857143,47.3257142857143,NA,115,39,26,22,17,94,76,68
2020,12,81,"Sinop",42.0231,35.1531,22.4142857142857,6.67142857142857,3.32857142857143,75.1285714285714,40.975,NA,117,12,11,33,30,118,105,107
2020,13,81,"Sinop",42.0231,35.1531,18.6714285714286,8.88571428571429,0.485714285714286,88.2142857142857,51.4657142857143,NA,136,12,18,33,21,92,124,74
2020,14,81,"Sinop",42.0231,35.1531,27,9.68571428571429,1.18571428571429,82.8285714285714,47.52,NA,155,73,58,64,55,121,82,63
2020,15,81,"Sinop",42.0231,35.1531,22.4285714285714,9.85714285714286,0.285714285714286,75.3571428571429,61.7071428571429,NA,133,0,0,65,89,118,133,118
2020,16,81,"Sinop",42.0231,35.1531,22.9428571428571,11.3142857142857,0.771428571428572,76.1,35.6542857142857,NA,141,62,41,55,54,106,79,65
2020,17,81,"Sinop",42.0231,35.1531,23.1714285714286,11.1428571428571,1.17142857142857,73.1,32.7814285714286,NA,137,66,32,41,50,123,71,91
2020,18,81,"Sinop",42.0231,35.1531,20.1571428571429,13.4,0.114285714285714,81.9857142857143,34.8042857142857,NA,146,80,113,27,18,164,66,51
2020,19,81,"Sinop",42.0231,35.1531,22.1142857142857,13.7428571428571,1.25714285714286,81.5,31.5628571428571,NA,137,2,0,112,99,157,135,157
2020,20,81,"Sinop",42.0231,35.1531,27.1,17.9714285714286,0,75.1714285714286,50.4228571428571,NA,164,78,71,44,55,164,86,93
2020,21,81,"Sinop",42.0231,35.1531,27.9714285714286,15.9285714285714,2,78.2142857142857,41.5614285714286,NA,146,62,37,63,49,96,84,59
2020,22,81,"Sinop",42.0231,35.1531,19.6857142857143,15.7285714285714,0.728571428571429,76.8857142857143,25.7171428571429,NA,118,65,40,30,45,100,53,60
2020,23,81,"Sinop",42.0231,35.1531,17.5285714285714,18.4714285714286,2.87142857142857,79.6571428571429,30.8442857142857,NA,112,28,22,26,20,70,84,48
2020,24,81,"Sinop",42.0231,35.1531,13.9571428571429,20.5714285714286,4.2,83.8142857142857,37.1585714285714,NA,140,19,46,100,94,150,121,104
2020,25,81,"Sinop",42.0231,35.1531,20.2571428571429,22,0.0142857142857143,83.4142857142857,35.6014285714286,NA,137,31,10,81,68,108,106,98
2020,26,81,"Sinop",42.0231,35.1531,21.8142857142857,22.8857142857143,1.4,84.7,40.32,NA,173,54,43,119,90,133,119,90
2020,27,81,"Sinop",42.0231,35.1531,15.1571428571429,24.7571428571429,0,75.8428571428571,39.6428571428571,NA,113,11,38,94,43,113,102,75
2020,28,81,"Sinop",42.0231,35.1531,22.4428571428571,24.9,0,74.2142857142857,48.1928571428571,NA,164,54,43,86,57,122,110,79
2020,29,81,"Sinop",42.0231,35.1531,23.4428571428571,23.5428571428571,0.342857142857143,75.0857142857143,36.8833333333333,NA,186,78,67,89,41,111,108,44
2020,30,81,"Sinop",42.0231,35.1531,23.4714285714286,24.0428571428571,0.0285714285714286,78.5285714285714,37.9271428571429,NA,190,0,0,146,132,142,190,142
2020,31,81,"Sinop",42.0231,35.1531,20.7714285714286,24.2142857142857,1.62857142857143,80.6857142857143,32.48,NA,150,0,0,132,108,127,150,127
2020,32,81,"Sinop",42.0231,35.1531,18.6,24.8,0,73.3285714285714,33.0642857142857,NA,146,62,29,48,22,107,84,78
2020,33,81,"Sinop",42.0231,35.1531,24.0142857142857,24.0428571428571,0.2,70.7142857142857,33.4814285714286,NA,183,0,0,134,64,83,183,83
2020,34,81,"Sinop",42.0231,35.1531,19.7,23.9,0.6,72.8857142857143,35.3614285714286,NA,197,29,7,87,57,97,168,90
2020,35,81,"Sinop",42.0231,35.1531,19.1285714285714,24.0857142857143,0,74.3285714285714,29.4257142857143,NA,164,64,63,40,29,157,100,94
2020,36,81,"Sinop",42.0231,35.1531,23.3714285714286,24.3142857142857,0.228571428571429,80.3,34.88,NA,179,94,40,67,42,112,85,72
2020,37,81,"Sinop",42.0231,35.1531,17.7714285714286,24.3,0.142857142857143,72.9857142857143,35.6714285714286,NA,193,85,44,100,38,91,108,47
2020,38,81,"Sinop",42.0231,35.1531,19.2571428571429,23.2285714285714,0.528571428571429,73.1571428571429,42.9728571428571,NA,235,56,56,121,87,157,179,101
2020,39,81,"Sinop",42.0231,35.1531,14.0571428571429,22.6857142857143,0.1,74.2142857142857,38.2771428571429,NA,220,101,30,54,59,129,119,99
2020,40,81,"Sinop",42.0231,35.1531,18.7571428571429,21.7714285714286,1.5,77.2571428571429,29.3883333333333,NA,187,85,55,43,20,154,102,99
2020,41,81,"Sinop",42.0231,35.1531,23.5142857142857,21.6142857142857,0.0428571428571429,78.2142857142857,29.895,NA,182,128,90,54,37,127,54,37
2020,42,81,"Sinop",42.0231,35.1531,21.2571428571429,21.8571428571429,0.0714285714285714,79.1714285714286,39.9257142857143,NA,177,93,36,51,56,111,84,75
2020,43,81,"Sinop",42.0231,35.1531,20.8714285714286,18.7428571428571,2.82857142857143,78.9857142857143,27.6157142857143,NA,194,119,126,10,6,161,75,35
2020,44,81,"Sinop",42.0231,35.1531,21.8142857142857,19.1,1.34285714285714,77.3571428571429,42.4742857142857,NA,255,14,2,196,156,233,241,231
2020,45,81,"Sinop",42.0231,35.1531,24.8857142857143,15.8714285714286,0.828571428571429,74.0428571428571,41.5442857142857,NA,156,36,35,97,60,103,120,68
2020,46,81,"Sinop",42.0231,35.1531,17.3,14.6285714285714,0.657142857142857,72.7857142857143,27.6214285714286,NA,208,111,68,20,8,109,97,41
2020,47,81,"Sinop",42.0231,35.1531,24.7,11.8428571428571,10.0428571428571,73.4285714285714,29.0385714285714,NA,173,28,2,85,39,83,145,81
2020,48,81,"Sinop",42.0231,35.1531,18.5571428571429,11.4857142857143,0.457142857142857,71.7571428571429,28.0314285714286,NA,199,17,13,64,127,262,182,249
2020,49,81,"Sinop",42.0231,35.1531,14.7857142857143,12.6428571428571,1.02857142857143,81.8,38.4314285714286,NA,207,84,28,26,8,116,123,88
2020,50,81,"Sinop",42.0231,35.1531,18.2428571428571,13.4428571428571,4.77142857142857,76.9571428571429,31.9971428571429,NA,181,43,28,0,0,98,138,70
2020,51,81,"Sinop",42.0231,35.1531,18.6,11.6571428571429,3.5,80,31.7883333333333,NA,171,72,39,44,21,90,99,51
2020,52,81,"Sinop",42.0231,35.1531,22.9571428571429,10.1571428571429,6.42857142857143,71.3571428571429,24.74,NA,203,0,0,39,40,113,203,113
2020,53,81,"Sinop",42.0231,35.1531,13.125,13.15,0,70.025,36.7,NA,122,0,0,0,0,111,122,111
2017,1,82,"Sirnak",39.7477,37.0179,40.7142857142857,-3.12857142857143,2.14228571428571,84.0857142857143,NA,NA,563,121,202,0,0,847,442,645
2017,2,82,"Sirnak",39.7477,37.0179,32.1,-6.78571428571429,3.61685714285714,84.1285714285714,NA,NA,757,437,829,105,125,1214,320,385
2017,3,82,"Sirnak",39.7477,37.0179,18.4428571428571,-5.47142857142857,0.215,84.1,NA,NA,762,301,425,143,549,1449,461,1024
2017,4,82,"Sirnak",39.7477,37.0179,28.2142857142857,-8.7,2.778,85.6142857142857,NA,NA,639,240,352,88,163,889,399,537
2017,5,82,"Sirnak",39.7477,37.0179,24.6571428571429,-10.6714285714286,0.154,80.3714285714286,NA,NA,588,267,652,39,107,1163,321,511
2017,6,82,"Sirnak",39.7477,37.0179,20.0285714285714,-2.85714285714286,0.241,86.2857142857143,NA,NA,736,352,753,0,0,1519,384,766
2017,7,82,"Sirnak",39.7477,37.0179,26.3,-9.77142857142857,0.254428571428571,80.5142857142857,NA,NA,492,134,113,107,235,717,358,604
2017,8,82,"Sirnak",39.7477,37.0179,25.4285714285714,-0.828571428571429,0.0722857142857143,77.4857142857143,NA,NA,739,232,453,99,308,1747,507,1294
2017,9,82,"Sirnak",39.7477,37.0179,24.4857142857143,2.7,1.00157142857143,76.7714285714286,NA,NA,574,274,519,1,0,866,300,347
2017,10,82,"Sirnak",39.7477,37.0179,30.7142857142857,5.34285714285714,0.875142857142857,63.3,NA,NA,712,189,368,0,0,1043,523,675
2017,11,82,"Sirnak",39.7477,37.0179,27.3,0,3.30714285714286,87.3714285714286,NA,NA,525,36,46,69,148,725,489,679
2017,12,82,"Sirnak",39.7477,37.0179,28.3428571428571,2.34285714285714,0.381714285714286,67.1,NA,NA,589,0,0,248,527,1077,589,1077
2017,13,82,"Sirnak",39.7477,37.0179,25,4.3,2.31357142857143,67.4,NA,NA,574,141,162,63,71,887,433,725
2017,14,82,"Sirnak",39.7477,37.0179,31.4428571428571,5.62857142857143,3.56414285714286,60.1428571428571,NA,NA,639,103,367,5,6,1336,536,969
2017,15,82,"Sirnak",39.7477,37.0179,24.0571428571429,4.8,2.25157142857143,76.9571428571429,NA,NA,587,125,259,147,231,1187,462,928
2017,16,82,"Sirnak",39.7477,37.0179,43.2571428571429,10.0285714285714,0.454714285714286,53.3428571428571,NA,NA,717,0,0,170,117,920,717,920
2017,17,82,"Sirnak",39.7477,37.0179,22,9.02857142857143,0.722142857142857,41.0857142857143,NA,NA,731,412,932,99,139,1478,319,546
2017,18,82,"Sirnak",39.7477,37.0179,26.6428571428571,9.91428571428571,4.281,69.4714285714286,NA,NA,506,77,128,161,345,923,429,795
2017,19,82,"Sirnak",39.7477,37.0179,34.4142857142857,13.1571428571429,0.953428571428572,59.9428571428571,NA,NA,471,0,0,233,468,966,471,966
2017,20,82,"Sirnak",39.7477,37.0179,28.7714285714286,9.25714285714286,2.87285714285714,77.5428571428571,NA,NA,472,68,193,83,394,1205,404,1012
2017,21,82,"Sirnak",39.7477,37.0179,23.9142857142857,9.24285714285714,5.41114285714286,75.6,96.455,NA,448,155,232,229,418,849,293,617
2017,22,82,"Sirnak",39.7477,37.0179,27.8285714285714,13.3285714285714,0.267,68.4,85.085,NA,522,38,132,93,73,1015,484,883
2017,23,82,"Sirnak",39.7477,37.0179,27.8571428571429,15.9857142857143,1.14057142857143,68.8571428571429,113.58,NA,578,124,293,231,688,1388,454,1095
2017,24,82,"Sirnak",39.7477,37.0179,23.1142857142857,13.9285714285714,0.503428571428571,67.8428571428571,129.292857142857,NA,552,72,113,60,186,1139,480,1026
2017,25,82,"Sirnak",39.7477,37.0179,28.0857142857143,13.7,3.08271428571429,76.5,NA,NA,584,0,0,204,309,1041,584,1041
2017,26,82,"Sirnak",39.7477,37.0179,27.1142857142857,20.0428571428571,0,52.5571428571429,NA,NA,564,0,0,2,6,971,564,971
2017,27,82,"Sirnak",39.7477,37.0179,29.9571428571429,17.5285714285714,0,63.3714285714286,NA,NA,511,0,0,117,262,642,511,642
2017,28,82,"Sirnak",39.7477,37.0179,30.0571428571429,17.9857142857143,0,50.2571428571429,NA,NA,481,0,0,37,80,864,481,864
2017,29,82,"Sirnak",39.7477,37.0179,30.3285714285714,19.8285714285714,0,59.9142857142857,NA,NA,532,33,134,50,192,1272,499,1138
2017,30,82,"Sirnak",39.7477,37.0179,26.2571428571429,20.2142857142857,0,51.6285714285714,NA,NA,531,3,2,79,114,928,528,926
2017,31,82,"Sirnak",39.7477,37.0179,29.2285714285714,21.5142857142857,0.0277142857142857,58.7,NA,NA,559,20,132,36,45,1047,539,915
2017,32,82,"Sirnak",39.7477,37.0179,29.2571428571429,22.3,0,55.2571428571429,NA,NA,567,0,0,43,152,1092,567,1092
2017,33,82,"Sirnak",39.7477,37.0179,30.5285714285714,21,0.138857142857143,57.4,NA,NA,596,40,80,7,44,1199,556,1119
2017,34,82,"Sirnak",39.7477,37.0179,30.5571428571429,17.8571428571429,0,63.6571428571429,NA,NA,601,0,0,99,146,1280,601,1280
2017,35,82,"Sirnak",39.7477,37.0179,27.5571428571429,16.5857142857143,0,59.2571428571429,NA,NA,493,0,0,72,172,1014,493,1014
2017,36,82,"Sirnak",39.7477,37.0179,23.1285714285714,18.2,0.296714285714286,40.5571428571429,NA,NA,507,72,143,181,585,1321,435,1178
2017,37,82,"Sirnak",39.7477,37.0179,19.7142857142857,22.0571428571429,0,27.7714285714286,NA,NA,589,271,372,19,33,1138,318,766
2017,38,82,"Sirnak",39.7477,37.0179,23.7,19.6,0,40.0285714285714,22.055,NA,671,249,390,117,319,1312,422,922
2017,39,82,"Sirnak",39.7477,37.0179,22.7,13.3428571428571,2.58528571428571,64.4285714285714,14.8885714285714,NA,782,304,558,71,182,1630,478,1072
2017,40,82,"Sirnak",39.7477,37.0179,23.5714285714286,8.91428571428571,2.40928571428571,60.5142857142857,12.5316666666667,NA,543,21,27,30,51,1137,522,1110
2017,41,82,"Sirnak",39.7477,37.0179,22.3428571428571,6.91428571428571,1.76985714285714,76.5571428571428,9.7275,NA,487,0,0,75,167,843,487,843
2017,42,82,"Sirnak",39.7477,37.0179,21.0571428571429,7.65714285714286,0.140142857142857,63.0285714285714,10.0114285714286,NA,530,104,143,165,245,815,426,672
2017,43,82,"Sirnak",39.7477,37.0179,27.8428571428571,10.2428571428571,0.156,56.0142857142857,11.9757142857143,NA,506,39,118,108,172,919,467,801
2017,44,82,"Sirnak",39.7477,37.0179,23.8714285714286,3.17142857142857,1.49642857142857,65.6714285714286,12.7342857142857,NA,561,276,585,144,229,1102,285,517
2017,45,82,"Sirnak",39.7477,37.0179,15.0571428571429,3.9,0.854,79.3857142857143,14.0233333333333,NA,577,54,61,206,237,829,523,768
2017,46,82,"Sirnak",39.7477,37.0179,22.5285714285714,6.54285714285714,0.128571428571429,63.7857142857143,NA,NA,587,279,586,0,0,1085,308,499
2017,47,82,"Sirnak",39.7477,37.0179,25.5857142857143,-1.32857142857143,1.70985714285714,85.4857142857143,NA,NA,418,111,313,183,332,804,307,491
2017,48,82,"Sirnak",39.7477,37.0179,19.2142857142857,1.14285714285714,1.85957142857143,83.0285714285714,NA,NA,386,281,449,0,0,619,105,170
2017,49,82,"Sirnak",39.7477,37.0179,22.6285714285714,-1.68571428571429,0.545571428571428,83.2428571428571,NA,NA,407,92,192,160,220,645,315,453
2017,50,82,"Sirnak",39.7477,37.0179,17.0428571428571,2.34285714285714,0.320714285714286,73.3571428571429,NA,NA,346,221,310,42,81,442,125,132
2017,51,82,"Sirnak",39.7477,37.0179,32.9,3.67142857142857,9.71242857142857,85.7,15.515,NA,386,19,39,1,0,349,367,310
2017,52,82,"Sirnak",39.7477,37.0179,28.325,-0.375,0.178875,78.2875,18.21,NA,528,172,224,103,69,507,356,283
2018,1,82,"Sirnak",39.7477,37.0179,22.5375,-0.975,0.97425,87.3875,28.9566666666667,NA,618,122,185,114,157,914,496,729
2018,2,82,"Sirnak",39.7477,37.0179,20.6142857142857,-0.9,1.13928571428571,87.6857142857143,NA,NA,624,230,193,167,754,1309,394,1116
2018,3,82,"Sirnak",39.7477,37.0179,29.2142857142857,-2.62857142857143,5.91514285714286,88.2142857142857,NA,NA,639,55,220,10,51,655,584,435
2018,4,82,"Sirnak",39.7477,37.0179,30.3285714285714,-3.7,1.933,87.9857142857143,NA,NA,604,28,33,5,5,764,576,731
2018,5,82,"Sirnak",39.7477,37.0179,21.8571428571429,-2.77142857142857,0,86.1428571428571,NA,NA,670,269,444,266,189,819,401,375
2018,6,82,"Sirnak",39.7477,37.0179,24.9714285714286,2.08571428571429,0.367,77.0857142857143,NA,NA,704,364,561,30,26,1022,340,461
2018,7,82,"Sirnak",39.7477,37.0179,33.6,2.27142857142857,0.0408571428571428,73.4857142857143,NA,NA,478,73,139,89,106,557,405,418
2018,8,82,"Sirnak",39.7477,37.0179,21.1428571428571,2,2.833,78.9142857142857,NA,NA,711,285,460,0,0,1321,426,861
2018,9,82,"Sirnak",39.7477,37.0179,35.9285714285714,1.6,2.74942857142857,80.2142857142857,NA,NA,621,14,29,94,162,956,607,927
2018,10,82,"Sirnak",39.7477,37.0179,28.5714285714286,4.87142857142857,4.03728571428571,79.0714285714286,NA,NA,556,2,1,303,664,1330,554,1329
2018,11,82,"Sirnak",39.7477,37.0179,26.8,5.57142857142857,2.54285714285714,74.7142857142857,NA,NA,551,7,3,215,580,1426,544,1423
2018,12,82,"Sirnak",39.7477,37.0179,39.6285714285714,10.1,0.646714285714286,52.3714285714286,NA,NA,425,0,0,116,279,1187,425,1187
2018,13,82,"Sirnak",39.7477,37.0179,34.7,8.08571428571429,2.254,59.6714285714286,NA,NA,356,0,0,80,55,428,356,428
2018,14,82,"Sirnak",39.7477,37.0179,25.5428571428571,8.15714285714286,0.436285714285714,53.1857142857143,NA,NA,407,74,76,3,0,486,333,410
2018,15,82,"Sirnak",39.7477,37.0179,30.5285714285714,10.2857142857143,0.0988571428571429,57.3857142857143,NA,NA,374,151,245,2,10,450,223,205
2018,16,82,"Sirnak",39.7477,37.0179,32.0571428571429,7.74285714285714,0.00528571428571429,48.5285714285714,NA,NA,411,0,0,21,54,648,411,648
2018,17,82,"Sirnak",39.7477,37.0179,28.8714285714286,12.1285714285714,0,48.0571428571429,NA,NA,419,56,192,2,0,652,363,460
2018,18,82,"Sirnak",39.7477,37.0179,25.1857142857143,12.5571428571429,1.23842857142857,70.5714285714286,NA,NA,303,193,385,0,0,474,110,89
2018,19,82,"Sirnak",39.7477,37.0179,27.6,8.47142857142857,7.22971428571429,86.4571428571429,36.6416666666667,NA,275,6,23,130,170,467,269,444
2018,20,82,"Sirnak",39.7477,37.0179,23.3857142857143,12.4714285714286,1.33371428571429,65.1142857142857,60.69,NA,204,10,1,14,34,306,194,305
2018,21,82,"Sirnak",39.7477,37.0179,25.5714285714286,14.2428571428571,0.349,67.9142857142857,102.221428571429,NA,252,58,75,34,34,281,194,206
2018,22,82,"Sirnak",39.7477,37.0179,26.2714285714286,12.6428571428571,1.86157142857143,80.1428571428571,130.2675,NA,249,60,170,24,59,427,189,257
2018,23,82,"Sirnak",39.7477,37.0179,25.2571428571429,14.6,0.896857142857143,65.0285714285714,NA,NA,267,0,0,100,211,812,267,812
2018,24,82,"Sirnak",39.7477,37.0179,28.6285714285714,15.1285714285714,0.963142857142857,69.7428571428571,NA,NA,267,71,71,35,157,448,196,377
2018,25,82,"Sirnak",39.7477,37.0179,21.7428571428571,14.8142857142857,1.19371428571429,77.9142857142857,NA,NA,358,0,0,117,137,518,358,518
2018,26,82,"Sirnak",39.7477,37.0179,22.1,19.9428571428571,1.014,62.1285714285714,NA,NA,355,77,156,103,178,587,278,431
2018,27,82,"Sirnak",39.7477,37.0179,29.7857142857143,15.7857142857143,0,75.0142857142857,NA,NA,342,0,0,38,93,418,342,418
2018,28,82,"Sirnak",39.7477,37.0179,30.3142857142857,19.7571428571429,0,61.5571428571429,NA,NA,286,0,0,10,19,585,286,585
2018,29,82,"Sirnak",39.7477,37.0179,28.3285714285714,16.8714285714286,0.353142857142857,63.3571428571429,NA,NA,260,0,0,9,16,756,260,756
2018,30,82,"Sirnak",39.7477,37.0179,28.4285714285714,19.7285714285714,0.002,60.3428571428571,NA,NA,265,0,0,54,324,822,265,822
2018,31,82,"Sirnak",39.7477,37.0179,33.9714285714286,18.4,0.00128571428571429,68.1285714285714,123.53,NA,267,0,0,8,5,499,267,499
2018,32,82,"Sirnak",39.7477,37.0179,34.7,15.9428571428571,0.00271428571428571,70.3428571428571,127.792857142857,NA,297,0,0,12,48,403,297,403
2018,33,82,"Sirnak",39.7477,37.0179,29.9857142857143,16.8428571428571,0,59.7142857142857,145.045714285714,NA,216,0,0,29,71,332,216,332
2018,34,82,"Sirnak",39.7477,37.0179,30.4142857142857,18.2142857142857,0,59.4714285714286,96.8371428571429,NA,144,22,4,10,3,227,122,223
2018,35,82,"Sirnak",39.7477,37.0179,30.5285714285714,20.0285714285714,0.000857142857142857,46.3571428571429,117.542857142857,NA,201,17,17,37,84,314,184,297
2018,36,82,"Sirnak",39.7477,37.0179,26.5714285714286,16.4571428571429,0.0277142857142857,57.4571428571429,123.092857142857,NA,341,52,36,150,181,370,289,334
2018,37,82,"Sirnak",39.7477,37.0179,26.5428571428571,15.2857142857143,1.09571428571429,61.7857142857143,130.728571428571,NA,241,44,89,62,140,419,197,330
2018,38,82,"Sirnak",39.7477,37.0179,26.0285714285714,13.2285714285714,0,65.7428571428571,111.28,NA,189,0,0,46,130,344,189,344
2018,39,82,"Sirnak",39.7477,37.0179,24.2857142857143,13.1857142857143,0,57.2571428571429,105.73,NA,180,0,0,65,92,353,180,353
2018,40,82,"Sirnak",39.7477,37.0179,23.9142857142857,11.0142857142857,2.362,65.6857142857143,99.3771428571429,NA,191,14,45,18,13,341,177,296
2018,41,82,"Sirnak",39.7477,37.0179,22.8285714285714,12.3571428571429,1.63185714285714,69.8142857142857,119.798333333333,NA,187,164,392,0,0,422,23,30
2018,42,82,"Sirnak",39.7477,37.0179,19.9714285714286,12.5571428571429,0.767714285714286,67.0571428571429,108.52,NA,168,117,343,0,0,381,51,38
2018,43,82,"Sirnak",39.7477,37.0179,27.3428571428571,6.2,3.21028571428571,79.0142857142857,106.111428571429,NA,187,33,58,19,107,402,154,344
2018,44,82,"Sirnak",39.7477,37.0179,20.1857142857143,8.55714285714286,0,50.3857142857143,96.1957142857143,NA,196,85,128,14,21,264,111,136
2018,45,82,"Sirnak",39.7477,37.0179,18.8285714285714,5.04285714285714,0,71.1428571428571,49.8314285714286,NA,231,122,254,44,127,473,109,219
2018,46,82,"Sirnak",39.7477,37.0179,18.3857142857143,-0.6,0.556714285714286,83.6857142857143,59.8328571428571,NA,230,75,134,25,84,465,155,331
2018,47,82,"Sirnak",39.7477,37.0179,16.8,2.92857142857143,1.04014285714286,88.9,76.9542857142857,NA,270,80,89,50,195,499,190,410
2018,48,82,"Sirnak",39.7477,37.0179,28.8142857142857,4.48571428571429,1.03085714285714,88.6,76.9285714285714,NA,245,103,153,0,0,201,142,48
2018,49,82,"Sirnak",39.7477,37.0179,24.2285714285714,0.757142857142857,1.20971428571429,88.1428571428571,56.41,NA,257,137,236,0,0,420,120,184
2018,50,82,"Sirnak",39.7477,37.0179,25.5,-1.11428571428571,3.76157142857143,91.4,75.0757142857143,NA,256,89,130,29,20,305,167,175
2018,51,82,"Sirnak",39.7477,37.0179,22.9285714285714,0.857142857142857,0.737428571428571,90.1571428571429,80.18,NA,250,95,92,78,64,248,155,156
2018,52,82,"Sirnak",39.7477,37.0179,30.6714285714286,-5.37142857142857,1.81142857142857,88.3142857142857,69.5185714285714,NA,244,34,32,50,23,273,210,241
2019,1,82,"Sirnak",39.7477,37.0179,37.3125,-1.4875,3.39125,92.2375,63.18625,NA,343,145,281,0,0,784,198,503
2019,2,82,"Sirnak",39.7477,37.0179,29.8571428571429,-8.62857142857143,1.74657142857143,85.5571428571428,81.9328571428571,NA,255,146,96,11,12,208,109,112
2019,3,82,"Sirnak",39.7477,37.0179,34.3571428571429,-7.04285714285714,3.51885714285714,88.4857142857143,131.392857142857,NA,192,49,97,8,5,198,143,101
2019,4,82,"Sirnak",39.7477,37.0179,38.6285714285714,-1.94285714285714,0.374428571428571,83.8285714285714,149.43,NA,308,124,211,0,0,314,184,103
2019,5,82,"Sirnak",39.7477,37.0179,30.1571428571429,-2.2,0.134428571428571,87.2714285714286,64.3885714285714,NA,253,111,78,31,22,143,142,65
2019,6,82,"Sirnak",39.7477,37.0179,30.9142857142857,-1.87142857142857,2.58571428571429,84.0857142857143,90.8028571428571,NA,276,244,117,0,0,127,32,10
2019,7,82,"Sirnak",39.7477,37.0179,23.7142857142857,-2.92857142857143,0,85.8428571428571,65.5814285714286,NA,325,40,37,2,1,234,285,197
2019,8,82,"Sirnak",39.7477,37.0179,22.0571428571429,-1.5,0,78.5714285714286,73.962,NA,305,82,100,64,61,219,223,119
2019,9,82,"Sirnak",39.7477,37.0179,26.0142857142857,-2.87142857142857,0.616428571428571,86.1571428571429,NA,NA,331,45,50,88,110,310,286,260
2019,10,82,"Sirnak",39.7477,37.0179,22.5142857142857,-0.457142857142857,0.775714285714286,76.3,NA,NA,359,28,89,49,40,252,331,163
2019,11,82,"Sirnak",39.7477,37.0179,32.0285714285714,2.61428571428571,1.546,82.1857142857143,NA,NA,373,11,67,30,29,400,362,333
2019,12,82,"Sirnak",39.7477,37.0179,26.2857142857143,0.285714285714286,0.056,72,NA,NA,343,0,0,99,55,416,343,416
2019,13,82,"Sirnak",39.7477,37.0179,27.9,0.0428571428571429,1.65285714285714,71.5285714285714,NA,NA,256,48,13,64,93,194,208,181
2019,14,82,"Sirnak",39.7477,37.0179,22.8714285714286,3.47142857142857,0.362857142857143,76.6142857142857,NA,NA,365,109,88,2,0,208,256,120
2019,15,82,"Sirnak",39.7477,37.0179,32.3142857142857,7.65714285714286,2.44428571428571,70.4428571428571,NA,NA,359,3,12,41,18,183,356,171
2019,16,82,"Sirnak",39.7477,37.0179,29.4714285714286,0.985714285714286,2.078,90.2714285714286,NA,NA,318,46,11,11,7,208,272,197
2019,17,82,"Sirnak",39.7477,37.0179,23.6285714285714,4.98571428571429,1.25442857142857,73.5285714285714,NA,NA,412,8,17,58,67,313,404,296
2019,18,82,"Sirnak",39.7477,37.0179,29.8857142857143,9.84285714285714,0.110714285714286,67.2428571428571,21.7,NA,523,0,0,78,46,353,523,353
2019,19,82,"Sirnak",39.7477,37.0179,28.8714285714286,9.58571428571429,0.427,69.2857142857143,50.8157142857143,NA,452,8,7,202,186,386,444,379
2019,20,82,"Sirnak",39.7477,37.0179,28.1142857142857,14.7857142857143,0.311571428571429,53.7,61.6671428571429,NA,454,239,194,133,132,389,215,195
2019,21,82,"Sirnak",39.7477,37.0179,37.6285714285714,14.2,0.721142857142857,64.4285714285714,74.4642857142857,NA,457,0,0,367,371,413,457,413
2019,22,82,"Sirnak",39.7477,37.0179,20.9,17.2857142857143,0.706285714285714,54.6714285714286,47.3757142857143,NA,453,21,60,12,7,323,432,263
2019,23,82,"Sirnak",39.7477,37.0179,25.6,18.0285714285714,0.228857142857143,63.0571428571429,83.1442857142857,NA,378,57,53,42,85,532,321,479
2019,24,82,"Sirnak",39.7477,37.0179,27.0714285714286,16.0285714285714,4.98742857142857,72.6,78.32,NA,378,222,200,48,14,244,156,44
2019,25,82,"Sirnak",39.7477,37.0179,24.7142857142857,15.7142857142857,1.681,80.6714285714286,71.2785714285714,NA,306,39,32,12,22,325,267,293
2019,26,82,"Sirnak",39.7477,37.0179,28.3428571428571,16.3,0,69.7,72.5228571428571,NA,377,0,0,9,8,342,377,342
2019,27,82,"Sirnak",39.7477,37.0179,31.0714285714286,15.6857142857143,0,62.1571428571429,84.7842857142857,NA,456,0,0,10,4,222,456,222
2019,28,82,"Sirnak",39.7477,37.0179,26.2714285714286,16.0285714285714,0.449142857142857,64.7571428571429,81.4528571428571,NA,398,0,0,109,129,421,398,421
2019,29,82,"Sirnak",39.7477,37.0179,28.9428571428571,14.9142857142857,2.17142857142857,73.9857142857143,71.99,NA,453,55,19,57,5,203,398,184
2019,30,82,"Sirnak",39.7477,37.0179,33.2,15.5428571428571,0.00114285714285714,71.4285714285714,84.3628571428571,NA,456,0,0,18,22,335,456,335
2019,31,82,"Sirnak",39.7477,37.0179,29.1571428571429,19.5857142857143,0.00114285714285714,56.3285714285714,86.42,NA,334,0,0,143,202,375,334,375
2019,32,82,"Sirnak",39.7477,37.0179,34,15.1142857142857,0,65.3428571428571,80.36,NA,346,0,0,18,40,395,346,395
2019,33,82,"Sirnak",39.7477,37.0179,31.1285714285714,20.0285714285714,0.100428571428571,53.2142857142857,79.7314285714286,NA,337,2,1,57,99,531,335,530
2019,34,82,"Sirnak",39.7477,37.0179,31.5142857142857,16.2428571428571,1.06528571428571,76.4714285714286,75.9528571428571,NA,299,47,35,53,70,345,252,310
2019,35,82,"Sirnak",39.7477,37.0179,30.3,16.5857142857143,0.0734285714285714,73.5428571428571,80.1485714285714,NA,307,0,0,15,19,415,307,415
2019,36,82,"Sirnak",39.7477,37.0179,25.8,14.2142857142857,0,63.9857142857143,89.1371428571429,NA,171,0,0,12,9,67,171,67
2019,37,82,"Sirnak",39.7477,37.0179,30.7571428571429,13.1428571428571,1.87914285714286,75.2,90.7928571428571,NA,218,0,0,6,3,55,218,55
2019,38,82,"Sirnak",39.7477,37.0179,24.4857142857143,12.3142857142857,0.557142857142857,65.9714285714286,96.1628571428571,NA,266,1,0,57,37,91,265,91
2019,39,82,"Sirnak",39.7477,37.0179,19.3714285714286,12.6142857142857,0.352142857142857,59.2714285714286,108.645714285714,NA,237,0,0,45,15,79,237,79
2019,40,82,"Sirnak",39.7477,37.0179,26.2571428571429,14.5714285714286,0.0714285714285714,48,99.44,NA,241,3,1,66,21,111,238,110
2019,41,82,"Sirnak",39.7477,37.0179,23.3714285714286,12.3714285714286,0.0415714285714286,60.8714285714286,120.551428571429,NA,416,66,100,161,216,448,350,348
2019,42,82,"Sirnak",39.7477,37.0179,25.4714285714286,13.1571428571429,0.0317142857142857,52.5,74.4757142857143,NA,356,200,281,0,0,408,156,127
2019,43,82,"Sirnak",39.7477,37.0179,22.1,9.57142857142857,1.16671428571429,76.8571428571429,56.1714285714286,NA,306,159,130,19,38,300,147,170
2019,44,82,"Sirnak",39.7477,37.0179,19.1285714285714,4.92857142857143,2.72314285714286,76.1571428571429,47.1657142857143,NA,350,127,108,121,62,250,223,142
2019,45,82,"Sirnak",39.7477,37.0179,19.5285714285714,7.44285714285714,0,52.6285714285714,83.7842857142857,NA,417,168,193,0,0,328,249,135
2019,46,82,"Sirnak",39.7477,37.0179,18.6142857142857,7.72857142857143,0,46.5857142857143,85.9885714285714,NA,401,279,264,0,0,337,122,73
2019,47,82,"Sirnak",39.7477,37.0179,16.7142857142857,3.01428571428571,0,47.2142857142857,90.6871428571429,NA,391,26,63,127,124,339,365,276
2019,48,82,"Sirnak",39.7477,37.0179,27.7428571428571,3.92857142857143,2.25457142857143,78.1285714285714,75.9614285714286,NA,320,45,46,56,75,251,275,205
2019,49,82,"Sirnak",39.7477,37.0179,13.7857142857143,-3.9,1.62514285714286,92.7571428571429,65.8057142857143,NA,393,74,64,7,2,274,319,210
2019,50,82,"Sirnak",39.7477,37.0179,24.3428571428571,0.3,0.435,89.6714285714286,71.05,NA,218,108,41,0,0,119,110,78
2019,51,82,"Sirnak",39.7477,37.0179,15.8,2.27142857142857,0.0714285714285714,74.1142857142857,105.394285714286,NA,361,52,120,50,44,488,309,368
2019,52,82,"Sirnak",39.7477,37.0179,34.4,0.671428571428571,3.238,85.4857142857143,88.48,NA,279,100,104,0,0,281,179,177
2020,1,82,"Sirnak",39.7477,37.0179,21.18,-3.44,1.5666,93.8,61.374,NA,160,54,53,93,60,126,106,73
2020,2,82,"Sirnak",39.7477,37.0179,29.9142857142857,-3.64285714285714,0.348714285714286,89.5571428571429,72.0885714285714,NA,240,41,46,3,2,173,199,127
2020,3,82,"Sirnak",39.7477,37.0179,22.9428571428571,-6.25714285714286,0.0142857142857143,83.9714285714286,73.9928571428571,NA,270,213,344,1,0,382,57,38
2020,4,82,"Sirnak",39.7477,37.0179,24.2,-7.91428571428571,0.576857142857143,88.3428571428571,61.0428571428571,NA,358,30,40,64,33,295,328,255
2020,5,82,"Sirnak",39.7477,37.0179,27.1857142857143,-3.47142857142857,2.19528571428571,89.2428571428571,84.3442857142857,NA,331,110,141,50,21,272,221,131
2020,6,82,"Sirnak",39.7477,37.0179,43.5857142857143,-3.17142857142857,6.23885714285714,90.7,63.5328571428571,NA,343,13,12,102,67,267,330,255
2020,7,82,"Sirnak",39.7477,37.0179,22.8,-9.65714285714286,5.33357142857143,82.9857142857143,66.2671428571429,NA,341,205,153,10,2,338,136,185
2020,8,82,"Sirnak",39.7477,37.0179,24.3428571428571,-3.12857142857143,0.444857142857143,92.1428571428571,56.0342857142857,NA,283,160,128,2,0,187,123,59
2020,9,82,"Sirnak",39.7477,37.0179,36,-1.07142857142857,0.647857142857143,83.1857142857143,82.6914285714286,NA,393,22,9,1,0,528,371,519
2020,10,82,"Sirnak",39.7477,37.0179,26.7714285714286,1.37142857142857,0.0972857142857143,75.6857142857143,69.5414285714286,NA,205,152,169,0,0,210,53,41
2020,11,82,"Sirnak",39.7477,37.0179,36.3,6.05714285714286,0.333714285714286,74.3857142857143,63.5657142857143,NA,115,50,37,0,0,94,65,57
2020,12,82,"Sirnak",39.7477,37.0179,29.7142857142857,-2.85714285714286,5.55857142857143,87.7571428571429,45.8557142857143,NA,117,0,0,15,14,118,117,118
2020,13,82,"Sirnak",39.7477,37.0179,27.0857142857143,4.68571428571429,0.48,79.5285714285714,44.5942857142857,NA,136,60,51,14,8,92,76,41
2020,14,82,"Sirnak",39.7477,37.0179,23.4857142857143,4.88571428571429,4.78714285714286,78.5714285714286,41.4042857142857,NA,155,54,34,35,33,121,101,87
2020,15,82,"Sirnak",39.7477,37.0179,27.4142857142857,6.6,0.403142857142857,60.8857142857143,50.2857142857143,NA,133,27,55,2,0,118,106,63
2020,16,82,"Sirnak",39.7477,37.0179,20.8285714285714,9.27142857142857,0.249142857142857,53.8428571428571,48.94,NA,141,0,0,58,25,106,141,106
2020,17,82,"Sirnak",39.7477,37.0179,21.6,7.25714285714286,3.12228571428571,66.9142857142857,NA,NA,137,4,1,66,56,123,133,122
2020,18,82,"Sirnak",39.7477,37.0179,22.8571428571429,9.92857142857143,1.55057142857143,66.4857142857143,NA,NA,146,0,0,51,53,164,146,164
2020,19,82,"Sirnak",39.7477,37.0179,27.2,9.25714285714286,4.49814285714286,74.5,NA,NA,137,0,0,22,11,157,137,157
2020,20,82,"Sirnak",39.7477,37.0179,21.8428571428571,16.5,0,52.4285714285714,NA,NA,164,0,0,66,96,164,164,164
2020,21,82,"Sirnak",39.7477,37.0179,32.5,15.2428571428571,0.271428571428571,52.0142857142857,NA,NA,146,0,0,40,11,96,146,96
2020,22,82,"Sirnak",39.7477,37.0179,31.6714285714286,13.9571428571429,0.160285714285714,51.3857142857143,NA,NA,118,17,7,37,24,100,101,93
2020,23,82,"Sirnak",39.7477,37.0179,25.2714285714286,13.9285714285714,3.71985714285714,57.5714285714286,NA,NA,112,3,2,58,34,70,109,68
2020,24,82,"Sirnak",39.7477,37.0179,36.0142857142857,14.5857142857143,2.347,64.9714285714286,NA,NA,140,29,50,19,13,150,111,100
2020,25,82,"Sirnak",39.7477,37.0179,26.4857142857143,14.7857142857143,1.02071428571429,70.0428571428571,NA,NA,137,1,1,48,47,108,136,107
2020,26,82,"Sirnak",39.7477,37.0179,28.9714285714286,15.9571428571429,0.0435714285714286,68.1428571428571,NA,NA,173,27,14,38,42,133,146,119
2020,27,82,"Sirnak",39.7477,37.0179,31.6142857142857,17.3428571428571,0.0457142857142857,67.1714285714286,NA,NA,113,0,0,22,42,113,113,113
2020,28,82,"Sirnak",39.7477,37.0179,33.1285714285714,18.1,0.0415714285714286,66.8428571428571,NA,NA,164,0,0,30,35,122,164,122
2020,29,82,"Sirnak",39.7477,37.0179,31.0285714285714,18.8714285714286,0,59.1142857142857,NA,NA,186,59,51,12,5,111,127,60
2020,30,82,"Sirnak",39.7477,37.0179,32.9285714285714,18.4,0,61.5571428571429,NA,NA,190,0,0,33,24,142,190,142
2020,31,82,"Sirnak",39.7477,37.0179,33.4,18.3,0,62.4142857142857,90.6385714285714,NA,150,0,0,54,50,127,150,127
2020,32,82,"Sirnak",39.7477,37.0179,32.0857142857143,17.2285714285714,0.138857142857143,61.2428571428571,61.2742857142857,NA,146,0,0,45,45,107,146,107
2020,33,82,"Sirnak",39.7477,37.0179,34.0857142857143,15.3428571428571,0.0564285714285714,66.4285714285714,77.7642857142857,NA,183,0,0,10,2,83,183,83
2020,34,82,"Sirnak",39.7477,37.0179,33.7142857142857,14.7714285714286,0.0174285714285714,63.7428571428571,89.3542857142857,NA,197,0,0,60,60,97,197,97
2020,35,82,"Sirnak",39.7477,37.0179,26.8428571428571,17.6285714285714,0,45.1285714285714,75.1957142857143,NA,164,0,0,23,32,157,164,157
2020,36,82,"Sirnak",39.7477,37.0179,26.0285714285714,21.4714285714286,0,37.8714285714286,75.3228571428571,NA,179,47,23,80,52,112,132,89
2020,37,82,"Sirnak",39.7477,37.0179,32.3428571428571,18.3714285714286,0.125857142857143,55.2428571428571,74.55,NA,193,73,33,8,1,91,120,58
2020,38,82,"Sirnak",39.7477,37.0179,27.3857142857143,16.7142857142857,0.0277142857142857,60.2857142857143,75.9057142857143,NA,235,0,0,81,60,157,235,157
2020,39,82,"Sirnak",39.7477,37.0179,20.5571428571429,15.2428571428571,0.666714285714286,65.1285714285714,72.6071428571429,NA,220,7,3,83,25,129,213,126
2020,40,82,"Sirnak",39.7477,37.0179,24.3857142857143,14.5142857142857,0.00357142857142857,59.8142857142857,79.56,NA,187,0,0,102,73,154,187,154
2020,41,82,"Sirnak",39.7477,37.0179,23.8142857142857,13.8428571428571,0,35.9714285714286,59.0114285714286,NA,182,50,30,27,23,127,132,97
2020,42,82,"Sirnak",39.7477,37.0179,18.5714285714286,14.6285714285714,0,36.2,68.8328571428571,NA,177,27,17,52,29,111,150,94
2020,43,82,"Sirnak",39.7477,37.0179,17.2142857142857,11.5142857142857,0.430571428571428,60.5,71.3371428571429,NA,194,109,106,20,16,161,85,55
2020,44,82,"Sirnak",39.7477,37.0179,29.1142857142857,11.7857142857143,0.279,45.1571428571429,111.707142857143,NA,255,7,16,38,33,233,248,217
2020,45,82,"Sirnak",39.7477,37.0179,25.9428571428571,5.71428571428571,3.09028571428571,82.6571428571429,78.9614285714286,NA,156,60,40,2,1,103,96,63
2020,46,82,"Sirnak",39.7477,37.0179,18.3428571428571,3.08571428571429,0,68.9571428571429,64.2714285714286,NA,208,76,42,25,2,109,132,67
2020,47,82,"Sirnak",39.7477,37.0179,18.3714285714286,0.242857142857143,0.589,83.6857142857143,78.23,NA,173,42,30,39,11,83,131,53
2020,48,82,"Sirnak",39.7477,37.0179,22.1142857142857,-0.785714285714286,0,68.7285714285714,78.3628571428571,NA,199,100,155,0,0,262,99,107
2020,49,82,"Sirnak",39.7477,37.0179,18.3714285714286,1.17142857142857,0.602428571428571,81.4285714285714,73.2557142857143,NA,207,154,82,29,28,116,53,34
2020,50,82,"Sirnak",39.7477,37.0179,26.2714285714286,0.471428571428571,2.01785714285714,88.2142857142857,79.2357142857143,NA,181,79,67,0,0,98,102,31
2020,51,82,"Sirnak",39.7477,37.0179,20.3142857142857,-0.314285714285714,0.545142857142857,93.9714285714286,73.2785714285714,NA,171,54,26,32,9,90,117,64
2020,52,82,"Sirnak",39.7477,37.0179,15.3285714285714,-3.5,0.126285714285714,85.6142857142857,67.1042857142857,NA,203,112,55,49,46,113,91,58
2020,53,82,"Sirnak",39.7477,37.0179,25.3,1.575,0,58.25,81.01,NA,122,87,99,0,0,111,35,12
2017,1,83,"Basogretmen",37.5139,42.4543,16.3714285714286,2.17142857142857,1,68.3714285714286,63.56,40.6585714285714,563,153,256,0,0,847,410,591
2017,2,83,"Basogretmen",37.5139,42.4543,15.9571428571429,2.18571428571429,0.114285714285714,63.3714285714286,76.8014285714286,59.75,757,306,536,111,237,1214,451,678
2017,3,83,"Basogretmen",37.5139,42.4543,12.8,2.72857142857143,0.3,66.0714285714286,97.5414285714286,72.7171428571429,762,456,687,0,0,1449,306,762
2017,4,83,"Basogretmen",37.5139,42.4543,17.4571428571429,1.48571428571429,4.88571428571429,72.3571428571429,53.025,43.1757142857143,639,105,132,33,61,889,534,757
2017,5,83,"Basogretmen",37.5139,42.4543,13.1714285714286,-1.97142857142857,1.31428571428571,71.7714285714286,83.2428571428571,62.23,588,176,325,51,127,1163,412,838
2017,6,83,"Basogretmen",37.5139,42.4543,15.8428571428571,3.37142857142857,0.714285714285714,72.5142857142857,86.3957142857143,62.9957142857143,736,290,640,0,0,1519,446,879
2017,7,83,"Basogretmen",37.5139,42.4543,19.2428571428571,-0.0428571428571427,3.85714285714286,68.1142857142857,76.4171428571429,45.5942857142857,492,190,223,19,28,717,302,494
2017,8,83,"Basogretmen",37.5139,42.4543,13.6285714285714,4.52857142857143,0.0714285714285714,55.2428571428571,99.6014285714286,62.6371428571429,739,469,1074,0,0,1747,270,673
2017,9,83,"Basogretmen",37.5139,42.4543,14.8142857142857,8.67142857142857,1.97142857142857,70.4571428571429,98.53,41.8957142857143,574,151,281,0,0,866,423,585
2017,10,83,"Basogretmen",37.5139,42.4543,17.8428571428571,10.6714285714286,1.11428571428571,55.9571428571429,111.914285714286,46.9666666666667,712,135,169,0,0,1043,577,874
2017,11,83,"Basogretmen",37.5139,42.4543,23.9,7.81428571428571,10.0285714285714,81.9714285714286,40.1914285714286,NA,525,99,140,0,0,725,426,585
2017,12,83,"Basogretmen",37.5139,42.4543,15.1714285714286,7.45714285714286,3.77142857142857,70.6285714285714,69.54,NA,589,358,757,3,1,1077,231,320
2017,13,83,"Basogretmen",37.5139,42.4543,23.1285714285714,11.6142857142857,3.98571428571429,69.6,60.7028571428571,NA,574,80,148,0,0,887,494,739
2017,14,83,"Basogretmen",37.5139,42.4543,19.8571428571429,11.3285714285714,5.61428571428571,67.4428571428571,63.3928571428571,NA,639,206,426,95,276,1336,433,910
2017,15,83,"Basogretmen",37.5139,42.4543,16.9,12.3714285714286,6.58571428571429,71.0857142857143,50.4314285714286,40.095,587,227,681,106,103,1187,360,506
2017,16,83,"Basogretmen",37.5139,42.4543,18,14.7285714285714,3.42857142857143,65.3142857142857,116.472857142857,25.2214285714286,717,284,332,0,0,920,433,588
2017,17,83,"Basogretmen",37.5139,42.4543,17.8714285714286,16.1571428571429,1.08571428571429,51.1428571428571,39.9042857142857,28.05,731,193,548,0,0,1478,538,930
2017,18,83,"Basogretmen",37.5139,42.4543,21.6571428571429,16.0428571428571,4.24285714285714,67.5571428571428,56.0442857142857,32.4842857142857,506,265,457,0,0,923,241,466
2017,19,83,"Basogretmen",37.5139,42.4543,16.1857142857143,20.5428571428571,1.65714285714286,51.0285714285714,66.96,30.1814285714286,471,147,323,1,0,966,324,643
2017,20,83,"Basogretmen",37.5139,42.4543,19.9714285714286,20.4428571428571,3.4,50.5285714285714,26.3357142857143,23.5357142857143,472,234,858,18,15,1205,238,347
2017,21,83,"Basogretmen",37.5139,42.4543,18.1142857142857,19.5142857142857,1.34285714285714,48.9428571428571,32.6766666666667,30.4366666666667,448,205,306,71,176,849,243,543
2017,22,83,"Basogretmen",37.5139,42.4543,19.0285714285714,23.1857142857143,0.0571428571428571,36.6571428571429,37.7466666666667,27.51,522,211,473,104,126,1015,311,542
2017,23,83,"Basogretmen",37.5139,42.4543,18.3714285714286,27.3428571428571,0,29.8428571428571,43.8971428571429,25.1642857142857,578,66,148,119,302,1388,512,1240
2017,24,83,"Basogretmen",37.5139,42.4543,19.1285714285714,26.3142857142857,0,29,33.6857142857143,24.3842857142857,552,163,435,222,407,1139,389,704
2017,25,83,"Basogretmen",37.5139,42.4543,18.6142857142857,26.6285714285714,0,29.6428571428571,28.5685714285714,25.5614285714286,584,98,213,240,390,1041,486,828
2017,26,83,"Basogretmen",37.5139,42.4543,17.9,31.0142857142857,0.0285714285714286,24.7857142857143,35.0485714285714,25.16,564,345,598,30,71,971,219,373
2017,27,83,"Basogretmen",37.5139,42.4543,20.0285714285714,31.8714285714286,0,19.5142857142857,36.27,20.11,511,81,112,167,253,642,430,530
2017,28,83,"Basogretmen",37.5139,42.4543,17.0857142857143,31.0571428571429,0,18.4857142857143,36.8257142857143,21.5728571428571,481,82,129,0,0,864,399,735
2017,29,83,"Basogretmen",37.5139,42.4543,19.0714285714286,31.8857142857143,0,17.3285714285714,43.7514285714286,19.4928571428571,532,85,209,22,26,1272,447,1063
2017,30,83,"Basogretmen",37.5139,42.4543,18.1142857142857,30.9285714285714,0,20.1142857142857,52.16,21.7328571428571,531,143,210,74,74,928,388,718
2017,31,83,"Basogretmen",37.5139,42.4543,16.2714285714286,32.1714285714286,0,16.5428571428571,47.83,19.6857142857143,559,166,455,24,27,1047,393,592
2017,32,83,"Basogretmen",37.5139,42.4543,21.2714285714286,32.4285714285714,0,15.5571428571429,57.5,23.1942857142857,567,86,246,161,185,1092,481,846
2017,33,83,"Basogretmen",37.5139,42.4543,20.2285714285714,30.6,0.0571428571428571,24.9142857142857,44.0257142857143,19.7542857142857,596,0,0,156,305,1199,596,1199
2017,34,83,"Basogretmen",37.5139,42.4543,16.0428571428571,29.5714285714286,0,19.9571428571429,35.7471428571429,20.2471428571429,601,122,214,168,281,1280,479,1066
2017,35,83,"Basogretmen",37.5139,42.4543,18.7285714285714,29.3428571428571,0,19.7428571428571,32.2357142857143,19.5785714285714,493,72,65,69,82,1014,421,949
2017,36,83,"Basogretmen",37.5139,42.4543,14.8428571428571,27.7428571428571,0,18.8428571428571,40.6857142857143,29.2142857142857,507,190,399,40,108,1321,317,922
2017,37,83,"Basogretmen",37.5139,42.4543,14.2714285714286,27.7714285714286,0,17.2285714285714,81.8242857142857,39.6214285714286,589,339,671,0,0,1138,250,467
2017,38,83,"Basogretmen",37.5139,42.4543,16.6857142857143,26.5857142857143,0,23.6285714285714,71.2657142857143,31.444,671,252,511,105,178,1312,419,801
2017,39,83,"Basogretmen",37.5139,42.4543,17.9857142857143,23.3571428571429,0,30.9857142857143,50.5657142857143,25.2885714285714,782,77,147,106,153,1630,705,1483
2017,40,83,"Basogretmen",37.5139,42.4543,15.8571428571429,18.2285714285714,0.5,41.5428571428571,48.3771428571429,28.7942857142857,543,360,676,60,128,1137,183,461
2017,41,83,"Basogretmen",37.5139,42.4543,14.5571428571429,18.0285714285714,0.0142857142857143,38.4714285714286,43.7342857142857,30.8657142857143,487,214,455,2,0,843,273,388
2017,42,83,"Basogretmen",37.5139,42.4543,16.0285714285714,15.6857142857143,0,29.3,73.07,35.3814285714286,530,303,508,0,0,815,227,307
2017,43,83,"Basogretmen",37.5139,42.4543,16.8571428571429,17.7285714285714,0.785714285714286,37.4571428571429,95.2716666666667,35.5971428571429,506,46,75,0,0,919,460,844
2017,44,83,"Basogretmen",37.5139,42.4543,16.7,13.4285714285714,5.12857142857143,65.0142857142857,56.2057142857143,35.92,561,234,540,29,52,1102,327,562
2017,45,83,"Basogretmen",37.5139,42.4543,17.1285714285714,13.6142857142857,2.35714285714286,68.5142857142857,102.082857142857,44.9557142857143,577,161,325,0,0,829,416,504
2017,46,83,"Basogretmen",37.5139,42.4543,15.4285714285714,11.7,0.114285714285714,52.3285714285714,115.162857142857,44.2128571428571,587,196,334,27,64,1085,391,751
2017,47,83,"Basogretmen",37.5139,42.4543,19.1714285714286,6.24285714285714,6.94285714285714,69.8142857142857,71.1142857142857,34.1628571428571,418,80,149,10,17,804,338,655
2017,48,83,"Basogretmen",37.5139,42.4543,17.1142857142857,6.62857142857143,0.657142857142857,66.1857142857143,90.4242857142857,42.76,386,76,146,5,8,619,310,473
2017,49,83,"Basogretmen",37.5139,42.4543,17.2857142857143,4.08571428571429,3.14285714285714,66,60.1914285714286,34.8685714285714,407,255,332,0,0,645,152,313
2017,50,83,"Basogretmen",37.5139,42.4543,15.6857142857143,5.01428571428571,0,58.2857142857143,120.344285714286,49.4171428571429,346,132,129,0,0,442,214,313
2017,51,83,"Basogretmen",37.5139,42.4543,21.6857142857143,10.4857142857143,3.27142857142857,66.9714285714286,98.1042857142857,38.5814285714286,386,78,71,0,0,349,308,278
2017,52,83,"Basogretmen",37.5139,42.4543,17.4875,7.95,0.4875,63.8375,76.12125,44.73,528,141,83,0,0,507,387,424
2018,1,83,"Basogretmen",37.5139,42.4543,16.925,4.975,3.1875,78.675,59.79375,41.47625,618,164,304,0,0,914,454,610
2018,2,83,"Basogretmen",37.5139,42.4543,16.2285714285714,4.61428571428571,0.185714285714286,57.5,55.9471428571429,38.4928571428571,624,236,376,0,0,1309,388,933
2018,3,83,"Basogretmen",37.5139,42.4543,21.6714285714286,3.84285714285714,4.52857142857143,81.1285714285714,35.9114285714286,34.4928571428571,639,360,318,0,0,655,279,337
2018,4,83,"Basogretmen",37.5139,42.4543,19.9428571428571,5.58571428571429,1.64285714285714,75.5714285714286,48.4885714285714,32.9642857142857,604,124,176,78,79,764,480,588
2018,5,83,"Basogretmen",37.5139,42.4543,14.9857142857143,3.67142857142857,0,60.5428571428571,70.49,43.3514285714286,670,194,159,0,0,819,476,660
2018,6,83,"Basogretmen",37.5139,42.4543,18.1571428571429,8.15714285714286,0.514285714285714,55.5142857142857,111.19,43.6842857142857,704,94,146,0,0,1022,610,876
2018,7,83,"Basogretmen",37.5139,42.4543,17.8571428571429,8.14285714285714,3.85714285714286,81.5714285714286,51.6428571428571,30.2985714285714,478,77,125,0,0,557,401,432
2018,8,83,"Basogretmen",37.5139,42.4543,14.6714285714286,7.85714285714286,3.92857142857143,81.1285714285714,56.1242857142857,37.3857142857143,711,200,423,133,301,1321,511,898
2018,9,83,"Basogretmen",37.5139,42.4543,16.1,8.87142857142857,8.17142857142857,78.0714285714286,44.93,28.4671428571429,621,49,96,0,0,956,572,860
2018,10,83,"Basogretmen",37.5139,42.4543,17.6142857142857,11.6571428571429,2.48571428571429,70.6714285714286,63.4614285714286,37.9357142857143,556,99,352,60,95,1330,457,978
2018,11,83,"Basogretmen",37.5139,42.4543,14.7857142857143,10.9428571428571,0.314285714285714,63.5714285714286,48.6242857142857,30.2514285714286,551,198,413,0,0,1426,353,1013
2018,12,83,"Basogretmen",37.5139,42.4543,21.1714285714286,14.8,0.585714285714286,49.3142857142857,100.815714285714,25.1085714285714,425,130,332,53,57,1187,295,855
2018,13,83,"Basogretmen",37.5139,42.4543,18.2285714285714,13.9714285714286,1.37142857142857,58.9857142857143,65.6528571428571,25.1157142857143,356,70,80,39,64,428,286,348
2018,14,83,"Basogretmen",37.5139,42.4543,20.6571428571429,15.6857142857143,0,45.4571428571429,46.35,30.8657142857143,407,47,52,35,17,486,360,434
2018,15,83,"Basogretmen",37.5139,42.4543,17.6285714285714,15.3428571428571,7.6,67.8,55.5185714285714,28.5657142857143,374,103,136,0,0,450,271,314
2018,16,83,"Basogretmen",37.5139,42.4543,17.6714285714286,14.7714285714286,0.185714285714286,54.6571428571429,40.0271428571429,30.2442857142857,411,139,257,0,0,648,272,391
2018,17,83,"Basogretmen",37.5139,42.4543,18.6142857142857,15.6571428571429,1.14285714285714,65.5428571428571,41.3371428571429,30.2571428571429,419,71,57,61,96,652,348,595
2018,18,83,"Basogretmen",37.5139,42.4543,21.9857142857143,17.4714285714286,5.25714285714286,69.6428571428571,44.1128571428571,29.0414285714286,303,121,237,63,30,474,182,237
2018,19,83,"Basogretmen",37.5139,42.4543,17.9857142857143,14.3,9.54285714285714,82.1142857142857,24.7014285714286,27.99,275,20,58,0,0,467,255,409
2018,20,83,"Basogretmen",37.5139,42.4543,14.7285714285714,19.6571428571429,1.18571428571429,61.5857142857143,34.89,29.1314285714286,204,38,31,11,42,306,166,275
2018,21,83,"Basogretmen",37.5139,42.4543,17.6,22.6,0.985714285714286,52.9714285714286,47.2,26.31,252,37,33,0,0,281,215,248
2018,22,83,"Basogretmen",37.5139,42.4543,16.7,23.7857142857143,2.85714285714286,44.7,43.808,24.848,249,22,75,74,81,427,227,352
2018,23,83,"Basogretmen",37.5139,42.4543,18.1428571428571,25.1428571428571,0,38.3142857142857,31.9214285714286,26.6314285714286,267,53,154,0,0,812,214,658
2018,24,83,"Basogretmen",37.5139,42.4543,23.1428571428571,26.3714285714286,0.0571428571428571,36.5714285714286,31.6642857142857,21.7871428571429,267,27,25,42,163,448,240,423
2018,25,83,"Basogretmen",37.5139,42.4543,17.2,27.3285714285714,0.0285714285714286,31.4857142857143,26.9542857142857,23.0914285714286,358,7,13,74,107,518,351,505
2018,26,83,"Basogretmen",37.5139,42.4543,18.0571428571429,30.1142857142857,0,26.6857142857143,39.1757142857143,25.2485714285714,355,13,25,112,92,587,342,562
2018,27,83,"Basogretmen",37.5139,42.4543,20.3285714285714,32.5571428571429,0,21.7857142857143,26.1857142857143,16.1242857142857,342,30,33,143,142,418,312,385
2018,28,83,"Basogretmen",37.5139,42.4543,19.7,31.6571428571429,0,23.6142857142857,41.7671428571429,17.4028571428571,286,35,60,91,182,585,251,525
2018,29,83,"Basogretmen",37.5139,42.4543,18.0428571428571,29.8857142857143,0.0857142857142857,23.2428571428571,29.4342857142857,19.0685714285714,260,0,0,207,507,756,260,756
2018,30,83,"Basogretmen",37.5139,42.4543,17.2571428571429,30.7857142857143,0,22.7142857142857,45.7628571428571,19.3642857142857,265,0,0,127,280,822,265,822
2018,31,83,"Basogretmen",37.5139,42.4543,18.3714285714286,30.7857142857143,0.228571428571429,29.0142857142857,33.8857142857143,15.6014285714286,267,0,0,72,17,499,267,499
2018,32,83,"Basogretmen",37.5139,42.4543,17.7142857142857,30.6714285714286,0,24.2,30.6071428571429,16.3485714285714,297,0,0,188,291,403,297,403
2018,33,83,"Basogretmen",37.5139,42.4543,16.7857142857143,30.7571428571429,0,23.0428571428571,38.4271428571429,32.6514285714286,216,36,66,71,85,332,180,266
2018,34,83,"Basogretmen",37.5139,42.4543,15.5142857142857,30.4,0,23.6,31.6814285714286,31.8385714285714,144,18,46,46,53,227,126,181
2018,35,83,"Basogretmen",37.5139,42.4543,20.5428571428571,29.5285714285714,0,25.3857142857143,50.4471428571429,43.8628571428571,201,10,2,46,21,314,191,312
2018,36,83,"Basogretmen",37.5139,42.4543,18.9714285714286,27.4142857142857,0,29.0571428571429,47.0557142857143,44.14,341,4,12,164,123,370,337,358
2018,37,83,"Basogretmen",37.5139,42.4543,18.4428571428571,26.5142857142857,0,28.3571428571429,44.0428571428571,40.3414285714286,241,34,37,139,69,419,207,382
2018,38,83,"Basogretmen",37.5139,42.4543,15.5142857142857,25.7,0.0285714285714286,26.4714285714286,30.6828571428571,42.3542857142857,189,98,128,20,33,344,91,216
2018,39,83,"Basogretmen",37.5139,42.4543,14.1285714285714,24.6142857142857,0,25.1428571428571,40.1071428571429,36.4757142857143,180,21,6,66,76,353,159,347
2018,40,83,"Basogretmen",37.5139,42.4543,15.9285714285714,23.9857142857143,0,30.3571428571429,38.4114285714286,31.0328571428571,191,76,136,2,18,341,115,205
2018,41,83,"Basogretmen",37.5139,42.4543,20.3714285714286,22.0285714285714,1.11428571428571,41.6428571428571,65.9185714285714,34.3271428571429,187,58,261,3,7,422,129,161
2018,42,83,"Basogretmen",37.5139,42.4543,18.2857142857143,19.4,1.02857142857143,49.5714285714286,248.994285714286,39.22,168,23,36,0,0,381,145,345
2018,43,83,"Basogretmen",37.5139,42.4543,21.9142857142857,14.3142857142857,11.9714285714286,75.8142857142857,43.1457142857143,43.9842857142857,187,9,65,11,14,402,178,337
2018,44,83,"Basogretmen",37.5139,42.4543,14.7571428571429,13.7857142857143,0.2,52.4428571428571,82.4714285714286,59.7257142857143,196,110,105,0,0,264,86,159
2018,45,83,"Basogretmen",37.5139,42.4543,13.7285714285714,11.3857142857143,1.95714285714286,81.4571428571429,64.57,55.7071428571429,231,112,245,14,103,473,119,228
2018,46,83,"Basogretmen",37.5139,42.4543,14.0285714285714,10.1857142857143,6.5,79.6714285714286,43.77,45.9971428571429,230,69,213,0,0,465,161,252
2018,47,83,"Basogretmen",37.5139,42.4543,14.4142857142857,8.5,4.01428571428571,79.9,66.8871428571429,84.7757142857143,270,68,154,0,0,499,202,345
2018,48,83,"Basogretmen",37.5139,42.4543,16.4428571428571,8.65714285714286,7.1,86.2285714285714,46.4985714285714,86.37,245,59,66,2,0,201,186,135
2018,49,83,"Basogretmen",37.5139,42.4543,17.4571428571429,7.52857142857143,5.28571428571429,85.1285714285714,38.4914285714286,82.2242857142857,257,50,136,0,0,420,207,284
2018,50,83,"Basogretmen",37.5139,42.4543,20.1142857142857,6.5,6.28571428571429,80.8285714285714,39.83,81.8271428571429,256,95,133,21,8,305,161,172
2018,51,83,"Basogretmen",37.5139,42.4543,14.7857142857143,5.51428571428571,1.75714285714286,85.2857142857143,47.6142857142857,68.3885714285714,250,78,118,0,0,248,172,130
2018,52,83,"Basogretmen",37.5139,42.4543,23.6857142857143,3.71428571428571,8.58571428571429,82.7857142857143,46.6642857142857,57.1128571428571,244,25,76,0,0,273,219,197
2019,1,83,"Basogretmen",37.5139,42.4543,16.225,3.6,3.325,76.075,34.3775,53.1683333333333,343,156,483,0,0,784,187,301
2019,2,83,"Basogretmen",37.5139,42.4543,21.9285714285714,-0.0285714285714288,5.24285714285714,69.7714285714286,60.42,65.8271428571429,255,82,32,10,14,208,173,176
2019,3,83,"Basogretmen",37.5139,42.4543,18.5285714285714,2.21428571428571,3.85714285714286,81.4571428571429,47.0257142857143,53.2771428571429,192,29,42,0,0,198,163,156
2019,4,83,"Basogretmen",37.5139,42.4543,17.5857142857143,3.74285714285714,0.457142857142857,66.2285714285714,77.8342857142857,62.2,308,106,131,0,0,314,202,183
2019,5,83,"Basogretmen",37.5139,42.4543,20.2285714285714,4.92857142857143,6.8,81.8571428571429,79.2985714285714,55.4228571428571,253,60,26,0,0,143,193,117
2019,6,83,"Basogretmen",37.5139,42.4543,15.6142857142857,4.24285714285714,3.81428571428571,68.8285714285714,55.8114285714286,58.0957142857143,276,146,88,0,0,127,130,39
2019,7,83,"Basogretmen",37.5139,42.4543,18,4.45714285714286,1.25714285714286,74.7857142857143,69.8957142857143,49.0857142857143,325,84,36,0,0,234,241,198
2019,8,83,"Basogretmen",37.5139,42.4543,15.7142857142857,5.02857142857143,0.2,66.3857142857143,64.87,50.5828571428571,305,98,66,0,0,219,207,153
2019,9,83,"Basogretmen",37.5139,42.4543,19.3571428571429,4.78571428571429,12.3857142857143,76.9142857142857,50.18,59.96,331,5,41,0,0,310,326,269
2019,10,83,"Basogretmen",37.5139,42.4543,17.1714285714286,6.5,1.9,69.3,48.4914285714286,NA,359,141,111,0,0,252,218,141
2019,11,83,"Basogretmen",37.5139,42.4543,21.9285714285714,8.15714285714286,4.92857142857143,76.1714285714286,50.23,NA,373,10,53,6,16,400,363,347
2019,12,83,"Basogretmen",37.5139,42.4543,17.5857142857143,6.94285714285714,8.6,66.7,33.5766666666667,NA,343,241,91,8,4,416,102,325
2019,13,83,"Basogretmen",37.5139,42.4543,19.9,8.55714285714286,11.5714285714286,87.2,32.634,NA,256,34,28,54,38,194,222,166
2019,14,83,"Basogretmen",37.5139,42.4543,18.3714285714286,10.2,4.91428571428571,79.2714285714286,40.962,NA,365,14,19,50,27,208,351,189
2019,15,83,"Basogretmen",37.5139,42.4543,15.8285714285714,12.8857142857143,2.57142857142857,68.0571428571428,36.56,NA,359,125,73,0,0,183,234,110
2019,16,83,"Basogretmen",37.5139,42.4543,19.5285714285714,10.5571428571429,12.2571428571429,78.9285714285714,38.835,NA,318,16,27,21,2,208,302,181
2019,17,83,"Basogretmen",37.5139,42.4543,14.8142857142857,11,2.21428571428571,62.1,38.655,NA,412,125,49,66,73,313,287,264
2019,18,83,"Basogretmen",37.5139,42.4543,19.0428571428571,15.2714285714286,9.27142857142857,69.2428571428571,40.25,NA,523,7,11,3,6,353,516,342
2019,19,83,"Basogretmen",37.5139,42.4543,16.5142857142857,17.3428571428571,0.442857142857143,60.1428571428571,35.0714285714286,NA,452,9,31,71,64,386,443,355
2019,20,83,"Basogretmen",37.5139,42.4543,17.3142857142857,22.0428571428571,0,47.4571428571429,35.0142857142857,NA,454,174,129,0,0,389,280,260
2019,21,83,"Basogretmen",37.5139,42.4543,17.4571428571429,22.6428571428571,0.0428571428571429,46.1285714285714,40.4285714285714,NA,457,164,154,3,3,413,293,259
2019,22,83,"Basogretmen",37.5139,42.4543,17.5571428571429,24.7714285714286,0,33.8571428571429,54.9185714285714,NA,453,262,190,0,0,323,191,133
2019,23,83,"Basogretmen",37.5139,42.4543,15.0857142857143,27.8714285714286,0,32.3285714285714,38.4485714285714,NA,378,160,339,51,41,532,218,193
2019,24,83,"Basogretmen",37.5139,42.4543,20.4714285714286,28.0285714285714,0.0857142857142857,28.6285714285714,30.3342857142857,NA,378,67,34,160,96,244,311,210
2019,25,83,"Basogretmen",37.5139,42.4543,19.9285714285714,27.3,0.0142857142857143,33.1857142857143,26.0542857142857,NA,306,0,0,163,262,325,306,325
2019,26,83,"Basogretmen",37.5139,42.4543,21.9571428571429,30.9142857142857,0,23.7,25.9314285714286,NA,377,72,49,98,135,342,305,293
2019,27,83,"Basogretmen",37.5139,42.4543,20.4142857142857,30.0285714285714,0,20.8285714285714,27.8185714285714,NA,456,130,101,147,40,222,326,121
2019,28,83,"Basogretmen",37.5139,42.4543,17.5142857142857,29.8428571428571,0,25.6571428571429,26.38,NA,398,59,81,155,157,421,339,340
2019,29,83,"Basogretmen",37.5139,42.4543,19.2857142857143,28.8142857142857,0,29.5142857142857,26.0957142857143,NA,453,83,66,113,23,203,370,137
2019,30,83,"Basogretmen",37.5139,42.4543,18.7571428571429,29.8714285714286,0,25.7857142857143,25.92,NA,456,1,1,238,118,335,455,334
2019,31,83,"Basogretmen",37.5139,42.4543,18.2142857142857,30.5428571428571,0,22.6714285714286,40.2914285714286,NA,334,3,0,86,44,375,331,375
2019,32,83,"Basogretmen",37.5139,42.4543,16.8571428571429,30.7857142857143,0,21.6428571428571,28.4257142857143,NA,346,147,231,0,0,395,199,164
2019,33,83,"Basogretmen",37.5139,42.4543,18.1285714285714,31.7142857142857,0,25.1142857142857,44.0985714285714,NA,337,51,69,150,297,531,286,462
2019,34,83,"Basogretmen",37.5139,42.4543,17.1714285714286,29.1857142857143,0,28.9285714285714,31.3485714285714,NA,299,43,34,98,107,345,256,311
2019,35,83,"Basogretmen",37.5139,42.4543,18.9,29.1285714285714,0.371428571428571,26.2142857142857,32.58,NA,307,92,84,58,108,415,215,331
2019,36,83,"Basogretmen",37.5139,42.4543,17.2571428571429,26.7,0,28.5714285714286,31.6842857142857,NA,171,28,7,44,5,67,143,60
2019,37,83,"Basogretmen",37.5139,42.4543,13.7,25.1,0.0428571428571429,28.3571428571429,26.0157142857143,NA,218,92,13,25,3,55,126,42
2019,38,83,"Basogretmen",37.5139,42.4543,17.2,24.7857142857143,0,27.6857142857143,35.7885714285714,NA,266,43,10,117,36,91,223,81
2019,39,83,"Basogretmen",37.5139,42.4543,15.6857142857143,22.3428571428571,0,30.5714285714286,36.63,NA,237,96,27,21,2,79,141,52
2019,40,83,"Basogretmen",37.5139,42.4543,16.1428571428571,22.1428571428571,0,31.2857142857143,55.8685714285714,NA,241,94,37,89,36,111,147,74
2019,41,83,"Basogretmen",37.5139,42.4543,17.2571428571429,22.5857142857143,0,33.4571428571429,35.9971428571429,NA,416,139,218,1,0,448,277,230
2019,42,83,"Basogretmen",37.5139,42.4543,13.0142857142857,19.4571428571429,0.471428571428571,34.5571428571429,56.5157142857143,NA,356,248,279,1,2,408,108,129
2019,43,83,"Basogretmen",37.5139,42.4543,13.0857142857143,16.0142857142857,0.371428571428571,59.7714285714286,41.64,NA,306,192,153,0,0,300,114,147
2019,44,83,"Basogretmen",37.5139,42.4543,12.9428571428571,12.4142857142857,9.42857142857143,74.3714285714286,57.3514285714286,NA,350,194,102,0,0,250,156,148
2019,45,83,"Basogretmen",37.5139,42.4543,15.1142857142857,11.5285714285714,0,51.2285714285714,71.7571428571429,NA,417,232,193,0,0,328,185,135
2019,46,83,"Basogretmen",37.5139,42.4543,11.7285714285714,11.4428571428571,0,41.2,90.4971428571428,NA,401,262,231,0,0,337,139,106
2019,47,83,"Basogretmen",37.5139,42.4543,9.91428571428571,6.84285714285714,0,36.7,97.53,NA,391,282,291,0,0,339,109,48
2019,48,83,"Basogretmen",37.5139,42.4543,15.4285714285714,8.78571428571429,5.84285714285714,69.6714285714286,66.6371428571429,NA,320,162,93,0,0,251,158,158
2019,49,83,"Basogretmen",37.5139,42.4543,16.2,7.18571428571429,2.45714285714286,85.8571428571429,38.7328571428571,NA,393,51,30,0,0,274,342,244
2019,50,83,"Basogretmen",37.5139,42.4543,14.6285714285714,5.74285714285714,4.31428571428571,87.6142857142857,47.7985714285714,NA,218,77,77,0,0,119,141,42
2019,51,83,"Basogretmen",37.5139,42.4543,11.8428571428571,5.8,0,64.2,98.9057142857143,NA,361,300,438,0,0,488,61,50
2019,52,83,"Basogretmen",37.5139,42.4543,24.3857142857143,6.31428571428571,2.78571428571429,71.3571428571429,39.5071428571429,NA,279,16,9,0,0,281,263,272
2020,1,83,"Basogretmen",37.5139,42.4543,14.12,2.78,1.66,86.18,27.57,NA,160,64,61,0,0,126,96,65
2020,2,83,"Basogretmen",37.5139,42.4543,15.2857142857143,2.48571428571429,0.742857142857143,77.6285714285714,33.0671428571429,NA,240,97,99,0,0,173,143,74
2020,3,83,"Basogretmen",37.5139,42.4543,12.9285714285714,2.41428571428571,2.2,75.0285714285714,48.7014285714286,40.5316666666667,270,207,268,0,0,382,63,114
2020,4,83,"Basogretmen",37.5139,42.4543,18.0142857142857,0.7,5.7,76.9142857142857,31.3985714285714,37.1114285714286,358,175,94,0,0,295,183,201
2020,5,83,"Basogretmen",37.5139,42.4543,17.3285714285714,1.65714285714286,6.6,74.6571428571429,47.7757142857143,44.7914285714286,331,110,80,0,0,272,221,192
2020,6,83,"Basogretmen",37.5139,42.4543,20.5571428571429,2.28571428571429,12.8857142857143,77.2,33.8628571428571,35.3914285714286,343,70,51,31,3,267,273,216
2020,7,83,"Basogretmen",37.5139,42.4543,20.5142857142857,-3.98571428571429,3.18571428571429,78.7571428571429,56.8742857142857,58.52,341,51,103,0,0,338,290,235
2020,8,83,"Basogretmen",37.5139,42.4543,16.3857142857143,7.42857142857143,3.15714285714286,81.4714285714286,90.4242857142857,78.3157142857143,283,160,116,0,0,187,123,71
2020,9,83,"Basogretmen",37.5139,42.4543,19.7857142857143,8.6,6.48571428571429,69.4,50.5914285714286,45.1057142857143,393,128,144,0,0,528,265,384
2020,10,83,"Basogretmen",37.5139,42.4543,14.2857142857143,9.88571428571429,0.142857142857143,60.7571428571429,60.8871428571429,52.03,205,114,78,0,0,210,91,132
2020,11,83,"Basogretmen",37.5139,42.4543,13.4,12.6285714285714,0.742857142857143,58.4571428571429,71.4342857142857,57.0714285714286,115,57,61,0,0,94,58,33
2020,12,83,"Basogretmen",37.5139,42.4543,24.5571428571429,8.64285714285714,16.6857142857143,80.9714285714286,19.2971428571429,48.4957142857143,117,19,11,0,0,118,98,107
2020,13,83,"Basogretmen",37.5139,42.4543,22.9714285714286,10.8571428571429,6.82857142857143,72.4285714285714,41.09,52.2,136,13,40,11,5,92,123,52
2020,14,83,"Basogretmen",37.5139,42.4543,19.6571428571429,9.75714285714286,10.6857142857143,76.7285714285714,19.8985714285714,53.4928571428571,155,56,39,0,0,121,99,82
2020,15,83,"Basogretmen",37.5139,42.4543,22.6285714285714,12.7428571428571,2.14285714285714,67.1571428571429,27.9842857142857,56.9214285714286,133,41,84,8,4,118,92,34
2020,16,83,"Basogretmen",37.5139,42.4543,12.9714285714286,13.6,1.14285714285714,57.1571428571429,32.27,63.2114285714286,141,25,14,0,0,106,116,92
2020,17,83,"Basogretmen",37.5139,42.4543,22.4571428571429,15.3428571428571,9.38571428571429,70.6571428571429,22.4871428571429,63.8014285714286,137,29,22,5,0,123,108,101
2020,18,83,"Basogretmen",37.5139,42.4543,15.7,14.6571428571429,1.18571428571429,62.9714285714286,22.8028571428571,67.6528571428571,146,73,52,5,1,164,73,112
2020,19,83,"Basogretmen",37.5139,42.4543,22.6142857142857,16.4571428571429,3.82857142857143,66.8857142857143,14.1557142857143,62.8471428571429,137,23,20,4,11,157,114,137
2020,20,83,"Basogretmen",37.5139,42.4543,18.9857142857143,20.1571428571429,0.171428571428571,52.8285714285714,48.1057142857143,69.8614285714286,164,31,6,0,0,164,133,158
2020,21,83,"Basogretmen",37.5139,42.4543,23.9428571428571,23.7571428571429,0.314285714285714,41.7,52.8714285714286,59.9657142857143,146,58,21,16,20,96,88,75
2020,22,83,"Basogretmen",37.5139,42.4543,16.7,21.1,1,44.8142857142857,23.8128571428571,55.6071428571429,118,29,39,34,26,100,89,61
2020,23,83,"Basogretmen",37.5139,42.4543,18.8285714285714,24.2571428571429,0.0142857142857143,30.5428571428571,27.9757142857143,64.2842857142857,112,12,7,51,37,70,100,63
2020,24,83,"Basogretmen",37.5139,42.4543,22.4285714285714,26.8,0,26.1857142857143,34.3657142857143,62.1971428571429,140,37,54,56,61,150,103,96
2020,25,83,"Basogretmen",37.5139,42.4543,21,26.0428571428571,0,32.5142857142857,29.4757142857143,56.7842857142857,137,15,17,38,24,108,122,91
2020,26,83,"Basogretmen",37.5139,42.4543,17.8857142857143,28.3857142857143,0.285714285714286,25.9142857142857,33.6957142857143,55.8342857142857,173,16,1,18,9,133,157,132
2020,27,83,"Basogretmen",37.5139,42.4543,21.6142857142857,29.3,0.457142857142857,29.1142857142857,33.2583333333333,57.4642857142857,113,75,58,0,0,113,38,55
2020,28,83,"Basogretmen",37.5139,42.4543,17.8857142857143,31.1428571428571,0,25.4142857142857,NA,54.8671428571429,164,98,64,0,0,122,66,58
2020,29,83,"Basogretmen",37.5139,42.4543,18.3714285714286,30.6857142857143,0.285714285714286,25.8857142857143,NA,46.4114285714286,186,66,37,27,26,111,120,74
2020,30,83,"Basogretmen",37.5139,42.4543,21.1285714285714,32.5428571428571,0,19.1714285714286,NA,53.14,190,1,3,45,19,142,189,139
2020,31,83,"Basogretmen",37.5139,42.4543,20.9714285714286,32.7142857142857,0,21.5,NA,65.18,150,23,36,20,22,127,127,91
2020,32,83,"Basogretmen",37.5139,42.4543,18.9,31.0142857142857,0,22.4571428571429,NA,NA,146,49,46,19,7,107,97,61
2020,33,83,"Basogretmen",37.5139,42.4543,17.0571428571429,30.0857142857143,0,26.9571428571429,NA,NA,183,40,18,4,2,83,143,65
2020,34,83,"Basogretmen",37.5139,42.4543,19.6,27.9285714285714,0.6,26.0714285714286,NA,NA,197,64,50,1,0,97,133,47
2020,35,83,"Basogretmen",37.5139,42.4543,14.3571428571429,28.3142857142857,0,26.4428571428571,NA,NA,164,62,54,2,8,157,102,103
2020,36,83,"Basogretmen",37.5139,42.4543,21.4428571428571,29.8285714285714,0,21.3714285714286,NA,NA,179,86,31,0,0,112,93,81
2020,37,83,"Basogretmen",37.5139,42.4543,17.4857142857143,28.9,0.0142857142857143,20.1714285714286,NA,NA,193,56,21,28,4,91,137,70
2020,38,83,"Basogretmen",37.5139,42.4543,14.8,27.2714285714286,0,21.2714285714286,NA,NA,235,143,90,29,23,157,92,67
2020,39,83,"Basogretmen",37.5139,42.4543,16.1714285714286,24.7857142857143,0,31.4571428571429,NA,NA,220,13,2,58,35,129,207,127
2020,40,83,"Basogretmen",37.5139,42.4543,17.0571428571429,23.6285714285714,0,30.4857142857143,NA,NA,187,32,3,1,0,154,155,151
2020,41,83,"Basogretmen",37.5139,42.4543,17.1285714285714,20.0285714285714,0,29.2571428571429,NA,NA,182,66,42,0,0,127,116,85
2020,42,83,"Basogretmen",37.5139,42.4543,14.5857142857143,20.8,0,24.5571428571429,72.8,NA,177,55,22,5,0,111,122,89
2020,43,83,"Basogretmen",37.5139,42.4543,18.8142857142857,19.2714285714286,0,29.5,53.28,NA,194,0,0,0,0,161,194,161
2020,44,83,"Basogretmen",37.5139,42.4543,18,19,0,22.9428571428571,70.6828571428571,NA,255,107,87,0,0,233,148,146
2020,45,83,"Basogretmen",37.5139,42.4543,24.9142857142857,15.1285714285714,7.52857142857143,64.6571428571429,30.5257142857143,NA,156,12,10,7,7,103,144,93
2020,46,83,"Basogretmen",37.5139,42.4543,13.3571428571429,12.2285714285714,0.185714285714286,68.5142857142857,67.3757142857143,NA,208,73,23,69,42,109,135,86
2020,47,83,"Basogretmen",37.5139,42.4543,17.5,9.78571428571429,0.0428571428571429,70.9142857142857,51.5471428571429,NA,173,37,8,12,11,83,136,75
2020,48,83,"Basogretmen",37.5139,42.4543,13.7428571428571,8.48571428571429,0.171428571428571,68.7428571428571,78.8142857142857,NA,199,93,129,2,11,262,106,133
2020,49,83,"Basogretmen",37.5139,42.4543,14,7.48571428571429,0.142857142857143,71.6714285714286,70.2671428571429,NA,207,34,12,4,1,116,173,104
2020,50,83,"Basogretmen",37.5139,42.4543,14,6.2,0.771428571428571,76.8285714285714,41.8885714285714,NA,181,86,44,33,10,98,95,54
2020,51,83,"Basogretmen",37.5139,42.4543,19.2571428571429,7.32857142857143,1.82857142857143,79.4142857142857,45.0657142857143,NA,171,62,36,5,3,90,109,54
2020,52,83,"Basogretmen",37.5139,42.4543,16.0428571428571,2.7,4.14285714285714,69.1285714285714,51.7714285714286,NA,203,79,56,0,0,113,124,57
2020,53,83,"Basogretmen",37.5139,42.4543,16.65,5.25,0,61.675,76.7525,NA,122,1,0,1,0,111,121,111
2017,1,84,"Merkez",40.978,27.5111,22.0142857142857,0.957142857142857,12.2142857142857,91.1,90.3042857142857,43.0485714285714,563,69,77,200,326,847,494,770
2017,2,84,"Merkez",40.978,27.5111,22.2,1.42857142857143,5.32857142857143,84.2142857142857,70.69,46.322,757,90,172,380,570,1214,667,1042
2017,3,84,"Merkez",40.978,27.5111,20.7571428571429,3.68571428571429,1.7,88.9571428571429,53.3271428571429,38.5357142857143,762,0,0,401,599,1449,762,1449
2017,4,84,"Merkez",40.978,27.5111,17.8428571428571,1.62857142857143,0,76.2571428571429,91.7414285714286,42.52,639,0,0,306,367,889,639,889
2017,5,84,"Merkez",40.978,27.5111,20.1571428571429,5.84285714285714,0,80.6714285714286,97.5371428571429,47.6983333333333,588,4,1,103,290,1163,584,1162
2017,6,84,"Merkez",40.978,27.5111,20.2285714285714,5.77142857142857,0.142857142857143,85.4142857142857,85.8683333333333,41.49,736,105,125,294,818,1519,631,1394
2017,7,84,"Merkez",40.978,27.5111,18.1571428571429,3.34285714285714,0.1,75.6142857142857,121.697142857143,47.9114285714286,492,23,23,248,452,717,469,694
2017,8,84,"Merkez",40.978,27.5111,17.3,9.7,5.08571428571429,80.3142857142857,100.297142857143,45.5328571428571,739,52,95,134,295,1747,687,1652
2017,9,84,"Merkez",40.978,27.5111,8.87142857142857,7.57142857142857,0.885714285714286,92.9142857142857,119.757142857143,44.1671428571429,574,133,214,208,263,866,441,652
2017,10,84,"Merkez",40.978,27.5111,15.9857142857143,9.74285714285714,2.71428571428571,85.2571428571429,108.124285714286,43.41,712,57,54,98,170,1043,655,989
2017,11,84,"Merkez",40.978,27.5111,17.8142857142857,7.9,0.242857142857143,80.8142857142857,83.97,37.6971428571429,525,0,0,363,498,725,525,725
2017,12,84,"Merkez",40.978,27.5111,13.5,9.45714285714286,1.6,83.1142857142857,117.741428571429,44.8271428571429,589,241,441,0,0,1077,348,636
2017,13,84,"Merkez",40.978,27.5111,19.9428571428571,9.27142857142857,0.428571428571429,72.1571428571429,96.4142857142857,39.9328571428571,574,0,0,172,340,887,574,887
2017,14,84,"Merkez",40.978,27.5111,13.8285714285714,9.95714285714286,1.02857142857143,83.1285714285714,74.0014285714286,41.7928571428571,639,266,616,182,325,1336,373,720
2017,15,84,"Merkez",40.978,27.5111,14.6,11.6428571428571,0.0142857142857143,75.4285714285714,138.555714285714,51.9371428571429,587,229,561,205,430,1187,358,626
2017,16,84,"Merkez",40.978,27.5111,18.2571428571429,10.3,7.57142857142857,78.6,62.2342857142857,35.0857142857143,717,99,75,298,440,920,618,845
2017,17,84,"Merkez",40.978,27.5111,12.2428571428571,13.6714285714286,1.71428571428571,71.8142857142857,109.035714285714,55.0371428571429,731,110,164,369,630,1478,621,1314
2017,18,84,"Merkez",40.978,27.5111,13.8857142857143,15.7428571428571,0.0571428571428571,76.8428571428571,72.6757142857143,40.1157142857143,506,284,576,69,113,923,222,347
2017,19,84,"Merkez",40.978,27.5111,19.8571428571429,17.5142857142857,0.414285714285714,78.4857142857143,61.3133333333333,37.7342857142857,471,133,269,74,161,966,338,697
2017,20,84,"Merkez",40.978,27.5111,23.9,16.0571428571429,1.12857142857143,73.2571428571429,47.0885714285714,34.4542857142857,472,125,484,1,0,1205,347,721
2017,21,84,"Merkez",40.978,27.5111,18.2857142857143,16.7285714285714,0.571428571428572,78.9,47.6857142857143,48.3657142857143,448,62,175,57,116,849,386,674
2017,22,84,"Merkez",40.978,27.5111,18.5,20.9428571428571,0.0142857142857143,75.6,59.1428571428571,49.3371428571429,522,214,319,30,84,1015,308,696
2017,23,84,"Merkez",40.978,27.5111,17.3714285714286,20.2142857142857,1.22857142857143,80.8428571428571,55.3157142857143,45.0757142857143,578,146,376,82,212,1388,432,1012
2017,24,84,"Merkez",40.978,27.5111,19.3285714285714,20.6714285714286,1.82857142857143,74.1285714285714,51.7557142857143,45.9814285714286,552,47,130,118,235,1139,505,1009
2017,25,84,"Merkez",40.978,27.5111,15.9285714285714,22.1428571428571,2.71428571428571,79.6142857142857,61.4757142857143,53.1371428571429,584,255,458,124,171,1041,329,583
2017,26,84,"Merkez",40.978,27.5111,13.3,25.9285714285714,0,71.0571428571428,72.38,59.6785714285714,564,291,587,182,233,971,273,384
2017,27,84,"Merkez",40.978,27.5111,21.7285714285714,23.1428571428571,0,69.2857142857143,48.0257142857143,41.0528571428571,511,116,123,83,116,642,395,519
2017,28,84,"Merkez",40.978,27.5111,19.9,24.4714285714286,0,70.3857142857143,61.52,44.5771428571429,481,63,193,0,0,864,418,671
2017,29,84,"Merkez",40.978,27.5111,21.2428571428571,23.3,3.57142857142857,69.1428571428571,59.6442857142857,46.5914285714286,532,0,0,161,395,1272,532,1272
2017,30,84,"Merkez",40.978,27.5111,16.7142857142857,24.2142857142857,1.28571428571429,73.4714285714286,74.9771428571429,56.1871428571429,531,135,218,56,74,928,396,710
2017,31,84,"Merkez",40.978,27.5111,26.6,27.3285714285714,0,57.7714285714286,56.1142857142857,53.4042857142857,559,0,0,240,540,1047,559,1047
2017,32,84,"Merkez",40.978,27.5111,20.9714285714286,26.4285714285714,0,71.8285714285714,61.3842857142857,51.1357142857143,567,178,276,0,0,1092,389,816
2017,33,84,"Merkez",40.978,27.5111,21.7571428571429,25.3142857142857,0,66.7571428571429,64.8757142857143,48.4642857142857,596,166,324,225,545,1199,430,875
2017,34,84,"Merkez",40.978,27.5111,20.4571428571429,22.0428571428571,2.05714285714286,70.9285714285714,51.36,44.6242857142857,601,1,12,86,117,1280,600,1268
2017,35,84,"Merkez",40.978,27.5111,23.0428571428571,20.8857142857143,0.1,74.0857142857143,47.5928571428571,48.2757142857143,493,0,0,2,0,1014,493,1014
2017,36,84,"Merkez",40.978,27.5111,17.8,21.9571428571429,0.457142857142857,65.2571428571429,61.67,59.7428571428571,507,69,170,85,191,1321,438,1151
2017,37,84,"Merkez",40.978,27.5111,15.8714285714286,24.0285714285714,0,69.8285714285714,87.2283333333333,56.0566666666667,589,199,305,0,0,1138,390,833
2017,38,84,"Merkez",40.978,27.5111,15.6142857142857,21.5857142857143,0,68.0571428571428,82.9314285714286,53.7228571428571,671,187,406,182,254,1312,484,906
2017,39,84,"Merkez",40.978,27.5111,21.4571428571429,17.5571428571429,4.85714285714286,82.8857142857143,50.7885714285714,41.7257142857143,782,0,0,324,597,1630,782,1630
2017,40,84,"Merkez",40.978,27.5111,20.6714285714286,15.9142857142857,1.47142857142857,77.5428571428571,94.2557142857143,52.35,543,109,370,109,240,1137,434,767
2017,41,84,"Merkez",40.978,27.5111,14.6142857142857,15.6,0,73.0571428571428,139.302857142857,52.0357142857143,487,0,0,73,62,843,487,843
2017,42,84,"Merkez",40.978,27.5111,14.9,16.5285714285714,0,75,181.447142857143,57.5557142857143,530,0,0,250,475,815,530,815
2017,43,84,"Merkez",40.978,27.5111,19.6428571428571,13.1285714285714,10.5428571428571,87.0714285714286,81.4471428571429,44.3428571428571,506,83,54,204,513,919,423,865
2017,44,84,"Merkez",40.978,27.5111,16.1714285714286,10.2571428571429,1.24285714285714,64.4428571428572,92.51,48.1685714285714,561,0,0,460,902,1102,561,1102
2017,45,84,"Merkez",40.978,27.5111,20.0571428571429,12.6142857142857,0.614285714285714,86.3571428571429,103.152857142857,47.5714285714286,577,64,190,160,194,829,513,639
2017,46,84,"Merkez",40.978,27.5111,18.3285714285714,14.0857142857143,3.98571428571429,87.9571428571429,103.654285714286,54.6885714285714,587,0,0,89,172,1085,587,1085
2017,47,84,"Merkez",40.978,27.5111,14.1142857142857,9.78571428571428,6.25714285714286,84.4142857142857,98.6466666666667,54.5633333333333,418,0,0,217,313,804,418,804
2017,48,84,"Merkez",40.978,27.5111,27.1571428571429,12.8571428571429,0.885714285714286,81.2285714285714,85.8328571428571,51.9,386,223,301,69,123,619,163,318
2017,49,84,"Merkez",40.978,27.5111,21.2285714285714,9.57142857142857,1.28571428571429,73.1142857142857,96.9616666666667,57.2233333333333,407,86,72,191,314,645,321,573
2017,50,84,"Merkez",40.978,27.5111,22.4857142857143,12.7285714285714,2.6,82.1142857142857,84.2542857142857,63.9342857142857,346,93,176,0,0,442,253,266
2017,51,84,"Merkez",40.978,27.5111,16.8,3.57142857142857,5.54285714285714,82.3857142857143,65.44,40.61,386,0,0,329,309,349,386,349
2017,52,84,"Merkez",40.978,27.5111,22.2125,8.0125,4.625,87.425,85.13625,56.96375,528,164,196,176,208,507,364,311
2018,1,84,"Merkez",40.978,27.5111,16.9,7.275,2.3875,89.075,105.851428571429,55.3971428571429,618,56,63,208,308,914,562,851
2018,2,84,"Merkez",40.978,27.5111,18.4857142857143,8.21428571428571,0.185714285714286,90.6428571428571,75.5228571428571,46.4585714285714,624,0,0,248,322,1309,624,1309
2018,3,84,"Merkez",40.978,27.5111,26.1,7.34285714285714,3.38571428571429,81.9714285714286,84.2557142857143,53.4757142857143,639,226,365,16,4,655,413,290
2018,4,84,"Merkez",40.978,27.5111,17.4142857142857,3.17142857142857,3.58571428571429,77.1285714285714,72.9471428571429,47.6214285714286,604,0,0,498,680,764,604,764
2018,5,84,"Merkez",40.978,27.5111,21.6,9.57142857142857,1.57142857142857,83.2285714285714,96.2342857142857,60.85,670,107,261,18,14,819,563,558
2018,6,84,"Merkez",40.978,27.5111,19.1857142857143,7.81428571428571,4.71428571428571,87.8714285714286,70.6914285714286,54.25,704,0,0,119,245,1022,704,1022
2018,7,84,"Merkez",40.978,27.5111,19.0571428571429,6.4,1.07142857142857,84.6714285714286,47.5042857142857,48.9657142857143,478,90,116,5,1,557,388,441
2018,8,84,"Merkez",40.978,27.5111,23.6285714285714,6.61428571428571,2.78571428571429,87.6714285714286,42.9228571428571,43.7857142857143,711,0,0,52,71,1321,711,1321
2018,9,84,"Merkez",40.978,27.5111,27.0571428571429,5.75714285714286,3.92857142857143,83.7,53.1628571428571,49.9357142857143,621,97,158,226,324,956,524,798
2018,10,84,"Merkez",40.978,27.5111,15.6857142857143,9.52857142857143,1.94285714285714,89.8,65.19,57.2442857142857,556,81,148,89,159,1330,475,1182
2018,11,84,"Merkez",40.978,27.5111,21.4428571428571,12.3285714285714,0.328571428571429,81.9285714285714,81.4914285714286,62.0571428571429,551,121,386,114,275,1426,430,1040
2018,12,84,"Merkez",40.978,27.5111,32.3714285714286,8.17142857142857,2.67142857142857,87.7285714285714,37.2714285714286,44.9057142857143,425,53,47,0,0,1187,372,1140
2018,13,84,"Merkez",40.978,27.5111,25.5571428571429,10.0285714285714,4.81428571428571,85.5714285714286,64.7042857142857,55.1485714285714,356,153,169,52,129,428,203,259
2018,14,84,"Merkez",40.978,27.5111,15.3428571428571,12.6,0.285714285714286,69.0285714285714,65.0342857142857,56.3857142857143,407,0,0,158,118,486,407,486
2018,15,84,"Merkez",40.978,27.5111,13.3571428571429,12.9142857142857,0,86.8142857142857,69.1742857142857,58.4671428571429,374,257,262,0,0,450,117,188
2018,16,84,"Merkez",40.978,27.5111,18.8285714285714,12.4428571428571,0.214285714285714,75.1428571428571,62.5142857142857,53.0171428571429,411,257,392,82,151,648,154,256
2018,17,84,"Merkez",40.978,27.5111,19.8142857142857,17.1142857142857,0,71.2428571428571,92.315,68.206,419,0,0,66,54,652,419,652
2018,18,84,"Merkez",40.978,27.5111,19.7714285714286,14.9857142857143,0.285714285714286,87.8857142857143,40.1066666666667,39.5966666666667,303,81,80,0,0,474,222,394
2018,19,84,"Merkez",40.978,27.5111,16.9857142857143,17.0142857142857,3.01428571428571,82.9714285714286,44.2416666666667,46.26,275,61,164,77,84,467,214,303
2018,20,84,"Merkez",40.978,27.5111,16.2428571428571,19.8,0.0285714285714286,76.1857142857143,54.4342857142857,56.3728571428571,204,39,55,0,0,306,165,251
2018,21,84,"Merkez",40.978,27.5111,22.5571428571429,20.4142857142857,0.714285714285714,77.1428571428571,40.9471428571429,42.3928571428571,252,0,0,99,104,281,252,281
2018,22,84,"Merkez",40.978,27.5111,21.2714285714286,20.3142857142857,0,61.9571428571429,41.7171428571429,41.4042857142857,249,43,82,66,161,427,206,345
2018,23,84,"Merkez",40.978,27.5111,16.7285714285714,22.3714285714286,2.37142857142857,77.9428571428572,49.6685714285714,52.0814285714286,267,99,368,40,131,812,168,444
2018,24,84,"Merkez",40.978,27.5111,18.7571428571429,22.9285714285714,0.128571428571429,70.9428571428571,35.0314285714286,39.9771428571429,267,95,114,0,0,448,172,334
2018,25,84,"Merkez",40.978,27.5111,20.1571428571429,22.7571428571429,0.742857142857143,68.5285714285714,41.3071428571429,44.1614285714286,358,71,100,72,164,518,287,418
2018,26,84,"Merkez",40.978,27.5111,22.7428571428571,21.8285714285714,9.02857142857143,80.4,26.7471428571429,40.4428571428571,355,65,88,0,0,587,290,499
2018,27,84,"Merkez",40.978,27.5111,17.7,23.9714285714286,0,69.1285714285714,37.9628571428571,47.6628571428571,342,0,0,2,2,418,342,418
2018,28,84,"Merkez",40.978,27.5111,19.0285714285714,24.8285714285714,1.85714285714286,71.8142857142857,33.6842857142857,40.1285714285714,286,8,10,63,120,585,278,575
2018,29,84,"Merkez",40.978,27.5111,19.2714285714286,26.0571428571429,0.0571428571428571,57.6857142857143,35.43,46.8085714285714,260,27,39,136,228,756,233,717
2018,30,84,"Merkez",40.978,27.5111,18.2428571428571,24.5571428571429,9.92857142857143,79.3142857142857,29.9157142857143,40.85,265,45,82,146,320,822,220,740
2018,31,84,"Merkez",40.978,27.5111,24.9714285714286,26.3714285714286,0,73.3142857142857,32.7871428571429,38.63,267,46,120,46,141,499,221,379
2018,32,84,"Merkez",40.978,27.5111,26.2571428571429,26,0,58.4571428571429,34.3514285714286,41.28,297,0,0,3,13,403,297,403
2018,33,84,"Merkez",40.978,27.5111,21.5285714285714,26,0,63.3,37.8028571428571,41.6,216,0,0,80,149,332,216,332
2018,34,84,"Merkez",40.978,27.5111,23.1285714285714,25.6571428571429,0,62.1857142857143,30.2514285714286,33.7571428571429,144,0,0,40,52,227,144,227
2018,35,84,"Merkez",40.978,27.5111,24.1714285714286,26.3428571428571,0,61.2714285714286,40.2628571428571,42.9985714285714,201,0,0,42,23,314,201,314
2018,36,84,"Merkez",40.978,27.5111,20.2714285714286,23.7,0.685714285714286,73.9142857142857,38.8885714285714,39.8128571428571,341,61,48,62,78,370,280,322
2018,37,84,"Merkez",40.978,27.5111,23.2714285714286,21.3428571428571,0.771428571428571,71.9571428571429,32.0216666666667,42.8333333333333,241,0,0,156,315,419,241,419
2018,38,84,"Merkez",40.978,27.5111,26.2,20.5714285714286,0,74.0142857142857,31.5785714285714,39.5966666666667,189,0,0,7,4,344,189,344
2018,39,84,"Merkez",40.978,27.5111,31.7714285714286,16.9571428571429,3.28571428571429,73.3285714285714,30.078,38.448,180,0,0,58,111,353,180,353
2018,40,84,"Merkez",40.978,27.5111,24.1285714285714,17.5142857142857,2.07142857142857,77.8857142857143,28.2442857142857,38.3014285714286,191,28,38,17,21,341,163,303
2018,41,84,"Merkez",40.978,27.5111,21.0571428571429,17.3428571428571,0.671428571428571,76.7857142857143,25.91,38.465,187,0,0,168,395,422,187,422
2018,42,84,"Merkez",40.978,27.5111,15.6714285714286,17.1571428571429,1.65714285714286,80.1142857142857,44.98,40.1216666666667,168,0,0,167,371,381,168,381
2018,43,84,"Merkez",40.978,27.5111,27.5714285714286,14.7428571428571,0,67.9,46.2542857142857,36.91,187,10,10,69,122,402,177,392
2018,44,84,"Merkez",40.978,27.5111,19.8428571428571,16.1428571428571,0,80.0571428571429,46.1028571428571,35.5842857142857,196,15,28,27,31,264,181,236
2018,45,84,"Merkez",40.978,27.5111,21,14.3571428571429,0.114285714285714,78.0142857142857,30.7471428571429,35.1328571428571,231,0,0,87,250,473,231,473
2018,46,84,"Merkez",40.978,27.5111,20.8428571428571,10.1857142857143,0.342857142857143,74.5,27.2928571428571,30.3342857142857,230,0,0,142,289,465,230,465
2018,47,84,"Merkez",40.978,27.5111,18.7571428571429,10.7142857142857,2.22857142857143,79.1285714285714,38.59,32.3614285714286,270,45,21,67,175,499,225,478
2018,48,84,"Merkez",40.978,27.5111,23.1,7.64285714285714,3.74285714285714,77.2428571428571,39.845,36.2466666666667,245,28,5,129,128,201,217,196
2018,49,84,"Merkez",40.978,27.5111,19.0571428571429,7.04285714285714,2.04285714285714,73.7428571428571,67.34,59.7966666666667,257,21,23,188,354,420,236,397
2018,50,84,"Merkez",40.978,27.5111,16.7571428571429,7.92857142857143,3.95714285714286,77.3714285714286,45.9471428571429,54.5457142857143,256,43,55,102,126,305,213,250
2018,51,84,"Merkez",40.978,27.5111,15,5.05714285714286,4.5,81.1571428571429,49.79,44.13,250,0,0,158,193,248,250,248
2018,52,84,"Merkez",40.978,27.5111,16.9285714285714,5.4,3.95714285714286,73.2714285714286,57.7814285714286,48.1785714285714,244,0,0,151,181,273,244,273
2019,1,84,"Merkez",40.978,27.5111,29.3875,3.1375,4.1375,76.6125,34.49875,34.80625,343,0,0,228,377,784,343,784
2019,2,84,"Merkez",40.978,27.5111,24.4285714285714,3.31428571428571,1.5,75.2571428571429,39.6371428571429,41.4714285714286,255,95,65,107,126,208,160,143
2019,3,84,"Merkez",40.978,27.5111,18.4857142857143,5.3,0.428571428571429,74.1857142857143,67.0785714285714,57.29,192,8,5,59,49,198,184,193
2019,4,84,"Merkez",40.978,27.5111,22.4857142857143,8.07142857142857,1.48571428571429,79.9714285714286,44.0314285714286,47.9042857142857,308,79,86,0,0,314,229,228
2019,5,84,"Merkez",40.978,27.5111,21.3857142857143,9.5,0.3,76.4714285714286,52.9957142857143,52.9942857142857,253,163,92,9,7,143,90,51
2019,6,84,"Merkez",40.978,27.5111,21.9857142857143,6.11428571428571,0.728571428571429,77.7428571428571,55.12,42.1871428571429,276,36,19,120,64,127,240,108
2019,7,84,"Merkez",40.978,27.5111,21.2571428571429,6.05714285714286,3.64285714285714,72.7142857142857,30.9916666666667,41.54,325,21,98,107,78,234,304,136
2019,8,84,"Merkez",40.978,27.5111,15.2142857142857,4.37142857142857,1.28571428571429,78.2142857142857,84.5671428571429,50.4914285714286,305,0,0,209,163,219,305,219
2019,9,84,"Merkez",40.978,27.5111,17.7571428571429,6.35714285714286,0.0714285714285714,68.7571428571429,37.2771428571429,41.97,331,0,0,156,73,310,331,310
2019,10,84,"Merkez",40.978,27.5111,16.1571428571429,9.11428571428571,0.457142857142857,76.7142857142857,62.484,41.378,359,43,8,0,0,252,316,244
2019,11,84,"Merkez",40.978,27.5111,20.9571428571429,9.01428571428571,3.57142857142857,73.5,37.8166666666667,41.7733333333333,373,38,29,68,36,400,335,371
2019,12,84,"Merkez",40.978,27.5111,18.4285714285714,9.14285714285714,0,75.6857142857143,54.44,42.31,343,0,0,59,278,416,343,416
2019,13,84,"Merkez",40.978,27.5111,23.3857142857143,8.17142857142857,0,64.9714285714286,43.63,37.3985714285714,256,0,0,1,4,194,256,194
2019,14,84,"Merkez",40.978,27.5111,19.8857142857143,9.3,0.0142857142857143,70.1142857142857,40.685,36.5916666666667,365,65,25,29,13,208,300,183
2019,15,84,"Merkez",40.978,27.5111,18.8571428571429,12.8571428571429,5.31428571428571,79.3571428571429,35.285,41.2566666666667,359,170,82,0,0,183,189,101
2019,16,84,"Merkez",40.978,27.5111,20.9,9.17142857142857,0.557142857142857,71.5142857142857,32.5733333333333,37.375,318,48,19,112,82,208,270,189
2019,17,84,"Merkez",40.978,27.5111,12.2,13.1142857142857,0.0142857142857143,69.8285714285714,46.3928571428571,45.5571428571429,412,134,71,0,0,313,278,242
2019,18,84,"Merkez",40.978,27.5111,16.9428571428571,16.2285714285714,0.128571428571429,69.6285714285714,35.1814285714286,35.5271428571429,523,260,116,0,0,353,263,237
2019,19,84,"Merkez",40.978,27.5111,18.3857142857143,14.8428571428571,2.82857142857143,72.4571428571429,29.4742857142857,35.1271428571429,452,122,76,94,104,386,330,310
2019,20,84,"Merkez",40.978,27.5111,17.8285714285714,18.0142857142857,0.6,73.7857142857143,33.73,31.8371428571429,454,89,76,2,1,389,365,313
2019,21,84,"Merkez",40.978,27.5111,17.5,19.6,0.542857142857143,68.6428571428571,34.1,31.3657142857143,457,70,122,71,31,413,387,291
2019,22,84,"Merkez",40.978,27.5111,15.5,21.2285714285714,0.142857142857143,70.1571428571429,33.176,32.05,453,121,40,0,0,323,332,283
2019,23,84,"Merkez",40.978,27.5111,17.2,21.7857142857143,0.0714285714285714,69.1857142857143,25.46,31.32,378,178,217,0,0,532,200,315
2019,24,84,"Merkez",40.978,27.5111,20.4428571428571,23.8285714285714,0.7,68.6714285714286,30.9714285714286,33.59,378,1,1,167,147,244,377,243
2019,25,84,"Merkez",40.978,27.5111,17.9571428571429,25.1428571428571,0.0428571428571429,63.2857142857143,31.285,31.57,306,87,91,98,85,325,219,234
2019,26,84,"Merkez",40.978,27.5111,27.3285714285714,25.8142857142857,0,59.3857142857143,29.3271428571429,31.0814285714286,377,0,0,0,0,342,377,342
2019,27,84,"Merkez",40.978,27.5111,17.4571428571429,24.6142857142857,0,64.5857142857143,22.1771428571429,23.4671428571429,456,205,61,0,0,222,251,161
2019,28,84,"Merkez",40.978,27.5111,15.6428571428571,22.8,2.15714285714286,66.2571428571429,22.8242857142857,29.5114285714286,398,81,67,92,125,421,317,354
2019,29,84,"Merkez",40.978,27.5111,23.3714285714286,22.8857142857143,0,67.1428571428571,21.5228571428571,24.3328571428571,453,59,23,0,0,203,394,180
2019,30,84,"Merkez",40.978,27.5111,22.6714285714286,23.9428571428571,0.114285714285714,68.9428571428571,24.6628571428571,24.4457142857143,456,0,0,25,22,335,456,335
2019,31,84,"Merkez",40.978,27.5111,17.2571428571429,25.4285714285714,0,66.6857142857143,25.8042857142857,22.3871428571429,334,195,202,0,0,375,139,173
2019,32,84,"Merkez",40.978,27.5111,21.7571428571429,24.3571428571429,0,66.1571428571429,19.8171428571429,21.7014285714286,346,0,0,0,0,395,346,395
2019,33,84,"Merkez",40.978,27.5111,26.6428571428571,24.1,0.271428571428571,70.8,21.3085714285714,18.9714285714286,337,0,0,48,91,531,337,531
2019,34,84,"Merkez",40.978,27.5111,25.2571428571429,25.4571428571429,0,61.5857142857143,35.9028571428571,25.45,299,0,0,90,83,345,299,345
2019,35,84,"Merkez",40.978,27.5111,27.4285714285714,24.9571428571429,0,63.8428571428571,33.1857142857143,22.5085714285714,307,0,0,5,4,415,307,415
2019,36,84,"Merkez",40.978,27.5111,26.2857142857143,23.1142857142857,0.0142857142857143,71.6,31.7014285714286,22.74,171,0,0,3,2,67,171,67
2019,37,84,"Merkez",40.978,27.5111,27.7,22.4142857142857,0.0142857142857143,65.4571428571429,32.9742857142857,23.8642857142857,218,0,0,49,12,55,218,55
2019,38,84,"Merkez",40.978,27.5111,20.9285714285714,19.2428571428571,1,64.9,29.69,23.9914285714286,266,57,24,77,15,91,209,67
2019,39,84,"Merkez",40.978,27.5111,16.1142857142857,18.6857142857143,0.371428571428571,75.9571428571429,25.4557142857143,22.6928571428571,237,80,26,5,3,79,157,53
2019,40,84,"Merkez",40.978,27.5111,20.5,19.3285714285714,4.94285714285714,74.8,31.3571428571429,24.2428571428571,241,75,34,48,20,111,166,77
2019,41,84,"Merkez",40.978,27.5111,19.2857142857143,17.2857142857143,1.12857142857143,72.2142857142857,24.1966666666667,22.6533333333333,416,0,0,62,99,448,416,448
2019,42,84,"Merkez",40.978,27.5111,13.1857142857143,17.4285714285714,0,76.8285714285714,39.7585714285714,25.04,356,144,150,65,34,408,212,258
2019,43,84,"Merkez",40.978,27.5111,17.2285714285714,16.8428571428571,0,74.0142857142857,32.8285714285714,22.0085714285714,306,0,0,66,111,300,306,300
2019,44,84,"Merkez",40.978,27.5111,24.9857142857143,13.3714285714286,0.357142857142857,79.1714285714286,34.04,21.15,350,36,28,166,146,250,314,222
2019,45,84,"Merkez",40.978,27.5111,20.4428571428571,17.3714285714286,0.0428571428571429,77.8285714285714,47.1457142857143,25.5557142857143,417,231,197,0,0,328,186,131
2019,46,84,"Merkez",40.978,27.5111,19.3857142857143,15.5,0.571428571428572,81.7428571428571,54.1757142857143,23.9514285714286,401,104,88,62,70,337,297,249
2019,47,84,"Merkez",40.978,27.5111,21.5857142857143,14.1428571428571,0.0714285714285714,81.8,50.4571428571429,22.89,391,0,0,111,108,339,391,339
2019,48,84,"Merkez",40.978,27.5111,26.3428571428571,12.7857142857143,1.91428571428571,77.7285714285714,32.5057142857143,21.0485714285714,320,32,12,150,133,251,288,239
2019,49,84,"Merkez",40.978,27.5111,15.7142857142857,7.57142857142857,1.02857142857143,74.5142857142857,40.6514285714286,22.7557142857143,393,0,0,337,232,274,393,274
2019,50,84,"Merkez",40.978,27.5111,17.4714285714286,10.3714285714286,0.114285714285714,77.3285714285714,59.7742857142857,23.8114285714286,218,34,5,61,39,119,184,114
2019,51,84,"Merkez",40.978,27.5111,21.3285714285714,12.2714285714286,0.142857142857143,80.7142857142857,80.1385714285714,24.0214285714286,361,48,106,51,66,488,313,382
2019,52,84,"Merkez",40.978,27.5111,20.0285714285714,7.58571428571429,1.88571428571429,74.4285714285714,35.1514285714286,25.9171428571429,279,47,64,230,215,281,232,217
2020,1,84,"Merkez",40.978,27.5111,19.38,5.18,0.04,66.96,54.25,39.504,160,0,0,132,104,126,160,126
2020,2,84,"Merkez",40.978,27.5111,19.9857142857143,4.4,0.714285714285714,71.4,52.16,32.4442857142857,240,0,0,147,134,173,240,173
2020,3,84,"Merkez",40.978,27.5111,15.7285714285714,6.21428571428571,0.0428571428571429,73.7285714285714,48.1657142857143,35.39,270,0,0,225,292,382,270,382
2020,4,84,"Merkez",40.978,27.5111,18.7857142857143,4.95714285714286,0,69.5571428571429,81.9316666666667,37.925,358,0,0,194,155,295,358,295
2020,5,84,"Merkez",40.978,27.5111,22.4714285714286,9.81428571428571,3.21428571428571,75.9285714285714,50.26,33.1157142857143,331,0,0,40,26,272,331,272
2020,6,84,"Merkez",40.978,27.5111,23.0142857142857,6.22857142857143,2.74285714285714,72.8428571428571,33.6342857142857,26.8342857142857,343,13,13,108,78,267,330,254
2020,7,84,"Merkez",40.978,27.5111,23.3428571428571,7.9,0.542857142857143,73.4,50.4485714285714,35.3957142857143,341,48,48,121,90,338,293,290
2020,8,84,"Merkez",40.978,27.5111,15.7142857142857,6.47142857142857,0,75.6571428571429,66.555,37.3825,283,43,13,111,45,187,240,174
2020,9,84,"Merkez",40.978,27.5111,21.4714285714286,9.11428571428571,3,72.8428571428571,41.02,32.3183333333333,393,66,98,115,196,528,327,430
2020,10,84,"Merkez",40.978,27.5111,19.7142857142857,11.4571428571429,1.12857142857143,77.6428571428571,59.94,27.3828571428571,205,88,93,37,25,210,117,117
2020,11,84,"Merkez",40.978,27.5111,29.7857142857143,10.5857142857143,0.6,77.7142857142857,49.2328571428571,24.2128571428571,115,0,0,21,26,94,115,94
2020,12,84,"Merkez",40.978,27.5111,24.7714285714286,6.02857142857143,0.0571428571428571,70,44.6514285714286,30.2028571428571,117,5,0,21,11,118,112,118
2020,13,84,"Merkez",40.978,27.5111,31.0142857142857,8.11428571428571,1.32857142857143,84.4,46.284,20.368,136,0,0,0,0,92,136,92
2020,14,84,"Merkez",40.978,27.5111,37.2142857142857,7.42857142857143,5.1,84.4142857142857,22.494,21.69,155,5,12,22,19,121,150,109
2020,15,84,"Merkez",40.978,27.5111,34.6714285714286,9.15714285714286,0.514285714285714,65.6,35.33,25.7714285714286,133,0,0,23,11,118,133,118
2020,16,84,"Merkez",40.978,27.5111,20.3142857142857,10.4142857142857,0.728571428571429,73.5,38.66,29.2,141,25,29,0,0,106,116,77
2020,17,84,"Merkez",40.978,27.5111,32.9857142857143,10.2,0.228571428571429,70.0714285714286,25.6914285714286,17.77,137,36,18,0,0,123,101,105
2020,18,84,"Merkez",40.978,27.5111,20.8,15.3,2.07142857142857,71.8285714285714,33.4457142857143,25.2485714285714,146,18,10,0,0,164,128,154
2020,19,84,"Merkez",40.978,27.5111,21.4142857142857,13.4571428571429,7.38571428571429,76.9,27.9314285714286,20.2785714285714,137,37,80,36,23,157,100,77
2020,20,84,"Merkez",40.978,27.5111,25.6428571428571,19.3,0,69.5285714285714,50.0842857142857,21.0614285714286,164,29,15,0,0,164,135,149
2020,21,84,"Merkez",40.978,27.5111,33.2428571428571,16.6571428571429,1.84285714285714,71.7285714285714,28.68,17.3828571428571,146,7,0,0,0,96,139,96
2020,22,84,"Merkez",40.978,27.5111,25.3,14.8571428571429,2.87142857142857,77.2714285714286,18.2814285714286,23.5685714285714,118,0,0,30,45,100,118,100
2020,23,84,"Merkez",40.978,27.5111,21.2714285714286,17.7571428571429,2.74285714285714,74.3285714285714,28.89,26.4257142857143,112,13,2,19,2,70,99,68
2020,24,84,"Merkez",40.978,27.5111,21.7428571428571,20.6857142857143,3.15714285714286,74.4428571428571,34.14,24.42,140,24,14,0,0,150,116,136
2020,25,84,"Merkez",40.978,27.5111,19.5,21.8571428571429,4.14285714285714,76.5571428571428,29.7228571428571,18.4885714285714,137,14,11,3,2,108,123,97
2020,26,84,"Merkez",40.978,27.5111,22.8285714285714,22.7714285714286,0.128571428571429,69.3714285714286,27.8342857142857,25.4828571428571,173,40,11,29,30,133,133,122
2020,27,84,"Merkez",40.978,27.5111,20.6,24.7571428571429,1.28571428571429,70.7571428571429,32.0657142857143,27.4528571428571,113,19,2,0,0,113,94,111
2020,28,84,"Merkez",40.978,27.5111,29.4428571428571,23.9285714285714,0,70.4,26.7114285714286,21.1685714285714,164,0,0,0,0,122,164,122
2020,29,84,"Merkez",40.978,27.5111,23.0857142857143,21.4714285714286,0,70.1,18.9414285714286,17.5614285714286,186,4,23,0,0,111,182,88
2020,30,84,"Merkez",40.978,27.5111,24.2857142857143,24.0428571428571,1.42857142857143,71.5142857142857,21.8857142857143,20.0357142857143,190,0,0,0,0,142,190,142
2020,31,84,"Merkez",40.978,27.5111,21.3142857142857,24.9,0,70.7,26.04,21.3,150,0,0,0,0,127,150,127
2020,32,84,"Merkez",40.978,27.5111,26.7857142857143,24.9714285714286,0.0142857142857143,70.9857142857143,24.192,14.8357142857143,146,0,0,1,1,107,146,107
2020,33,84,"Merkez",40.978,27.5111,23.6285714285714,24.5428571428571,2.71428571428571,68.3142857142857,22.364,22.822,183,16,11,0,0,83,167,72
2020,34,84,"Merkez",40.978,27.5111,18.8142857142857,23.6714285714286,0.0714285714285714,67.7428571428571,22.0757142857143,27.4542857142857,197,59,21,24,11,97,138,76
2020,35,84,"Merkez",40.978,27.5111,21.5714285714286,24.2714285714286,0,70.4285714285714,23.9728571428571,20.3642857142857,164,53,38,0,0,157,111,119
2020,36,84,"Merkez",40.978,27.5111,19.6142857142857,23.5571428571429,0,70.4142857142857,20.9028571428571,25.5928571428571,179,32,24,23,23,112,147,88
2020,37,84,"Merkez",40.978,27.5111,23.9428571428571,24.2428571428571,0,66.7428571428571,25.9385714285714,24.8157142857143,193,29,4,10,7,91,164,87
2020,38,84,"Merkez",40.978,27.5111,27.3714285714286,22.9714285714286,0,66.2571428571429,23.0057142857143,19.9828571428571,235,0,0,0,0,157,235,157
2020,39,84,"Merkez",40.978,27.5111,20.3857142857143,21.6,2.02857142857143,71.5428571428571,24.4714285714286,16.6385714285714,220,92,27,0,0,129,128,102
2020,40,84,"Merkez",40.978,27.5111,20.6714285714286,20.3142857142857,0.0285714285714286,66.8285714285714,30.1957142857143,19.4657142857143,187,83,72,20,8,154,104,82
2020,41,84,"Merkez",40.978,27.5111,15.4,19.7142857142857,2.45714285714286,76.4714285714286,51.4014285714286,28.6,182,3,3,59,31,127,179,124
2020,42,84,"Merkez",40.978,27.5111,20.0857142857143,18.8142857142857,1.34285714285714,75.7571428571429,46.5214285714286,20.94,177,29,14,19,5,111,148,97
2020,43,84,"Merkez",40.978,27.5111,20.1285714285714,16.3428571428571,0.357142857142857,76.7285714285714,45.55,16.8057142857143,194,0,0,55,80,161,194,161
2020,44,84,"Merkez",40.978,27.5111,17.3142857142857,15.2,2.5,79.3714285714286,43.71,18.8483333333333,255,0,0,85,107,233,255,233
2020,45,84,"Merkez",40.978,27.5111,19.8,13.2428571428571,0,70.6571428571429,41.0171428571429,17.3228571428571,156,0,0,108,74,103,156,103
2020,46,84,"Merkez",40.978,27.5111,19.0428571428571,13.2142857142857,0.114285714285714,74.1285714285714,32.8971428571429,17.13,208,0,0,161,77,109,208,109
2020,47,84,"Merkez",40.978,27.5111,22.8714285714286,10.3285714285714,0.1,75.8857142857143,39.26,14.2514285714286,173,0,0,60,30,83,173,83
2020,48,84,"Merkez",40.978,27.5111,15.3571428571429,9.22857142857143,0,73.9,70.1828571428571,31.5571428571429,199,0,0,136,175,262,199,262
2020,49,84,"Merkez",40.978,27.5111,13.6571428571429,7.97142857142857,0,77.8857142857143,70.0514285714286,7.2325,207,0,0,153,84,116,207,116
2020,50,84,"Merkez",40.978,27.5111,24.3285714285714,12.3285714285714,3.41428571428571,78.5714285714286,47.2057142857143,4.68,181,52,58,24,8,98,129,40
2020,51,84,"Merkez",40.978,27.5111,16.1142857142857,8.22857142857143,1.12857142857143,80.3142857142857,44.3983333333333,30.1,171,0,0,154,84,90,171,90
2020,52,84,"Merkez",40.978,27.5111,19.2285714285714,9.9,0.0142857142857143,79.4571428571429,65.3042857142857,13.8916666666667,203,43,29,54,23,113,160,84
2020,53,84,"Merkez",40.978,27.5111,24.05,12.175,0.375,80.275,46.695,20.72,122,118,104,0,0,111,4,7
2017,1,85,"Tokat",40.3139,36.5544,19.3857142857143,3.75714285714286,4.12571428571429,65.7857142857143,41.9471428571429,NA,563,149,253,219,295,847,414,594
2017,2,85,"Tokat",40.3139,36.5544,22.9714285714286,-1.18571428571429,0.703142857142857,74.1,46.5328571428571,NA,757,532,838,105,125,1214,225,376
2017,3,85,"Tokat",40.3139,36.5544,12.7,1.54285714285714,0.242714285714286,69.4285714285714,54.1414285714286,NA,762,635,1222,97,180,1449,127,227
2017,4,85,"Tokat",40.3139,36.5544,25.2571428571429,-3,0.516428571428571,76.6,38.99,NA,639,242,397,80,148,889,397,492
2017,5,85,"Tokat",40.3139,36.5544,20.6857142857143,-2.82857142857143,0.0571428571428571,61.9142857142857,54.56,NA,588,179,372,273,436,1163,409,791
2017,6,85,"Tokat",40.3139,36.5544,17.1285714285714,4.5,0.171428571428571,64.4857142857143,42.1471428571429,NA,736,622,1352,86,84,1519,114,167
2017,7,85,"Tokat",40.3139,36.5544,15.7857142857143,-0.771428571428572,0.157285714285714,62.4857142857143,29.1514285714286,NA,492,404,566,78,141,717,88,151
2017,8,85,"Tokat",40.3139,36.5544,18.2571428571429,7.97142857142857,0.1,50.9857142857143,45.1914285714286,NA,739,244,543,214,596,1747,495,1204
2017,9,85,"Tokat",40.3139,36.5544,19.0857142857143,10.7571428571429,0.0582857142857143,49.0285714285714,52.2614285714286,NA,574,290,436,86,154,866,284,430
2017,10,85,"Tokat",40.3139,36.5544,20.4142857142857,12.4142857142857,0.000857142857142857,42.0571428571429,54.2542857142857,NA,712,622,923,0,0,1043,90,120
2017,11,85,"Tokat",40.3139,36.5544,14.7428571428571,6.9,1.04657142857143,71.2142857142857,23.1385714285714,NA,525,326,389,54,140,725,199,336
2017,12,85,"Tokat",40.3139,36.5544,20.2,8.02857142857143,0.742142857142857,53.7857142857143,30.3157142857143,NA,589,506,999,83,78,1077,83,78
2017,13,85,"Tokat",40.3139,36.5544,17.7571428571429,9.51428571428571,1.78657142857143,53.0714285714286,31.2228571428571,NA,574,574,887,0,0,887,0,0
2017,14,85,"Tokat",40.3139,36.5544,17.9571428571429,11.4857142857143,2.31585714285714,52.0857142857143,26.2542857142857,NA,639,544,1172,0,0,1336,95,164
2017,15,85,"Tokat",40.3139,36.5544,13.4714285714286,10.4857142857143,2.55757142857143,69.4571428571429,27.7514285714286,NA,587,396,898,106,171,1187,191,289
2017,16,85,"Tokat",40.3139,36.5544,19.8428571428571,14.1571428571429,0.871428571428572,48.0142857142857,31.88,NA,717,316,389,374,474,920,401,531
2017,17,85,"Tokat",40.3139,36.5544,17.1571428571429,13.6285714285714,0.999571428571429,39.3285714285714,30.12,NA,731,619,1311,97,111,1478,112,167
2017,18,85,"Tokat",40.3139,36.5544,20.6142857142857,14.2571428571429,5.32685714285714,62.7285714285714,37.9428571428571,NA,506,187,230,69,113,923,319,693
2017,19,85,"Tokat",40.3139,36.5544,20.1428571428571,18.3714285714286,0.329285714285714,49.4857142857143,43.0828571428571,NA,471,269,625,96,138,966,202,341
2017,20,85,"Tokat",40.3139,36.5544,18.2142857142857,13.1142857142857,1.92928571428571,74.4714285714286,20.2085714285714,NA,472,386,943,74,249,1205,86,262
2017,21,85,"Tokat",40.3139,36.5544,17.9428571428571,14.2428571428571,3.30214285714286,69.7571428571429,24.1328571428571,NA,448,380,767,30,25,849,68,82
2017,22,85,"Tokat",40.3139,36.5544,15.8857142857143,18.5285714285714,2.11128571428571,67.0571428571428,28.6057142857143,NA,522,387,842,85,94,1015,135,173
2017,23,85,"Tokat",40.3139,36.5544,15.3428571428571,20.4571428571429,4.06914285714286,70.5857142857143,28.37,NA,578,545,1289,0,0,1388,33,99
2017,24,85,"Tokat",40.3139,36.5544,17.1857142857143,18.9285714285714,0.129142857142857,58.7571428571429,22.4442857142857,NA,552,542,1116,0,0,1139,10,23
2017,25,85,"Tokat",40.3139,36.5544,16.6428571428571,17.7571428571429,4.48585714285714,72.4,24.7985714285714,NA,584,230,434,100,150,1041,354,607
2017,26,85,"Tokat",40.3139,36.5544,16.3857142857143,24.5571428571429,0,50.5428571428571,33.7157142857143,NA,564,546,904,0,0,971,18,67
2017,27,85,"Tokat",40.3139,36.5544,23.3428571428571,20.6142857142857,0.000285714285714286,58.1,33.3642857142857,NA,511,413,464,0,0,642,98,178
2017,28,85,"Tokat",40.3139,36.5544,20.4142857142857,21.1714285714286,0,50.6714285714286,31.5471428571429,NA,481,377,526,1,3,864,104,338
2017,29,85,"Tokat",40.3139,36.5544,23.0285714285714,23.2857142857143,0,57.6857142857143,34.3857142857143,NA,532,512,1207,0,0,1272,20,65
2017,30,85,"Tokat",40.3139,36.5544,19.5714285714286,24.9857142857143,0,44,48.5957142857143,NA,531,430,620,0,0,928,101,308
2017,31,85,"Tokat",40.3139,36.5544,20.7857142857143,25.4428571428571,0,51.2285714285714,40.2114285714286,NA,559,558,1045,0,0,1047,1,2
2017,32,85,"Tokat",40.3139,36.5544,19.6285714285714,25.9857142857143,0,53.5571428571429,48.0557142857143,NA,567,434,751,0,0,1092,133,341
2017,33,85,"Tokat",40.3139,36.5544,21.4142857142857,25.2857142857143,0.000142857142857143,52.6571428571429,37.3371428571429,NA,596,596,1199,0,0,1199,0,0
2017,34,85,"Tokat",40.3139,36.5544,21.9428571428571,22.6571428571429,0,53.7285714285714,28.6542857142857,NA,601,601,1280,0,0,1280,0,0
2017,35,85,"Tokat",40.3139,36.5544,17.9714285714286,19.9714285714286,0,55.2571428571429,30.6357142857143,NA,493,405,772,0,0,1014,88,242
2017,36,85,"Tokat",40.3139,36.5544,16.9,20.7142857142857,1.68342857142857,43.8142857142857,35.8514285714286,NA,507,387,953,16,25,1321,120,368
2017,37,85,"Tokat",40.3139,36.5544,15.5428571428571,25.1142857142857,0,34.5142857142857,62.7342857142857,NA,589,587,1138,0,0,1138,2,0
2017,38,85,"Tokat",40.3139,36.5544,20.0857142857143,23.8,0,37.3714285714286,59.2385714285714,NA,671,646,1279,0,0,1312,25,33
2017,39,85,"Tokat",40.3139,36.5544,19.6,17.4714285714286,2.56985714285714,61.2857142857143,30.7685714285714,NA,782,782,1630,0,0,1630,0,0
2017,40,85,"Tokat",40.3139,36.5544,12.7428571428571,12.8285714285714,1.23042857142857,57.2,43.8957142857143,NA,543,531,1117,0,0,1137,12,20
2017,41,85,"Tokat",40.3139,36.5544,15.3,10.9,0.715285714285714,68.4142857142857,27.3471428571429,NA,487,341,531,0,0,843,146,312
2017,42,85,"Tokat",40.3139,36.5544,12.2142857142857,11.1428571428571,0.043,60.7714285714286,57.37,NA,530,363,546,104,145,815,167,269
2017,43,85,"Tokat",40.3139,36.5544,21.7857142857143,13.5285714285714,0.114285714285714,53.2428571428571,125.904285714286,NA,506,108,253,121,185,919,398,666
2017,44,85,"Tokat",40.3139,36.5544,20.1285714285714,6.14285714285714,1.37114285714286,61.7,49.6628571428571,NA,561,251,578,236,381,1102,310,524
2017,45,85,"Tokat",40.3139,36.5544,11.4,7.55714285714286,0.243571428571429,72.6571428571429,75.6614285714286,NA,577,135,204,181,208,829,442,625
2017,46,85,"Tokat",40.3139,36.5544,15.4142857142857,9.48571428571429,0.128571428571429,64.2714285714286,107.59,NA,587,352,587,0,0,1085,235,498
2017,47,85,"Tokat",40.3139,36.5544,23.5857142857143,3.65714285714286,2.55828571428571,74.8142857142857,43.4114285714286,NA,418,102,305,181,284,804,316,499
2017,48,85,"Tokat",40.3139,36.5544,17.7,4.77142857142857,1.44257142857143,75.9857142857143,71.5214285714286,NA,386,345,544,0,0,619,41,75
2017,49,85,"Tokat",40.3139,36.5544,18.8142857142857,3.14285714285714,1.643,73.1571428571429,64.9642857142857,NA,407,223,393,113,142,645,184,252
2017,50,85,"Tokat",40.3139,36.5544,12.9714285714286,5.72857142857143,0.0434285714285714,71.4142857142857,87.7128571428571,NA,346,260,293,42,81,442,86,149
2017,51,85,"Tokat",40.3139,36.5544,28.5857142857143,6.8,2.63785714285714,77.2142857142857,27.4928571428571,NA,386,188,184,1,0,349,198,165
2017,52,85,"Tokat",40.3139,36.5544,24.75,2.925,0.749375,73.2875,88.0157142857143,NA,528,158,149,133,80,507,370,358
2018,1,85,"Tokat",40.3139,36.5544,19.6625,3.8625,3.583625,77.1625,43.86,NA,618,348,487,41,30,914,270,427
2018,2,85,"Tokat",40.3139,36.5544,22.4285714285714,4.07142857142857,0.0157142857142857,74.3,49.57,NA,624,334,334,161,750,1309,290,975
2018,3,85,"Tokat",40.3139,36.5544,25.4571428571429,3.05714285714286,2.44714285714286,70.6571428571429,27.23,NA,639,231,306,101,117,655,408,349
2018,4,85,"Tokat",40.3139,36.5544,27,1.18571428571429,0.587571428571429,72.7714285714286,21.7857142857143,NA,604,426,500,96,105,764,178,264
2018,5,85,"Tokat",40.3139,36.5544,18.7285714285714,3.75714285714286,0,65.4428571428571,49.3685714285714,NA,670,220,335,254,184,819,450,484
2018,6,85,"Tokat",40.3139,36.5544,20.1142857142857,7.42857142857143,0.214714285714286,66.6428571428571,69.5471428571429,NA,704,446,654,0,0,1022,258,368
2018,7,85,"Tokat",40.3139,36.5544,19.3285714285714,8.01428571428571,0.470857142857143,61.6,33.2228571428571,NA,478,333,390,136,138,557,145,167
2018,8,85,"Tokat",40.3139,36.5544,16.6571428571429,7.72857142857143,0.487857142857143,66.6142857142857,36.8442857142857,NA,711,705,1308,0,0,1321,6,13
2018,9,85,"Tokat",40.3139,36.5544,17.6571428571429,8.48571428571429,3.48457142857143,59.4142857142857,34.2485714285714,NA,621,174,293,340,507,956,447,663
2018,10,85,"Tokat",40.3139,36.5544,15.3285714285714,10.3142857142857,3.84142857142857,67.1857142857143,42.6771428571429,NA,556,371,829,175,494,1330,185,501
2018,11,85,"Tokat",40.3139,36.5544,14.4714285714286,10.9142857142857,1.04528571428571,65.1714285714286,39.9185714285714,NA,551,336,1008,88,127,1426,215,418
2018,12,85,"Tokat",40.3139,36.5544,17.6857142857143,15.3714285714286,1.28557142857143,45.3571428571429,77.805,NA,425,110,162,127,241,1187,315,1025
2018,13,85,"Tokat",40.3139,36.5544,19.1285714285714,13.1285714285714,2.64228571428571,53.4,100.048333333333,NA,356,208,252,55,70,428,148,176
2018,14,85,"Tokat",40.3139,36.5544,18.2142857142857,13.5428571428571,0.200142857142857,47.6571428571429,34.48,NA,407,341,412,49,19,486,66,74
2018,15,85,"Tokat",40.3139,36.5544,14.2714285714286,15.6428571428571,0.285714285714286,50.4142857142857,43.8,NA,374,367,428,0,0,450,7,22
2018,16,85,"Tokat",40.3139,36.5544,18.7571428571429,11.9571428571429,0.185571428571429,46.7857142857143,30.0957142857143,NA,411,298,502,1,1,648,113,146
2018,17,85,"Tokat",40.3139,36.5544,17.3571428571429,16.2142857142857,0,43.8142857142857,31.3742857142857,NA,419,419,652,0,0,652,0,0
2018,18,85,"Tokat",40.3139,36.5544,19.0571428571429,19.3857142857143,0.586285714285714,52.5428571428571,31.3085714285714,NA,303,303,474,0,0,474,0,0
2018,19,85,"Tokat",40.3139,36.5544,16.6571428571429,14.6571428571429,4.27542857142857,71.1142857142857,22.8328571428571,NA,275,192,332,25,36,467,83,135
2018,20,85,"Tokat",40.3139,36.5544,15.3142857142857,18.6142857142857,0.516428571428571,54.4142857142857,27.5057142857143,NA,204,172,268,0,0,306,32,38
2018,21,85,"Tokat",40.3139,36.5544,18.2142857142857,20.7571428571429,1.56942857142857,58.8714285714286,31.1642857142857,NA,252,251,281,0,0,281,1,0
2018,22,85,"Tokat",40.3139,36.5544,20.3714285714286,18.4714285714286,1.01457142857143,63.2142857142857,28.2671428571429,NA,249,245,427,0,0,427,4,0
2018,23,85,"Tokat",40.3139,36.5544,16.6,20.7571428571429,1.28442857142857,52.1571428571429,25.445,NA,267,250,680,0,0,812,17,132
2018,24,85,"Tokat",40.3139,36.5544,19.2571428571429,20.3571428571429,0.672142857142857,56.5571428571429,26.1316666666667,NA,267,217,376,0,0,448,50,72
2018,25,85,"Tokat",40.3139,36.5544,15.5857142857143,21.2142857142857,3.98071428571429,63.8142857142857,20.4171428571429,NA,358,301,465,0,0,518,57,53
2018,26,85,"Tokat",40.3139,36.5544,17.4,24.5285714285714,0.000857142857142857,54.4857142857143,27.2957142857143,NA,355,308,548,0,0,587,47,39
2018,27,85,"Tokat",40.3139,36.5544,19.0142857142857,21.5714285714286,0,56.9571428571429,24.4814285714286,NA,342,342,418,0,0,418,0,0
2018,28,85,"Tokat",40.3139,36.5544,24.4428571428571,24.1857142857143,0,52.8714285714286,34.7114285714286,NA,286,247,479,0,0,585,39,106
2018,29,85,"Tokat",40.3139,36.5544,20.3571428571429,21.2285714285714,0.714714285714286,56.2571428571429,22.8371428571429,NA,260,140,446,0,0,756,120,310
2018,30,85,"Tokat",40.3139,36.5544,17.1285714285714,23.7857142857143,0.0722857142857143,55.1428571428571,34.3928571428571,NA,265,196,462,4,3,822,69,360
2018,31,85,"Tokat",40.3139,36.5544,20.8714285714286,24.6285714285714,0.0428571428571429,54.5428571428571,33.2514285714286,NA,267,267,499,0,0,499,0,0
2018,32,85,"Tokat",40.3139,36.5544,19.1,22.3142857142857,0.1,61.3142857142857,27.0028571428571,NA,297,286,378,0,0,403,11,25
2018,33,85,"Tokat",40.3139,36.5544,19.5285714285714,22.9285714285714,0,56.9428571428571,28.5357142857143,NA,216,200,319,0,0,332,16,13
2018,34,85,"Tokat",40.3139,36.5544,16.6428571428571,23.8428571428571,0,52.9857142857143,30.6842857142857,NA,144,141,226,0,0,227,3,1
2018,35,85,"Tokat",40.3139,36.5544,21.1,24.9571428571429,0.0285714285714286,53.1285714285714,35.22,NA,201,201,314,0,0,314,0,0
2018,36,85,"Tokat",40.3139,36.5544,17.7285714285714,22.1428571428571,0.998428571428571,57.1285714285714,35.8271428571429,NA,341,183,188,61,48,370,158,182
2018,37,85,"Tokat",40.3139,36.5544,16.9,19.8428571428571,0.943285714285714,64.2714285714286,33.6242857142857,NA,241,0,0,106,141,419,241,419
2018,38,85,"Tokat",40.3139,36.5544,23.1285714285714,16.3714285714286,0,64.5,21.5514285714286,NA,189,22,52,0,0,344,167,292
2018,39,85,"Tokat",40.3139,36.5544,19.9428571428571,16.1428571428571,0.000428571428571429,58.0571428571429,28.3542857142857,NA,180,99,220,0,0,353,81,133
2018,40,85,"Tokat",40.3139,36.5544,17.7714285714286,15.0714285714286,0.0307142857142857,63.4714285714286,22.49,NA,191,130,254,0,0,341,61,87
2018,41,85,"Tokat",40.3139,36.5544,20.5571428571429,15.9,1.24328571428571,70.5571428571428,27.1014285714286,NA,187,77,101,0,0,422,110,321
2018,42,85,"Tokat",40.3139,36.5544,17.6428571428571,15.9571428571429,0.645142857142857,69.7857142857143,107.561666666667,NA,168,161,380,0,0,381,7,1
2018,43,85,"Tokat",40.3139,36.5544,21.4714285714286,9.78571428571429,3.10071428571429,77.2714285714286,23.33,NA,187,30,55,21,109,402,157,347
2018,44,85,"Tokat",40.3139,36.5544,12.4285714285714,11.0714285714286,0,63.9428571428571,NA,NA,196,179,236,0,0,264,17,28
2018,45,85,"Tokat",40.3139,36.5544,12.4571428571429,10.9428571428571,0,72.8714285714286,NA,NA,231,192,381,0,0,473,39,92
2018,46,85,"Tokat",40.3139,36.5544,13.7428571428571,6.02857142857143,0.0432857142857143,73.3857142857143,NA,NA,230,116,293,23,32,465,114,172
2018,47,85,"Tokat",40.3139,36.5544,14.7571428571429,8.52857142857143,0.444,76.4142857142857,NA,NA,270,150,348,0,0,499,120,151
2018,48,85,"Tokat",40.3139,36.5544,17.7285714285714,9.64285714285714,0.602,78,NA,NA,245,175,179,25,10,201,70,22
2018,49,85,"Tokat",40.3139,36.5544,14.1,5.85714285714286,0.0445714285714286,80.9428571428572,25.64,NA,257,41,56,43,84,420,216,364
2018,50,85,"Tokat",40.3139,36.5544,17,4.25714285714286,2.91642857142857,83.4571428571429,69.335,NA,256,94,130,51,17,305,162,175
2018,51,85,"Tokat",40.3139,36.5544,20.6714285714286,5.87142857142857,0.0438571428571429,79.1142857142857,47.21,NA,250,113,130,0,0,248,137,118
2018,52,85,"Tokat",40.3139,36.5544,19.8571428571429,0.114285714285714,14.7264285714286,83.3,25.545,NA,244,73,72,113,103,273,171,201
2019,1,85,"Tokat",40.3139,36.5544,19.725,4.7625,1.765375,76.425,19.14,NA,343,197,351,76,279,784,146,433
2019,2,85,"Tokat",40.3139,36.5544,11.4285714285714,-1.94285714285714,2.86942857142857,84,56.5366666666667,NA,255,140,84,86,91,208,115,124
2019,3,85,"Tokat",40.3139,36.5544,13.5428571428571,-0.985714285714286,45.2177142857143,84.5428571428571,49.1457142857143,NA,192,100,147,42,28,198,92,51
2019,4,85,"Tokat",40.3139,36.5544,27.0714285714286,4.01428571428571,0.985714285714286,74.8714285714286,90.91,NA,308,150,149,1,1,314,158,165
2019,5,85,"Tokat",40.3139,36.5544,27.8571428571429,5.18571428571429,0.842714285714286,70.7714285714286,52.2942857142857,NA,253,11,13,27,14,143,242,130
2019,6,85,"Tokat",40.3139,36.5544,14.8571428571429,6.68571428571429,1.08757142857143,67.3571428571429,56.555,NA,276,8,5,0,0,127,268,122
2019,7,85,"Tokat",40.3139,36.5544,16.6714285714286,5.48571428571429,0,65.5,NA,NA,325,256,121,0,0,234,69,113
2019,8,85,"Tokat",40.3139,36.5544,19.6142857142857,6.75714285714286,0,61.8,NA,NA,305,268,203,0,0,219,37,16
2019,9,85,"Tokat",40.3139,36.5544,19.0714285714286,2.7,0.186142857142857,71.1285714285714,NA,NA,331,151,160,79,59,310,180,150
2019,10,85,"Tokat",40.3139,36.5544,14.4714285714286,7.74285714285714,1.42757142857143,60.2714285714286,30.422,NA,359,207,175,80,42,252,152,77
2019,11,85,"Tokat",40.3139,36.5544,19.3428571428571,9.4,3.65385714285714,67.3714285714286,28.1471428571429,NA,373,88,156,28,4,400,285,244
2019,12,85,"Tokat",40.3139,36.5544,18.2,6.97142857142857,0.0142857142857143,61.0857142857143,25.925,NA,343,146,77,0,0,416,197,339
2019,13,85,"Tokat",40.3139,36.5544,24.3857142857143,4.95714285714286,0.00157142857142857,59.7142857142857,NA,NA,256,202,156,22,2,194,54,38
2019,14,85,"Tokat",40.3139,36.5544,18.4428571428571,10.6571428571429,0.0574285714285714,55.8857142857143,28.115,NA,365,302,170,0,0,208,63,38
2019,15,85,"Tokat",40.3139,36.5544,17.6571428571429,14.5142857142857,1.98557142857143,60.9285714285714,24.22,NA,359,42,6,100,36,183,317,177
2019,16,85,"Tokat",40.3139,36.5544,17.3857142857143,6.85714285714286,5.31042857142857,82.6571428571429,NA,NA,318,140,93,0,0,208,178,115
2019,17,85,"Tokat",40.3139,36.5544,13.3857142857143,11.9428571428571,1.15642857142857,64.6142857142857,34.6675,NA,412,385,309,0,0,313,27,4
2019,18,85,"Tokat",40.3139,36.5544,16.3571428571429,17.2714285714286,0.984857142857143,54.8428571428571,46.09,NA,523,6,3,135,69,353,517,350
2019,19,85,"Tokat",40.3139,36.5544,20.3142857142857,16.0714285714286,4.883,65.1285714285714,37.48,NA,452,151,120,0,0,386,301,266
2019,20,85,"Tokat",40.3139,36.5544,17.2428571428571,19.8857142857143,0.215428571428571,60.1,NA,NA,454,84,69,0,0,389,370,320
2019,21,85,"Tokat",40.3139,36.5544,27.8142857142857,19.7,0.957857142857143,62.7571428571429,28.5125,NA,457,152,114,198,216,413,305,299
2019,22,85,"Tokat",40.3139,36.5544,17.4571428571429,20.8857142857143,0.428428571428571,53.7285714285714,35.4628571428571,NA,453,452,323,0,0,323,1,0
2019,23,85,"Tokat",40.3139,36.5544,22.7142857142857,21.9,0.243,63.3,27.4125,NA,378,119,176,0,0,532,259,356
2019,24,85,"Tokat",40.3139,36.5544,20.4142857142857,20.1857142857143,1.54571428571429,70.6285714285714,24.5925,NA,378,225,150,47,13,244,153,94
2019,25,85,"Tokat",40.3139,36.5544,16.8571428571429,21.9428571428571,1.01657142857143,69.8571428571429,23.9142857142857,NA,306,228,198,39,94,325,78,127
2019,26,85,"Tokat",40.3139,36.5544,19.0285714285714,22.5857142857143,0.000142857142857143,58.1,27.9814285714286,NA,377,314,300,0,0,342,63,42
2019,27,85,"Tokat",40.3139,36.5544,21.4142857142857,20.6142857142857,0,57.5142857142857,27.5457142857143,NA,456,447,218,0,0,222,9,4
2019,28,85,"Tokat",40.3139,36.5544,23.3285714285714,22.2428571428571,1.17114285714286,56.9857142857143,24.89,NA,398,312,255,31,90,421,86,166
2019,29,85,"Tokat",40.3139,36.5544,19.5428571428571,20.5571428571429,1.172,65.7142857142857,32.5666666666667,NA,453,395,198,55,5,203,58,5
2019,30,85,"Tokat",40.3139,36.5544,19.0428571428571,21.4428571428571,0.0428571428571429,62.4428571428571,26.0128571428571,NA,456,208,200,0,0,335,248,135
2019,31,85,"Tokat",40.3139,36.5544,21.1714285714286,24.9428571428571,0.0428571428571429,53.1285714285714,32.5528571428571,NA,334,2,0,0,0,375,332,375
2019,32,85,"Tokat",40.3139,36.5544,24.9428571428571,18.9714285714286,0,61.8857142857143,25.6314285714286,NA,346,5,4,11,7,395,341,391
2019,33,85,"Tokat",40.3139,36.5544,21.9571428571429,23.8,0.115285714285714,55.8571428571429,28.1542857142857,NA,337,106,174,0,0,531,231,357
2019,34,85,"Tokat",40.3139,36.5544,17.2142857142857,20.9142857142857,6.85171428571429,78.2,24.2157142857143,NA,299,160,153,44,40,345,139,192
2019,35,85,"Tokat",40.3139,36.5544,19.5428571428571,22.4,0.142714285714286,63.6142857142857,26.0471428571429,NA,307,306,415,0,0,415,1,0
2019,36,85,"Tokat",40.3139,36.5544,20.1,20.6142857142857,0,57.8142857142857,26.1714285714286,NA,171,171,67,0,0,67,0,0
2019,37,85,"Tokat",40.3139,36.5544,18.1142857142857,19.4571428571429,0.144285714285714,65.0142857142857,21.728,NA,218,67,23,0,0,55,151,32
2019,38,85,"Tokat",40.3139,36.5544,20.8714285714286,17.6571428571429,0.0577142857142857,61.9285714285714,28.28,NA,266,211,55,54,36,91,55,36
2019,39,85,"Tokat",40.3139,36.5544,13.5285714285714,17.8428571428571,0.171428571428571,61.3285714285714,26.9528571428571,NA,237,114,53,0,0,79,123,26
2019,40,85,"Tokat",40.3139,36.5544,15.0285714285714,20.2428571428571,0.0715714285714286,49.4,39.7142857142857,NA,241,36,7,16,2,111,205,104
2019,41,85,"Tokat",40.3139,36.5544,15.6285714285714,17.2714285714286,0,62.0571428571429,27.6942857142857,NA,416,353,431,0,0,448,63,17
2019,42,85,"Tokat",40.3139,36.5544,15.0571428571429,17.5428571428571,0.142714285714286,58.2571428571429,48.6557142857143,NA,356,322,394,0,0,408,34,14
2019,43,85,"Tokat",40.3139,36.5544,17.6857142857143,16.1285714285714,0.00114285714285714,67.8857142857143,24.0028571428571,NA,306,256,232,0,0,300,50,68
2019,44,85,"Tokat",40.3139,36.5544,14.0142857142857,11.4571428571429,1.53,72.5142857142857,27.2057142857143,NA,350,279,205,0,0,250,71,45
2019,45,85,"Tokat",40.3139,36.5544,11.7571428571429,10.7142857142857,0,63.3714285714286,70.16,NA,417,385,303,0,0,328,32,25
2019,46,85,"Tokat",40.3139,36.5544,10.4142857142857,10.9,0,59.2571428571429,84.2528571428571,NA,401,318,268,0,0,337,83,69
2019,47,85,"Tokat",40.3139,36.5544,9.62857142857143,5.24285714285714,0,62.7857142857143,85.9371428571429,NA,391,391,339,0,0,339,0,0
2019,48,85,"Tokat",40.3139,36.5544,11.9571428571429,9.24285714285714,3.17,75.5857142857143,57.0585714285714,NA,320,204,196,68,37,251,116,55
2019,49,85,"Tokat",40.3139,36.5544,16.0571428571429,3.47142857142857,0.00157142857142857,72.6,29.04,NA,393,246,198,77,49,274,147,76
2019,50,85,"Tokat",40.3139,36.5544,12.9857142857143,6.11428571428571,0.157285714285714,76.8285714285714,61.6128571428571,NA,218,138,104,25,3,119,80,15
2019,51,85,"Tokat",40.3139,36.5544,11.6857142857143,4.84285714285714,0.0715714285714286,78.3,65.9571428571429,NA,361,361,488,0,0,488,0,0
2019,52,85,"Tokat",40.3139,36.5544,24.4,7.64285714285714,3.07271428571429,72.3428571428571,23.395,NA,279,65,51,83,39,281,214,230
2020,1,85,"Tokat",40.3139,36.5544,14,4.02,1.1002,78.22,18.144,NA,160,100,80,28,22,126,60,46
2020,2,85,"Tokat",40.3139,36.5544,14.8428571428571,4.25714285714286,0.0577142857142857,69.9571428571429,28.1057142857143,NA,240,164,137,45,28,173,76,36
2020,3,85,"Tokat",40.3139,36.5544,13,2.28571428571429,0.0142857142857143,72.0285714285714,29.878,NA,270,233,301,35,81,382,37,81
2020,4,85,"Tokat",40.3139,36.5544,10.8714285714286,0.157142857142857,15.7762857142857,77.0428571428571,27.5585714285714,NA,358,160,157,138,54,295,198,138
2020,5,85,"Tokat",40.3139,36.5544,13.4857142857143,3.4,4.02585714285714,77.4285714285714,44.5971428571429,NA,331,74,67,152,80,272,257,205
2020,6,85,"Tokat",40.3139,36.5544,23.0142857142857,4.38571428571429,6.056,72.7285714285714,29.375,NA,343,52,32,35,33,267,291,235
2020,7,85,"Tokat",40.3139,36.5544,14.2857142857143,-0.657142857142857,2.00257142857143,74.3285714285714,25.61,NA,341,137,103,0,0,338,204,235
2020,8,85,"Tokat",40.3139,36.5544,17.9,5.25714285714286,0.016,68.9857142857143,NA,NA,283,205,154,0,0,187,78,33
2020,9,85,"Tokat",40.3139,36.5544,20.3571428571429,7.6,1.32714285714286,62.7142857142857,NA,NA,393,223,270,92,112,528,170,258
2020,10,85,"Tokat",40.3139,36.5544,16.0571428571429,11.9428571428571,0.000428571428571429,50.8,NA,NA,205,139,156,0,0,210,66,54
2020,11,85,"Tokat",40.3139,36.5544,26.1857142857143,12.6714285714286,1.01314285714286,59.8714285714286,27.0333333333333,NA,115,85,83,0,0,94,30,11
2020,12,85,"Tokat",40.3139,36.5544,24.0571428571429,1.31428571428571,1.60285714285714,78.9142857142857,14.7557142857143,NA,117,45,45,23,17,118,72,73
2020,13,85,"Tokat",40.3139,36.5544,22.5142857142857,8,1.28457142857143,73.3,20.0871428571429,NA,136,120,82,11,6,92,16,10
2020,14,85,"Tokat",40.3139,36.5544,19.8428571428571,7.41428571428571,1.37471428571429,75.2,18.6257142857143,NA,155,69,36,35,22,121,86,85
2020,15,85,"Tokat",40.3139,36.5544,26.6142857142857,7.37142857142857,0.000285714285714286,63.7142857142857,23.6214285714286,NA,133,83,86,0,0,118,50,32
2020,16,85,"Tokat",40.3139,36.5544,19.9714285714286,10.0571428571429,0.970857142857143,61.0857142857143,22.9285714285714,NA,141,29,19,45,20,106,112,87
2020,17,85,"Tokat",40.3139,36.5544,21.0571428571429,8.18571428571429,0.915857142857143,68.3428571428571,16.2028571428571,NA,137,64,37,5,1,123,73,86
2020,18,85,"Tokat",40.3139,36.5544,18.8428571428571,11.7285714285714,2.10171428571429,70.7,21.938,NA,146,1,0,56,50,164,145,164
2020,19,85,"Tokat",40.3139,36.5544,21.8,10.8714285714286,2.43042857142857,76.7428571428571,NA,NA,137,25,38,5,4,157,112,119
2020,20,85,"Tokat",40.3139,36.5544,18.6714285714286,17.9714285714286,0,57.4571428571429,46.884,NA,164,42,15,30,34,164,122,149
2020,21,85,"Tokat",40.3139,36.5544,28.1428571428571,16.4428571428571,0.986428571428571,59.5857142857143,39.215,NA,146,47,39,0,0,96,99,57
2020,22,85,"Tokat",40.3139,36.5544,23.7857142857143,14.8714285714286,0.285428571428571,62.6142857142857,NA,NA,118,36,23,28,20,100,82,77
2020,23,85,"Tokat",40.3139,36.5544,19.2857142857143,19.0428571428571,3.91228571428571,62.3714285714286,NA,NA,112,1,0,47,27,70,111,70
2020,24,85,"Tokat",40.3139,36.5544,17.2,20.5,4.99614285714286,64.8714285714286,NA,NA,140,0,0,79,87,150,140,150
2020,25,85,"Tokat",40.3139,36.5544,18.2571428571429,20.4428571428571,1.24385714285714,68.5142857142857,24.296,NA,137,0,0,96,69,108,137,108
2020,26,85,"Tokat",40.3139,36.5544,18.7714285714286,22.3,1.569,61.8428571428571,29.1214285714286,NA,173,0,0,112,55,133,173,133
2020,27,85,"Tokat",40.3139,36.5544,20.6428571428571,22.2714285714286,0.142571428571429,58.0571428571429,32.2033333333333,NA,113,0,0,33,39,113,113,113
2020,28,85,"Tokat",40.3139,36.5544,18.0142857142857,21.4428571428571,0,64.6428571428571,30.26,NA,164,0,0,137,67,122,164,122
2020,29,85,"Tokat",40.3139,36.5544,22.2714285714286,22.2857142857143,0.000142857142857143,58.5428571428571,32.72,NA,186,5,3,25,14,111,181,108
2020,30,85,"Tokat",40.3139,36.5544,22.2714285714286,21.7428571428571,0,59,33.1666666666667,NA,190,5,3,30,14,142,185,139
2020,31,85,"Tokat",40.3139,36.5544,22.4714285714286,22.0285714285714,0,59.7857142857143,NA,NA,150,0,0,16,9,127,150,127
2020,32,85,"Tokat",40.3139,36.5544,22.2142857142857,21.0857142857143,0.000142857142857143,59.4714285714286,NA,NA,146,0,0,0,0,107,146,107
2020,33,85,"Tokat",40.3139,36.5544,21.7,19.7142857142857,0.0285714285714286,59.6857142857143,NA,NA,183,3,4,74,48,83,180,79
2020,34,85,"Tokat",40.3139,36.5544,22.8,18.9285714285714,0.128428571428571,61.1285714285714,NA,NA,197,2,0,17,5,97,195,97
2020,35,85,"Tokat",40.3139,36.5544,19.8571428571429,20.7571428571429,0,48.8857142857143,NA,NA,164,20,47,12,11,157,144,110
2020,36,85,"Tokat",40.3139,36.5544,21.1285714285714,24.4,0,40.6,NA,NA,179,119,68,0,0,112,60,44
2020,37,85,"Tokat",40.3139,36.5544,20.6428571428571,21.3857142857143,0.0287142857142857,59.7142857142857,NA,NA,193,175,78,0,0,91,18,13
2020,38,85,"Tokat",40.3139,36.5544,20.0571428571429,19.6142857142857,0,61.3714285714286,NA,NA,235,181,131,21,8,157,54,26
2020,39,85,"Tokat",40.3139,36.5544,17.2142857142857,18.9285714285714,0.000571428571428571,62.1142857142857,20.9185714285714,NA,220,74,52,36,14,129,146,77
2020,40,85,"Tokat",40.3139,36.5544,18.8285714285714,18.8,0.157,57.8428571428571,23.9671428571429,NA,187,38,17,24,27,154,149,137
2020,41,85,"Tokat",40.3139,36.5544,18.3857142857143,17.7428571428571,0,41.2,23.292,NA,182,70,40,19,7,127,112,87
2020,42,85,"Tokat",40.3139,36.5544,16.6428571428571,17.3714285714286,0,47.1285714285714,51.4,NA,177,53,49,0,0,111,124,62
2020,43,85,"Tokat",40.3139,36.5544,16.9285714285714,14.3571428571429,0.000428571428571429,59.9285714285714,38.6425,NA,194,62,46,0,0,161,132,115
2020,44,85,"Tokat",40.3139,36.5544,20.6285714285714,14.4285714285714,0.0431428571428571,48.1,41.2128571428571,NA,255,2,2,14,25,233,253,231
2020,45,85,"Tokat",40.3139,36.5544,22.8571428571429,9.15714285714286,1.22942857142857,76.6571428571429,20.45,NA,156,86,63,0,0,103,70,40
2020,46,85,"Tokat",40.3139,36.5544,12.7285714285714,6.1,0,71.6142857142857,25.5642857142857,NA,208,147,65,0,0,109,61,44
2020,47,85,"Tokat",40.3139,36.5544,16.1571428571429,4.54285714285714,0.200142857142857,75.9714285714286,19.2533333333333,NA,173,75,35,11,3,83,98,48
2020,48,85,"Tokat",40.3139,36.5544,15.6142857142857,1.81428571428571,0,71.4,30.9457142857143,NA,199,172,236,13,24,262,27,26
2020,49,85,"Tokat",40.3139,36.5544,16.4285714285714,3.37142857142857,0.186142857142857,79.9142857142857,54.3371428571429,NA,207,163,78,17,4,116,44,38
2020,50,85,"Tokat",40.3139,36.5544,22.8,5.61428571428571,1.14342857142857,75.4571428571429,43.5742857142857,NA,181,74,57,0,0,98,107,41
2020,51,85,"Tokat",40.3139,36.5544,17.7428571428571,4.91428571428571,0.129714285714286,81.3571428571429,20.6314285714286,NA,171,79,40,22,5,90,92,50
2020,52,85,"Tokat",40.3139,36.5544,15.6,0.7,0.043,75.6857142857143,35.8157142857143,NA,203,138,61,51,46,113,65,52
2020,53,85,"Tokat",40.3139,36.5544,22.15,3.9,0,63,28.76,NA,122,107,108,0,0,111,15,3
2017,1,86,"Meydan",41.0015,39.7178,27.4428571428571,11.0142857142857,0.0857142857142857,51.2857142857143,NA,40.9185714285714,563,0,0,190,327,847,563,847
2017,2,86,"Meydan",41.0015,39.7178,26.9,7.32857142857143,1.74642857142857,66.9285714285714,111.133333333333,44.5257142857143,757,29,184,302,408,1214,728,1030
2017,3,86,"Meydan",41.0015,39.7178,21.9285714285714,7.58571428571429,0.159,69.4571428571429,107.654285714286,47.2571428571429,762,18,45,567,1165,1449,744,1404
2017,4,86,"Meydan",41.0015,39.7178,23.8,3.88571428571429,4.60728571428571,75.1285714285714,83.5871428571429,41.4528571428571,639,1,14,309,416,889,638,875
2017,5,86,"Meydan",41.0015,39.7178,25.0285714285714,3.15714285714286,9.89928571428571,67.5571428571428,128.578571428571,55.8242857142857,588,1,0,331,786,1163,587,1163
2017,6,86,"Meydan",41.0015,39.7178,23.2857142857143,8.21428571428571,0.0387142857142857,68.1857142857143,110.597142857143,45.4714285714286,736,0,0,477,1054,1519,736,1519
2017,7,86,"Meydan",41.0015,39.7178,22.7285714285714,2.92857142857143,6.14742857142857,70.2714285714286,87.6485714285714,42.8457142857143,492,10,0,353,602,717,482,717
2017,8,86,"Meydan",41.0015,39.7178,30.7285714285714,10.1571428571429,1.02528571428571,61.3571428571429,101.577142857143,45.75,739,205,579,116,167,1747,534,1168
2017,9,86,"Meydan",41.0015,39.7178,17.1142857142857,9.61428571428571,0.197285714285714,78.4857142857143,121.505714285714,47.1671428571429,574,441,728,0,0,866,133,138
2017,10,86,"Meydan",41.0015,39.7178,22.7285714285714,12.9142857142857,0.001,62.8857142857143,120.342857142857,51.5685714285714,712,362,533,0,0,1043,350,510
2017,11,86,"Meydan",41.0015,39.7178,19.2714285714286,8.38571428571429,2.564,82.5571428571429,66.2857142857143,36.4485714285714,525,142,195,177,186,725,383,530
2017,12,86,"Meydan",41.0015,39.7178,19.9714285714286,7.55714285714286,0.0395714285714286,77.3142857142857,75.386,39.048,589,412,625,81,166,1077,177,452
2017,13,86,"Meydan",41.0015,39.7178,17.3285714285714,8.88571428571429,1.44785714285714,79.4285714285714,85.006,41.918,574,342,555,60,93,887,232,332
2017,14,86,"Meydan",41.0015,39.7178,23.3857142857143,10.2285714285714,2.69485714285714,81.2571428571429,78.4985714285714,44.5671428571429,639,370,862,20,61,1336,269,474
2017,15,86,"Meydan",41.0015,39.7178,20.2285714285714,10.3571428571429,1.78757142857143,80.9428571428572,66.5428571428571,39.9985714285714,587,209,661,76,202,1187,378,526
2017,16,86,"Meydan",41.0015,39.7178,35.3571428571429,12.6571428571429,2.28757142857143,75.2714285714286,53.0271428571429,34.6885714285714,717,334,345,275,399,920,383,575
2017,17,86,"Meydan",41.0015,39.7178,17.0571428571429,11.6714285714286,1.30371428571429,70.8,60.66,41.7228571428571,731,619,1356,0,0,1478,112,122
2017,18,86,"Meydan",41.0015,39.7178,16.3285714285714,14.3142857142857,0.991285714285714,86.5857142857143,71.4142857142857,40.9185714285714,506,227,415,12,22,923,279,508
2017,19,86,"Meydan",41.0015,39.7178,30.6714285714286,17.1571428571429,2.26914285714286,74.5857142857143,57.1133333333333,32.1642857142857,471,243,502,103,188,966,228,464
2017,20,86,"Meydan",41.0015,39.7178,20.0571428571429,14.3428571428571,3.88071428571429,88.5714285714286,27.4842857142857,26.1871428571429,472,266,609,123,488,1205,206,596
2017,21,86,"Meydan",41.0015,39.7178,14.7857142857143,15.1285714285714,2.74985714285714,84.8285714285714,26.0742857142857,26.7114285714286,448,243,460,185,351,849,205,389
2017,22,86,"Meydan",41.0015,39.7178,18.9857142857143,18.9428571428571,0.0321428571428571,77.0571428571429,24.0985714285714,21.1885714285714,522,326,756,0,0,1015,196,259
2017,23,86,"Meydan",41.0015,39.7178,21.3428571428571,20.6571428571429,1.50985714285714,82.6285714285714,24.8233333333333,21.46,578,403,917,88,270,1388,175,471
2017,24,86,"Meydan",41.0015,39.7178,19.2142857142857,19.6428571428571,2.77514285714286,78.1857142857143,25.9385714285714,21.1542857142857,552,93,214,299,651,1139,459,925
2017,25,86,"Meydan",41.0015,39.7178,17.4428571428571,20.9142857142857,4.69428571428571,79.1571428571429,29.49,24.5428571428571,584,98,213,357,566,1041,486,828
2017,26,86,"Meydan",41.0015,39.7178,12.9285714285714,24.2714285714286,0,77.1857142857143,21.0185714285714,15.5314285714286,564,390,723,0,0,971,174,248
2017,27,86,"Meydan",41.0015,39.7178,24.2285714285714,23.6428571428571,0.0568571428571429,70.5285714285714,27.995,20.99,511,90,165,350,386,642,421,477
2017,28,86,"Meydan",41.0015,39.7178,13.2571428571429,24.1857142857143,0,71.6,17.1128571428571,15.7671428571429,481,215,390,123,282,864,266,474
2017,29,86,"Meydan",41.0015,39.7178,17.9571428571429,25.1571428571429,0.108142857142857,76.1285714285714,28.0342857142857,25.65,532,66,180,411,931,1272,466,1092
2017,30,86,"Meydan",41.0015,39.7178,21.3571428571429,25.5571428571429,0.354428571428571,70.8,38.2328571428571,22.8285714285714,531,180,385,191,296,928,351,543
2017,31,86,"Meydan",41.0015,39.7178,12.7,25.4428571428571,0.537857142857143,78.1428571428571,33.6457142857143,26.1942857142857,559,74,105,169,434,1047,485,942
2017,32,86,"Meydan",41.0015,39.7178,17.3857142857143,27.6857142857143,0.0895714285714286,77.9428571428572,39.3457142857143,19.49,567,0,0,254,680,1092,567,1092
2017,33,86,"Meydan",41.0015,39.7178,19,27.1857142857143,0.831285714285714,75.4,30.9657142857143,20.9685714285714,596,0,0,565,1174,1199,596,1199
2017,34,86,"Meydan",41.0015,39.7178,25.8285714285714,24.4428571428571,1.76142857142857,77.1857142857143,24.1342857142857,24.7157142857143,601,0,0,488,835,1280,601,1280
2017,35,86,"Meydan",41.0015,39.7178,19.5571428571429,23.4714285714286,1.273,76.1571428571429,24.0142857142857,24.1728571428571,493,17,122,352,649,1014,476,892
2017,36,86,"Meydan",41.0015,39.7178,17.6142857142857,23.0571428571429,0.577714285714286,74.5857142857143,23.9057142857143,22.2571428571429,507,64,219,224,739,1321,443,1102
2017,37,86,"Meydan",41.0015,39.7178,14.5,24.6857142857143,0.0848571428571429,70.6714285714286,56.5571428571429,30.3214285714286,589,310,657,63,292,1138,279,481
2017,38,86,"Meydan",41.0015,39.7178,19.5285714285714,23.7714285714286,1.87785714285714,79.2571428571429,48.7614285714286,28.01,671,238,374,303,742,1312,433,938
2017,39,86,"Meydan",41.0015,39.7178,22.6714285714286,21.4428571428571,0.256428571428571,74.3428571428571,29.2342857142857,23.2257142857143,782,0,0,631,1453,1630,782,1630
2017,40,86,"Meydan",41.0015,39.7178,19.7428571428571,18.2714285714286,1.20271428571429,64,27.0171428571429,21.58,543,47,193,207,330,1137,496,944
2017,41,86,"Meydan",41.0015,39.7178,24.5857142857143,16.5428571428571,7.04814285714286,75.8142857142857,26.0285714285714,26.088,487,0,0,412,702,843,487,843
2017,42,86,"Meydan",41.0015,39.7178,18.1857142857143,16.2428571428571,1.77757142857143,70.7428571428571,58.2814285714286,32.9785714285714,530,27,67,213,262,815,503,748
2017,43,86,"Meydan",41.0015,39.7178,22.1142857142857,18.5571428571429,2.25485714285714,70.4285714285714,74.6185714285714,33.9928571428571,506,12,13,199,413,919,494,906
2017,44,86,"Meydan",41.0015,39.7178,22.5142857142857,13.0571428571429,3.28671428571429,73.6142857142857,43.1828571428571,30.71,561,1,0,267,559,1102,560,1102
2017,45,86,"Meydan",41.0015,39.7178,13.9714285714286,15.0285714285714,0.765428571428571,78.1857142857143,74.1957142857143,35.7771428571429,577,21,90,269,258,829,556,739
2017,46,86,"Meydan",41.0015,39.7178,21.3,16.6142857142857,0.00171428571428571,65.9,94.0028571428571,37.2514285714286,587,101,157,153,219,1085,486,928
2017,47,86,"Meydan",41.0015,39.7178,31.7,10.7857142857143,6.64671428571429,61.4,73.4571428571429,38.2357142857143,418,0,0,307,491,804,418,804
2017,48,86,"Meydan",41.0015,39.7178,20.6714285714286,13.1571428571429,1.18328571428571,61.6857142857143,112.447142857143,44.9357142857143,386,40,71,52,109,619,346,548
2017,49,86,"Meydan",41.0015,39.7178,27.7428571428571,11.4714285714286,4.96271428571429,63.3714285714286,83.4442857142857,37.8728571428571,407,0,0,272,393,645,407,645
2017,50,86,"Meydan",41.0015,39.7178,17.0857142857143,11.6,0.449714285714286,67.5571428571428,127.53,46.8942857142857,346,19,43,50,92,442,327,399
2017,51,86,"Meydan",41.0015,39.7178,25.0285714285714,11.5571428571429,5.37742857142857,79.1571428571429,53.2257142857143,30.5671428571429,386,47,50,300,260,349,339,299
2017,52,86,"Meydan",41.0015,39.7178,24.2625,12.225,1.311875,57.2375,124.651428571429,43.11625,528,0,0,284,227,507,528,507
2018,1,86,"Meydan",41.0015,39.7178,20.7125,10.525,3.72675,73.1875,94.3428571428571,36,618,13,53,314,392,914,605,861
2018,2,86,"Meydan",41.0015,39.7178,23.9857142857143,10.3571428571429,1.25085714285714,70.5571428571429,81.0428571428571,35.0828571428571,624,7,28,446,925,1309,617,1281
2018,3,86,"Meydan",41.0015,39.7178,24.8285714285714,9.17142857142857,1.49542857142857,67.9571428571429,78.1428571428571,33.16,639,21,175,194,117,655,618,480
2018,4,86,"Meydan",41.0015,39.7178,22.9142857142857,8.27142857142857,6.55342857142857,72.3571428571429,63.8757142857143,33.84,604,0,0,434,535,764,604,764
2018,5,86,"Meydan",41.0015,39.7178,22.6142857142857,10.1285714285714,0.381428571428571,62.1714285714286,89.4142857142857,38.1657142857143,670,59,102,206,169,819,611,717
2018,6,86,"Meydan",41.0015,39.7178,21.3428571428571,10.8142857142857,1.13957142857143,79.1142857142857,78.0957142857143,32.6885714285714,704,146,223,183,306,1022,558,799
2018,7,86,"Meydan",41.0015,39.7178,20.5857142857143,9.97142857142857,4.99971428571429,79.9,73.8028571428571,33.6714285714286,478,16,50,170,229,557,462,507
2018,8,86,"Meydan",41.0015,39.7178,15.7857142857143,9.27142857142857,0.582,82.2714285714286,54.8357142857143,29.0942857142857,711,249,494,47,167,1321,462,827
2018,9,86,"Meydan",41.0015,39.7178,34.3714285714286,10.1285714285714,3.42485714285714,72.8,69.3014285714286,33.1528571428571,621,83,142,102,131,956,538,814
2018,10,86,"Meydan",41.0015,39.7178,26.4714285714286,11.4571428571429,3.10528571428571,77.8428571428571,74.83,33.2442857142857,556,209,427,125,257,1330,347,903
2018,11,86,"Meydan",41.0015,39.7178,19.4428571428571,12.2142857142857,3.50628571428571,78.6142857142857,65.4957142857143,33.7142857142857,551,259,566,194,570,1426,292,860
2018,12,86,"Meydan",41.0015,39.7178,30.7714285714286,14.1571428571429,1.398,74.0142857142857,81.87,32.2042857142857,425,129,288,239,728,1187,296,899
2018,13,86,"Meydan",41.0015,39.7178,23.4285714285714,12.3428571428571,1.72657142857143,80.6142857142857,75.295,30.05,356,169,202,80,114,428,187,226
2018,14,86,"Meydan",41.0015,39.7178,21.1285714285714,12.9428571428571,1.44971428571429,66.7571428571429,NA,24.69,407,179,166,110,70,486,228,320
2018,15,86,"Meydan",41.0015,39.7178,15.5571428571429,12.3285714285714,0.017,86.6285714285714,33.606,22.7014285714286,374,145,258,16,56,450,229,192
2018,16,86,"Meydan",41.0015,39.7178,18.1714285714286,12.3857142857143,0.904571428571428,75.4857142857143,39.3557142857143,25.5757142857143,411,255,428,90,171,648,156,220
2018,17,86,"Meydan",41.0015,39.7178,15.6142857142857,15.6714285714286,0.0291428571428571,72.4,51.4,25.1614285714286,419,206,350,108,174,652,213,302
2018,18,86,"Meydan",41.0015,39.7178,15.5142857142857,16.7,0.00657142857142857,89.6714285714286,36.5228571428571,20.4342857142857,303,221,340,0,0,474,82,134
2018,19,86,"Meydan",41.0015,39.7178,19.2571428571429,17.8142857142857,2.02628571428571,82.2714285714286,29.2028571428571,19.9914285714286,275,35,41,92,111,467,240,426
2018,20,86,"Meydan",41.0015,39.7178,21.0285714285714,19.0285714285714,3.172,79.3571428571429,34.3514285714286,27.4142857142857,204,167,284,0,0,306,37,22
2018,21,86,"Meydan",41.0015,39.7178,17.4428571428571,21.2428571428571,1.63157142857143,83.1857142857143,26.1442857142857,23.0914285714286,252,123,163,19,24,281,129,118
2018,22,86,"Meydan",41.0015,39.7178,19.7285714285714,21.2857142857143,3.25042857142857,75.7714285714286,29.1157142857143,25.5614285714286,249,30,42,168,307,427,219,385
2018,23,86,"Meydan",41.0015,39.7178,16.3857142857143,22.0571428571429,0.118428571428571,76.0142857142857,26.8028571428571,24.1385714285714,267,125,380,45,196,812,142,432
2018,24,86,"Meydan",41.0015,39.7178,16.6285714285714,24.0857142857143,0.873714285714286,73.2142857142857,25.6042857142857,22.3685714285714,267,27,85,84,156,448,240,363
2018,25,86,"Meydan",41.0015,39.7178,21.0857142857143,24.4428571428571,1.02885714285714,72.8714285714286,17.05,21.1214285714286,358,0,0,342,502,518,358,518
2018,26,86,"Meydan",41.0015,39.7178,17.1428571428571,25.6857142857143,0.267285714285714,80.9142857142857,22.3185714285714,20.1,355,124,241,106,150,587,231,346
2018,27,86,"Meydan",41.0015,39.7178,19.7857142857143,24.5142857142857,4.19971428571429,71.6571428571429,24.7685714285714,21.8657142857143,342,46,80,283,312,418,296,338
2018,28,86,"Meydan",41.0015,39.7178,20.3,25.7857142857143,1.18671428571429,76.5571428571429,28.61,20.8871428571429,286,40,73,105,289,585,246,512
2018,29,86,"Meydan",41.0015,39.7178,22.0857142857143,24.9714285714286,0.751571428571429,68.7142857142857,17.0633333333333,17.5242857142857,260,29,17,156,478,756,231,739
2018,30,86,"Meydan",41.0015,39.7178,16.4142857142857,26.8714285714286,2.419,74.9428571428571,20.2928571428571,16.3157142857143,265,34,139,87,256,822,231,683
2018,31,86,"Meydan",41.0015,39.7178,20.0285714285714,26.6285714285714,0.819142857142857,72.6857142857143,26.4728571428571,18.6242857142857,267,0,0,215,447,499,267,499
2018,32,86,"Meydan",41.0015,39.7178,23.2142857142857,25.6571428571429,1.14357142857143,67.3857142857143,25.18,17.2228571428571,297,33,69,190,253,403,264,334
2018,33,86,"Meydan",41.0015,39.7178,15.6,25.1285714285714,0,68.7142857142857,25.2842857142857,15.1014285714286,216,0,0,207,321,332,216,332
2018,34,86,"Meydan",41.0015,39.7178,16.1428571428571,25.5,1.02814285714286,72.8571428571429,21.615,16.7342857142857,144,44,74,72,121,227,100,153
2018,35,86,"Meydan",41.0015,39.7178,14.5571428571429,26.2285714285714,0.0115714285714286,73.4857142857143,30.495,15.6885714285714,201,38,57,71,192,314,163,257
2018,36,86,"Meydan",41.0015,39.7178,26.6857142857143,24.8714285714286,3.91,70.6,34.315,15.0142857142857,341,19,16,264,274,370,322,354
2018,37,86,"Meydan",41.0015,39.7178,20.8285714285714,22.6714285714286,7.53328571428571,77.4857142857143,23.4483333333333,22.5957142857143,241,15,51,176,260,419,226,368
2018,38,86,"Meydan",41.0015,39.7178,16.6428571428571,21.6,1.22457142857143,72.8714285714286,15.6871428571429,28.7966666666667,189,6,32,160,247,344,183,312
2018,39,86,"Meydan",41.0015,39.7178,23.4714285714286,19.9428571428571,4.14471428571429,76.2857142857143,17.8014285714286,26.536,180,5,13,89,191,353,175,340
2018,40,86,"Meydan",41.0015,39.7178,22.7,19.8857142857143,4.25414285714286,73.1285714285714,14.2128571428571,21.5571428571429,191,11,48,78,157,341,180,293
2018,41,86,"Meydan",41.0015,39.7178,12.4571428571429,20.5,3.87228571428571,81.9714285714286,22.688,34.1871428571429,187,0,0,161,311,422,187,422
2018,42,86,"Meydan",41.0015,39.7178,15.0571428571429,20.7285714285714,0.0318571428571429,79.7428571428571,40.2185714285714,31.4171428571429,168,16,31,66,105,381,152,350
2018,43,86,"Meydan",41.0015,39.7178,25.3142857142857,16.7142857142857,5.23157142857143,75.1,18.2514285714286,31.2171428571429,187,9,65,83,197,402,178,337
2018,44,86,"Meydan",41.0015,39.7178,13.0428571428571,16.6142857142857,0,74.4,46.5783333333333,52,196,0,0,120,129,264,196,264
2018,45,86,"Meydan",41.0015,39.7178,16.1,15.9714285714286,0.605285714285714,72.5285714285714,23.0371428571429,40.0642857142857,231,0,0,73,101,473,231,473
2018,46,86,"Meydan",41.0015,39.7178,23.3,11.8857142857143,6.84885714285714,71.1857142857143,7.81571428571429,35.8914285714286,230,0,0,160,325,465,230,465
2018,47,86,"Meydan",41.0015,39.7178,20.1,13.1714285714286,1.28471428571429,76.3428571428571,45.2828571428571,44.4171428571429,270,0,0,111,125,499,270,499
2018,48,86,"Meydan",41.0015,39.7178,28.2142857142857,15.1142857142857,3.78928571428571,71.1142857142857,37.82,42.3914285714286,245,31,45,122,82,201,214,156
2018,49,86,"Meydan",41.0015,39.7178,21.3857142857143,11.2571428571429,0.458571428571429,75.5714285714286,56.7316666666667,53.565,257,3,1,138,284,420,254,419
2018,50,86,"Meydan",41.0015,39.7178,25.0142857142857,11.6428571428571,5.93585714285714,63.7857142857143,68.12,64.4671428571429,256,8,15,105,92,305,248,290
2018,51,86,"Meydan",41.0015,39.7178,18.2142857142857,11.8285714285714,0.0854285714285714,73.7857142857143,82.4871428571429,56.5042857142857,250,0,0,68,93,248,250,248
2018,52,86,"Meydan",41.0015,39.7178,27.6714285714286,7.75714285714286,3.60814285714286,69.1428571428571,24.4675,51.75,244,0,0,191,174,273,244,273
2019,1,86,"Meydan",41.0015,39.7178,21.9875,10.3125,3.231,72.4,NA,53.795,343,14,39,120,172,784,329,745
2019,2,86,"Meydan",41.0015,39.7178,30.6428571428571,8.61428571428571,0.657714285714286,65.3285714285714,NA,53.86,255,1,0,137,125,208,254,208
2019,3,86,"Meydan",41.0015,39.7178,23.1857142857143,8.25714285714286,1.38657142857143,62.3285714285714,54.3233333333333,45.398,192,4,6,55,42,198,188,192
2019,4,86,"Meydan",41.0015,39.7178,25.3857142857143,12.3428571428571,0.0644285714285714,53.7428571428571,84.892,78.16,308,4,16,132,71,314,304,298
2019,5,86,"Meydan",41.0015,39.7178,24.1857142857143,11.0428571428571,0.390857142857143,65.8142857142857,70.8657142857143,67.6,253,92,72,90,54,143,161,71
2019,6,86,"Meydan",41.0015,39.7178,13.8571428571429,9.41428571428571,0.836142857142857,79.8142857142857,70.2528571428571,64.2414285714286,276,39,36,58,51,127,237,91
2019,7,86,"Meydan",41.0015,39.7178,22.0571428571429,8.4,0.108,75.2142857142857,41.3785714285714,46.0028571428571,325,92,129,112,67,234,233,105
2019,8,86,"Meydan",41.0015,39.7178,23.0142857142857,8.41428571428571,0.0338571428571429,75,48.9933333333333,50.7485714285714,305,30,16,149,142,219,275,203
2019,9,86,"Meydan",41.0015,39.7178,21.8,7.18571428571429,1.33557142857143,73.9571428571429,36.07,38.685,331,0,0,94,80,310,331,310
2019,10,86,"Meydan",41.0015,39.7178,22.4857142857143,10.1142857142857,0.282428571428571,63.2142857142857,54.1114285714286,67.432,359,119,90,153,92,252,240,162
2019,11,86,"Meydan",41.0015,39.7178,25.4428571428571,11.4,1.89114285714286,75.0714285714286,43.2728571428571,63.5457142857143,373,39,27,177,296,400,334,373
2019,12,86,"Meydan",41.0015,39.7178,19.3571428571429,8.01428571428571,0.614714285714286,72.8142857142857,43.0928571428571,64.5571428571428,343,5,257,214,104,416,338,159
2019,13,86,"Meydan",41.0015,39.7178,15.4142857142857,7.18571428571429,0.239,72.8142857142857,38.7771428571429,58.91,256,42,61,93,93,194,214,133
2019,14,86,"Meydan",41.0015,39.7178,14.7285714285714,9.3,1.27614285714286,84.8714285714286,35.0685714285714,58.5342857142857,365,290,180,22,12,208,75,28
2019,15,86,"Meydan",41.0015,39.7178,18.5,15.0714285714286,0.321714285714286,69,45.6142857142857,60.3385714285714,359,178,99,55,15,183,181,84
2019,16,86,"Meydan",41.0015,39.7178,20.9285714285714,10.1428571428571,6.248,84.5285714285714,21.8971428571429,47.5914285714286,318,76,73,131,72,208,242,135
2019,17,86,"Meydan",41.0015,39.7178,16.6857142857143,11.4142857142857,0.174857142857143,79.3714285714286,39.8757142857143,50.2357142857143,412,311,197,10,6,313,101,116
2019,18,86,"Meydan",41.0015,39.7178,20.9571428571429,16.7142857142857,3.15271428571429,74.1285714285714,38.2442857142857,49.71,523,380,171,0,0,353,143,182
2019,19,86,"Meydan",41.0015,39.7178,20.8428571428571,16.8571428571429,0.358714285714286,77.5142857142857,37.55,51.665,452,122,100,205,210,386,330,286
2019,20,86,"Meydan",41.0015,39.7178,19.0285714285714,17.9571428571429,0.00385714285714286,81.0571428571429,NA,36.99,454,407,335,0,0,389,47,54
2019,21,86,"Meydan",41.0015,39.7178,21.7142857142857,19.7285714285714,0.302428571428571,80.9857142857143,NA,26.395,457,247,282,138,99,413,210,131
2019,22,86,"Meydan",41.0015,39.7178,14.7142857142857,20.3,0.00657142857142857,76.4285714285714,12.64,43.238,453,383,251,3,3,323,70,72
2019,23,86,"Meydan",41.0015,39.7178,16.7142857142857,23.2142857142857,0.134428571428571,85.3,9.75142857142857,28.9066666666667,378,64,66,10,17,532,314,466
2019,24,86,"Meydan",41.0015,39.7178,15.0142857142857,24.3285714285714,0.192857142857143,80.4428571428571,22.36,26.2914285714286,378,51,39,111,83,244,327,205
2019,25,86,"Meydan",41.0015,39.7178,18.9428571428571,25.0428571428571,14.2222857142857,76.0285714285714,18.0685714285714,25.0714285714286,306,0,0,267,293,325,306,325
2019,26,86,"Meydan",41.0015,39.7178,23.1714285714286,24.7857142857143,2.495,74,22.5528571428571,24.0125,377,0,0,224,146,342,377,342
2019,27,86,"Meydan",41.0015,39.7178,19.4285714285714,23.3,2.73885714285714,69.0285714285714,19.6871428571429,24.0657142857143,456,2,1,213,81,222,454,221
2019,28,86,"Meydan",41.0015,39.7178,23.0428571428571,23.8571428571429,1.80142857142857,71.3428571428571,18.346,29.028,398,7,5,179,204,421,391,416
2019,29,86,"Meydan",41.0015,39.7178,18.2857142857143,23.8428571428571,2.27242857142857,72.6428571428571,17.1357142857143,36.7157142857143,453,56,20,264,119,203,397,183
2019,30,86,"Meydan",41.0015,39.7178,16.4857142857143,23.9,0.425571428571429,74.7857142857143,10.0342857142857,42.4414285714286,456,98,76,199,166,335,358,259
2019,31,86,"Meydan",41.0015,39.7178,18.7142857142857,25.2285714285714,5.698,76.3857142857143,9.36833333333333,40.132,334,84,94,92,81,375,250,281
2019,32,86,"Meydan",41.0015,39.7178,19.8571428571429,23.2285714285714,2.07871428571429,68.6142857142857,7.42285714285714,49.2571428571429,346,0,0,281,328,395,346,395
2019,33,86,"Meydan",41.0015,39.7178,17.8142857142857,24.9285714285714,0.173142857142857,73.9,9.82428571428571,43.8033333333333,337,39,58,128,231,531,298,473
2019,34,86,"Meydan",41.0015,39.7178,20.1714285714286,24.6428571428571,0.731571428571428,77.7428571428571,9.17,36.0816666666667,299,0,0,164,199,345,299,345
2019,35,86,"Meydan",41.0015,39.7178,17.6714285714286,24.6571428571429,3.31428571428571,78.6428571428571,9.915,32.895,307,37,63,220,315,415,270,352
2019,36,86,"Meydan",41.0015,39.7178,19.2714285714286,23.7,0.191571428571429,70.3142857142857,NA,NA,171,0,0,169,45,67,171,67
2019,37,86,"Meydan",41.0015,39.7178,13.8857142857143,22.7142857142857,0.881571428571429,72.5571428571429,NA,44.5125,218,0,0,217,55,55,218,55
2019,38,86,"Meydan",41.0015,39.7178,22.6142857142857,20.5857142857143,2.27828571428571,72.4428571428572,NA,37.9833333333333,266,5,0,150,74,91,261,91
2019,39,86,"Meydan",41.0015,39.7178,17.6857142857143,20.2571428571429,2.47485714285714,73.9571428571429,NA,35.3283333333333,237,17,22,61,9,79,220,57
2019,40,86,"Meydan",41.0015,39.7178,19.9714285714286,21.0857142857143,2.13057142857143,73.2,NA,58.24,241,12,40,94,33,111,229,71
2019,41,86,"Meydan",41.0015,39.7178,21.9,18.7571428571429,0.71,76.5571428571428,NA,44.235,416,55,86,202,238,448,361,362
2019,42,86,"Meydan",41.0015,39.7178,10.7428571428571,19.1,1.00457142857143,81,NA,52.71,356,39,25,44,68,408,317,383
2019,43,86,"Meydan",41.0015,39.7178,15.1285714285714,18.3571428571429,11.2795714285714,82.3571428571429,NA,58.7985714285714,306,0,0,306,300,300,306,300
2019,44,86,"Meydan",41.0015,39.7178,20.3142857142857,15.3571428571429,13.3698571428571,76.1285714285714,NA,52.0183333333333,350,0,0,221,183,250,350,250
2019,45,86,"Meydan",41.0015,39.7178,13.8,16.7142857142857,0,60.2,NA,74.71,417,22,22,36,20,328,395,306
2019,46,86,"Meydan",41.0015,39.7178,13.1714285714286,16.3571428571429,0,66.7,NA,88.04,401,6,1,0,0,337,395,336
2019,47,86,"Meydan",41.0015,39.7178,15.2142857142857,13.8714285714286,0,68.3714285714286,NA,68.8685714285714,391,0,0,163,144,339,391,339
2019,48,86,"Meydan",41.0015,39.7178,22.1428571428571,15.3714285714286,3.53357142857143,63.8571428571429,NA,78.19,320,0,0,158,157,251,320,251
2019,49,86,"Meydan",41.0015,39.7178,17.4571428571429,8.85714285714286,6.02385714285714,69.8285714285714,NA,61.5371428571429,393,0,0,271,175,274,393,274
2019,50,86,"Meydan",41.0015,39.7178,16.7285714285714,12.9142857142857,0.000142857142857143,59.0142857142857,NA,84.5571428571428,218,8,1,47,22,119,210,118
2019,51,86,"Meydan",41.0015,39.7178,14.6571428571429,11.6857142857143,0.442428571428571,63.6,NA,93.3471428571429,361,11,16,156,115,488,350,472
2019,52,86,"Meydan",41.0015,39.7178,22.4714285714286,15.0571428571429,0.00571428571428571,50.4142857142857,NA,66.2685714285714,279,23,19,98,73,281,256,262
2020,1,86,"Meydan",41.0015,39.7178,17.36,8.48,9.714,76.86,NA,54.892,160,0,0,92,102,126,160,126
2020,2,86,"Meydan",41.0015,39.7178,24.0428571428571,9.41428571428571,1.09214285714286,69.0857142857143,NA,63.3514285714286,240,0,0,123,98,173,240,173
2020,3,86,"Meydan",41.0015,39.7178,19.7714285714286,7.77142857142857,1.71257142857143,70.4,NA,67.8785714285714,270,0,0,179,239,382,270,382
2020,4,86,"Meydan",41.0015,39.7178,22.4857142857143,6.7,2.24528571428571,63.7857142857143,NA,69.9042857142857,358,0,0,183,121,295,358,295
2020,5,86,"Meydan",41.0015,39.7178,20.8714285714286,9.85714285714286,1.05171428571429,63.6857142857143,NA,81.156,331,4,2,66,44,272,327,270
2020,6,86,"Meydan",41.0015,39.7178,34.8714285714286,9.77142857142857,9.64657142857143,64.7714285714286,NA,70.9814285714286,343,0,0,271,189,267,343,267
2020,7,86,"Meydan",41.0015,39.7178,25.0428571428571,5.25714285714286,1.18028571428571,62.8571428571429,NA,74.7642857142857,341,10,1,171,194,338,331,337
2020,8,86,"Meydan",41.0015,39.7178,17.1142857142857,7.95714285714286,0.528857142857143,79.5,NA,45.7557142857143,283,42,80,91,38,187,241,107
2020,9,86,"Meydan",41.0015,39.7178,29.5142857142857,9.95714285714286,0.905571428571429,68.2142857142857,NA,35.1542857142857,393,42,35,130,167,528,351,493
2020,10,86,"Meydan",41.0015,39.7178,21.8714285714286,12.6571428571429,0,60.6714285714286,NA,37.6457142857143,205,113,102,19,21,210,92,108
2020,11,86,"Meydan",41.0015,39.7178,23.4571428571429,13.7571428571429,1.38485714285714,74.6285714285714,NA,29.0928571428571,115,21,11,34,55,94,94,83
2020,12,86,"Meydan",41.0015,39.7178,15.1,6.71428571428571,4.25785714285714,79.5,NA,33.4542857142857,117,24,27,56,69,118,93,91
2020,13,86,"Meydan",41.0015,39.7178,13.4857142857143,9.91428571428571,1.46628571428571,87.7857142857143,31.3942857142857,41.5028571428571,136,24,25,78,35,92,112,67
2020,14,86,"Meydan",41.0015,39.7178,18.7142857142857,10.6571428571429,3.06271428571429,83.9714285714286,47.6257142857143,47.8314285714286,155,38,36,64,59,121,117,85
2020,15,86,"Meydan",41.0015,39.7178,15.2857142857143,10.2714285714286,0.120285714285714,78.5857142857143,39.3671428571429,36.6271428571429,133,41,18,45,86,118,92,100
2020,16,86,"Meydan",41.0015,39.7178,23.4285714285714,11.7428571428571,0.448428571428571,74.6571428571429,35.5528571428571,36.5085714285714,141,55,26,28,36,106,86,80
2020,17,86,"Meydan",41.0015,39.7178,19.3,10.9285714285714,3.41685714285714,76.6857142857143,33.9528571428571,54.61,137,37,28,66,80,123,100,95
2020,18,86,"Meydan",41.0015,39.7178,18.7,14.1571428571429,0.685428571428571,84.2571428571429,29.4042857142857,NA,146,61,93,26,18,164,85,71
2020,19,86,"Meydan",41.0015,39.7178,19.9857142857143,14.3142857142857,4.65185714285714,80.4571428571429,24.1257142857143,NA,137,17,33,72,42,157,120,124
2020,20,86,"Meydan",41.0015,39.7178,21.1142857142857,18.1714285714286,0.000142857142857143,70.5714285714286,47.605,27.55,164,111,109,40,55,164,53,55
2020,21,86,"Meydan",41.0015,39.7178,26.1857142857143,17.2285714285714,2.65671428571429,75.3714285714286,38.7371428571429,29.71,146,73,45,45,27,96,73,51
2020,22,86,"Meydan",41.0015,39.7178,19.5,15.9142857142857,1.46314285714286,79.6285714285714,20.8771428571429,28.5983333333333,118,70,49,35,37,100,48,51
2020,23,86,"Meydan",41.0015,39.7178,17.5857142857143,19.3,1.19414285714286,79.2,28.9342857142857,34.8142857142857,112,60,37,2,0,70,52,33
2020,24,86,"Meydan",41.0015,39.7178,18.2285714285714,22.1,0.393,78.1285714285714,38.8171428571429,39.2471428571429,140,36,55,9,12,150,104,95
2020,25,86,"Meydan",41.0015,39.7178,18.1714285714286,23.2571428571429,1.11014285714286,75.0714285714286,26.76,29.0414285714286,137,54,33,35,36,108,83,75
2020,26,86,"Meydan",41.0015,39.7178,18.1571428571429,23.8571428571429,0.444714285714286,75.7571428571429,27.9171428571429,26.38,173,54,43,43,48,133,119,90
2020,27,86,"Meydan",41.0015,39.7178,16.3428571428571,25.2285714285714,0.00942857142857143,74.6142857142857,28.8971428571429,26.44,113,8,33,49,48,113,105,80
2020,28,86,"Meydan",41.0015,39.7178,23.2714285714286,25.6571428571429,1.29185714285714,73.3142857142857,26.9266666666667,25.7742857142857,164,0,0,107,55,122,164,122
2020,29,86,"Meydan",41.0015,39.7178,17.9285714285714,25.0428571428571,0.709857142857143,76.2142857142857,25.3828571428571,26.3157142857143,186,78,66,51,32,111,108,45
2020,30,86,"Meydan",41.0015,39.7178,20.3142857142857,25.4428571428571,0.108571428571429,71.3714285714286,30.4371428571429,27.0428571428571,190,36,25,62,62,142,154,117
2020,31,86,"Meydan",41.0015,39.7178,18.6857142857143,25.2857142857143,0.765142857142857,74.2714285714286,28.1442857142857,32.4875,150,1,0,98,92,127,149,127
2020,32,86,"Meydan",41.0015,39.7178,14.2714285714286,25.3714285714286,0.0778571428571429,69.0428571428571,20.9514285714286,21.2283333333333,146,62,29,44,63,107,84,78
2020,33,86,"Meydan",41.0015,39.7178,25.5571428571429,24.8857142857143,0.829714285714286,67.1142857142857,31.3085714285714,24.8242857142857,183,0,0,159,60,83,183,83
2020,34,86,"Meydan",41.0015,39.7178,20.3714285714286,23.8571428571429,4.09514285714286,71.0571428571429,32.5628571428571,28.9171428571429,197,21,13,166,78,97,176,84
2020,35,86,"Meydan",41.0015,39.7178,16.8571428571429,24.4,0,71.2428571428571,30.5014285714286,21.8485714285714,164,10,27,72,94,157,154,130
2020,36,86,"Meydan",41.0015,39.7178,17.2142857142857,24.9,0.613571428571429,79.9,32.5257142857143,26.9457142857143,179,40,26,67,42,112,139,86
2020,37,86,"Meydan",41.0015,39.7178,17.2142857142857,24.7428571428571,0.355142857142857,75.0857142857143,26.2185714285714,23.2314285714286,193,32,21,105,49,91,161,70
2020,38,86,"Meydan",41.0015,39.7178,18.4571428571429,24.1285714285714,3.66257142857143,76.3285714285714,33.6142857142857,31.1283333333333,235,12,9,95,62,157,223,148
2020,39,86,"Meydan",41.0015,39.7178,15.6,23.5,0.0345714285714286,74.0857142857143,27.4171428571429,33.204,220,25,14,106,69,129,195,115
2020,40,86,"Meydan",41.0015,39.7178,20.8,22.7857142857143,4.50014285714286,77.7714285714286,37.1571428571429,38.0985714285714,187,9,15,141,109,154,178,139
2020,41,86,"Meydan",41.0015,39.7178,17.1142857142857,21.8285714285714,0.0427142857142857,69.2428571428571,34.3271428571429,38.1185714285714,182,38,26,21,11,127,144,101
2020,42,86,"Meydan",41.0015,39.7178,14.7714285714286,21.5,0.00114285714285714,76.1,59.3814285714286,41.5385714285714,177,45,26,18,12,111,132,85
2020,43,86,"Meydan",41.0015,39.7178,17.9142857142857,18.6285714285714,2.79042857142857,77.2714285714286,37.6314285714286,37.0914285714286,194,11,1,62,42,161,183,160
2020,44,86,"Meydan",41.0015,39.7178,19.5285714285714,19.8571428571429,0.169285714285714,76.1285714285714,68.6114285714286,47.8228571428571,255,23,32,50,50,233,232,201
2020,45,86,"Meydan",41.0015,39.7178,19.4714285714286,15.9,14.5668571428571,82.6857142857143,34.3585714285714,40.1071428571429,156,0,0,73,46,103,156,103
2020,46,86,"Meydan",41.0015,39.7178,21.4142857142857,14.6142857142857,2.10314285714286,67.9142857142857,49.3242857142857,40.2028571428571,208,0,0,138,58,109,208,109
2020,47,86,"Meydan",41.0015,39.7178,22.6857142857143,12.1142857142857,10.827,76.2142857142857,40.3885714285714,45.1485714285714,173,0,0,145,62,83,173,83
2020,48,86,"Meydan",41.0015,39.7178,18.2,10.7571428571429,1.32442857142857,65.4142857142857,62.9442857142857,45.9871428571429,199,0,0,75,65,262,199,262
2020,49,86,"Meydan",41.0015,39.7178,17.4428571428571,12.3571428571429,1.40885714285714,74.5142857142857,103.301428571429,59.5828571428571,207,0,0,66,27,116,207,116
2020,50,86,"Meydan",41.0015,39.7178,24.2428571428571,14.0714285714286,0.438142857142857,56.4428571428571,84.0914285714286,57.0442857142857,181,0,0,17,6,98,181,98
2020,51,86,"Meydan",41.0015,39.7178,24.6142857142857,13,0.486857142857143,67.9428571428572,57.7371428571429,42.8028571428571,171,0,0,64,32,90,171,90
2020,52,86,"Meydan",41.0015,39.7178,23.4714285714286,9.57142857142857,3.22214285714286,64.6285714285714,58.3628571428571,46.2142857142857,203,2,0,102,65,113,201,113
2020,53,86,"Meydan",41.0015,39.7178,10.25,12.175,0,50.8,152.515,79.9225,122,10,3,13,1,111,112,108
2017,1,87,"Tunceli",39.1061,39.5475,14.6857142857143,-0.3,3.24057142857143,77.1142857142857,21.6628571428571,NA,563,58,118,147,226,847,505,729
2017,2,87,"Tunceli",39.1061,39.5475,16.9857142857143,-1.28571428571429,2.62685714285714,73.4714285714286,23.7028571428571,NA,757,27,34,380,669,1214,730,1180
2017,3,87,"Tunceli",39.1061,39.5475,11.6571428571429,-1.01428571428571,0,64.4857142857143,19.4285714285714,NA,762,0,0,570,1178,1449,762,1449
2017,4,87,"Tunceli",39.1061,39.5475,14.1,-3.12857142857143,6.74314285714286,71.5571428571428,10.4,NA,639,0,0,454,699,889,639,889
2017,5,87,"Tunceli",39.1061,39.5475,13.6285714285714,-5.38571428571429,0.485571428571429,67.5142857142857,20.61,NA,588,0,0,349,880,1163,588,1163
2017,6,87,"Tunceli",39.1061,39.5475,9.32857142857143,0.271428571428571,0,75.0428571428571,28.7485714285714,NA,736,0,0,647,1308,1519,736,1519
2017,7,87,"Tunceli",39.1061,39.5475,12.2857142857143,-2.92857142857143,0,51.6571428571429,16.38,NA,492,0,0,386,575,717,492,717
2017,8,87,"Tunceli",39.1061,39.5475,7.48571428571429,1.94285714285714,1.26614285714286,62.1,19.8757142857143,NA,739,0,0,703,1690,1747,739,1747
2017,9,87,"Tunceli",39.1061,39.5475,6.17142857142857,6.48571428571429,2.54242857142857,69.7428571428571,24.7414285714286,NA,574,59,93,305,490,866,515,773
2017,10,87,"Tunceli",39.1061,39.5475,11.8428571428571,8.17142857142857,2.04157142857143,60.6857142857143,17.88,NA,712,272,491,126,154,1043,440,552
2017,11,87,"Tunceli",39.1061,39.5475,12.9142857142857,5.17142857142857,7.06185714285714,71.9571428571429,8.9075,NA,525,100,80,282,466,725,425,645
2017,12,87,"Tunceli",39.1061,39.5475,10.7571428571429,6.12857142857143,0.571142857142857,56.1142857142857,NA,NA,589,18,23,341,655,1077,571,1054
2017,13,87,"Tunceli",39.1061,39.5475,12.3571428571429,10,4.81842857142857,57.7142857142857,12.03,NA,574,61,87,400,685,887,513,800
2017,14,87,"Tunceli",39.1061,39.5475,13.1,8.41428571428571,4.50871428571429,62.9285714285714,11.1285714285714,NA,639,0,0,456,944,1336,639,1336
2017,15,87,"Tunceli",39.1061,39.5475,13.1142857142857,9.64285714285714,5.74114285714286,63.3714285714286,11.2042857142857,NA,587,0,0,402,992,1187,587,1187
2017,16,87,"Tunceli",39.1061,39.5475,14.9857142857143,13.6428571428571,2.228,61.7714285714286,28.6642857142857,NA,717,103,141,185,161,920,614,779
2017,17,87,"Tunceli",39.1061,39.5475,16.2285714285714,13.8,0,39.7,14.3128571428571,NA,731,0,0,633,1182,1478,731,1478
2017,18,87,"Tunceli",39.1061,39.5475,12.7714285714286,14.7857142857143,4.99042857142857,67.7857142857143,16.5385714285714,NA,506,3,1,310,544,923,503,922
2017,19,87,"Tunceli",39.1061,39.5475,11.5142857142857,17.3285714285714,0.464428571428571,56.0142857142857,23.32,NA,471,0,0,452,951,966,471,966
2017,20,87,"Tunceli",39.1061,39.5475,17.3142857142857,16.5,5.38342857142857,59.4714285714286,15.0028571428571,NA,472,0,0,401,1118,1205,472,1205
2017,21,87,"Tunceli",39.1061,39.5475,11.5714285714286,14.7714285714286,7.625,67.1714285714286,11.3114285714286,NA,448,9,27,339,660,849,439,822
2017,22,87,"Tunceli",39.1061,39.5475,11.4285714285714,18.4571428571429,0.428857142857143,51.7428571428571,15.9428571428571,NA,522,0,0,480,925,1015,522,1015
2017,23,87,"Tunceli",39.1061,39.5475,13.6714285714286,23.2,0.0285714285714286,43.5285714285714,21.4414285714286,NA,578,0,0,516,1177,1388,578,1388
2017,24,87,"Tunceli",39.1061,39.5475,15.4142857142857,21,0.143,44.3857142857143,16.7785714285714,NA,552,0,0,525,1075,1139,552,1139
2017,25,87,"Tunceli",39.1061,39.5475,13.4571428571429,22.0714285714286,0.000142857142857143,42.1,18.88,NA,584,0,0,522,959,1041,584,1041
2017,26,87,"Tunceli",39.1061,39.5475,15.8571428571429,27.4571428571429,0,32.3285714285714,23.9628571428571,NA,564,0,0,351,635,971,564,971
2017,27,87,"Tunceli",39.1061,39.5475,18.0285714285714,27.2285714285714,0,34.5142857142857,26.4442857142857,NA,511,0,0,476,610,642,511,642
2017,28,87,"Tunceli",39.1061,39.5475,17.7714285714286,27.2428571428571,0,28.8428571428571,24.1485714285714,NA,481,0,0,478,858,864,481,864
2017,29,87,"Tunceli",39.1061,39.5475,15,28.6714285714286,0,28.3285714285714,31.4214285714286,NA,532,0,0,448,1096,1272,532,1272
2017,30,87,"Tunceli",39.1061,39.5475,14.2142857142857,27.5714285714286,0,31.3,33.4042857142857,NA,531,0,0,518,913,928,531,928
2017,31,87,"Tunceli",39.1061,39.5475,10.1428571428571,28.4,0,25.8285714285714,36.5385714285714,NA,559,0,0,540,901,1047,559,1047
2017,32,87,"Tunceli",39.1061,39.5475,10.3714285714286,28.5428571428571,0,24.3,38.4657142857143,NA,567,0,0,559,1038,1092,567,1092
2017,33,87,"Tunceli",39.1061,39.5475,11.4142857142857,26.9571428571429,0.862714285714286,34.2857142857143,34.16,NA,596,0,0,542,1075,1199,596,1199
2017,34,87,"Tunceli",39.1061,39.5475,13.6428571428571,27.1571428571429,0,31.8428571428571,32.6014285714286,NA,601,0,0,598,1278,1280,601,1280
2017,35,87,"Tunceli",39.1061,39.5475,13.0428571428571,25.4428571428571,0,30.4,34.1442857142857,NA,493,0,0,449,923,1014,493,1014
2017,36,87,"Tunceli",39.1061,39.5475,12.5571428571429,23.6142857142857,0.000142857142857143,27.6857142857143,31.716,NA,507,0,0,467,1198,1321,507,1321
2017,37,87,"Tunceli",39.1061,39.5475,11.9428571428571,24.5142857142857,0,24.2285714285714,36.6585714285714,NA,589,0,0,504,785,1138,589,1138
2017,38,87,"Tunceli",39.1061,39.5475,11.2285714285714,23.3285714285714,0,29.6571428571429,42.5971428571429,NA,671,0,0,616,1060,1312,671,1312
2017,39,87,"Tunceli",39.1061,39.5475,14.0714285714286,19.7857142857143,0.456857142857143,41.6571428571429,36.4666666666667,NA,782,0,0,622,1124,1630,782,1630
2017,40,87,"Tunceli",39.1061,39.5475,15.0714285714286,14.4428571428571,0.000571428571428571,43.2428571428571,NA,NA,543,1,0,389,800,1137,542,1137
2017,41,87,"Tunceli",39.1061,39.5475,14.3571428571429,13.3285714285714,1.71357142857143,60.7142857142857,NA,NA,487,0,0,267,452,843,487,843
2017,42,87,"Tunceli",39.1061,39.5475,17.6142857142857,12.2571428571429,0,44.3571428571429,NA,NA,530,0,0,487,758,815,530,815
2017,43,87,"Tunceli",39.1061,39.5475,11.8857142857143,13.1857142857143,1.21342857142857,52.6857142857143,26.5233333333333,NA,506,64,167,195,256,919,442,752
2017,44,87,"Tunceli",39.1061,39.5475,12.8285714285714,8.61428571428571,4.59714285714286,64.5571428571429,15.7457142857143,NA,561,67,72,451,854,1102,494,1030
2017,45,87,"Tunceli",39.1061,39.5475,11.3142857142857,8.87142857142857,0.742714285714286,75.7,54.1014285714286,NA,577,89,103,423,473,829,488,726
2017,46,87,"Tunceli",39.1061,39.5475,9.7,7.94285714285714,0.713714285714286,62.9,35.5542857142857,NA,587,0,0,408,802,1085,587,1085
2017,47,87,"Tunceli",39.1061,39.5475,16.1714285714286,3.25714285714286,4.12614285714286,75.0142857142857,15.09,NA,418,74,108,277,552,804,344,696
2017,48,87,"Tunceli",39.1061,39.5475,16.9714285714286,2.55714285714286,7.96585714285714,81.4142857142857,23.766,NA,386,11,34,225,386,619,375,585
2017,49,87,"Tunceli",39.1061,39.5475,15.6428571428571,1.55714285714286,0.856714285714286,75.2428571428571,52.9333333333333,NA,407,0,0,324,451,645,407,645
2017,50,87,"Tunceli",39.1061,39.5475,10.1,0.228571428571429,0.142714285714286,82.6285714285714,52.1675,NA,346,0,0,299,350,442,346,442
2017,51,87,"Tunceli",39.1061,39.5475,18.7142857142857,5.05714285714286,5.59671428571429,85.4428571428571,57.19,NA,386,47,50,50,82,349,339,299
2017,52,87,"Tunceli",39.1061,39.5475,14.4875,4,1.936625,72.9625,30.7942857142857,NA,528,50,51,301,257,507,478,456
2018,1,87,"Tunceli",39.1061,39.5475,16.025,3.0375,2.436,81.2375,23.3242857142857,NA,618,212,284,259,430,914,406,630
2018,2,87,"Tunceli",39.1061,39.5475,17.0142857142857,1.94285714285714,0.770857142857143,73.1,29.7685714285714,NA,624,0,0,267,810,1309,624,1309
2018,3,87,"Tunceli",39.1061,39.5475,23.8857142857143,1.74285714285714,13.4354285714286,83.5142857142857,23.505,NA,639,141,70,291,383,655,498,585
2018,4,87,"Tunceli",39.1061,39.5475,18.7571428571429,3.41428571428571,6.73914285714286,80.5571428571429,23.75,NA,604,257,292,16,60,764,347,472
2018,5,87,"Tunceli",39.1061,39.5475,20.4,1.55714285714286,0,64.8285714285714,18.5028571428571,NA,670,0,0,455,468,819,670,819
2018,6,87,"Tunceli",39.1061,39.5475,20.8,5.31428571428571,0,61.7285714285714,30.1257142857143,NA,704,0,0,215,344,1022,704,1022
2018,7,87,"Tunceli",39.1061,39.5475,14.4714285714286,6.55714285714286,3.15742857142857,70.6285714285714,18.7785714285714,NA,478,50,50,159,192,557,428,507
2018,8,87,"Tunceli",39.1061,39.5475,13.4714285714286,5.5,3.02657142857143,74.7428571428571,NA,NA,711,0,0,595,1164,1321,711,1321
2018,9,87,"Tunceli",39.1061,39.5475,18.6142857142857,5.05714285714286,4.38271428571429,77.1428571428571,17.0325,NA,621,146,227,177,303,956,475,729
2018,10,87,"Tunceli",39.1061,39.5475,15.0428571428571,8.37142857142857,3.47071428571429,69.9428571428572,21.23,NA,556,0,0,515,1245,1330,556,1330
2018,11,87,"Tunceli",39.1061,39.5475,17.5857142857143,10.1714285714286,0.172,59.1714285714286,24.244,NA,551,1,0,382,882,1426,550,1426
2018,12,87,"Tunceli",39.1061,39.5475,20.1285714285714,13.7714285714286,0.0428571428571429,47.0714285714286,47.1228571428571,NA,425,5,201,160,377,1187,420,986
2018,13,87,"Tunceli",39.1061,39.5475,21.2571428571429,12.3428571428571,3.37,56.1,27.8866666666667,NA,356,38,68,141,134,428,318,360
2018,14,87,"Tunceli",39.1061,39.5475,17.6714285714286,12.2285714285714,0.000714285714285714,42.9714285714286,22.03,NA,407,0,0,353,376,486,407,486
2018,15,87,"Tunceli",39.1061,39.5475,19.6,14.9428571428571,0.657285714285714,50.7285714285714,18.6366666666667,NA,374,0,0,307,385,450,374,450
2018,16,87,"Tunceli",39.1061,39.5475,20.6,13.9571428571429,0.0142857142857143,37.1428571428571,13.0216666666667,NA,411,0,0,345,493,648,411,648
2018,17,87,"Tunceli",39.1061,39.5475,16.9,16.5857142857143,0.0858571428571429,45.1571428571429,16.8171428571429,NA,419,76,82,274,470,652,343,570
2018,18,87,"Tunceli",39.1061,39.5475,16.1571428571429,16.0428571428571,4.18385714285714,68.9428571428572,10.595,NA,303,138,277,116,135,474,165,197
2018,19,87,"Tunceli",39.1061,39.5475,13.0714285714286,13.6285714285714,6.19914285714286,80.4285714285714,10.095,NA,275,20,115,135,151,467,255,352
2018,20,87,"Tunceli",39.1061,39.5475,18.8,17.6714285714286,4.32942857142857,64.9285714285714,8.85714285714286,NA,204,0,0,161,253,306,204,306
2018,21,87,"Tunceli",39.1061,39.5475,15.6571428571429,19.2857142857143,1.64457142857143,61.8,15.3328571428571,NA,252,10,44,176,154,281,242,237
2018,22,87,"Tunceli",39.1061,39.5475,22.5714285714286,17.8428571428571,4.85485714285714,68.4428571428572,12.4914285714286,NA,249,0,0,172,274,427,249,427
2018,23,87,"Tunceli",39.1061,39.5475,16.1285714285714,20.8285714285714,0.115142857142857,53.9714285714286,10.2633333333333,NA,267,1,8,183,406,812,266,804
2018,24,87,"Tunceli",39.1061,39.5475,16.0714285714286,21.7428571428571,1.46714285714286,56.3571428571429,13.8142857142857,NA,267,6,12,177,201,448,261,436
2018,25,87,"Tunceli",39.1061,39.5475,17.7428571428571,22.8142857142857,0.671857142857143,50.4857142857143,9.52833333333333,NA,358,0,0,288,363,518,358,518
2018,26,87,"Tunceli",39.1061,39.5475,13.6714285714286,26.9285714285714,0.0285714285714286,37.4857142857143,18.2316666666667,NA,355,0,0,316,465,587,355,587
2018,27,87,"Tunceli",39.1061,39.5475,22.6857142857143,27.7142857142857,0.000285714285714286,35.9,18.5614285714286,NA,342,0,0,320,343,418,342,418
2018,28,87,"Tunceli",39.1061,39.5475,19.4571428571429,27.8285714285714,1.25942857142857,37.3142857142857,17.87,NA,286,0,0,197,354,585,286,585
2018,29,87,"Tunceli",39.1061,39.5475,22.6142857142857,25.9142857142857,0.000142857142857143,37.0571428571429,10.9542857142857,NA,260,0,0,246,738,756,260,756
2018,30,87,"Tunceli",39.1061,39.5475,15.0142857142857,27.1571428571429,0,31.4285714285714,20.9728571428571,NA,265,0,0,247,777,822,265,822
2018,31,87,"Tunceli",39.1061,39.5475,18.3428571428571,28.2428571428571,0,36.5571428571429,16.6714285714286,NA,267,0,0,219,409,499,267,499
2018,32,87,"Tunceli",39.1061,39.5475,22.1714285714286,27.1285714285714,0.0715714285714286,34.7714285714286,13.19,NA,297,0,0,273,351,403,297,403
2018,33,87,"Tunceli",39.1061,39.5475,21.4285714285714,26.8714285714286,0,28.6857142857143,12.5671428571429,NA,216,0,0,197,317,332,216,332
2018,34,87,"Tunceli",39.1061,39.5475,17.3285714285714,27.3285714285714,0,32.1428571428571,13.7242857142857,NA,144,0,0,121,170,227,144,227
2018,35,87,"Tunceli",39.1061,39.5475,17.8142857142857,26.7714285714286,0,29.6571428571429,19.9942857142857,NA,201,0,0,145,156,314,201,314
2018,36,87,"Tunceli",39.1061,39.5475,20.3285714285714,23.9,1.36257142857143,40.5,23.72,NA,341,0,0,276,233,370,341,370
2018,37,87,"Tunceli",39.1061,39.5475,21.0142857142857,21.0285714285714,0.236285714285714,47.8285714285714,22.0825,NA,241,3,0,196,275,419,238,419
2018,38,87,"Tunceli",39.1061,39.5475,17.2714285714286,21.9857142857143,0,34.9857142857143,18.7971428571429,NA,189,0,0,173,297,344,189,344
2018,39,87,"Tunceli",39.1061,39.5475,14.5571428571429,20.9428571428571,0,33.7285714285714,23.4614285714286,NA,180,0,0,121,108,353,180,353
2018,40,87,"Tunceli",39.1061,39.5475,16.8428571428571,19.1857142857143,0,37.9428571428571,19.3571428571429,NA,191,25,46,64,120,341,166,295
2018,41,87,"Tunceli",39.1061,39.5475,14.8,17.6142857142857,1.17085714285714,58.3714285714286,31.37,NA,187,0,0,132,282,422,187,422
2018,42,87,"Tunceli",39.1061,39.5475,13.0285714285714,17.1142857142857,1.65642857142857,58.5571428571429,67.4771428571429,NA,168,0,0,137,331,381,168,381
2018,43,87,"Tunceli",39.1061,39.5475,15.8571428571429,11.8142857142857,10.0235714285714,77.6,7.16,NA,187,18,92,78,150,402,169,310
2018,44,87,"Tunceli",39.1061,39.5475,12.2857142857143,11.1714285714286,0,62.4285714285714,17.75,NA,196,0,0,187,251,264,196,264
2018,45,87,"Tunceli",39.1061,39.5475,11.0714285714286,9.44285714285714,0.0574285714285714,70.2142857142857,21.0666666666667,NA,231,1,0,142,211,473,230,473
2018,46,87,"Tunceli",39.1061,39.5475,14.4857142857143,5.38571428571429,4.71342857142857,74.3,15.4,NA,230,0,0,165,345,465,230,465
2018,47,87,"Tunceli",39.1061,39.5475,12.3857142857143,6.35714285714286,1.52785714285714,82.1,26.6383333333333,NA,270,0,0,186,428,499,270,499
2018,48,87,"Tunceli",39.1061,39.5475,16.8714285714286,6.87142857142857,8.46785714285714,87.0285714285714,20.305,NA,245,84,70,56,64,201,161,131
2018,49,87,"Tunceli",39.1061,39.5475,13.6428571428571,5.7,3.02728571428571,84.3857142857143,16.3366666666667,NA,257,0,0,118,196,420,257,420
2018,50,87,"Tunceli",39.1061,39.5475,19.8714285714286,4.2,9.295,82.5,14.2,NA,256,1,1,116,98,305,255,304
2018,51,87,"Tunceli",39.1061,39.5475,13.5714285714286,3.87142857142857,4.72714285714286,88.0857142857143,NA,NA,250,31,55,96,89,248,219,193
2018,52,87,"Tunceli",39.1061,39.5475,17.6714285714286,0.171428571428572,15.5801428571429,84.5142857142857,NA,NA,244,15,23,72,94,273,229,250
2019,1,87,"Tunceli",39.1061,39.5475,18.0875,1.9,8.981375,87.8,40.01,NA,343,96,293,46,70,784,247,491
2019,2,87,"Tunceli",39.1061,39.5475,13.7714285714286,-3.45714285714286,6.09214285714286,80.7285714285714,NA,NA,255,39,26,74,55,208,216,182
2019,3,87,"Tunceli",39.1061,39.5475,21.7285714285714,-1.91428571428571,6.996,79.9857142857143,NA,NA,192,15,17,128,127,198,177,181
2019,4,87,"Tunceli",39.1061,39.5475,13.1285714285714,0.728571428571428,0.656714285714286,78.9142857142857,NA,NA,308,47,63,158,151,314,261,251
2019,5,87,"Tunceli",39.1061,39.5475,13.6285714285714,2.3,4.511,76.4142857142857,NA,NA,253,41,18,124,102,143,212,125
2019,6,87,"Tunceli",39.1061,39.5475,16.8142857142857,1.38571428571429,5.75385714285714,80.2142857142857,NA,NA,276,58,24,62,52,127,218,103
2019,7,87,"Tunceli",39.1061,39.5475,13.4714285714286,2.5,2.14157142857143,74.9857142857143,NA,NA,325,29,8,126,153,234,296,226
2019,8,87,"Tunceli",39.1061,39.5475,17.2285714285714,3.25714285714286,0.328285714285714,64.6714285714286,NA,NA,305,0,0,193,166,219,305,219
2019,9,87,"Tunceli",39.1061,39.5475,13.9285714285714,2.75714285714286,2.071,71.5142857142857,16.2566666666667,NA,331,0,0,229,174,310,331,310
2019,10,87,"Tunceli",39.1061,39.5475,14.8428571428571,5.55714285714286,0.214285714285714,59.3142857142857,14.2942857142857,NA,359,0,0,269,225,252,359,252
2019,11,87,"Tunceli",39.1061,39.5475,18.9714285714286,6.45714285714286,10.6524285714286,73.9142857142857,14.46,NA,373,127,210,74,85,400,246,190
2019,12,87,"Tunceli",39.1061,39.5475,20.7571428571429,6.32857142857143,1.05657142857143,50.5714285714286,10.2057142857143,NA,343,0,0,296,394,416,343,416
2019,13,87,"Tunceli",39.1061,39.5475,12.6714285714286,5.97142857142857,9.89557142857143,82.3714285714286,9.04,NA,256,21,2,119,73,194,235,192
2019,14,87,"Tunceli",39.1061,39.5475,12.3714285714286,8.84285714285714,1.37185714285714,74.0142857142857,9.17,NA,365,99,70,177,96,208,266,138
2019,15,87,"Tunceli",39.1061,39.5475,17.5857142857143,11.3571428571429,3.57114285714286,66.2,NA,NA,359,44,15,221,111,183,315,168
2019,16,87,"Tunceli",39.1061,39.5475,16.2,8.32857142857143,10.7251428571429,77.5285714285714,NA,NA,318,13,37,93,47,208,305,171
2019,17,87,"Tunceli",39.1061,39.5475,15.0714285714286,10.7428571428571,1.71328571428571,56.2285714285714,NA,NA,412,0,0,395,250,313,412,313
2019,18,87,"Tunceli",39.1061,39.5475,12.3285714285714,13.1142857142857,7.39757142857143,75.1142857142857,NA,NA,523,73,32,362,293,353,450,321
2019,19,87,"Tunceli",39.1061,39.5475,15.9285714285714,15.1,2.91628571428571,62.5,NA,NA,452,209,182,95,33,386,243,204
2019,20,87,"Tunceli",39.1061,39.5475,13.7428571428571,19.0857142857143,0,51.9285714285714,NA,NA,454,0,0,386,312,389,454,389
2019,21,87,"Tunceli",39.1061,39.5475,13.8285714285714,20.3428571428571,0.043,48.5571428571429,NA,NA,457,0,0,441,390,413,457,413
2019,22,87,"Tunceli",39.1061,39.5475,13,22.4428571428571,0,42.3,NA,NA,453,0,0,428,279,323,453,323
2019,23,87,"Tunceli",39.1061,39.5475,9.84285714285714,24.1428571428571,0,39.4714285714286,NA,NA,378,0,0,314,466,532,378,532
2019,24,87,"Tunceli",39.1061,39.5475,15.4857142857143,23.0142857142857,2.17042857142857,47.2,NA,NA,378,1,1,260,172,244,377,243
2019,25,87,"Tunceli",39.1061,39.5475,13.5857142857143,22.8571428571429,0.722142857142857,55.0428571428571,NA,NA,306,0,0,250,292,325,306,325
2019,26,87,"Tunceli",39.1061,39.5475,19.0857142857143,26.3428571428571,0.000142857142857143,40.9714285714286,NA,NA,377,0,0,365,316,342,377,342
2019,27,87,"Tunceli",39.1061,39.5475,16.1285714285714,24.4714285714286,0,35.6428571428571,NA,NA,456,49,27,342,103,222,407,195
2019,28,87,"Tunceli",39.1061,39.5475,19.3285714285714,24.8571428571429,1.854,40,NA,NA,398,0,0,338,336,421,398,421
2019,29,87,"Tunceli",39.1061,39.5475,17.3571428571429,25.4285714285714,0,39.7142857142857,NA,NA,453,0,0,387,183,203,453,203
2019,30,87,"Tunceli",39.1061,39.5475,19.4714285714286,26.8,0,37.1285714285714,NA,NA,456,0,0,437,324,335,456,335
2019,31,87,"Tunceli",39.1061,39.5475,18.3714285714286,27.7428571428571,0,31.4857142857143,NA,NA,334,0,0,299,346,375,334,375
2019,32,87,"Tunceli",39.1061,39.5475,17.3857142857143,26.5714285714286,0,32.6857142857143,43.5225,NA,346,48,78,148,123,395,298,317
2019,33,87,"Tunceli",39.1061,39.5475,12.1571428571429,27.9714285714286,0,32.5571428571429,47.2542857142857,NA,337,0,0,327,514,531,337,531
2019,34,87,"Tunceli",39.1061,39.5475,14.2857142857143,26.1857142857143,0,39.1571428571429,45.0085714285714,NA,299,0,0,273,326,345,299,345
2019,35,87,"Tunceli",39.1061,39.5475,12.7285714285714,24.6142857142857,1.02828571428571,44.4428571428571,32.2242857142857,NA,307,0,0,209,295,415,307,415
2019,36,87,"Tunceli",39.1061,39.5475,15.9285714285714,23.3571428571429,0,35.1714285714286,30.1342857142857,NA,171,0,0,144,28,67,171,67
2019,37,87,"Tunceli",39.1061,39.5475,13.0714285714286,22.2714285714286,0.0857142857142857,37.8857142857143,30.62,NA,218,0,0,183,35,55,218,55
2019,38,87,"Tunceli",39.1061,39.5475,14.3285714285714,20.0285714285714,0.371285714285714,42.9714285714286,37.34,NA,266,0,0,239,81,91,266,91
2019,39,87,"Tunceli",39.1061,39.5475,12,19.0571428571429,0,38.2142857142857,39.5033333333333,NA,237,0,0,215,61,79,237,79
2019,40,87,"Tunceli",39.1061,39.5475,12.0857142857143,18.8428571428571,0,37.7857142857143,45.1185714285714,NA,241,0,0,231,96,111,241,111
2019,41,87,"Tunceli",39.1061,39.5475,11.8857142857143,18.7142857142857,0,41.8714285714286,44.5314285714286,NA,416,0,0,367,405,448,416,448
2019,42,87,"Tunceli",39.1061,39.5475,8.98571428571429,16.2,0.899571428571429,49.7428571428571,38.6571428571429,NA,356,0,0,283,340,408,356,408
2019,43,87,"Tunceli",39.1061,39.5475,9,13.4857142857143,3.46971428571429,71.6285714285714,31.0757142857143,NA,306,0,0,265,234,300,306,300
2019,44,87,"Tunceli",39.1061,39.5475,11.5,9.87142857142857,2.456,73.5,34.8814285714286,NA,350,0,0,270,156,250,350,250
2019,45,87,"Tunceli",39.1061,39.5475,7.71428571428571,7.78571428571429,0,62.9428571428571,66.9685714285714,NA,417,0,0,351,193,328,417,328
2019,46,87,"Tunceli",39.1061,39.5475,8.57142857142857,7.38571428571429,0,51.6285714285714,81.5828571428572,NA,401,0,0,365,306,337,401,337
2019,47,87,"Tunceli",39.1061,39.5475,8.28571428571429,4.01428571428571,0,51.7857142857143,88.1228571428571,NA,391,0,0,380,326,339,391,339
2019,48,87,"Tunceli",39.1061,39.5475,15.7428571428571,5.85714285714286,6.382,75.6428571428571,63.0071428571429,NA,320,101,63,137,78,251,219,188
2019,49,87,"Tunceli",39.1061,39.5475,12.7571428571429,3.25714285714286,4.17114285714286,79.9714285714286,39.9414285714286,NA,393,0,0,229,161,274,393,274
2019,50,87,"Tunceli",39.1061,39.5475,11.4142857142857,4.02857142857143,5.13971428571429,85.5571428571429,39.9871428571429,NA,218,48,11,93,60,119,170,108
2019,51,87,"Tunceli",39.1061,39.5475,8.41428571428571,2.38571428571429,0,83.8,78.92,NA,361,0,0,289,396,488,361,488
2019,52,87,"Tunceli",39.1061,39.5475,24.5857142857143,4.55714285714286,11.5637142857143,77.5,53.9657142857143,NA,279,177,191,70,73,281,102,90
2020,1,87,"Tunceli",39.1061,39.5475,13.26,1.8,4.797,88.98,41.372,NA,160,28,22,49,27,126,132,104
2020,2,87,"Tunceli",39.1061,39.5475,19.4571428571429,1.58571428571429,3.91014285714286,76.9,42.8928571428571,NA,240,32,37,90,69,173,208,136
2020,3,87,"Tunceli",39.1061,39.5475,17.6,-0.771428571428571,0,59.8285714285714,34.0642857142857,NA,270,0,0,157,201,382,270,382
2020,4,87,"Tunceli",39.1061,39.5475,15.8857142857143,-0.742857142857143,1.11371428571429,61.9714285714286,44.4085714285714,NA,358,0,0,287,242,295,358,295
2020,5,87,"Tunceli",39.1061,39.5475,18.0857142857143,1.15714285714286,5.08357142857143,70.5428571428571,47.5828571428571,NA,331,0,0,258,222,272,331,272
2020,6,87,"Tunceli",39.1061,39.5475,24.8285714285714,1.42857142857143,7.167,76.5142857142857,50.7871428571429,NA,343,196,152,69,42,267,147,115
2020,7,87,"Tunceli",39.1061,39.5475,11.4142857142857,-5.5,1.71514285714286,69.6714285714286,43.9271428571429,NA,341,38,88,218,197,338,303,250
2020,8,87,"Tunceli",39.1061,39.5475,12.2142857142857,2.8,2.09585714285714,80.8857142857143,46.9557142857143,NA,283,0,0,201,146,187,283,187
2020,9,87,"Tunceli",39.1061,39.5475,14.8428571428571,4.97142857142857,2.41385714285714,66.8,37.8971428571429,NA,393,0,0,281,334,528,393,528
2020,10,87,"Tunceli",39.1061,39.5475,15.4571428571429,8.37142857142857,0.0285714285714286,52.7142857142857,39.9814285714286,NA,205,0,0,175,182,210,205,210
2020,11,87,"Tunceli",39.1061,39.5475,18.1571428571429,11.5,2.727,61.0428571428571,43.5657142857143,NA,115,36,42,33,27,94,79,52
2020,12,87,"Tunceli",39.1061,39.5475,13.6285714285714,6.65714285714286,10.9532857142857,79.0142857142857,22.69,NA,117,11,14,28,18,118,106,104
2020,13,87,"Tunceli",39.1061,39.5475,13.9428571428571,8.55714285714286,5.89542857142857,75.2714285714286,28.5342857142857,NA,136,43,48,61,17,92,93,44
2020,14,87,"Tunceli",39.1061,39.5475,14.7285714285714,8.15714285714286,9.42714285714286,74.5428571428571,23.2214285714286,NA,155,26,22,93,67,121,129,99
2020,15,87,"Tunceli",39.1061,39.5475,16.5714285714286,11.2428571428571,0.716142857142857,54.6,27.15,NA,133,3,3,74,49,118,130,115
2020,16,87,"Tunceli",39.1061,39.5475,13.0571428571429,12.7857142857143,0.202571428571429,52.3571428571429,27.3157142857143,NA,141,0,0,95,73,106,141,106
2020,17,87,"Tunceli",39.1061,39.5475,17.5285714285714,13.0428571428571,1.07128571428571,60.7428571428571,27.445,NA,137,1,0,73,45,123,136,123
2020,18,87,"Tunceli",39.1061,39.5475,12.8,12.5285714285714,4.526,68.9142857142857,19.37,NA,146,1,0,78,72,164,145,164
2020,19,87,"Tunceli",39.1061,39.5475,11.6571428571429,13.6142857142857,4.94157142857143,74.5714285714286,33.6175,NA,137,0,0,13,8,157,137,157
2020,20,87,"Tunceli",39.1061,39.5475,6.91428571428571,18.9142857142857,0,51.0142857142857,NA,NA,164,34,27,0,0,164,130,137
2020,21,87,"Tunceli",39.1061,39.5475,9.8,19.8428571428571,1.44371428571429,44.3142857142857,NA,NA,146,2,0,23,22,96,144,96
2020,22,87,"Tunceli",39.1061,39.5475,8.31428571428571,17.2571428571429,3.85542857142857,58.5857142857143,23.92,NA,118,1,4,34,17,100,117,96
2020,23,87,"Tunceli",39.1061,39.5475,11.5428571428571,19.5571428571429,0.428285714285714,48.9,29.8533333333333,NA,112,0,0,52,17,70,112,70
2020,24,87,"Tunceli",39.1061,39.5475,11.9571428571429,22.4142857142857,0.114714285714286,43.1285714285714,NA,NA,140,8,6,12,7,150,132,144
2020,25,87,"Tunceli",39.1061,39.5475,11.3428571428571,22.0857142857143,0.000857142857142857,47.4142857142857,NA,NA,137,0,0,89,90,108,137,108
2020,26,87,"Tunceli",39.1061,39.5475,18.6,24.4,0,41.0285714285714,NA,NA,173,0,0,159,116,133,173,133
2020,27,87,"Tunceli",39.1061,39.5475,15.1142857142857,25.5714285714286,0,38.9714285714286,46.22,NA,113,17,9,69,69,113,96,104
2020,28,87,"Tunceli",39.1061,39.5475,15.9285714285714,26.6142857142857,0,39.6142857142857,23.85,NA,164,0,0,142,118,122,164,122
2020,29,87,"Tunceli",39.1061,39.5475,14.6285714285714,27.1428571428571,0.000142857142857143,33.3428571428571,NA,NA,186,0,0,173,95,111,186,111
2020,30,87,"Tunceli",39.1061,39.5475,16.7571428571429,28.8,0.0142857142857143,32,43.5566666666667,NA,190,0,0,108,65,142,190,142
2020,31,87,"Tunceli",39.1061,39.5475,17.2285714285714,27.8714285714286,0.0857142857142857,35.1571428571429,45.9366666666667,NA,150,8,0,86,51,127,142,127
2020,32,87,"Tunceli",39.1061,39.5475,16.1,27.6857142857143,0,28.2571428571429,28.455,NA,146,0,0,113,75,107,146,107
2020,33,87,"Tunceli",39.1061,39.5475,19.0428571428571,25.8857142857143,0,35.9571428571429,32.47,NA,183,0,0,128,63,83,183,83
2020,34,87,"Tunceli",39.1061,39.5475,21.7714285714286,25.0857142857143,0.0631428571428571,33.0142857142857,29.64,NA,197,0,0,173,65,97,197,97
2020,35,87,"Tunceli",39.1061,39.5475,12.7857142857143,24.4142857142857,0,28.7714285714286,NA,NA,164,0,0,137,86,157,164,157
2020,36,87,"Tunceli",39.1061,39.5475,11.9142857142857,26.0857142857143,0.0142857142857143,28.0285714285714,NA,NA,179,0,0,135,94,112,179,112
2020,37,87,"Tunceli",39.1061,39.5475,14.8571428571429,25.1714285714286,0,33.0428571428571,35.874,NA,193,26,6,137,61,91,167,85
2020,38,87,"Tunceli",39.1061,39.5475,11.2714285714286,24.0285714285714,0,29.2857142857143,47.3542857142857,NA,235,0,0,188,111,157,235,157
2020,39,87,"Tunceli",39.1061,39.5475,16.1285714285714,21.6285714285714,1,42.4714285714286,42.3271428571429,NA,220,0,0,172,91,129,220,129
2020,40,87,"Tunceli",39.1061,39.5475,11.2,20.4428571428571,0.0714285714285714,43.7571428571429,40.2871428571429,NA,187,0,0,112,85,154,187,154
2020,41,87,"Tunceli",39.1061,39.5475,6.91428571428571,17.0142857142857,0,36.3714285714286,33.7114285714286,NA,182,12,5,8,2,127,170,122
2020,42,87,"Tunceli",39.1061,39.5475,6.65714285714286,17.6,0,34.1428571428571,57.3428571428571,NA,177,4,1,15,13,111,173,110
2020,43,87,"Tunceli",39.1061,39.5475,8.31428571428571,15.8285714285714,0.086,45.4714285714286,51.0985714285714,NA,194,0,0,92,60,161,194,161
2020,44,87,"Tunceli",39.1061,39.5475,7.37142857142857,15.8571428571429,0.0428571428571429,39.3,77.6171428571429,NA,255,14,25,17,14,233,241,208
2020,45,87,"Tunceli",39.1061,39.5475,10.3571428571429,11.4857142857143,8.51085714285714,77.9285714285714,46.05,NA,156,23,19,55,27,103,133,84
2020,46,87,"Tunceli",39.1061,39.5475,7.22857142857143,8.91428571428571,0.000142857142857143,62.3571428571429,55.95,NA,208,29,12,17,1,109,179,97
2020,47,87,"Tunceli",39.1061,39.5475,10.4714285714286,5.08571428571429,5.13985714285714,74.3714285714286,NA,NA,173,1,0,60,14,83,172,83
2020,48,87,"Tunceli",39.1061,39.5475,9.77142857142857,4.32857142857143,0,61.3285714285714,63.3675,NA,199,6,16,68,39,262,193,246
2020,49,87,"Tunceli",39.1061,39.5475,9.05714285714286,3.9,3.84085714285714,80.5285714285714,62.8371428571429,NA,207,13,1,84,65,116,194,115
2020,50,87,"Tunceli",39.1061,39.5475,13.4714285714286,3.05714285714286,4.51171428571429,80.5857142857143,45,NA,181,0,0,67,53,98,181,98
2020,51,87,"Tunceli",39.1061,39.5475,11.1428571428571,4.42857142857143,3.042,83.0428571428571,48.6428571428571,NA,171,0,0,45,18,90,171,90
2020,52,87,"Tunceli",39.1061,39.5475,8.22857142857143,0.2,0.543142857142857,71.8,69.7014285714286,NA,203,0,0,96,64,113,203,113
2020,53,87,"Tunceli",39.1061,39.5475,9.1,1.375,0,69.675,120.6675,NA,122,0,0,52,18,111,122,111
2017,1,88,"Van",38.4942,43.3808,14.3285714285714,-3.42857142857143,0.0428571428571429,71,45.2957142857143,NA,563,264,390,41,45,847,299,457
2017,2,88,"Van",38.4942,43.3808,15.1428571428571,-4.55714285714286,1.14285714285714,70.3285714285714,47.5442857142857,NA,757,418,698,14,2,1214,339,516
2017,3,88,"Van",38.4942,43.3808,11.7142857142857,-3.6,0.0285714285714286,77.8428571428571,62.2685714285714,NA,762,628,1184,0,0,1449,134,265
2017,4,88,"Van",38.4942,43.3808,18.0142857142857,-3.81428571428571,2.1,72.9285714285714,34.6142857142857,NA,639,303,527,29,44,889,336,362
2017,5,88,"Van",38.4942,43.3808,21.7714285714286,-6.27142857142857,0.128571428571429,69.2857142857143,38.0557142857143,NA,588,405,766,0,0,1163,183,397
2017,6,88,"Van",38.4942,43.3808,12.7428571428571,-2.11428571428571,0.2,79.1285714285714,45.6728571428571,NA,736,622,1352,0,0,1519,114,167
2017,7,88,"Van",38.4942,43.3808,15.8714285714286,-7.72857142857143,2.54285714285714,74.0428571428571,35.4728571428571,NA,492,492,717,0,0,717,0,0
2017,8,88,"Van",38.4942,43.3808,11.4571428571429,-3.17142857142857,0.171428571428571,72.9714285714286,62.7314285714286,NA,739,488,1135,91,219,1747,251,612
2017,9,88,"Van",38.4942,43.3808,13,1.52857142857143,0,82.9571428571429,84.3614285714286,NA,574,118,228,200,229,866,456,638
2017,10,88,"Van",38.4942,43.3808,20.3857142857143,2.27142857142857,0.0428571428571429,69.8857142857143,52.305,NA,712,0,0,58,76,1043,712,1043
2017,11,88,"Van",38.4942,43.3808,25.4142857142857,2.1,3.21428571428571,78.6714285714286,30.6242857142857,NA,525,32,79,56,140,725,493,646
2017,12,88,"Van",38.4942,43.3808,22.8,1.91428571428571,1.35714285714286,70.2857142857143,30.0585714285714,NA,589,0,0,98,186,1077,589,1077
2017,13,88,"Van",38.4942,43.3808,19.5571428571429,5.84285714285714,2.04285714285714,71.4285714285714,24.4,NA,574,0,0,161,254,887,574,887
2017,14,88,"Van",38.4942,43.3808,24.0714285714286,5.31428571428571,3.47142857142857,65.1857142857143,28.0828571428571,NA,639,4,0,334,650,1336,635,1336
2017,15,88,"Van",38.4942,43.3808,25.4571428571429,6.82857142857143,1.1,72.3142857142857,22.7014285714286,NA,587,0,0,68,199,1187,587,1187
2017,16,88,"Van",38.4942,43.3808,24.6,10.4428571428571,1.04285714285714,60.1714285714286,25.1157142857143,NA,717,0,0,172,220,920,717,920
2017,17,88,"Van",38.4942,43.3808,23.3142857142857,9.81428571428571,0,56.7,21.9242857142857,NA,731,0,0,359,873,1478,731,1478
2017,18,88,"Van",38.4942,43.3808,29.6428571428571,11.2428571428571,2.68571428571429,66.3714285714286,17.7871428571429,NA,506,0,0,97,162,923,506,923
2017,19,88,"Van",38.4942,43.3808,30.2,14.3142857142857,0.485714285714286,58.9,33.1483333333333,NA,471,0,0,150,292,966,471,966
2017,20,88,"Van",38.4942,43.3808,26.7142857142857,12.8285714285714,6.05714285714286,66.8,27.3928571428571,NA,472,83,446,106,142,1205,389,759
2017,21,88,"Van",38.4942,43.3808,20.8571428571429,12.9714285714286,1.05714285714286,60.9571428571429,17.6728571428571,NA,448,0,0,138,244,849,448,849
2017,22,88,"Van",38.4942,43.3808,22.4857142857143,15.9,0,51.8857142857143,17.4785714285714,NA,522,32,16,75,204,1015,490,999
2017,23,88,"Van",38.4942,43.3808,23.0428571428571,19.1142857142857,0,51.2,22.6128571428571,NA,578,0,0,349,871,1388,578,1388
2017,24,88,"Van",38.4942,43.3808,21.7571428571429,18.6571428571429,0,47.1857142857143,26.4957142857143,NA,552,0,0,96,207,1139,552,1139
2017,25,88,"Van",38.4942,43.3808,23.3,18.3428571428571,0.0285714285714286,51.9142857142857,20.03,NA,584,0,0,239,411,1041,584,1041
2017,26,88,"Van",38.4942,43.3808,22.7571428571429,21.5428571428571,0,47.9285714285714,25.8942857142857,NA,564,74,96,270,512,971,490,875
2017,27,88,"Van",38.4942,43.3808,20.6,22.5857142857143,0,45.1142857142857,32.9471428571429,NA,511,0,0,511,642,642,511,642
2017,28,88,"Van",38.4942,43.3808,20.9428571428571,21.4428571428571,0.285714285714286,49.3,28.8314285714286,NA,481,54,195,180,337,864,427,669
2017,29,88,"Van",38.4942,43.3808,15.1,22.3857142857143,0,43.1857142857143,33.5842857142857,NA,532,0,0,398,969,1272,532,1272
2017,30,88,"Van",38.4942,43.3808,19,22.4142857142857,0,43.8714285714286,29.4442857142857,NA,531,0,0,180,332,928,531,928
2017,31,88,"Van",38.4942,43.3808,24.9,24.1857142857143,0,41.5571428571429,33.8142857142857,NA,559,56,86,83,227,1047,503,961
2017,32,88,"Van",38.4942,43.3808,21.4285714285714,23.8428571428571,0,38.3857142857143,32.8228571428571,NA,567,1,0,195,304,1092,566,1092
2017,33,88,"Van",38.4942,43.3808,18.4857142857143,21.9571428571429,0.214285714285714,49.2857142857143,46.0885714285714,NA,596,0,0,252,593,1199,596,1199
2017,34,88,"Van",38.4942,43.3808,15.6571428571429,21.4285714285714,0,42.9142857142857,47.9571428571429,NA,601,9,6,371,730,1280,592,1274
2017,35,88,"Van",38.4942,43.3808,18.4857142857143,21.9714285714286,0,36.1,46.7985714285714,NA,493,17,20,173,308,1014,476,994
2017,36,88,"Van",38.4942,43.3808,22.7571428571429,19.3285714285714,0,39.0714285714286,42.4514285714286,NA,507,0,0,347,1004,1321,507,1321
2017,37,88,"Van",38.4942,43.3808,15.0571428571429,18.6285714285714,0,45.7571428571429,55.0114285714286,NA,589,0,0,305,718,1138,589,1138
2017,38,88,"Van",38.4942,43.3808,18.0142857142857,19.6142857142857,0.0142857142857143,38.3857142857143,63.7914285714286,NA,671,68,139,280,466,1312,603,1173
2017,39,88,"Van",38.4942,43.3808,22.0142857142857,16.5142857142857,0,42.5142857142857,53.9457142857143,NA,782,163,381,143,353,1630,619,1249
2017,40,88,"Van",38.4942,43.3808,21.6714285714286,10.5142857142857,1.1,58.7571428571429,26.4928571428571,NA,543,350,745,84,178,1137,193,392
2017,41,88,"Van",38.4942,43.3808,18.2285714285714,12.0428571428571,0.2,51.8,39.0014285714286,NA,487,57,21,93,122,843,430,822
2017,42,88,"Van",38.4942,43.3808,23.0142857142857,8.17142857142857,0,50.4714285714286,39.1871428571429,NA,530,76,141,79,121,815,454,674
2017,43,88,"Van",38.4942,43.3808,19.0571428571429,10.7285714285714,1.31428571428571,53.8,63.4185714285714,NA,506,116,102,275,488,919,390,817
2017,44,88,"Van",38.4942,43.3808,22.2857142857143,8.42857142857143,1.47142857142857,66.1571428571429,54.8614285714286,NA,561,70,83,132,167,1102,491,1019
2017,45,88,"Van",38.4942,43.3808,23.6142857142857,8.91428571428571,1.3,73.2571428571429,41.1185714285714,NA,577,34,31,80,218,829,543,798
2017,46,88,"Van",38.4942,43.3808,10.6857142857143,4.94285714285714,0.0857142857142857,75.5142857142857,71.6871428571429,NA,587,389,704,0,0,1085,198,381
2017,47,88,"Van",38.4942,43.3808,26.4428571428571,1.81428571428571,2.55714285714286,64.8857142857143,23.0557142857143,NA,418,24,141,155,289,804,394,663
2017,48,88,"Van",38.4942,43.3808,13.3,1.92857142857143,0.128571428571429,72.8571428571429,46.7066666666667,NA,386,122,180,41,56,619,264,439
2017,49,88,"Van",38.4942,43.3808,19.6142857142857,0.0571428571428573,0.514285714285714,70.6714285714286,54.03,NA,407,138,326,78,54,645,269,319
2017,50,88,"Van",38.4942,43.3808,11.2,-0.685714285714286,0,77.8571428571429,90.73,NA,346,145,178,29,14,442,201,264
2017,51,88,"Van",38.4942,43.3808,22.7571428571429,5.54285714285714,1.41428571428571,71.4571428571429,55.7742857142857,NA,386,71,93,142,129,349,315,256
2017,52,88,"Van",38.4942,43.3808,14.6125,2,0.1125,77.8125,77.84125,NA,528,54,67,89,90,507,474,440
2018,1,88,"Van",38.4942,43.3808,17.35,0.675,0.6,79.5125,40.77625,NA,618,248,407,34,8,914,370,507
2018,2,88,"Van",38.4942,43.3808,13.8142857142857,-0.657142857142857,0,75.6428571428571,62.2085714285714,NA,624,475,1195,0,0,1309,149,114
2018,3,88,"Van",38.4942,43.3808,21.7714285714286,-0.0428571428571429,2.6,76.5857142857143,32.7671428571429,NA,639,164,314,63,26,655,475,341
2018,4,88,"Van",38.4942,43.3808,18.5285714285714,1.05714285714286,0.171428571428571,67.2285714285714,44.2371428571429,NA,604,173,187,157,133,764,431,577
2018,5,88,"Van",38.4942,43.3808,18.2857142857143,-1.54285714285714,0,65.4857142857143,48.7514285714286,NA,670,202,299,119,87,819,468,520
2018,6,88,"Van",38.4942,43.3808,14.8428571428571,1.22857142857143,0.0142857142857143,74.1857142857143,87.5928571428571,NA,704,115,232,238,392,1022,589,790
2018,7,88,"Van",38.4942,43.3808,16.6428571428571,3.04285714285714,1.62857142857143,78.1142857142857,47.5657142857143,NA,478,80,72,124,140,557,398,485
2018,8,88,"Van",38.4942,43.3808,16.6857142857143,2.17142857142857,0.357142857142857,77.3142857142857,35.4925,NA,711,102,209,114,330,1321,609,1112
2018,9,88,"Van",38.4942,43.3808,20.3285714285714,4.64285714285714,0.371428571428571,68.4714285714286,NA,NA,621,0,0,109,223,956,621,956
2018,10,88,"Van",38.4942,43.3808,25.9285714285714,6.4,0.657142857142857,65.7857142857143,NA,NA,556,0,0,272,649,1330,556,1330
2018,11,88,"Van",38.4942,43.3808,19.8714285714286,5.97142857142857,0.571428571428571,63.8428571428571,42.15,NA,551,65,412,192,382,1426,486,1014
2018,12,88,"Van",38.4942,43.3808,26.4428571428571,9.75714285714286,1,53.1285714285714,88.4057142857143,NA,425,0,0,281,972,1187,425,1187
2018,13,88,"Van",38.4942,43.3808,25.2,8.28571428571429,1.45714285714286,65.1857142857143,61.3328571428571,NA,356,0,0,62,105,428,356,428
2018,14,88,"Van",38.4942,43.3808,21.7142857142857,8.21428571428571,0,57.8571428571429,37.8814285714286,NA,407,0,0,202,275,486,407,486
2018,15,88,"Van",38.4942,43.3808,24.8857142857143,10.2857142857143,0.8,67.6714285714286,24.0114285714286,NA,374,0,0,115,263,450,374,450
2018,16,88,"Van",38.4942,43.3808,23.3571428571429,8.12857142857143,2.5,60.8714285714286,26.9085714285714,NA,411,15,2,105,223,648,396,646
2018,17,88,"Van",38.4942,43.3808,19.7714285714286,10.2428571428571,0.414285714285714,66.8571428571429,31.2828571428571,NA,419,1,4,255,488,652,418,648
2018,18,88,"Van",38.4942,43.3808,22.7714285714286,12.9142857142857,0.5,67.5571428571428,20.67,NA,303,1,0,89,240,474,302,474
2018,19,88,"Van",38.4942,43.3808,24.2857142857143,10.7428571428571,4.42857142857143,74.7857142857143,17.2157142857143,NA,275,0,0,20,124,467,275,467
2018,20,88,"Van",38.4942,43.3808,18.8285714285714,13.4285714285714,0.571428571428572,65.4285714285714,25.5385714285714,NA,204,15,13,76,107,306,189,293
2018,21,88,"Van",38.4942,43.3808,24.5857142857143,15.1857142857143,1.45714285714286,68.5571428571429,40.2528571428571,NA,252,4,10,73,81,281,248,271
2018,22,88,"Van",38.4942,43.3808,24.3428571428571,16.0714285714286,3.31428571428571,66,33.1828571428571,NA,249,0,0,39,131,427,249,427
2018,23,88,"Van",38.4942,43.3808,22.2285714285714,16.7857142857143,0.128571428571429,62.1428571428571,24.6742857142857,NA,267,0,0,106,299,812,267,812
2018,24,88,"Van",38.4942,43.3808,25.1714285714286,17.3285714285714,1.25714285714286,61.0714285714286,32.1185714285714,NA,267,42,28,96,204,448,225,420
2018,25,88,"Van",38.4942,43.3808,22.7428571428571,19.1714285714286,0,56.8857142857143,31.0785714285714,NA,358,0,0,99,207,518,358,518
2018,26,88,"Van",38.4942,43.3808,17.7142857142857,21.5857142857143,0,52.3,46.6028571428571,NA,355,0,0,157,265,587,355,587
2018,27,88,"Van",38.4942,43.3808,22.4714285714286,25.2857142857143,0,34.1428571428571,49.1971428571429,NA,342,29,62,104,140,418,313,356
2018,28,88,"Van",38.4942,43.3808,17.7571428571429,23.6714285714286,0,47.3142857142857,57.9628571428571,NA,286,0,0,215,453,585,286,585
2018,29,88,"Van",38.4942,43.3808,22.7714285714286,22.4,0,43.4142857142857,39.1671428571429,NA,260,0,0,5,13,756,260,756
2018,30,88,"Van",38.4942,43.3808,17.2428571428571,23.0142857142857,0,43.4428571428571,54.9385714285714,NA,265,0,0,29,87,822,265,822
2018,31,88,"Van",38.4942,43.3808,19,23.3142857142857,0.0285714285714286,48.4,47.6571428571429,NA,267,0,0,72,153,499,267,499
2018,32,88,"Van",38.4942,43.3808,23.3285714285714,22.3714285714286,0,48.2714285714286,42.6183333333333,NA,297,0,0,11,86,403,297,403
2018,33,88,"Van",38.4942,43.3808,20.3285714285714,22.0714285714286,0,48.3571428571429,40.7028571428571,NA,216,0,0,91,176,332,216,332
2018,34,88,"Van",38.4942,43.3808,19.3,22.0285714285714,0,49.8571428571429,42.9171428571429,NA,144,17,10,48,78,227,127,217
2018,35,88,"Van",38.4942,43.3808,19.3428571428571,21.3714285714286,0,47,49.0585714285714,NA,201,0,0,80,168,314,201,314
2018,36,88,"Van",38.4942,43.3808,23.0285714285714,20.6285714285714,0.114285714285714,44.0857142857143,49.9475,NA,341,0,0,90,134,370,341,370
2018,37,88,"Van",38.4942,43.3808,22.2714285714286,19.1428571428571,0,43.7428571428571,48.355,NA,241,0,0,83,75,419,241,419
2018,38,88,"Van",38.4942,43.3808,21.2285714285714,17.2714285714286,0.0571428571428571,50.3,34.3985714285714,NA,189,57,101,9,0,344,132,243
2018,39,88,"Van",38.4942,43.3808,18.7428571428571,15.6857142857143,0,47.5,37.3042857142857,NA,180,27,4,34,130,353,153,349
2018,40,88,"Van",38.4942,43.3808,19.6,16.0571428571429,0,47.6857142857143,31.3971428571429,NA,191,80,116,28,45,341,111,225
2018,41,88,"Van",38.4942,43.3808,24.8428571428571,13.6571428571429,1.21428571428571,64.3285714285714,46.3342857142857,NA,187,46,149,31,26,422,141,273
2018,42,88,"Van",38.4942,43.3808,16.6428571428571,12.0571428571429,0.185714285714286,65.8428571428571,69.2442857142857,NA,168,47,67,35,37,381,121,314
2018,43,88,"Van",38.4942,43.3808,27,9.75714285714286,9.07142857142857,70.3428571428571,32.18,NA,187,64,129,66,57,402,123,273
2018,44,88,"Van",38.4942,43.3808,16.7285714285714,7.6,0.0285714285714286,59.8857142857143,53.6914285714286,NA,196,96,198,0,0,264,100,66
2018,45,88,"Van",38.4942,43.3808,13.0428571428571,6.54285714285714,0.342857142857143,72.8857142857143,38.4057142857143,NA,231,125,210,42,94,473,106,263
2018,46,88,"Van",38.4942,43.3808,18.8285714285714,6.12857142857143,0.242857142857143,70.5,40.5842857142857,NA,230,69,210,42,67,465,161,255
2018,47,88,"Van",38.4942,43.3808,15.4,4.72857142857143,1.72857142857143,77.9428571428572,45.82,NA,270,205,409,45,39,499,65,90
2018,48,88,"Van",38.4942,43.3808,18.0285714285714,5.68571428571429,5.05714285714286,76.8571428571429,51.226,NA,245,56,66,17,3,201,189,135
2018,49,88,"Van",38.4942,43.3808,15.3571428571429,3.47142857142857,1.17142857142857,79.7285714285714,54.4042857142857,NA,257,84,216,0,0,420,173,204
2018,50,88,"Van",38.4942,43.3808,26.5,3.2,2.34285714285714,68.7,30.9957142857143,NA,256,46,59,92,98,305,210,246
2018,51,88,"Van",38.4942,43.3808,15.6142857142857,2.44285714285714,1.18571428571429,74.2285714285714,45.2271428571429,NA,250,29,36,0,0,248,221,212
2018,52,88,"Van",38.4942,43.3808,25.7142857142857,0.528571428571429,2.71428571428571,69.6142857142857,26.4942857142857,NA,244,55,115,17,1,273,189,158
2019,1,88,"Van",38.4942,43.3808,15.9625,-0.3625,2.9,65.3875,40.60625,NA,343,123,118,0,0,784,220,666
2019,2,88,"Van",38.4942,43.3808,23.3285714285714,-2.87142857142857,0.3,66.3857142857143,43.1228571428571,NA,255,71,37,78,43,208,184,171
2019,3,88,"Van",38.4942,43.3808,22.7428571428571,-1.15714285714286,14.4714285714286,67.2428571428571,47.232,NA,192,58,82,29,17,198,134,116
2019,4,88,"Van",38.4942,43.3808,16.9857142857143,-0.185714285714286,0.0571428571428571,69.4,NA,NA,308,144,110,106,35,314,164,204
2019,5,88,"Van",38.4942,43.3808,20.3428571428571,-0.442857142857143,2.14285714285714,79.5571428571429,43.3025,NA,253,96,53,30,36,143,157,90
2019,6,88,"Van",38.4942,43.3808,15.1,-1.35714285714286,1.07142857142857,79.0428571428571,75.9014285714286,NA,276,172,62,25,15,127,104,65
2019,7,88,"Van",38.4942,43.3808,17.9714285714286,-1.02857142857143,0.771428571428571,74.6142857142857,51.8657142857143,NA,325,145,52,0,0,234,180,182
2019,8,88,"Van",38.4942,43.3808,15.6142857142857,-0.928571428571428,0.0571428571428571,67.1714285714286,42.3714285714286,NA,305,76,34,94,56,219,229,185
2019,9,88,"Van",38.4942,43.3808,20.6714285714286,0.471428571428572,1.71428571428571,73.9571428571429,31.4828571428571,NA,331,0,0,111,67,310,331,310
2019,10,88,"Van",38.4942,43.3808,15.8714285714286,1.17142857142857,2.42857142857143,74.3142857142857,36.3828571428571,NA,359,99,54,8,64,252,260,198
2019,11,88,"Van",38.4942,43.3808,19.2571428571429,3.45714285714286,1.02857142857143,73.6714285714286,48.6728571428571,NA,373,0,0,13,139,400,373,400
2019,12,88,"Van",38.4942,43.3808,17.4142857142857,1.24285714285714,1.24285714285714,71.0571428571429,32.8342857142857,NA,343,40,23,107,61,416,303,393
2019,13,88,"Van",38.4942,43.3808,21.6714285714286,5.15714285714286,2.31428571428571,77.1571428571429,17.9085714285714,NA,256,32,16,30,34,194,224,178
2019,14,88,"Van",38.4942,43.3808,21.7571428571429,5.45714285714286,1.42857142857143,77.2857142857143,24.6171428571429,NA,365,1,0,53,42,208,364,208
2019,15,88,"Van",38.4942,43.3808,19.3142857142857,7.6,1.48571428571429,70.3571428571429,35.4085714285714,NA,359,0,0,114,71,183,359,183
2019,16,88,"Van",38.4942,43.3808,27.2571428571429,7.22857142857143,3.01428571428571,64.8428571428571,21.7685714285714,NA,318,0,0,182,75,208,318,208
2019,17,88,"Van",38.4942,43.3808,21.4857142857143,6.1,0.471428571428571,57.8428571428571,19.7014285714286,NA,412,0,0,29,48,313,412,313
2019,18,88,"Van",38.4942,43.3808,25.3714285714286,10.6714285714286,2.72857142857143,64.8,26.34,NA,523,0,0,157,82,353,523,353
2019,19,88,"Van",38.4942,43.3808,20.6285714285714,12.1714285714286,0.114285714285714,62.0142857142857,32.536,NA,452,0,0,125,105,386,452,386
2019,20,88,"Van",38.4942,43.3808,21.9857142857143,15.3,0.457142857142857,54.5,29.8442857142857,NA,454,0,0,132,118,389,454,389
2019,21,88,"Van",38.4942,43.3808,23.8142857142857,17.4714285714286,0.128571428571429,51.9571428571429,37.4871428571429,NA,457,0,0,194,83,413,457,413
2019,22,88,"Van",38.4942,43.3808,19.6,16.6857142857143,0,52.8428571428571,24.6942857142857,NA,453,0,0,30,21,323,453,323
2019,23,88,"Van",38.4942,43.3808,16.8571428571429,20.2428571428571,0,53.8,46.1428571428571,NA,378,0,0,62,47,532,378,532
2019,24,88,"Van",38.4942,43.3808,24.9285714285714,19.8142857142857,1.47142857142857,50.6571428571429,32.8933333333333,NA,378,80,71,9,25,244,298,173
2019,25,88,"Van",38.4942,43.3808,22.2142857142857,20.5,0.0142857142857143,51.3,34.1942857142857,NA,306,0,0,85,137,325,306,325
2019,26,88,"Van",38.4942,43.3808,20.6428571428571,22.2714285714286,0,48.3571428571429,40.36,NA,377,0,0,65,50,342,377,342
2019,27,88,"Van",38.4942,43.3808,24.0285714285714,20.3142857142857,0,45.1571428571429,33.8257142857143,NA,456,0,0,88,29,222,456,222
2019,28,88,"Van",38.4942,43.3808,21.4857142857143,21.8285714285714,0.114285714285714,45.3857142857143,35.1783333333333,NA,398,0,0,37,65,421,398,421
2019,29,88,"Van",38.4942,43.3808,18.7857142857143,21.8857142857143,0,45.8142857142857,52.0757142857143,NA,453,0,0,120,71,203,453,203
2019,30,88,"Van",38.4942,43.3808,19.3428571428571,23.2142857142857,0,43.5142857142857,48.1114285714286,NA,456,0,0,13,25,335,456,335
2019,31,88,"Van",38.4942,43.3808,17.4571428571429,22.9285714285714,0,40.6428571428571,46.6442857142857,NA,334,0,0,91,138,375,334,375
2019,32,88,"Van",38.4942,43.3808,20.3285714285714,22.5285714285714,0,46.9142857142857,47.9057142857143,NA,346,0,0,53,108,395,346,395
2019,33,88,"Van",38.4942,43.3808,19.8142857142857,23.7142857142857,0,48.1571428571429,46.066,NA,337,0,0,100,162,531,337,531
2019,34,88,"Van",38.4942,43.3808,16.6,22.8,0.0285714285714286,41.7714285714286,42.516,NA,299,38,31,101,103,345,261,314
2019,35,88,"Van",38.4942,43.3808,20.1285714285714,20.6857142857143,0.428571428571429,48.0571428571429,36.0042857142857,NA,307,24,7,24,53,415,283,408
2019,36,88,"Van",38.4942,43.3808,20.1142857142857,19.7428571428571,0,44.3857142857143,36.4585714285714,NA,171,28,24,4,3,67,143,43
2019,37,88,"Van",38.4942,43.3808,21.1857142857143,17.8428571428571,0.542857142857143,50.5571428571429,27.9628571428571,NA,218,181,32,27,17,55,37,23
2019,38,88,"Van",38.4942,43.3808,24.6,18.1857142857143,0.0285714285714286,45.9428571428571,37.4142857142857,NA,266,0,0,85,48,91,266,91
2019,39,88,"Van",38.4942,43.3808,17.1571428571429,16.1142857142857,0,45.1285714285714,43.1614285714286,NA,237,13,5,1,0,79,224,74
2019,40,88,"Van",38.4942,43.3808,17.2142857142857,15.1714285714286,0,48.0571428571429,46.9314285714286,NA,241,0,0,85,21,111,241,111
2019,41,88,"Van",38.4942,43.3808,18.2714285714286,15.4,0.0285714285714286,49.3,49.8485714285714,NA,416,89,55,97,96,448,327,393
2019,42,88,"Van",38.4942,43.3808,14.3285714285714,11.6428571428571,0.0714285714285714,50.8428571428571,40.8828571428571,NA,356,76,98,128,112,408,280,310
2019,43,88,"Van",38.4942,43.3808,19.6142857142857,10.7714285714286,0.714285714285714,64.9857142857143,27.5585714285714,NA,306,13,24,21,11,300,293,276
2019,44,88,"Van",38.4942,43.3808,20.1285714285714,8.05714285714286,2.1,69.6428571428571,32.6871428571429,NA,350,98,91,146,82,250,252,159
2019,45,88,"Van",38.4942,43.3808,11.4571428571429,5.24285714285714,0,69.0428571428571,68.12,NA,417,221,168,3,13,328,196,160
2019,46,88,"Van",38.4942,43.3808,12.4857142857143,4.35714285714286,0,56.8285714285714,61.3385714285714,NA,401,248,212,0,0,337,153,125
2019,47,88,"Van",38.4942,43.3808,13.0428571428571,2.27142857142857,0,48.5714285714286,64.66,NA,391,343,316,0,0,339,48,23
2019,48,88,"Van",38.4942,43.3808,17.4571428571429,5.3,2.24285714285714,68.3714285714286,44.1371428571429,NA,320,155,83,50,72,251,165,168
2019,49,88,"Van",38.4942,43.3808,16.1714285714286,3.35714285714286,3.45714285714286,75.6571428571429,38.1,NA,393,169,117,1,0,274,224,157
2019,50,88,"Van",38.4942,43.3808,13.7714285714286,2.45714285714286,3.08571428571429,77.3,39.8628571428571,NA,218,47,37,4,1,119,171,82
2019,51,88,"Van",38.4942,43.3808,12.7428571428571,0.971428571428571,0.0571428571428571,74.9571428571429,87.4771428571429,NA,361,114,159,59,14,488,247,329
2019,52,88,"Van",38.4942,43.3808,29.1571428571429,3.58571428571429,1.3,58.1428571428571,36.2857142857143,NA,279,1,1,66,81,281,278,280
2020,1,88,"Van",38.4942,43.3808,13,-0.72,1.96,75.58,34.666,NA,160,114,74,0,0,126,46,52
2020,2,88,"Van",38.4942,43.3808,13,-2.11428571428571,0.0428571428571429,70.9285714285714,43.0614285714286,NA,240,225,145,0,0,173,15,28
2020,3,88,"Van",38.4942,43.3808,13.8714285714286,-4.4,2.3,80.1142857142857,59.0428571428571,NA,270,144,243,0,0,382,126,139
2020,4,88,"Van",38.4942,43.3808,14.8428571428571,-5.04285714285714,1.57142857142857,77.1714285714286,41.8514285714286,NA,358,236,208,0,0,295,122,87
2020,5,88,"Van",38.4942,43.3808,22.2857142857143,-2.48571428571429,0.785714285714286,70.6714285714286,51.5742857142857,NA,331,65,50,86,55,272,266,222
2020,6,88,"Van",38.4942,43.3808,28.5571428571429,-0.885714285714286,3.88571428571429,73.7,25.3771428571429,NA,343,65,77,47,28,267,278,190
2020,7,88,"Van",38.4942,43.3808,18.5428571428571,-7.21428571428571,3.6,71.1428571428571,26.1316666666667,NA,341,127,98,0,0,338,214,240
2020,8,88,"Van",38.4942,43.3808,11.7142857142857,0.385714285714286,0.8,85.6142857142857,64.965,NA,283,0,0,119,62,187,283,187
2020,9,88,"Van",38.4942,43.3808,19.1,0,1.91428571428571,77.4428571428572,62.6528571428571,NA,393,120,159,165,248,528,273,369
2020,10,88,"Van",38.4942,43.3808,12.7428571428571,1.88571428571429,26.3714285714286,79.1428571428571,77.7285714285714,NA,205,37,25,66,92,210,168,185
2020,11,88,"Van",38.4942,43.3808,14.8428571428571,4.92857142857143,0.2,77.5857142857143,74.8571428571429,NA,115,0,0,14,6,94,115,94
2020,12,88,"Van",38.4942,43.3808,27.5,5.38571428571429,3.68571428571429,66.9571428571429,23.1171428571429,NA,117,0,0,18,25,118,117,118
2020,13,88,"Van",38.4942,43.3808,19.6,6.21428571428571,1.18571428571429,69.1571428571429,36.2528571428571,NA,136,0,0,27,27,92,136,92
2020,14,88,"Van",38.4942,43.3808,23.5142857142857,6.11428571428571,1.38571428571429,71.3,16.9757142857143,NA,155,0,0,26,22,121,155,121
2020,15,88,"Van",38.4942,43.3808,25.1,7.5,0.814285714285714,68.9428571428571,23.5414285714286,NA,133,19,6,29,16,118,114,112
2020,16,88,"Van",38.4942,43.3808,19.5571428571429,8.11428571428571,0.571428571428572,58.8571428571429,29.1642857142857,NA,141,0,0,17,25,106,141,106
2020,17,88,"Van",38.4942,43.3808,26.4857142857143,9.91428571428571,4.67142857142857,69.6428571428571,22.9671428571429,NA,137,13,5,82,80,123,124,118
2020,18,88,"Van",38.4942,43.3808,24.3428571428571,9.45714285714286,0.714285714285714,66.5571428571429,16.3171428571429,NA,146,0,0,17,19,164,146,164
2020,19,88,"Van",38.4942,43.3808,35.1857142857143,12.3285714285714,2.15714285714286,60.9714285714286,28.0414285714286,NA,137,0,0,30,19,157,137,157
2020,20,88,"Van",38.4942,43.3808,18.5285714285714,13.1428571428571,0.142857142857143,61.2142857142857,26.1014285714286,NA,164,0,0,36,63,164,164,164
2020,21,88,"Van",38.4942,43.3808,25.6714285714286,16.6714285714286,0.457142857142857,51.1,33.2314285714286,NA,146,0,0,76,65,96,146,96
2020,22,88,"Van",38.4942,43.3808,23.2571428571429,15.3857142857143,0.714285714285714,55,28.4714285714286,NA,118,0,0,48,66,100,118,100
2020,23,88,"Van",38.4942,43.3808,23.2571428571429,16.9285714285714,0,47.0285714285714,34.4214285714286,NA,112,0,0,31,10,70,112,70
2020,24,88,"Van",38.4942,43.3808,27.5714285714286,19.4,0.614285714285714,41.6285714285714,36.2414285714286,NA,140,0,0,66,79,150,140,150
2020,25,88,"Van",38.4942,43.3808,26.2428571428571,18.4285714285714,0.457142857142857,52.7285714285714,34.175,NA,137,0,0,46,53,108,137,108
2020,26,88,"Van",38.4942,43.3808,19.5571428571429,19.6714285714286,0,52.3285714285714,25.802,NA,173,0,0,59,54,133,173,133
2020,27,88,"Van",38.4942,43.3808,27.0714285714286,19.5714285714286,2.84285714285714,58.5571428571429,26.6571428571429,NA,113,24,7,27,20,113,89,106
2020,28,88,"Van",38.4942,43.3808,23.8142857142857,21.7714285714286,0.471428571428571,50.5285714285714,28.9757142857143,NA,164,21,22,36,23,122,143,100
2020,29,88,"Van",38.4942,43.3808,23.2714285714286,21.9428571428571,0.0857142857142857,52.4714285714286,33.9757142857143,NA,186,0,0,131,74,111,186,111
2020,30,88,"Van",38.4942,43.3808,15.6142857142857,23.9142857142857,0.0142857142857143,47.9285714285714,46.6166666666667,NA,190,0,0,77,107,142,190,142
2020,31,88,"Van",38.4942,43.3808,20.3428571428571,23.9285714285714,0.0714285714285714,44.8857142857143,42.3083333333333,NA,150,35,37,20,15,127,115,90
2020,32,88,"Van",38.4942,43.3808,21.7,22.1142857142857,0,43.3714285714286,27.1933333333333,NA,146,42,19,12,25,107,104,88
2020,33,88,"Van",38.4942,43.3808,20.3714285714286,21.7,0,51.7,40.8442857142857,NA,183,0,0,74,48,83,183,83
2020,34,88,"Van",38.4942,43.3808,22.2428571428571,19.9714285714286,1.57142857142857,51.8142857142857,39.4942857142857,NA,197,0,0,79,44,97,197,97
2020,35,88,"Van",38.4942,43.3808,16.1285714285714,18.6428571428571,0,51.2857142857143,27.2033333333333,NA,164,16,15,58,81,157,148,142
2020,36,88,"Van",38.4942,43.3808,19.3,20.9285714285714,0,46.4142857142857,45.1828571428571,NA,179,0,0,72,43,112,179,112
2020,37,88,"Van",38.4942,43.3808,16.9,20.1714285714286,0,45.7714285714286,49.0657142857143,NA,193,15,5,80,43,91,178,86
2020,38,88,"Van",38.4942,43.3808,15.1,18.8714285714286,0,45.4714285714286,55.7214285714286,NA,235,0,0,128,68,157,235,157
2020,39,88,"Van",38.4942,43.3808,18.0142857142857,18.0285714285714,0.0285714285714286,47.9857142857143,47.8028571428571,NA,220,18,22,36,14,129,202,107
2020,40,88,"Van",38.4942,43.3808,23.6,16.7857142857143,0.0285714285714286,45.5285714285714,38.3642857142857,NA,187,10,1,67,84,154,177,153
2020,41,88,"Van",38.4942,43.3808,19.6,11.9285714285714,0.314285714285714,53.6428571428571,31.8785714285714,NA,182,140,101,0,0,127,42,26
2020,42,88,"Van",38.4942,43.3808,13.2571428571429,11.8285714285714,0,52.9285714285714,50.8614285714286,NA,177,43,16,59,64,111,134,95
2020,43,88,"Van",38.4942,43.3808,13,10.9,0,54.7571428571429,56.6971428571429,NA,194,57,69,0,0,161,137,92
2020,44,88,"Van",38.4942,43.3808,14.5857142857143,12.1285714285714,0,46.9285714285714,78.19,NA,255,103,59,0,0,233,152,174
2020,45,88,"Van",38.4942,43.3808,27.3285714285714,10.6,0.285714285714286,59.2857142857143,33.6914285714286,NA,156,15,16,23,19,103,141,87
2020,46,88,"Van",38.4942,43.3808,14.2857142857143,5.95714285714286,0.0285714285714286,66.2571428571429,40.84,NA,208,94,65,31,4,109,114,44
2020,47,88,"Van",38.4942,43.3808,18.5857142857143,5,1.98571428571429,71.3285714285714,39.0914285714286,NA,173,115,60,0,0,83,58,23
2020,48,88,"Van",38.4942,43.3808,13,2.94285714285714,0.0571428571428571,70.2571428571429,38.02,NA,199,118,187,0,0,262,81,75
2020,49,88,"Van",38.4942,43.3808,14.8428571428571,3.01428571428571,0,67.7571428571429,39.7142857142857,NA,207,148,92,0,0,116,59,24
2020,50,88,"Van",38.4942,43.3808,12.2285714285714,2.74285714285714,2.17142857142857,72.6428571428571,41.8157142857143,NA,181,156,92,0,0,98,25,6
2020,51,88,"Van",38.4942,43.3808,19.3571428571429,3.47142857142857,0.7,73.8714285714286,37.0142857142857,NA,171,46,24,0,0,90,125,66
2020,52,88,"Van",38.4942,43.3808,18.2857142857143,-2.95714285714286,1.75714285714286,73.0714285714286,37.8285714285714,NA,203,78,35,0,0,113,125,78
2020,53,88,"Van",38.4942,43.3808,8.95,-2.975,0,76.375,74.285,NA,122,39,70,0,0,111,83,41
2017,1,89,"Yalova",40.65,29.2667,18.3,3.82857142857143,4.02471428571429,76.8571428571429,39.6314285714286,NA,563,285,394,52,93,847,278,453
2017,2,89,"Yalova",40.65,29.2667,18.5428571428571,4.84285714285714,4.94314285714286,75.0857142857143,49.0485714285714,NA,757,203,279,18,30,1214,554,935
2017,3,89,"Yalova",40.65,29.2667,15.4857142857143,5.34285714285714,4.22971428571429,86.7428571428571,66.4971428571429,NA,762,0,0,1,0,1449,762,1449
2017,4,89,"Yalova",40.65,29.2667,15.4857142857143,2.92857142857143,0.467,78.1857142857143,79.7014285714286,NA,639,0,0,144,162,889,639,889
2017,5,89,"Yalova",40.65,29.2667,13.7142857142857,5.72857142857143,0.0131428571428571,65.8857142857143,74.1683333333333,NA,588,105,140,0,0,1163,483,1023
2017,6,89,"Yalova",40.65,29.2667,17,7.9,0.376857142857143,75.4714285714286,60.1685714285714,NA,736,84,153,192,511,1519,652,1366
2017,7,89,"Yalova",40.65,29.2667,12.3714285714286,4.05714285714286,0.0651428571428571,73.4714285714286,79.3314285714286,NA,492,0,0,151,207,717,492,717
2017,8,89,"Yalova",40.65,29.2667,15.8,10.5142857142857,2.23271428571429,72.3428571428571,76.6328571428571,NA,739,0,0,176,475,1747,739,1747
2017,9,89,"Yalova",40.65,29.2667,9.52857142857143,8.61428571428571,0.0297142857142857,83.4142857142857,106,NA,574,86,154,383,614,866,488,712
2017,10,89,"Yalova",40.65,29.2667,14.0714285714286,10.9428571428571,1.07585714285714,76.4571428571429,75.0042857142857,NA,712,94,113,207,259,1043,618,930
2017,11,89,"Yalova",40.65,29.2667,12.0142857142857,7.17142857142857,7.11542857142857,82.2571428571429,62.64,NA,525,0,0,363,498,725,525,725
2017,12,89,"Yalova",40.65,29.2667,16.2857142857143,9.68571428571429,0.0295714285714286,77.8857142857143,112.795714285714,NA,589,0,0,33,65,1077,589,1077
2017,13,89,"Yalova",40.65,29.2667,17.9857142857143,9.45714285714286,0.791285714285714,73.4857142857143,92.4514285714286,NA,574,0,0,0,0,887,574,887
2017,14,89,"Yalova",40.65,29.2667,13.2857142857143,10.7142857142857,0.724,78.3571428571429,99.8885714285714,NA,639,0,0,299,566,1336,639,1336
2017,15,89,"Yalova",40.65,29.2667,10.1285714285714,12.3428571428571,0.140857142857143,68.3857142857143,86.1828571428571,NA,587,0,0,233,758,1187,587,1187
2017,16,89,"Yalova",40.65,29.2667,14.2142857142857,11.7142857142857,3.50671428571429,72.8571428571429,50.6471428571429,NA,717,25,80,341,493,920,692,840
2017,17,89,"Yalova",40.65,29.2667,12,14.8,0.704428571428572,61.9285714285714,88.7257142857143,NA,731,0,0,413,711,1478,731,1478
2017,18,89,"Yalova",40.65,29.2667,13.4285714285714,16.1428571428571,1.32571428571429,76.0285714285714,87.17,NA,506,0,0,220,484,923,506,923
2017,19,89,"Yalova",40.65,29.2667,11.0857142857143,18.5142857142857,3.09414285714286,74.5857142857143,73.1214285714286,NA,471,0,0,256,507,966,471,966
2017,20,89,"Yalova",40.65,29.2667,12.5,16.3142857142857,0.961571428571429,75.8142857142857,58.3528571428571,NA,472,0,0,127,291,1205,472,1205
2017,21,89,"Yalova",40.65,29.2667,10.4142857142857,17.7285714285714,0.345857142857143,73.5142857142857,52.2914285714286,NA,448,0,0,170,315,849,448,849
2017,22,89,"Yalova",40.65,29.2667,10.4,20.8,2.81171428571429,74.2714285714286,62.5714285714286,NA,522,0,0,186,220,1015,522,1015
2017,23,89,"Yalova",40.65,29.2667,10.7714285714286,20.7857142857143,8.17428571428571,80.9428571428572,49.3642857142857,NA,578,0,0,425,1137,1388,578,1388
2017,24,89,"Yalova",40.65,29.2667,11.1142857142857,21.5857142857143,0.301285714285714,71.2714285714286,42.4785714285714,NA,552,0,0,235,425,1139,552,1139
2017,25,89,"Yalova",40.65,29.2667,10.7,22.8142857142857,3.85385714285714,72.5,46.9128571428571,NA,584,0,0,431,748,1041,584,1041
2017,26,89,"Yalova",40.65,29.2667,11.5428571428571,27.0428571428571,0,64.0857142857143,56.0633333333333,NA,564,0,0,142,355,971,564,971
2017,27,89,"Yalova",40.65,29.2667,15.5142857142857,23.7142857142857,1.042,69.2714285714286,45.8871428571429,NA,511,0,0,142,268,642,511,642
2017,28,89,"Yalova",40.65,29.2667,15.8285714285714,25.0142857142857,0.000571428571428571,69.5,52.5185714285714,NA,481,0,0,1,3,864,481,864
2017,29,89,"Yalova",40.65,29.2667,15,23.9571428571429,0.0471428571428571,74.9285714285714,59.6114285714286,NA,532,0,0,162,358,1272,532,1272
2017,30,89,"Yalova",40.65,29.2667,12.5,25.7,0.559857142857143,67.2857142857143,66.0757142857143,NA,531,0,0,309,501,928,531,928
2017,31,89,"Yalova",40.65,29.2667,11.6714285714286,25.9285714285714,0.0117142857142857,73.9142857142857,64.4614285714286,NA,559,0,0,176,379,1047,559,1047
2017,32,89,"Yalova",40.65,29.2667,12.9714285714286,26.5571428571429,0,77.2428571428571,66.82,NA,567,0,0,269,485,1092,567,1092
2017,33,89,"Yalova",40.65,29.2667,11.4,24.9285714285714,2.08214285714286,77.6428571428571,62.6242857142857,NA,596,0,0,438,918,1199,596,1199
2017,34,89,"Yalova",40.65,29.2667,11.2428571428571,22.9285714285714,3.39571428571429,72.8428571428571,58.3657142857143,NA,601,0,0,41,91,1280,601,1280
2017,35,89,"Yalova",40.65,29.2667,11.9571428571429,22.1857142857143,0.00142857142857143,67.3571428571429,52.2314285714286,NA,493,0,0,20,36,1014,493,1014
2017,36,89,"Yalova",40.65,29.2667,9.38571428571429,22.3,0.00285714285714286,66.7714285714286,63.2828571428571,NA,507,0,0,169,481,1321,507,1321
2017,37,89,"Yalova",40.65,29.2667,10.5857142857143,24.5,0,71.4428571428572,75.6185714285714,NA,589,0,0,339,592,1138,589,1138
2017,38,89,"Yalova",40.65,29.2667,13.1142857142857,21.9714285714286,2.42085714285714,71.5571428571429,67.6785714285714,NA,671,0,0,275,544,1312,671,1312
2017,39,89,"Yalova",40.65,29.2667,16.2428571428571,18.7285714285714,4.97085714285714,79.8857142857143,64.5042857142857,NA,782,0,0,89,118,1630,782,1630
2017,40,89,"Yalova",40.65,29.2667,9.74285714285714,16.2857142857143,1.73228571428571,74.2428571428571,68.5742857142857,NA,543,90,227,72,128,1137,453,910
2017,41,89,"Yalova",40.65,29.2667,7.52857142857143,14.1857142857143,0.567142857142857,73.8571428571429,71.67,NA,487,0,0,162,202,843,487,843
2017,42,89,"Yalova",40.65,29.2667,10.0857142857143,16,0.000142857142857143,78.4857142857143,106.167142857143,NA,530,0,0,170,236,815,530,815
2017,43,89,"Yalova",40.65,29.2667,15.4714285714286,14.6,12.4571428571429,83.9,74.72,NA,506,0,0,132,203,919,506,919
2017,44,89,"Yalova",40.65,29.2667,12.2857142857143,10.7857142857143,1.10128571428571,68.9428571428571,67.4442857142857,NA,561,0,0,112,121,1102,561,1102
2017,45,89,"Yalova",40.65,29.2667,8.67142857142857,12.9714285714286,0.014,79.3285714285714,106.037142857143,NA,577,75,141,89,103,829,502,688
2017,46,89,"Yalova",40.65,29.2667,12.2714285714286,14.4,0.0952857142857143,80.3714285714286,133.78,NA,587,0,0,0,0,1085,587,1085
2017,47,89,"Yalova",40.65,29.2667,14.0428571428571,10.3,5.39071428571429,77.2,72.8585714285714,NA,418,45,170,133,167,804,373,634
2017,48,89,"Yalova",40.65,29.2667,12.7285714285714,14.1428571428571,5.07314285714286,66.7285714285714,63.5885714285714,NA,386,202,299,67,117,619,184,320
2017,49,89,"Yalova",40.65,29.2667,17.9571428571429,9.85714285714286,7.39085714285714,69.1,55.4971428571429,NA,407,31,35,176,359,645,376,610
2017,50,89,"Yalova",40.65,29.2667,16.0714285714286,13.7285714285714,0.541571428571429,67.2142857142857,65.0557142857143,NA,346,79,95,0,0,442,267,347
2017,51,89,"Yalova",40.65,29.2667,18.2714285714286,6.18571428571429,14.439,85.9857142857143,37.7,NA,386,0,0,40,47,349,386,349
2017,52,89,"Yalova",40.65,29.2667,13.7375,9.225,4.502875,71.2125,45.78375,NA,528,286,264,99,161,507,242,243
2018,1,89,"Yalova",40.65,29.2667,11.95,8.3125,1.04725,79.725,58.395,49.92,618,2,0,145,224,914,616,914
2018,2,89,"Yalova",40.65,29.2667,16.7714285714286,8.9,3.19142857142857,82.2142857142857,71.8871428571429,NA,624,0,0,90,193,1309,624,1309
2018,3,89,"Yalova",40.65,29.2667,14.6285714285714,8.44285714285714,2.38642857142857,67.2142857142857,43.7371428571429,NA,639,105,83,84,33,655,534,572
2018,4,89,"Yalova",40.65,29.2667,17.8428571428571,4.82857142857143,2.44285714285714,72.3142857142857,53.82,NA,604,0,0,65,80,764,604,764
2018,5,89,"Yalova",40.65,29.2667,12.9,10.6285714285714,0.857714285714286,69.6285714285714,89.6457142857143,NA,670,0,0,301,213,819,670,819
2018,6,89,"Yalova",40.65,29.2667,14.7571428571429,9.38571428571429,6.65585714285714,82.3714285714286,92.0985714285714,NA,704,0,0,92,152,1022,704,1022
2018,7,89,"Yalova",40.65,29.2667,14.5,8.12857142857143,0.377,80.4428571428572,54.2628571428571,NA,478,71,104,6,2,557,407,453
2018,8,89,"Yalova",40.65,29.2667,16.5142857142857,8.22857142857143,3.82,83.7285714285714,61.2928571428571,NA,711,0,0,0,0,1321,711,1321
2018,9,89,"Yalova",40.65,29.2667,17.7428571428571,7.54285714285714,6.58542857142857,80.1142857142857,55.3742857142857,NA,621,0,0,194,253,956,621,956
2018,10,89,"Yalova",40.65,29.2667,12.4142857142857,11.1857142857143,3.13785714285714,84.3142857142857,95.0728571428571,NA,556,0,0,328,614,1330,556,1330
2018,11,89,"Yalova",40.65,29.2667,13.5,14.6285714285714,1.08214285714286,65.6857142857143,71.4971428571429,NA,551,65,412,156,294,1426,486,1014
2018,12,89,"Yalova",40.65,29.2667,18.2,10.7857142857143,1.61542857142857,82,51.1771428571429,NA,425,0,0,86,389,1187,425,1187
2018,13,89,"Yalova",40.65,29.2667,12.7428571428571,12.5714285714286,1.85342857142857,73.0428571428571,103.694285714286,NA,356,15,5,141,193,428,341,423
2018,14,89,"Yalova",40.65,29.2667,10.7857142857143,12.4857142857143,0.307,74.2857142857143,72.9442857142857,NA,407,0,0,273,236,486,407,486
2018,15,89,"Yalova",40.65,29.2667,13.3428571428571,13.9571428571429,0.000285714285714286,80.7142857142857,111.38,NA,374,0,0,193,294,450,374,450
2018,16,89,"Yalova",40.65,29.2667,13.3,12.9857142857143,0.713571428571429,75.7714285714286,48.96,NA,411,0,0,109,204,648,411,648
2018,17,89,"Yalova",40.65,29.2667,13.4142857142857,17.5285714285714,0,70.3714285714286,47.7142857142857,NA,419,0,0,106,109,652,419,652
2018,18,89,"Yalova",40.65,29.2667,13.5,15.7,0.466142857142857,85.6,49.5228571428571,NA,303,0,0,24,96,474,303,474
2018,19,89,"Yalova",40.65,29.2667,10.4,16.8571428571429,8.799,83.9571428571429,27.5571428571429,NA,275,0,0,146,264,467,275,467
2018,20,89,"Yalova",40.65,29.2667,11.9142857142857,21.3285714285714,0.00428571428571429,69.5142857142857,40.9985714285714,NA,204,0,0,11,10,306,204,306
2018,21,89,"Yalova",40.65,29.2667,14.3285714285714,20.2285714285714,7.55071428571429,84.1285714285714,33.5642857142857,NA,252,0,0,33,41,281,252,281
2018,22,89,"Yalova",40.65,29.2667,12.5571428571429,20.3142857142857,0.529142857142857,76.6285714285714,36.28,NA,249,0,0,103,241,427,249,427
2018,23,89,"Yalova",40.65,29.2667,12.2428571428571,23.2285714285714,0.447714285714286,71.9857142857143,37.2685714285714,NA,267,0,0,69,323,812,267,812
2018,24,89,"Yalova",40.65,29.2667,15.7285714285714,22.9142857142857,2.57328571428571,72.0714285714286,28.7985714285714,NA,267,0,0,114,222,448,267,448
2018,25,89,"Yalova",40.65,29.2667,17.9857142857143,23.1571428571429,1.48071428571429,79.6714285714286,28.5,NA,358,0,0,172,200,518,358,518
2018,26,89,"Yalova",40.65,29.2667,15.9,23.1714285714286,1.89942857142857,77.7,23.5385714285714,NA,355,0,0,237,432,587,355,587
2018,27,89,"Yalova",40.65,29.2667,14.7714285714286,25.4285714285714,0,62.4142857142857,31.694,NA,342,0,0,29,79,418,342,418
2018,28,89,"Yalova",40.65,29.2667,16.1142857142857,25.7142857142857,0.0264285714285714,74.8285714285714,32.0842857142857,NA,286,0,0,106,192,585,286,585
2018,29,89,"Yalova",40.65,29.2667,16.8428571428571,25.5428571428571,0.302714285714286,70.2714285714286,28.8085714285714,NA,260,0,0,159,276,756,260,756
2018,30,89,"Yalova",40.65,29.2667,18.6571428571429,25.2571428571429,4.34528571428571,75.9571428571429,27.7285714285714,NA,265,0,0,180,690,822,265,822
2018,31,89,"Yalova",40.65,29.2667,15.9571428571429,26.8571428571429,0.581,76.0714285714286,37.0428571428571,NA,267,0,0,1,3,499,267,499
2018,32,89,"Yalova",40.65,29.2667,15.6714285714286,25.8285714285714,0.00228571428571429,69.5428571428571,35.0266666666667,NA,297,0,0,2,3,403,297,403
2018,33,89,"Yalova",40.65,29.2667,16.4142857142857,25.1428571428571,0.03,74,36.8028571428571,NA,216,0,0,70,149,332,216,332
2018,34,89,"Yalova",40.65,29.2667,16.1857142857143,25.3571428571429,0,72.0714285714286,33.9471428571429,NA,144,0,0,61,61,227,144,227
2018,35,89,"Yalova",40.65,29.2667,15.3857142857143,26.0142857142857,0.00328571428571429,78.5,41.0771428571429,NA,201,0,0,34,60,314,201,314
2018,36,89,"Yalova",40.65,29.2667,14.1571428571429,24.0571428571429,1.66042857142857,76.9142857142857,36.1914285714286,NA,341,0,0,154,172,370,341,370
2018,37,89,"Yalova",40.65,29.2667,17.5142857142857,21.4714285714286,13.7345714285714,76.6,28.1771428571429,NA,241,0,0,129,221,419,241,419
2018,38,89,"Yalova",40.65,29.2667,21.4714285714286,21.1714285714286,0.0142857142857143,74.8571428571429,30.9742857142857,NA,189,0,0,1,0,344,189,344
2018,39,89,"Yalova",40.65,29.2667,21.0714285714286,18.0285714285714,1.71728571428571,77.0428571428571,27.175,NA,180,0,0,35,69,353,180,353
2018,40,89,"Yalova",40.65,29.2667,16.0428571428571,18.3857142857143,3.3,77.0571428571428,38.4928571428571,NA,191,0,0,41,59,341,191,341
2018,41,89,"Yalova",40.65,29.2667,14.8571428571429,17.7285714285714,0.409,82.6571428571429,41.98,NA,187,0,0,15,30,422,187,422
2018,42,89,"Yalova",40.65,29.2667,12.7142857142857,18.4285714285714,2.52971428571429,86.7571428571429,54.7742857142857,NA,168,0,0,36,70,381,168,381
2018,43,89,"Yalova",40.65,29.2667,17.0142857142857,15.3,1.24671428571429,69.1142857142857,44.5014285714286,28.8366666666667,187,54,85,65,112,402,133,317
2018,44,89,"Yalova",40.65,29.2667,10.6714285714286,16.0142857142857,0,75.8285714285714,51.6628571428571,49.7985714285714,196,0,0,36,25,264,196,264
2018,45,89,"Yalova",40.65,29.2667,14.4285714285714,15.1,0.00128571428571429,81.0857142857143,38.0814285714286,36.7957142857143,231,0,0,0,0,473,231,473
2018,46,89,"Yalova",40.65,29.2667,15.5571428571429,10.9428571428571,6.029,78.8714285714286,30.8957142857143,34.48,230,0,0,59,106,465,230,465
2018,47,89,"Yalova",40.65,29.2667,14.8142857142857,12.0714285714286,3.16471428571429,81.5285714285714,42.7942857142857,33.756,270,0,0,3,69,499,270,499
2018,48,89,"Yalova",40.65,29.2667,19.8857142857143,10.5,3.42371428571429,78.9428571428572,30.0757142857143,27.9528571428571,245,0,0,37,48,201,245,201
2018,49,89,"Yalova",40.65,29.2667,17.7714285714286,8.54285714285714,3.46628571428571,75.1285714285714,38.9357142857143,33.1185714285714,257,23,11,2,1,420,234,409
2018,50,89,"Yalova",40.65,29.2667,18.6285714285714,8.91428571428571,8.94142857142857,75.5428571428571,27.8157142857143,33.8228571428571,256,103,96,102,126,305,153,209
2018,51,89,"Yalova",40.65,29.2667,17.3571428571429,8,8.43528571428571,81.0857142857143,35.1128571428571,32.4657142857143,250,0,0,79,151,248,250,248
2018,52,89,"Yalova",40.65,29.2667,14.3,5.32857142857143,11.2555714285714,78.7142857142857,25.5828571428571,31.12,244,34,32,54,67,273,210,241
2019,1,89,"Yalova",40.65,29.2667,19.4625,5.25,4.981625,79.75,24.6575,40.89875,343,0,0,52,124,784,343,784
2019,2,89,"Yalova",40.65,29.2667,20.0571428571429,5.02857142857143,4.647,73.6285714285714,22.0085714285714,37.4814285714286,255,93,63,35,64,208,162,145
2019,3,89,"Yalova",40.65,29.2667,15.4714285714286,6.95714285714286,2.62328571428571,70,28.5114285714286,35.1985714285714,192,52,72,28,33,198,140,126
2019,4,89,"Yalova",40.65,29.2667,17.2571428571429,10,0.818285714285714,70.8571428571429,39.9557142857143,42.84,308,114,117,0,0,314,194,197
2019,5,89,"Yalova",40.65,29.2667,14.0857142857143,11.5,0.423428571428571,63.7428571428571,33.06,39.6285714285714,253,134,90,0,0,143,119,53
2019,6,89,"Yalova",40.65,29.2667,17.6714285714286,7.6,1.86985714285714,81.4714285714286,34.4314285714286,45.1557142857143,276,0,0,36,24,127,276,127
2019,7,89,"Yalova",40.65,29.2667,19.9571428571429,6.92857142857143,5.695,74.9285714285714,27.8057142857143,37.6114285714286,325,0,0,0,0,234,325,234
2019,8,89,"Yalova",40.65,29.2667,14.9142857142857,5.22857142857143,2.41142857142857,84.6714285714286,58.8257142857143,60.1457142857143,305,0,0,112,100,219,305,219
2019,9,89,"Yalova",40.65,29.2667,20.6571428571429,6.88571428571429,1.85757142857143,74.2714285714286,28.73,41.2228571428571,331,0,0,69,113,310,331,310
2019,10,89,"Yalova",40.65,29.2667,14.0142857142857,10.5428571428571,0.128428571428571,65.3285714285714,46.61,59.7042857142857,359,0,0,281,215,252,359,252
2019,11,89,"Yalova",40.65,29.2667,19.4,10.0285714285714,3.96042857142857,72.7285714285714,31.4228571428571,45.4785714285714,373,0,0,145,131,400,373,400
2019,12,89,"Yalova",40.65,29.2667,14.5428571428571,10.1857142857143,0,67.8142857142857,37.2928571428571,45.1842857142857,343,0,0,86,300,416,343,416
2019,13,89,"Yalova",40.65,29.2667,20.9142857142857,8.21428571428571,0.000142857142857143,66.0714285714286,31.2057142857143,36.9028571428571,256,0,0,69,57,194,256,194
2019,14,89,"Yalova",40.65,29.2667,15.2142857142857,9.7,0.0561428571428571,76.6714285714286,48.4957142857143,48.6771428571429,365,0,0,30,13,208,365,208
2019,15,89,"Yalova",40.65,29.2667,15.4714285714286,13.9,4.513,79.2714285714286,28.53,45.9771428571429,359,0,0,159,100,183,359,183
2019,16,89,"Yalova",40.65,29.2667,17.4571428571429,9.38571428571429,1.26657142857143,73.1285714285714,21.6883333333333,30.6442857142857,318,0,0,147,108,208,318,208
2019,17,89,"Yalova",40.65,29.2667,12.8571428571429,13.8142857142857,0.0148571428571429,64.4285714285714,57.266,49.5214285714286,412,0,0,114,60,313,412,313
2019,18,89,"Yalova",40.65,29.2667,14.5571428571429,17.7285714285714,1.06585714285714,65.3857142857143,43.9757142857143,32.7214285714286,523,2,5,417,311,353,521,348
2019,19,89,"Yalova",40.65,29.2667,16.6142857142857,15.9714285714286,2.17942857142857,70.0714285714286,33.7085714285714,27.5314285714286,452,63,73,258,175,386,389,313
2019,20,89,"Yalova",40.65,29.2667,18.0857142857143,18.9,0.120285714285714,72.3714285714286,46.06,42.7928571428571,454,0,0,99,91,389,454,389
2019,21,89,"Yalova",40.65,29.2667,14.8285714285714,20.9142857142857,0.557857142857143,66.8571428571429,38.4885714285714,33.1357142857143,457,0,0,280,297,413,457,413
2019,22,89,"Yalova",40.65,29.2667,13.4857142857143,22.9571428571429,0.295714285714286,68.7428571428571,45.21,36.7214285714286,453,0,0,227,146,323,453,323
2019,23,89,"Yalova",40.65,29.2667,14.5,22.7142857142857,0.288428571428571,69.8714285714286,33.0642857142857,22.27,378,0,0,217,207,532,378,532
2019,24,89,"Yalova",40.65,29.2667,16.8285714285714,23.4142857142857,0.364714285714286,77.8857142857143,40.58,28.8485714285714,378,0,0,219,65,244,378,244
2019,25,89,"Yalova",40.65,29.2667,13.7857142857143,23.9714285714286,3.88985714285714,78.2285714285714,50.2428571428571,34.8385714285714,306,0,0,103,137,325,306,325
2019,26,89,"Yalova",40.65,29.2667,16.6142857142857,25.0571428571429,0.706285714285714,66.2857142857143,36.5457142857143,35.2171428571429,377,0,0,1,0,342,377,342
2019,27,89,"Yalova",40.65,29.2667,16.8571428571429,24.2714285714286,0,68.7428571428571,34.2285714285714,31.5128571428571,456,0,0,79,22,222,456,222
2019,28,89,"Yalova",40.65,29.2667,15.4428571428571,22.8,2.73742857142857,67.6142857142857,32.7828571428571,34.6871428571429,398,0,0,5,10,421,398,421
2019,29,89,"Yalova",40.65,29.2667,17.0857142857143,22.9142857142857,0.523714285714286,71.2285714285714,33.3085714285714,30.6171428571429,453,0,0,64,9,203,453,203
2019,30,89,"Yalova",40.65,29.2667,16.4571428571429,23.7428571428571,0.852,73.1714285714286,38.8314285714286,31.7185714285714,456,0,0,55,62,335,456,335
2019,31,89,"Yalova",40.65,29.2667,13.7428571428571,25.6857142857143,0.003,70,38.9485714285714,26.69,334,0,0,139,171,375,334,375
2019,32,89,"Yalova",40.65,29.2667,17.2571428571429,24.4285714285714,0,65.1571428571429,31.9871428571429,31.9385714285714,346,0,0,0,0,395,346,395
2019,33,89,"Yalova",40.65,29.2667,19.7,23.3571428571429,8.76157142857143,77,31.9142857142857,27.5557142857143,337,0,0,1,0,531,337,531
2019,34,89,"Yalova",40.65,29.2667,15.6,23.8142857142857,2.079,79.5,42.89,29.4942857142857,299,0,0,134,123,345,299,345
2019,35,89,"Yalova",40.65,29.2667,17.9571428571429,24.1571428571429,0,73.5714285714286,46.1742857142857,39.495,307,0,0,0,0,415,307,415
2019,36,89,"Yalova",40.65,29.2667,16.6428571428571,23.1142857142857,0,71.5714285714286,42.4242857142857,36.9966666666667,171,0,0,0,0,67,171,67
2019,37,89,"Yalova",40.65,29.2667,16.2571428571429,22.0857142857143,0.143571428571429,71.4714285714286,39.9928571428571,33.79,218,0,0,0,0,55,218,55
2019,38,89,"Yalova",40.65,29.2667,17.9857142857143,19.4285714285714,1.69414285714286,68.8714285714286,37.0028571428571,35.5171428571429,266,0,0,59,33,91,266,91
2019,39,89,"Yalova",40.65,29.2667,12.8714285714286,19.1857142857143,0.233142857142857,74.9428571428572,33.93,35.238,237,0,0,135,46,79,237,79
2019,40,89,"Yalova",40.65,29.2667,20.4285714285714,20.3,5.33085714285714,71.6,41.7257142857143,44.7285714285714,241,0,0,91,57,111,241,111
2019,41,89,"Yalova",40.65,29.2667,15.4571428571429,17.3142857142857,2.14085714285714,77.9,32.2228571428571,37.8485714285714,416,0,0,65,87,448,416,448
2019,42,89,"Yalova",40.65,29.2667,11.1428571428571,18.2142857142857,0,82.1714285714286,77.2885714285714,42.8842857142857,356,0,0,44,33,408,356,408
2019,43,89,"Yalova",40.65,29.2667,13.4428571428571,17.4428571428571,0.000285714285714286,76.8857142857143,47.7585714285714,39.5214285714286,306,0,0,0,0,300,306,300
2019,44,89,"Yalova",40.65,29.2667,13.0857142857143,14.5714285714286,3.017,77.9857142857143,38.9985714285714,38.5185714285714,350,0,0,45,69,250,350,250
2019,45,89,"Yalova",40.65,29.2667,10,18.9571428571429,0.0144285714285714,63.5142857142857,52.7914285714286,49.8757142857143,417,150,143,0,0,328,267,185
2019,46,89,"Yalova",40.65,29.2667,11.5857142857143,16.3571428571429,0.186857142857143,73.4571428571429,61.1085714285714,60.8985714285714,401,45,28,0,0,337,356,309
2019,47,89,"Yalova",40.65,29.2667,13.6428571428571,13.6142857142857,0.0441428571428571,76.2142857142857,69.0228571428571,65.0571428571429,391,0,0,0,0,339,391,339
2019,48,89,"Yalova",40.65,29.2667,17.7857142857143,13.9857142857143,3.23814285714286,74.9857142857143,36.6171428571429,41.7114285714286,320,69,46,19,15,251,251,205
2019,49,89,"Yalova",40.65,29.2667,13.3142857142857,8.21428571428571,2.51071428571429,71.9428571428571,25.8571428571429,39.3,393,58,29,0,0,274,335,245
2019,50,89,"Yalova",40.65,29.2667,9.61428571428571,10.6,0.0651428571428571,73.9571428571429,52.1842857142857,61.5085714285714,218,93,45,0,0,119,125,74
2019,51,89,"Yalova",40.65,29.2667,12.9,13.1428571428571,0.000571428571428571,59.1142857142857,37.2814285714286,38.4528571428571,361,159,184,0,0,488,202,304
2019,52,89,"Yalova",40.65,29.2667,15.9714285714286,9.42857142857143,6.05671428571429,74.2142857142857,15.1228571428571,31.6742857142857,279,0,0,79,123,281,279,281
2020,1,89,"Yalova",40.65,29.2667,17.62,6.6,0.7816,73.14,27.772,41.68,160,31,10,5,4,126,129,116
2020,2,89,"Yalova",40.65,29.2667,18.4285714285714,6.77142857142857,5.608,71.2285714285714,25.1371428571429,43.4185714285714,240,108,70,0,0,173,132,103
2020,3,89,"Yalova",40.65,29.2667,15.3571428571429,7.45714285714286,0.202142857142857,69.2142857142857,33.8357142857143,45.1,270,71,105,0,0,382,199,277
2020,4,89,"Yalova",40.65,29.2667,16.9571428571429,6.24285714285714,1.29214285714286,66.9714285714286,27.0114285714286,35.7142857142857,358,50,43,14,3,295,308,252
2020,5,89,"Yalova",40.65,29.2667,15.4857142857143,10.4714285714286,3.88814285714286,67.8571428571429,30.6085714285714,40.2414285714286,331,63,56,37,26,272,268,216
2020,6,89,"Yalova",40.65,29.2667,23.7142857142857,8.45714285714286,2.88485714285714,69.5428571428571,20.9271428571429,27.7385714285714,343,0,0,110,107,267,343,267
2020,7,89,"Yalova",40.65,29.2667,15.2714285714286,8.11428571428571,2.48714285714286,69.0571428571429,25.65,37.6528571428571,341,83,137,13,10,338,258,201
2020,8,89,"Yalova",40.65,29.2667,13.9285714285714,7.14285714285714,1.74771428571429,77.1142857142857,45.6428571428571,49.9983333333333,283,0,0,84,33,187,283,187
2020,9,89,"Yalova",40.65,29.2667,22.5142857142857,11.2,1.94628571428571,63.1714285714286,27.8885714285714,35.4057142857143,393,0,0,80,122,528,393,528
2020,10,89,"Yalova",40.65,29.2667,11.6142857142857,13.2571428571429,0.867571428571429,67.1857142857143,46.5214285714286,58.1014285714286,205,92,124,61,50,210,113,86
2020,11,89,"Yalova",40.65,29.2667,13.2714285714286,11.2285714285714,1.23642857142857,76.2571428571429,40.5271428571429,48.9285714285714,115,0,0,60,34,94,115,94
2020,12,89,"Yalova",40.65,29.2667,17.1571428571429,7.24285714285714,0.996,68.9571428571429,26.5985714285714,36.6157142857143,117,7,4,10,5,118,110,114
2020,13,89,"Yalova",40.65,29.2667,18.1428571428571,9.21428571428571,3.52457142857143,79.5857142857143,38.6728571428571,27.7742857142857,136,5,6,23,27,92,131,86
2020,14,89,"Yalova",40.65,29.2667,17.7857142857143,9.62857142857143,2.39442857142857,79.5857142857143,32.4885714285714,31.0014285714286,155,9,3,24,20,121,146,118
2020,15,89,"Yalova",40.65,29.2667,20.1428571428571,10.3285714285714,1.17371428571429,68.1714285714286,34.9757142857143,27.1014285714286,133,2,3,41,29,118,131,115
2020,16,89,"Yalova",40.65,29.2667,13.3857142857143,12.4142857142857,0.573,65.5,35.5914285714286,34.0514285714286,141,9,14,56,21,106,132,92
2020,17,89,"Yalova",40.65,29.2667,19.3857142857143,11.0428571428571,0.0147142857142857,68.1857142857143,28.8257142857143,22.5728571428571,137,3,4,36,13,123,134,119
2020,18,89,"Yalova",40.65,29.2667,15.2,15.8285714285714,1.56771428571429,68.6571428571429,29.1857142857143,28.2914285714286,146,0,0,106,84,164,146,164
2020,19,89,"Yalova",40.65,29.2667,20.6571428571429,14.1571428571429,2.56042857142857,75.0714285714286,22.75,21.6642857142857,137,0,0,90,70,157,137,157
2020,20,89,"Yalova",40.65,29.2667,17.8,20.8,0,65.2142857142857,56.2828571428571,33.6385714285714,164,0,0,54,51,164,164,164
2020,21,89,"Yalova",40.65,29.2667,24.4285714285714,17.3857142857143,3.60414285714286,74.2571428571429,38.5242857142857,27.0042857142857,146,0,0,46,40,96,146,96
2020,22,89,"Yalova",40.65,29.2667,16.7857142857143,15.7285714285714,1.17557142857143,75.4142857142857,20.8242857142857,17.9057142857143,118,0,0,76,73,100,118,100
2020,23,89,"Yalova",40.65,29.2667,14.5285714285714,19.2428571428571,0.792285714285714,69.5285714285714,28.4842857142857,29.4942857142857,112,0,0,69,38,70,112,70
2020,24,89,"Yalova",40.65,29.2667,16.0428571428571,22.1714285714286,0.286857142857143,69.8428571428571,34.4042857142857,23.7228571428571,140,0,0,110,132,150,140,150
2020,25,89,"Yalova",40.65,29.2667,17.3428571428571,22.5857142857143,14.3308571428571,75.7142857142857,33.1485714285714,25.0714285714286,137,23,14,67,71,108,114,94
2020,26,89,"Yalova",40.65,29.2667,17.4,23.2285714285714,0.00685714285714286,73.2,33.0757142857143,23.2,173,0,0,113,92,133,173,133
2020,27,89,"Yalova",40.65,29.2667,13.9714285714286,24.8857142857143,0,74.3428571428571,42.3983333333333,29.5428571428571,113,0,0,56,21,113,113,113
2020,28,89,"Yalova",40.65,29.2667,16.9428571428571,24.2285714285714,0.0845714285714286,72.2714285714286,35.484,28.6085714285714,164,9,2,41,54,122,155,120
2020,29,89,"Yalova",40.65,29.2667,15.6285714285714,22.1714285714286,0.281571428571429,73.3285714285714,28.67,27.4828571428571,186,3,6,30,26,111,183,105
2020,30,89,"Yalova",40.65,29.2667,18.0285714285714,24.4571428571429,0,71.1571428571429,37.19,29.7385714285714,190,5,3,56,35,142,185,139
2020,31,89,"Yalova",40.65,29.2667,18.1714285714286,25.2714285714286,0,68.1142857142857,34.7371428571429,29.6214285714286,150,3,2,52,49,127,147,125
2020,32,89,"Yalova",40.65,29.2667,16.6428571428571,25.0571428571429,0,72.2571428571429,33.3742857142857,25.9042857142857,146,2,0,84,43,107,144,107
2020,33,89,"Yalova",40.65,29.2667,16.6857142857143,24.8142857142857,0.000142857142857143,67.6,31.7914285714286,26.0371428571429,183,1,0,0,0,83,182,83
2020,34,89,"Yalova",40.65,29.2667,16.1,23.2,0.00785714285714286,72.0714285714286,31.55,29.6428571428571,197,0,0,139,81,97,197,97
2020,35,89,"Yalova",40.65,29.2667,14.7857142857143,24.3142857142857,0,69.4857142857143,32.7014285714286,32.2457142857143,164,0,0,85,81,157,164,157
2020,36,89,"Yalova",40.65,29.2667,15.9285714285714,23.9285714285714,0.142,74.6428571428571,34,26.0314285714286,179,0,0,152,100,112,179,112
2020,37,89,"Yalova",40.65,29.2667,17.2571428571429,24.1,0.0427142857142857,74.8714285714286,40.7385714285714,28.38,193,0,0,0,0,91,193,91
2020,38,89,"Yalova",40.65,29.2667,16.6571428571429,23.1714285714286,0.126857142857143,73.9714285714286,39.7528571428571,27.7914285714286,235,24,23,35,19,157,211,134
2020,39,89,"Yalova",40.65,29.2667,15.1714285714286,22.5714285714286,0.0868571428571429,70.0285714285714,41.9833333333333,41.8033333333333,220,24,8,90,40,129,196,121
2020,40,89,"Yalova",40.65,29.2667,16.0285714285714,20.2142857142857,3.68814285714286,70.0142857142857,48.0983333333333,41.72,187,0,0,81,55,154,187,154
2020,41,89,"Yalova",40.65,29.2667,15.2857142857143,21.2,4.14142857142857,73.7428571428571,67.2742857142857,52.0942857142857,182,0,0,117,86,127,182,127
2020,42,89,"Yalova",40.65,29.2667,16.9714285714286,20.4,0.715571428571429,73.2,50.9657142857143,38.4457142857143,177,0,0,43,35,111,177,111
2020,43,89,"Yalova",40.65,29.2667,13.3,17.3857142857143,0.998571428571429,83.9428571428572,61.0242857142857,42.14,194,0,0,24,18,161,194,161
2020,44,89,"Yalova",40.65,29.2667,23.6,16.6,5.66928571428571,81.2857142857143,54.9,35.2328571428571,255,0,0,186,155,233,255,233
2020,45,89,"Yalova",40.65,29.2667,13.8,13.5714285714286,3.11014285714286,80.0285714285714,41.3357142857143,38.4528571428571,156,30,26,15,8,103,126,77
2020,46,89,"Yalova",40.65,29.2667,14.3285714285714,13.7714285714286,1.56071428571429,81.5142857142857,49.2742857142857,43.1085714285714,208,1,0,0,0,109,207,109
2020,47,89,"Yalova",40.65,29.2667,17.6857142857143,11.2857142857143,0.05,79,45.3414285714286,35.5185714285714,173,0,0,3,2,83,173,83
2020,48,89,"Yalova",40.65,29.2667,12.6714285714286,9.9,0.281714285714286,72.8714285714286,54.37,50.0771428571429,199,50,38,0,0,262,149,224
2020,49,89,"Yalova",40.65,29.2667,14.6428571428571,9.9,0.355714285714286,82.4714285714286,56.122,38.45,207,0,0,16,1,116,207,116
2020,50,89,"Yalova",40.65,29.2667,13.2714285714286,13.1142857142857,0.466142857142857,72.6714285714286,48.2628571428571,43.0471428571429,181,47,57,24,8,98,134,41
2020,51,89,"Yalova",40.65,29.2667,16.1,10.2857142857143,3.21428571428571,85.9571428571429,47.496,42.278,171,0,0,0,0,90,171,90
2020,52,89,"Yalova",40.65,29.2667,11.9285714285714,11.1,0.0157142857142857,70.7428571428571,43.6914285714286,39.3585714285714,203,19,25,0,0,113,184,88
2020,53,89,"Yalova",40.65,29.2667,11,13.85,0.2545,61.725,40.1725,42.0475,122,110,103,0,0,111,12,8
2017,1,90,"Yozgat",39.8181,34.8147,12.2285714285714,-2.28571428571429,4.45714285714286,79.7857142857143,14.2357142857143,NA,563,38,42,112,180,847,525,805
2017,2,90,"Yozgat",39.8181,34.8147,12.7857142857143,-3.51428571428571,0.414285714285714,74.6142857142857,14.4128571428571,NA,757,158,331,225,425,1214,599,883
2017,3,90,"Yozgat",39.8181,34.8147,8.05714285714286,-0.585714285714286,0.3,79.1857142857143,15.8057142857143,NA,762,217,585,67,133,1449,545,864
2017,4,90,"Yozgat",39.8181,34.8147,10.9,-5.18571428571429,1.57142857142857,77.9142857142857,17.1985714285714,NA,639,287,347,0,0,889,352,542
2017,5,90,"Yozgat",39.8181,34.8147,9.08571428571429,-6.28571428571429,0.471428571428571,68.3,21.854,NA,588,26,93,360,493,1163,562,1070
2017,6,90,"Yozgat",39.8181,34.8147,10.3142857142857,1.11428571428571,0.242857142857143,77.1857142857143,18.8785714285714,NA,736,165,236,28,25,1519,571,1283
2017,7,90,"Yozgat",39.8181,34.8147,10.6714285714286,-4.32857142857143,0.2,67.2857142857143,19.9585714285714,NA,492,117,114,71,137,717,375,603
2017,8,90,"Yozgat",39.8181,34.8147,13.5,3.9,0.385714285714286,67.8428571428571,21.3257142857143,NA,739,54,107,0,0,1747,685,1640
2017,9,90,"Yozgat",39.8181,34.8147,11.4285714285714,6.62857142857143,1.47142857142857,62.7285714285714,35.424,NA,574,311,562,0,0,866,263,304
2017,10,90,"Yozgat",39.8181,34.8147,11.7857142857143,7.48571428571429,1.61428571428571,58.9428571428571,26.8683333333333,NA,712,511,842,0,0,1043,201,201
2017,11,90,"Yozgat",39.8181,34.8147,11.7857142857143,1.47142857142857,7.64285714285714,83.4285714285714,21.6025,NA,525,0,0,79,109,725,525,725
2017,12,90,"Yozgat",39.8181,34.8147,13.4571428571429,5.34285714285714,1,54.2571428571429,30.6742857142857,NA,589,63,40,197,474,1077,526,1037
2017,13,90,"Yozgat",39.8181,34.8147,12.2714285714286,6.91428571428571,0.371428571428571,57.8714285714286,31.1985714285714,NA,574,184,262,45,77,887,390,625
2017,14,90,"Yozgat",39.8181,34.8147,11.4571428571429,8.02857142857143,1.32857142857143,50.1714285714286,35.2357142857143,NA,639,126,327,85,115,1336,513,1009
2017,15,90,"Yozgat",39.8181,34.8147,7.54285714285714,6.38571428571429,3.97142857142857,69.4285714285714,21.3133333333333,NA,587,25,12,102,105,1187,562,1175
2017,16,90,"Yozgat",39.8181,34.8147,17.5,9.28571428571428,0.514285714285714,58.3714285714286,20.7357142857143,NA,717,0,0,28,14,920,717,920
2017,17,90,"Yozgat",39.8181,34.8147,9.44285714285714,10.6857142857143,0.0142857142857143,43.6142857142857,28.1171428571429,NA,731,36,85,140,306,1478,695,1393
2017,18,90,"Yozgat",39.8181,34.8147,10.9428571428571,13.0428571428571,2.5,57.9714285714286,28.9057142857143,NA,506,207,317,19,32,923,299,606
2017,19,90,"Yozgat",39.8181,34.8147,14.0714285714286,15.7428571428571,0.571428571428572,50.3142857142857,32.1071428571429,NA,471,0,0,130,234,966,471,966
2017,20,90,"Yozgat",39.8181,34.8147,14.5571428571429,10.8571428571429,5.68571428571429,70.9857142857143,18.5485714285714,NA,472,20,42,83,446,1205,452,1163
2017,21,90,"Yozgat",39.8181,34.8147,9.85714285714286,10.9571428571429,4.61428571428571,68.9714285714286,17.6942857142857,NA,448,50,75,92,165,849,398,774
2017,22,90,"Yozgat",39.8181,34.8147,9.34285714285714,14.8285714285714,2.21428571428571,66.6142857142857,21.05,NA,522,11,12,61,54,1015,511,1003
2017,23,90,"Yozgat",39.8181,34.8147,9.4,17.4,1.68571428571429,64.2428571428571,21.87,NA,578,64,125,201,637,1388,514,1263
2017,24,90,"Yozgat",39.8181,34.8147,10.3571428571429,17.3428571428571,0.114285714285714,56.7857142857143,26.65,NA,552,117,186,0,0,1139,435,953
2017,25,90,"Yozgat",39.8181,34.8147,9.68571428571429,16.6571428571429,3.94285714285714,66.6714285714286,21.9642857142857,NA,584,0,0,105,117,1041,584,1041
2017,26,90,"Yozgat",39.8181,34.8147,12.5571428571429,23.6857142857143,0.114285714285714,44.3428571428571,29.4771428571429,NA,564,64,96,18,44,971,500,875
2017,27,90,"Yozgat",39.8181,34.8147,17.9,21.1714285714286,0.0142857142857143,48.6285714285714,33.6857142857143,NA,511,20,81,53,43,642,491,561
2017,28,90,"Yozgat",39.8181,34.8147,19.8571428571429,22.7714285714286,0,36.2714285714286,33.5614285714286,NA,481,0,0,0,0,864,481,864
2017,29,90,"Yozgat",39.8181,34.8147,20.2,23.3714285714286,0.114285714285714,50.7714285714286,31.14,NA,532,0,0,0,0,1272,532,1272
2017,30,90,"Yozgat",39.8181,34.8147,17.7428571428571,23.6285714285714,0.0142857142857143,36.4571428571429,43.8728571428571,NA,531,1,1,100,108,928,530,927
2017,31,90,"Yozgat",39.8181,34.8147,15.8,21.5714285714286,1.61428571428571,59.9,36.2385714285714,NA,559,0,0,0,0,1047,559,1047
2017,32,90,"Yozgat",39.8181,34.8147,17.4428571428571,24.9285714285714,0,47.9571428571429,36.3228571428571,NA,567,37,32,0,0,1092,530,1060
2017,33,90,"Yozgat",39.8181,34.8147,17.3857142857143,23.4857142857143,0.428571428571429,52.8857142857143,22.6314285714286,NA,596,21,14,0,0,1199,575,1185
2017,34,90,"Yozgat",39.8181,34.8147,18.6142857142857,19.6714285714286,0,57.3285714285714,18.1271428571429,NA,601,0,0,78,111,1280,601,1280
2017,35,90,"Yozgat",39.8181,34.8147,13.9285714285714,19.0428571428571,0.771428571428571,53.2428571428571,18.4042857142857,NA,493,60,73,0,0,1014,433,941
2017,36,90,"Yozgat",39.8181,34.8147,10.7571428571429,19.9,0.0714285714285714,38.3857142857143,21.3142857142857,NA,507,151,288,131,318,1321,356,1033
2017,37,90,"Yozgat",39.8181,34.8147,10.7285714285714,23.9571428571429,0,30.3714285714286,42.0185714285714,NA,589,96,179,0,0,1138,493,959
2017,38,90,"Yozgat",39.8181,34.8147,12.1,21.9857142857143,0.185714285714286,34.1857142857143,31.1742857142857,NA,671,179,251,15,20,1312,492,1061
2017,39,90,"Yozgat",39.8181,34.8147,11.8428571428571,15.4571428571429,0.471428571428571,61.5571428571429,18.5985714285714,NA,782,0,0,0,0,1630,782,1630
2017,40,90,"Yozgat",39.8181,34.8147,10.3714285714286,10.8571428571429,2.3,53.4714285714286,23.4914285714286,NA,543,94,223,0,0,1137,449,914
2017,41,90,"Yozgat",39.8181,34.8147,9.18571428571429,9.78571428571429,0.2,63.9571428571429,14.3228571428571,NA,487,16,71,0,0,843,471,772
2017,42,90,"Yozgat",39.8181,34.8147,8.47142857142857,10.7428571428571,0.0142857142857143,50.6428571428571,27.2842857142857,NA,530,219,301,59,86,815,311,514
2017,43,90,"Yozgat",39.8181,34.8147,13.3,11.7428571428571,0.971428571428571,54.4714285714286,36.2528571428571,NA,506,61,149,6,5,919,445,770
2017,44,90,"Yozgat",39.8181,34.8147,11.2285714285714,4.3,3.75714285714286,63.0857142857143,21.0928571428571,NA,561,158,307,162,272,1102,403,795
2017,45,90,"Yozgat",39.8181,34.8147,9.38571428571429,5.85714285714286,0.471428571428571,74.5857142857143,33.8685714285714,NA,577,86,110,0,0,829,491,719
2017,46,90,"Yozgat",39.8181,34.8147,9.17142857142857,8.72857142857143,0.0142857142857143,61.6571428571429,42.0485714285714,NA,587,431,723,0,0,1085,156,362
2017,47,90,"Yozgat",39.8181,34.8147,14.1285714285714,2.28571428571429,3.55714285714286,80.1714285714286,17.1466666666667,NA,418,74,249,145,233,804,344,555
2017,48,90,"Yozgat",39.8181,34.8147,11.0142857142857,5.22857142857143,2.01428571428571,73.6285714285714,31.6642857142857,NA,386,176,314,0,0,619,210,305
2017,49,90,"Yozgat",39.8181,34.8147,13.1285714285714,2.02857142857143,1.8,73.7714285714286,26.326,NA,407,4,4,95,176,645,403,641
2017,50,90,"Yozgat",39.8181,34.8147,11.5428571428571,4.82857142857143,0.0571428571428571,74.6,30.0571428571429,NA,346,178,184,0,0,442,168,258
2017,51,90,"Yozgat",39.8181,34.8147,13.6428571428571,4.71428571428571,5.45714285714286,86.0428571428571,17.4183333333333,NA,386,65,46,0,0,349,321,303
2017,52,90,"Yozgat",39.8181,34.8147,11.9,1.3625,1.3125,72.1375,21.89875,NA,528,325,361,41,32,507,203,146
2018,1,90,"Yozgat",39.8181,34.8147,9.9125,2.0375,5.4125,83.825,23.2685714285714,29.31,618,123,144,95,138,914,495,770
2018,2,90,"Yozgat",39.8181,34.8147,11.2285714285714,2.12857142857143,0.371428571428571,85,23.6585714285714,NA,624,287,872,0,0,1309,337,437
2018,3,90,"Yozgat",39.8181,34.8147,14.7857142857143,0.985714285714286,2.15714285714286,78.8857142857143,9.25571428571429,NA,639,1,0,93,62,655,638,655
2018,4,90,"Yozgat",39.8181,34.8147,16.6714285714286,-2.28571428571429,4.5,84.3142857142857,15.91,NA,604,34,37,0,0,764,570,727
2018,5,90,"Yozgat",39.8181,34.8147,11.8,2.01428571428571,0.157142857142857,73.2571428571429,NA,NA,670,2,0,0,0,819,668,819
2018,6,90,"Yozgat",39.8181,34.8147,12.2142857142857,6.8,0.2,64.9571428571429,NA,NA,704,264,326,0,0,1022,440,696
2018,7,90,"Yozgat",39.8181,34.8147,13.8571428571429,4.22857142857143,1.68571428571429,69.8428571428571,NA,NA,478,113,133,92,86,557,365,424
2018,8,90,"Yozgat",39.8181,34.8147,9.17142857142857,5.14285714285714,0.871428571428571,73.6428571428571,NA,NA,711,486,782,104,219,1321,225,539
2018,9,90,"Yozgat",39.8181,34.8147,19.1285714285714,4.5,5.1,70.5,NA,NA,621,86,143,86,145,956,535,813
2018,10,90,"Yozgat",39.8181,34.8147,13.2285714285714,7.17142857142857,9.42857142857143,75.9428571428571,NA,NA,556,1,0,139,278,1330,555,1330
2018,11,90,"Yozgat",39.8181,34.8147,12.1714285714286,8.07142857142857,2.04285714285714,69.2714285714286,31.75,38.375,551,2,0,50,90,1426,549,1426
2018,12,90,"Yozgat",39.8181,34.8147,16.2714285714286,10.9571428571429,1.64285714285714,50.6428571428571,21.332,28.9775,425,0,0,0,0,1187,425,1187
2018,13,90,"Yozgat",39.8181,34.8147,15.2571428571429,10.0571428571429,1.48571428571429,59.3571428571429,57.1014285714286,29.2414285714286,356,0,0,0,0,428,356,428
2018,14,90,"Yozgat",39.8181,34.8147,11.8142857142857,9.91428571428571,1.28571428571429,55.8714285714286,53.51,32.7728571428571,407,231,355,0,0,486,176,131
2018,15,90,"Yozgat",39.8181,34.8147,10.3142857142857,12.8142857142857,1.55714285714286,60.9428571428571,56.7785714285714,29.9814285714286,374,137,241,0,0,450,237,209
2018,16,90,"Yozgat",39.8181,34.8147,12.1571428571429,10.3142857142857,0.142857142857143,48.5714285714286,46.2528571428571,29.7771428571429,411,161,180,0,0,648,250,468
2018,17,90,"Yozgat",39.8181,34.8147,12.3142857142857,15.3285714285714,0,39.8428571428571,74.5885714285714,30.4871428571429,419,54,81,61,96,652,365,571
2018,18,90,"Yozgat",39.8181,34.8147,9.12857142857143,16.2571428571429,3.45714285714286,56.2428571428571,108.575714285714,28.13,303,146,246,0,0,474,157,228
2018,19,90,"Yozgat",39.8181,34.8147,11.1285714285714,11.8428571428571,3.84285714285714,76.2285714285714,58.9957142857143,23.0714285714286,275,11,31,57,68,467,264,436
2018,20,90,"Yozgat",39.8181,34.8147,9.54285714285714,16.4142857142857,3.48571428571429,59.2142857142857,145.086,33.654,204,92,121,0,0,306,112,185
2018,21,90,"Yozgat",39.8181,34.8147,10.4571428571429,17.1428571428571,4.85714285714286,68.7428571428571,51.88,22.2425,252,15,5,5,2,281,237,276
2018,22,90,"Yozgat",39.8181,34.8147,13.9,15.7142857142857,0.171428571428571,69.6714285714286,44.24,20.43,249,15,11,0,0,427,234,416
2018,23,90,"Yozgat",39.8181,34.8147,9.78571428571429,18.9428571428571,0.142857142857143,54.0571428571429,41.1757142857143,25.4028571428571,267,85,255,67,168,812,182,557
2018,24,90,"Yozgat",39.8181,34.8147,14.6142857142857,19.2285714285714,3.7,55.9142857142857,38.3585714285714,21.424,267,28,8,38,152,448,239,440
2018,25,90,"Yozgat",39.8181,34.8147,12.7285714285714,18.3714285714286,1.82857142857143,70.3285714285714,30.31,20.7628571428571,358,34,41,146,148,518,324,477
2018,26,90,"Yozgat",39.8181,34.8147,12.9571428571429,22.5714285714286,0,49.2857142857143,43.3142857142857,21.5885714285714,355,60,95,75,151,587,295,492
2018,27,90,"Yozgat",39.8181,34.8147,17.4857142857143,20.5428571428571,0,54.5857142857143,32.0428571428571,17.3,342,9,19,0,0,418,333,399
2018,28,90,"Yozgat",39.8181,34.8147,19.6,23.1428571428571,0,49.6,57.5928571428571,18.2657142857143,286,32,55,4,1,585,254,530
2018,29,90,"Yozgat",39.8181,34.8147,15.2857142857143,21.1571428571429,0.114285714285714,48.9714285714286,31.6742857142857,20.1257142857143,260,25,13,114,364,756,235,743
2018,30,90,"Yozgat",39.8181,34.8147,14.7,23.0857142857143,0.0285714285714286,50.0571428571429,44.7983333333333,21.9783333333333,265,41,91,0,0,822,224,731
2018,31,90,"Yozgat",39.8181,34.8147,18.6142857142857,22.6714285714286,0,53.6142857142857,39.2128571428571,16.9757142857143,267,0,0,3,42,499,267,499
2018,32,90,"Yozgat",39.8181,34.8147,18.0285714285714,19.7857142857143,0,52.9428571428571,32.5357142857143,20.0414285714286,297,0,0,3,3,403,297,403
2018,33,90,"Yozgat",39.8181,34.8147,16.1,21.4,0,44.6142857142857,35.0114285714286,23.6242857142857,216,0,0,1,0,332,216,332
2018,34,90,"Yozgat",39.8181,34.8147,14.7142857142857,22.4285714285714,0,40.8571428571429,NA,NA,144,0,0,0,0,227,144,227
2018,35,90,"Yozgat",39.8181,34.8147,16.5,23.4571428571429,0,44.6428571428571,40.7766666666667,23.715,201,0,0,0,0,314,201,314
2018,36,90,"Yozgat",39.8181,34.8147,10.8142857142857,20.2,0.185714285714286,48.5857142857143,45.2928571428571,29.4471428571429,341,105,87,72,72,370,236,283
2018,37,90,"Yozgat",39.8181,34.8147,15.0285714285714,18.2285714285714,0.228571428571429,54.9857142857143,41.4971428571429,22.3985714285714,241,14,23,13,50,419,227,396
2018,38,90,"Yozgat",39.8181,34.8147,13.7571428571429,16.4,0,53.6714285714286,33.7,28.0571428571429,189,28,53,0,0,344,161,291
2018,39,90,"Yozgat",39.8181,34.8147,17.3,15.1571428571429,0,55.1428571428571,40.7025,30.52,180,51,138,0,0,353,129,215
2018,40,90,"Yozgat",39.8181,34.8147,13.9142857142857,13.9285714285714,0.228571428571429,56.9428571428571,NA,28.8771428571429,191,70,99,1,2,341,121,242
2018,41,90,"Yozgat",39.8181,34.8147,10.6571428571429,14.3714285714286,1.21428571428571,67.7714285714286,NA,26.3657142857143,187,21,40,0,0,422,166,382
2018,42,90,"Yozgat",39.8181,34.8147,8.34285714285714,15.0285714285714,1.04285714285714,65.5857142857143,78.515,33.0485714285714,168,64,204,0,0,381,104,177
2018,43,90,"Yozgat",39.8181,34.8147,11.8428571428571,8.38571428571429,3.82857142857143,73.0428571428571,47.3642857142857,37.344,187,90,228,59,159,402,97,174
2018,44,90,"Yozgat",39.8181,34.8147,9.4,10.4857142857143,0,55.4428571428571,56.5657142857143,41.8571428571429,196,60,84,1,0,264,136,180
2018,45,90,"Yozgat",39.8181,34.8147,9.12857142857143,6.95714285714286,0,70.1571428571429,47.1842857142857,34.7228571428571,231,44,114,0,0,473,187,359
2018,46,90,"Yozgat",39.8181,34.8147,8.94285714285714,3.07142857142857,0.0142857142857143,72.1571428571429,43.6285714285714,33.3485714285714,230,116,208,0,0,465,114,257
2018,47,90,"Yozgat",39.8181,34.8147,12,6.35714285714286,0.414285714285714,75.2428571428571,53.12,34.3471428571429,270,106,359,0,0,499,164,140
2018,48,90,"Yozgat",39.8181,34.8147,12.3142857142857,6.92857142857143,5.6,83.4571428571429,38.8128571428571,30.0714285714286,245,114,142,0,0,201,131,59
2018,49,90,"Yozgat",39.8181,34.8147,12.4428571428571,3.6,3.31428571428571,80.4428571428572,37.6314285714286,31.198,257,74,83,0,0,420,183,337
2018,50,90,"Yozgat",39.8181,34.8147,13.8428571428571,2.35714285714286,7.75714285714286,83.7857142857143,29.72,27.5671428571429,256,86,68,0,0,305,170,237
2018,51,90,"Yozgat",39.8181,34.8147,11.4285714285714,5,4.32857142857143,83.2714285714286,34.2,22.98,250,100,108,81,95,248,150,140
2018,52,90,"Yozgat",39.8181,34.8147,13.1428571428571,-2.45714285714286,4.94285714285714,77.9714285714286,32.76,30.054,244,1,1,14,2,273,243,272
2019,1,90,"Yozgat",39.8181,34.8147,14.6875,0.9,8.125,82.9,25.20375,37.23,343,106,160,135,360,784,237,624
2019,2,90,"Yozgat",39.8181,34.8147,13.8571428571429,-2.8,1.77142857142857,76.3714285714286,34.0942857142857,31.8,255,69,35,117,121,208,186,173
2019,3,90,"Yozgat",39.8181,34.8147,16.4142857142857,-2.17142857142857,3.4,79.8714285714286,48.0257142857143,42.338,192,95,100,33,9,198,97,98
2019,4,90,"Yozgat",39.8181,34.8147,13.1428571428571,2.44285714285714,2.08571428571429,76.1571428571429,46.004,28.2566666666667,308,99,72,66,10,314,209,242
2019,5,90,"Yozgat",39.8181,34.8147,12.5,2.91428571428571,1.62857142857143,74.8571428571429,45.6142857142857,30.2757142857143,253,82,46,81,40,143,171,97
2019,6,90,"Yozgat",39.8181,34.8147,9.34285714285714,4.04285714285714,3.37142857142857,74.9,53.6,33.295,276,269,121,0,0,127,7,6
2019,7,90,"Yozgat",39.8181,34.8147,12.8857142857143,1.82857142857143,0.585714285714286,75.9,49.4171428571429,26.9642857142857,325,193,94,92,111,234,132,140
2019,8,90,"Yozgat",39.8181,34.8147,11.8142857142857,3.07142857142857,0.3,66.9571428571429,69.5857142857143,40.46,305,33,40,98,72,219,272,179
2019,9,90,"Yozgat",39.8181,34.8147,10.8714285714286,0.971428571428571,0.128571428571429,71.6857142857143,46.1785714285714,NA,331,119,22,99,169,310,212,288
2019,10,90,"Yozgat",39.8181,34.8147,10.8714285714286,4.31428571428571,0.871428571428571,60.7,51.2842857142857,NA,359,82,44,216,162,252,277,208
2019,11,90,"Yozgat",39.8181,34.8147,14.1714285714286,6.45714285714286,2.08571428571429,67.3714285714286,39.8814285714286,27.586,373,0,0,292,281,400,373,400
2019,12,90,"Yozgat",39.8181,34.8147,12.3142857142857,5.18571428571429,0.2,57.1428571428571,46.4228571428571,41.13,343,200,74,56,290,416,143,342
2019,13,90,"Yozgat",39.8181,34.8147,20.6714285714286,1.92857142857143,0.0142857142857143,61.8714285714286,33.5128571428571,36.9742857142857,256,152,53,3,5,194,104,141
2019,14,90,"Yozgat",39.8181,34.8147,9.74285714285714,7.27142857142857,0.328571428571429,57.6428571428571,39.695,44.4028571428571,365,288,165,0,0,208,77,43
2019,15,90,"Yozgat",39.8181,34.8147,13.2571428571429,9.97142857142857,2.5,66.6857142857143,40.1933333333333,29.7128571428571,359,0,0,270,102,183,359,183
2019,16,90,"Yozgat",39.8181,34.8147,11.1857142857143,3.71428571428571,2.58571428571429,82.7285714285714,25.02,32.3257142857143,318,237,161,0,0,208,81,47
2019,17,90,"Yozgat",39.8181,34.8147,9.17142857142857,9.15714285714286,0.2,63.4285714285714,53.4285714285714,36.5128571428571,412,144,66,0,0,313,268,247
2019,18,90,"Yozgat",39.8181,34.8147,13.7571428571429,13.4714285714286,0.0285714285714286,51.7428571428571,50.5157142857143,28.7,523,0,0,516,349,353,523,353
2019,19,90,"Yozgat",39.8181,34.8147,13.7,12.2142857142857,2.6,61.9857142857143,40.01,21.474,452,55,26,268,253,386,397,360
2019,20,90,"Yozgat",39.8181,34.8147,11.4285714285714,17.4428571428571,0.8,51.5,42.0842857142857,23.1,454,274,202,97,90,389,180,187
2019,21,90,"Yozgat",39.8181,34.8147,18.0571428571429,17.7285714285714,1.25714285714286,52.6714285714286,55.9542857142857,28.2285714285714,457,3,5,352,333,413,454,408
2019,22,90,"Yozgat",39.8181,34.8147,10.1571428571429,21.2142857142857,0.0142857142857143,46.1142857142857,54.0114285714286,28.6142857142857,453,263,218,0,0,323,190,105
2019,23,90,"Yozgat",39.8181,34.8147,13.8,21.5285714285714,1.42857142857143,49.5571428571429,52.21,25.2571428571429,378,163,318,47,88,532,215,214
2019,24,90,"Yozgat",39.8181,34.8147,11.7571428571429,18.2428571428571,4.18571428571429,72.8,36.3671428571429,24.4771428571429,378,212,135,48,13,244,166,109
2019,25,90,"Yozgat",39.8181,34.8147,10.1,18.7142857142857,6.18571428571429,73.3857142857143,37.0142857142857,23.6214285714286,306,151,237,0,0,325,155,88
2019,26,90,"Yozgat",39.8181,34.8147,15.0285714285714,20.4142857142857,0,57.5571428571429,38.0871428571429,20.5185714285714,377,323,293,0,0,342,54,49
2019,27,90,"Yozgat",39.8181,34.8147,17.2428571428571,19.3142857142857,0,50.2,35.4171428571429,19.5157142857143,456,448,217,0,0,222,8,5
2019,28,90,"Yozgat",39.8181,34.8147,13.9428571428571,19.6428571428571,1.51428571428571,54.3428571428571,35.2428571428571,22.6728571428571,398,177,134,38,101,421,221,287
2019,29,90,"Yozgat",39.8181,34.8147,16.2,17.6857142857143,1.71428571428571,62.3714285714286,33.3885714285714,21.9871428571429,453,311,135,58,5,203,142,68
2019,30,90,"Yozgat",39.8181,34.8147,16.6142857142857,19.6,0.114285714285714,52.7,38.1885714285714,23.59,456,409,308,0,0,335,47,27
2019,31,90,"Yozgat",39.8181,34.8147,9.91428571428571,22.8,0,46.5714285714286,45.0028571428571,27.4657142857143,334,119,144,106,149,375,215,231
2019,32,90,"Yozgat",39.8181,34.8147,15.5142857142857,18.1857142857143,0,53.8428571428571,30.6442857142857,21.8585714285714,346,346,395,0,0,395,0,0
2019,33,90,"Yozgat",39.8181,34.8147,17.3857142857143,22.5714285714286,4.01428571428571,48.7142857142857,37.9442857142857,25.9942857142857,337,203,284,0,0,531,134,247
2019,34,90,"Yozgat",39.8181,34.8147,15.3857142857143,18.7,1.34285714285714,72.1857142857143,36.1771428571429,25.37,299,129,141,0,0,345,170,204
2019,35,90,"Yozgat",39.8181,34.8147,12.9428571428571,19.4428571428571,0,61.3142857142857,36.11,20.8585714285714,307,293,375,0,0,415,14,40
2019,36,90,"Yozgat",39.8181,34.8147,8.31428571428571,18.5,0,48.4857142857143,36.0414285714286,27.0957142857143,171,171,67,0,0,67,0,0
2019,37,90,"Yozgat",39.8181,34.8147,11.9714285714286,15.9285714285714,0,63.4285714285714,30.2328571428571,22.5171428571429,218,218,55,0,0,55,0,0
2019,38,90,"Yozgat",39.8181,34.8147,10.1714285714286,14.3714285714286,0.0142857142857143,57.3285714285714,41.6228571428571,34.88,266,103,30,105,43,91,163,61
2019,39,90,"Yozgat",39.8181,34.8147,10.4,15.1285714285714,0.442857142857143,55.1714285714286,35.395,37.2242857142857,237,0,0,165,66,79,237,79
2019,40,90,"Yozgat",39.8181,34.8147,9.75714285714286,16.9857142857143,0.714285714285714,42.4857142857143,59.76,45.5116666666667,241,47,6,136,71,111,194,105
2019,41,90,"Yozgat",39.8181,34.8147,10.2,14.7,0.0571428571428571,54.3,38.6757142857143,34.8385714285714,416,80,30,193,161,448,336,418
2019,42,90,"Yozgat",39.8181,34.8147,7.21428571428571,14.9285714285714,0.0285714285714286,53.7857142857143,53.58,48.1528571428571,356,63,45,35,53,408,293,363
2019,43,90,"Yozgat",39.8181,34.8147,10.4285714285714,11.3571428571429,0.0285714285714286,77.1285714285714,34.6042857142857,28.0128571428571,306,305,299,0,0,300,1,1
2019,44,90,"Yozgat",39.8181,34.8147,8.05714285714286,7.87142857142857,1.48571428571429,69.7285714285714,45.76,43.2785714285714,350,166,142,135,55,250,184,108
2019,45,90,"Yozgat",39.8181,34.8147,8.87142857142857,10.1285714285714,0,52.0428571428571,64.66,60.5142857142857,417,231,170,110,48,328,186,158
2019,46,90,"Yozgat",39.8181,34.8147,8.57142857142857,10.4714285714286,0,49.1714285714286,70.1785714285714,51.7442857142857,401,244,214,0,0,337,157,123
2019,47,90,"Yozgat",39.8181,34.8147,7.54285714285714,5.01428571428571,0,50.2571428571429,78.9542857142857,59.2842857142857,391,6,7,146,104,339,385,332
2019,48,90,"Yozgat",39.8181,34.8147,10.3714285714286,6.35714285714286,4.81428571428571,77.8285714285714,68.0942857142857,43.2514285714286,320,131,102,114,98,251,189,149
2019,49,90,"Yozgat",39.8181,34.8147,9.54285714285714,-1.54285714285714,1.6,86.2142857142857,27.9328571428571,26.63,393,211,152,130,106,274,182,122
2019,50,90,"Yozgat",39.8181,34.8147,10.0571428571429,3.31428571428571,0.257142857142857,81.6857142857143,39.6728571428571,34.5483333333333,218,104,66,64,28,119,114,53
2019,51,90,"Yozgat",39.8181,34.8147,8.18571428571429,4.48571428571429,0,66.3428571428571,67.2714285714286,57.8871428571429,361,134,266,212,209,488,227,222
2019,52,90,"Yozgat",39.8181,34.8147,12.8285714285714,2.58571428571429,10.1714285714286,84.8,28.26,31.5028571428571,279,72,52,12,14,281,207,229
2020,1,90,"Yozgat",39.8181,34.8147,8.24,-1.24,0.6,85.72,26.62,31.452,160,61,59,38,35,126,99,67
2020,2,90,"Yozgat",39.8181,34.8147,11.2857142857143,-0.185714285714286,0.471428571428571,74.8285714285714,31.5357142857143,34.3971428571429,240,135,114,0,0,173,105,59
2020,3,90,"Yozgat",39.8181,34.8147,8.08571428571429,-1.02857142857143,0.0285714285714286,75.5714285714286,39.1042857142857,37.9757142857143,270,198,324,7,8,382,72,58
2020,4,90,"Yozgat",39.8181,34.8147,10.5142857142857,-4.12857142857143,1.31428571428571,72.5714285714286,33.2585714285714,41.9857142857143,358,148,140,103,96,295,210,155
2020,5,90,"Yozgat",39.8181,34.8147,14.1142857142857,0.914285714285714,6.64285714285714,80.3428571428571,47.1928571428571,42.1542857142857,331,64,52,128,71,272,267,220
2020,6,90,"Yozgat",39.8181,34.8147,16.2142857142857,-0.271428571428571,7.7,80.5285714285714,27.0742857142857,25.1271428571429,343,8,4,276,220,267,335,263
2020,7,90,"Yozgat",39.8181,34.8147,9.28571428571429,-3.3,28.7142857142857,71.8142857142857,31.9971428571429,42.3514285714286,341,160,180,94,71,338,181,158
2020,8,90,"Yozgat",39.8181,34.8147,9.65714285714286,0.842857142857143,1.28571428571429,76.4142857142857,37.5228571428571,41.9914285714286,283,200,146,0,0,187,83,41
2020,9,90,"Yozgat",39.8181,34.8147,14.2857142857143,4.02857142857143,0.842857142857143,66.3285714285714,47.05,29.52,393,69,102,216,273,528,324,426
2020,10,90,"Yozgat",39.8181,34.8147,10.6857142857143,7.58571428571429,0.0142857142857143,54.0142857142857,73.42,41.25,205,13,7,113,152,210,192,203
2020,11,90,"Yozgat",39.8181,34.8147,12.7857142857143,10,0.414285714285714,57.4571428571429,60.4142857142857,34.0657142857143,115,28,31,57,42,94,87,63
2020,12,90,"Yozgat",39.8181,34.8147,15.7,-1.08571428571429,3.62857142857143,81.0428571428571,39.7428571428571,21.6042857142857,117,106,108,0,0,118,11,10
2020,13,90,"Yozgat",39.8181,34.8147,13.4285714285714,8.3,0.342857142857143,69.7285714285714,42.4871428571429,25.0928571428571,136,90,53,3,3,92,46,39
2020,14,90,"Yozgat",39.8181,34.8147,15.5714285714286,7.77142857142857,2.54285714285714,70.3285714285714,33.4328571428571,23.6066666666667,155,72,53,9,4,121,83,68
2020,15,90,"Yozgat",39.8181,34.8147,19.5142857142857,6.5,0.171428571428571,58.5142857142857,37.6157142857143,20.92,133,75,90,0,0,118,58,28
2020,16,90,"Yozgat",39.8181,34.8147,11.7,9.41428571428571,1.65714285714286,54.9571428571429,36.5342857142857,27.1585714285714,141,33,39,42,37,106,108,67
2020,17,90,"Yozgat",39.8181,34.8147,13.9428571428571,7.77142857142857,1.01428571428571,59.9714285714286,27.7916666666667,26.4,137,62,33,21,21,123,75,90
2020,18,90,"Yozgat",39.8181,34.8147,9.85714285714286,11.0285714285714,1.51428571428571,64.2142857142857,28.83,26.7742857142857,146,0,0,80,57,164,146,164
2020,19,90,"Yozgat",39.8181,34.8147,12.5142857142857,9.94285714285714,1.98571428571429,70.4,24.0214285714286,20.6857142857143,137,39,82,39,50,157,98,75
2020,20,90,"Yozgat",39.8181,34.8147,12.0285714285714,18.8714285714286,0,45.2142857142857,62.1057142857143,26.0342857142857,164,39,26,68,98,164,125,138
2020,21,90,"Yozgat",39.8181,34.8147,17.5,17.1428571428571,1.17142857142857,47.6142857142857,68.3285714285714,19.1114285714286,146,25,13,54,19,96,121,83
2020,22,90,"Yozgat",39.8181,34.8147,14.1571428571429,14.1,1.85714285714286,50.3,24.1157142857143,16.1871428571429,118,2,1,49,57,100,116,99
2020,23,90,"Yozgat",39.8181,34.8147,11.7428571428571,16.6285714285714,0.728571428571429,47.5285714285714,31.2485714285714,23.24,112,0,0,75,47,70,112,70
2020,24,90,"Yozgat",39.8181,34.8147,11.4571428571429,18.1857142857143,2.77142857142857,55.2285714285714,44.8014285714286,21.8471428571429,140,57,99,78,46,150,83,51
2020,25,90,"Yozgat",39.8181,34.8147,9.34285714285714,17.0428571428571,1.62857142857143,64.0857142857143,33.22,20.5328571428571,137,56,30,69,71,108,81,78
2020,26,90,"Yozgat",39.8181,34.8147,11.2,18.8428571428571,6.88571428571429,60.2571428571429,37.5028571428571,22.0185714285714,173,102,52,62,72,133,71,81
2020,27,90,"Yozgat",39.8181,34.8147,12.7428571428571,21.1428571428571,0,47.1857142857143,39.3142857142857,23.1514285714286,113,112,113,0,0,113,1,0
2020,28,90,"Yozgat",39.8181,34.8147,18.3285714285714,21.4428571428571,0.0714285714285714,55.7857142857143,34.1214285714286,17.9471428571429,164,157,115,0,0,122,7,7
2020,29,90,"Yozgat",39.8181,34.8147,18.5142857142857,22.5142857142857,0.0142857142857143,51.8571428571429,37.5214285714286,20.205,186,135,77,0,0,111,51,34
2020,30,90,"Yozgat",39.8181,34.8147,11.7142857142857,21.2142857142857,0,52.1285714285714,38.565,19.465,190,154,117,36,25,142,36,25
2020,31,90,"Yozgat",39.8181,34.8147,17.4857142857143,22.9428571428571,0.285714285714286,47.8714285714286,27.962,20.23,150,75,62,13,23,127,75,65
2020,32,90,"Yozgat",39.8181,34.8147,15.6428571428571,21.6571428571429,0,43.7428571428571,23.43,22.9285714285714,146,113,84,0,0,107,33,23
2020,33,90,"Yozgat",39.8181,34.8147,10.7857142857143,19.2,0,48.5285714285714,27.8514285714286,20.4957142857143,183,183,83,0,0,83,0,0
2020,34,90,"Yozgat",39.8181,34.8147,13.4285714285714,19.3285714285714,0,47.5714285714286,27.1157142857143,23.9785714285714,197,147,81,0,0,97,50,16
2020,35,90,"Yozgat",39.8181,34.8147,12.5571428571429,21.9,0,34.5,28.9714285714286,33.7857142857143,164,118,78,0,0,157,46,79
2020,36,90,"Yozgat",39.8181,34.8147,9.28571428571429,23.9428571428571,0,32.0857142857143,44.7685714285714,36.5242857142857,179,53,35,23,23,112,126,77
2020,37,90,"Yozgat",39.8181,34.8147,13.5428571428571,20.8428571428571,0.0285714285714286,54.5714285714286,41.3,20.7257142857143,193,162,87,0,0,91,31,4
2020,38,90,"Yozgat",39.8181,34.8147,13,18.4714285714286,0,55.9571428571429,36.0371428571429,20.4071428571429,235,171,115,61,42,157,64,42
2020,39,90,"Yozgat",39.8181,34.8147,9.91428571428571,17.0285714285714,0.885714285714286,59.0571428571429,35.36,31.41,220,38,25,7,4,129,182,104
2020,40,90,"Yozgat",39.8181,34.8147,11.1857142857143,16.4,0.628571428571429,51.7857142857143,41.52,30.4728571428571,187,7,2,39,12,154,180,152
2020,41,90,"Yozgat",39.8181,34.8147,11.0857142857143,18.6142857142857,0,33.5,39.3485714285714,33.0271428571429,182,54,26,28,19,127,128,101
2020,42,90,"Yozgat",39.8181,34.8147,8.65714285714286,16.4,0,43.6571428571429,36.7671428571429,40.7442857142857,177,52,16,24,35,111,125,95
2020,43,90,"Yozgat",39.8181,34.8147,7.68571428571429,14.1285714285714,0.114285714285714,53.8857142857143,37.6314285714286,33.2942857142857,194,65,27,9,10,161,129,134
2020,44,90,"Yozgat",39.8181,34.8147,10.9428571428571,12.6,0.142857142857143,49.7571428571429,51.3385714285714,36.4128571428571,255,32,71,16,27,233,223,162
2020,45,90,"Yozgat",39.8181,34.8147,13.0428571428571,6.21428571428571,4.45714285714286,73.6285714285714,26.8714285714286,28.59,156,37,24,0,0,103,119,79
2020,46,90,"Yozgat",39.8181,34.8147,7.72857142857143,5.18571428571429,0,72.2571428571429,35.9057142857143,36.7285714285714,208,109,70,0,0,109,99,39
2020,47,90,"Yozgat",39.8181,34.8147,9.97142857142857,2.57142857142857,0.114285714285714,75.3571428571429,29.8385714285714,34.0742857142857,173,52,15,0,0,83,121,68
2020,48,90,"Yozgat",39.8181,34.8147,9.42857142857143,1.02857142857143,0.0142857142857143,67.5714285714286,31.78,36.2114285714286,199,85,95,0,0,262,114,167
2020,49,90,"Yozgat",39.8181,34.8147,6.17142857142857,3.72857142857143,0.0142857142857143,65.8428571428571,48.2814285714286,46.3571428571429,207,122,89,0,0,116,85,27
2020,50,90,"Yozgat",39.8181,34.8147,11.6,4.57142857142857,2.77142857142857,77.6428571428571,37.4671428571429,30.9828571428571,181,76,58,0,0,98,105,40
2020,51,90,"Yozgat",39.8181,34.8147,9.21428571428571,3.94285714285714,0.628571428571429,78.8571428571429,28.4671428571429,27.6028571428571,171,78,55,0,0,90,93,35
2020,52,90,"Yozgat",39.8181,34.8147,9.11428571428571,0.528571428571429,0.0714285714285714,73.6714285714286,38.58,37.2885714285714,203,96,20,37,40,113,107,93
2020,53,90,"Yozgat",39.8181,34.8147,9.3,3.7,0,64.1,45.5875,46.02,122,73,57,0,0,111,49,54
2017,1,91,"Trafik",41.4564,31.7987,17.2571428571429,5.57142857142857,4.31428571428571,74.0857142857143,85.7428571428571,NA,563,169,231,0,0,847,394,616
2017,2,91,"Trafik",41.4564,31.7987,19.1,5.25714285714286,2.09985714285714,65.4857142857143,91.7028571428571,NA,757,399,739,0,0,1214,358,475
2017,3,91,"Trafik",41.4564,31.7987,10.9571428571429,4.81428571428571,1.97128571428571,92.5,83.9042857142857,NA,762,134,149,116,193,1449,628,1300
2017,4,91,"Trafik",41.4564,31.7987,10.0428571428571,1.42857142857143,3.14371428571429,91.3142857142857,90.655,NA,639,116,147,127,191,889,523,742
2017,5,91,"Trafik",41.4564,31.7987,11.1857142857143,4.94285714285714,0.385857142857143,62.4428571428571,60.2725,NA,588,303,579,0,0,1163,285,584
2017,6,91,"Trafik",41.4564,31.7987,15.6142857142857,7.3,0.485857142857143,74.2428571428571,47.9471428571429,NA,736,139,211,1,10,1519,597,1308
2017,7,91,"Trafik",41.4564,31.7987,9.22857142857143,2.7,1.78585714285714,73.0571428571428,50.09,NA,492,95,92,243,392,717,397,625
2017,8,91,"Trafik",41.4564,31.7987,9.54285714285714,10.1571428571429,2.57128571428571,63.9142857142857,44.3533333333333,NA,739,66,203,154,402,1747,673,1544
2017,9,91,"Trafik",41.4564,31.7987,7.94285714285714,8.5,0.471285714285714,81.9857142857143,53.172,NA,574,92,95,130,114,866,482,771
2017,10,91,"Trafik",41.4564,31.7987,13.8142857142857,10.9,0.0285714285714286,68.3,50.63,NA,712,199,244,252,435,1043,513,799
2017,11,91,"Trafik",41.4564,31.7987,19.1428571428571,6.18571428571429,8.42814285714286,88.1,25.9385714285714,NA,525,0,0,222,363,725,525,725
2017,12,91,"Trafik",41.4564,31.7987,10.6857142857143,6.55714285714286,3.77071428571429,86.7428571428571,30.7971428571429,NA,589,0,0,409,620,1077,589,1077
2017,13,91,"Trafik",41.4564,31.7987,13.0285714285714,7.4,2.71414285714286,84.6857142857143,32.5157142857143,NA,574,0,0,195,316,887,574,887
2017,14,91,"Trafik",41.4564,31.7987,15.7,8.45714285714286,1.01442857142857,88,34.11,NA,639,128,264,169,344,1336,511,1072
2017,15,91,"Trafik",41.4564,31.7987,10.1714285714286,11.0571428571429,0.043,70.7857142857143,28.3071428571429,NA,587,109,283,86,233,1187,478,904
2017,16,91,"Trafik",41.4564,31.7987,17.4571428571429,10.6285714285714,10.4701428571429,76.6857142857143,20.8414285714286,NA,717,106,176,92,143,920,611,744
2017,17,91,"Trafik",41.4564,31.7987,11.4571428571429,12.7571428571429,0.814428571428571,63.9,28.1228571428571,NA,731,176,295,494,1021,1478,555,1183
2017,18,91,"Trafik",41.4564,31.7987,11.5,12.6,2.60028571428571,96.0857142857143,26.1042857142857,NA,506,69,113,406,721,923,437,810
2017,19,91,"Trafik",41.4564,31.7987,15.6571428571429,17.5571428571429,2.61414285714286,72.6142857142857,16.2042857142857,NA,471,122,306,103,192,966,349,660
2017,20,91,"Trafik",41.4564,31.7987,17.8,13.8285714285714,2.11471428571429,87.9857142857143,14.9285714285714,NA,472,0,0,165,520,1205,472,1205
2017,21,91,"Trafik",41.4564,31.7987,11.7142857142857,14.6285714285714,3.28542857142857,88.8285714285714,11.32,NA,448,0,0,203,534,849,448,849
2017,22,91,"Trafik",41.4564,31.7987,15.0857142857143,19.1714285714286,0.485714285714286,80.9142857142857,15.44,NA,522,0,0,80,88,1015,522,1015
2017,23,91,"Trafik",41.4564,31.7987,11.2,19.2285714285714,2.643,90.4142857142857,12.04,NA,578,42,31,389,976,1388,536,1357
2017,24,91,"Trafik",41.4564,31.7987,14.2285714285714,18.8571428571429,0.457142857142857,78.1428571428571,9.55142857142857,NA,552,0,0,102,144,1139,552,1139
2017,25,91,"Trafik",41.4564,31.7987,16.4,21.4571428571429,18.0972857142857,79.7571428571429,11.2714285714286,NA,584,0,0,58,39,1041,584,1041
2017,26,91,"Trafik",41.4564,31.7987,11.2285714285714,24.2714285714286,0,78.0428571428571,15.7614285714286,NA,564,66,96,156,285,971,498,875
2017,27,91,"Trafik",41.4564,31.7987,17.2857142857143,22.1428571428571,3.81357142857143,75.3571428571429,12.1271428571429,NA,511,0,0,149,182,642,511,642
2017,28,91,"Trafik",41.4564,31.7987,18.0571428571429,22.4428571428571,0,81.5428571428571,12.7542857142857,NA,481,0,0,69,126,864,481,864
2017,29,91,"Trafik",41.4564,31.7987,13.5571428571429,22,0.428571428571429,88.1857142857143,13.7385714285714,NA,532,0,0,73,109,1272,532,1272
2017,30,91,"Trafik",41.4564,31.7987,15.6142857142857,24.3857142857143,0.0431428571428571,69.5857142857143,14.2085714285714,NA,531,0,0,163,315,928,531,928
2017,31,91,"Trafik",41.4564,31.7987,13.8142857142857,23.8,0,81.8428571428571,15.7742857142857,NA,559,0,0,275,500,1047,559,1047
2017,32,91,"Trafik",41.4564,31.7987,14.5714285714286,25.4857142857143,0,84.5428571428571,20.0185714285714,NA,567,0,0,362,658,1092,567,1092
2017,33,91,"Trafik",41.4564,31.7987,16.6857142857143,23.9142857142857,1.11414285714286,80.8714285714286,15.6128571428571,NA,596,0,0,140,223,1199,596,1199
2017,34,91,"Trafik",41.4564,31.7987,18.9857142857143,21.4714285714286,15.1417142857143,76.4142857142857,10.4185714285714,NA,601,1,0,85,116,1280,600,1280
2017,35,91,"Trafik",41.4564,31.7987,16.7857142857143,20.4,0,71.9142857142857,8.14,NA,493,29,47,0,0,1014,464,967
2017,36,91,"Trafik",41.4564,31.7987,13.8571428571429,20.4142857142857,2.75685714285714,74.9571428571429,9.64428571428571,NA,507,97,251,153,505,1321,410,1070
2017,37,91,"Trafik",41.4564,31.7987,11.9714285714286,22.6571428571429,0,77.1857142857143,16.4885714285714,NA,589,126,270,241,400,1138,463,868
2017,38,91,"Trafik",41.4564,31.7987,15.1,21.0428571428571,3.61371428571429,77.8285714285714,14.1314285714286,NA,671,112,227,81,167,1312,559,1085
2017,39,91,"Trafik",41.4564,31.7987,21.7571428571429,16.8571428571429,1.78542857142857,84.9,14.7371428571429,NA,782,17,18,0,0,1630,765,1612
2017,40,91,"Trafik",41.4564,31.7987,17.8142857142857,15.1428571428571,1.85742857142857,74.5428571428571,15.5371428571429,NA,543,160,365,44,71,1137,383,772
2017,41,91,"Trafik",41.4564,31.7987,13.5571428571429,12.7857142857143,1.6,78.5571428571429,19.7614285714286,NA,487,250,494,0,0,843,237,349
2017,42,91,"Trafik",41.4564,31.7987,10.9857142857143,15.2142857142857,0.0858571428571429,75.2,27.6714285714286,NA,530,334,499,0,0,815,196,316
2017,43,91,"Trafik",41.4564,31.7987,17.0285714285714,15.5714285714286,8.31414285714286,80.5285714285714,22.8857142857143,NA,506,149,180,86,130,919,357,739
2017,44,91,"Trafik",41.4564,31.7987,16.6857142857143,9.6,5.78571428571429,73.3857142857143,24.4042857142857,NA,561,341,765,34,31,1102,220,337
2017,45,91,"Trafik",41.4564,31.7987,14.0142857142857,12.1857142857143,2.61414285714286,83.5428571428571,34.7614285714286,NA,577,164,406,0,0,829,413,423
2017,46,91,"Trafik",41.4564,31.7987,15.1857142857143,14.0857142857143,0.0285714285714286,77.0142857142857,36.2085714285714,NA,587,272,563,0,0,1085,315,522
2017,47,91,"Trafik",41.4564,31.7987,19.3571428571429,9.44285714285714,8.33042857142857,78.6571428571429,29.9957142857143,NA,418,151,376,138,212,804,267,428
2017,48,91,"Trafik",41.4564,31.7987,19.0857142857143,14.9285714285714,3.01385714285714,53.0428571428571,32.3471428571429,NA,386,308,478,0,0,619,78,141
2017,49,91,"Trafik",41.4564,31.7987,19.2571428571429,8.31428571428571,12.0285714285714,74.9714285714286,20.8757142857143,NA,407,56,42,66,111,645,351,603
2017,50,91,"Trafik",41.4564,31.7987,18.4571428571429,13.7285714285714,0.0857142857142857,56.9142857142857,36.95,NA,346,206,297,0,0,442,140,145
2017,51,91,"Trafik",41.4564,31.7987,17.2285714285714,6.07142857142857,17.17,87.4857142857143,16.4183333333333,NA,386,114,74,57,40,349,272,275
2017,52,91,"Trafik",41.4564,31.7987,18.9625,10.275,2.61225,61.9375,48.6325,NA,528,279,326,0,0,507,249,181
2018,1,91,"Trafik",41.4564,31.7987,14.6375,8.8,1.27525,75.3125,37.19,48.87,618,368,567,72,61,914,250,347
2018,2,91,"Trafik",41.4564,31.7987,17,8.32857142857143,2.84257142857143,84.2,37.1885714285714,NA,624,1,1,8,29,1309,623,1308
2018,3,91,"Trafik",41.4564,31.7987,23.8285714285714,7.24285714285714,4.87114285714286,67.3285714285714,24.1142857142857,NA,639,329,412,16,4,655,310,243
2018,4,91,"Trafik",41.4564,31.7987,19.6,4.04285714285714,2.42857142857143,74.0857142857143,20.7785714285714,NA,604,285,336,70,72,764,319,428
2018,5,91,"Trafik",41.4564,31.7987,15.8571428571429,11.5857142857143,0.0142857142857143,55.2857142857143,36.3757142857143,NA,670,239,399,108,69,819,431,420
2018,6,91,"Trafik",41.4564,31.7987,15.3428571428571,9.58571428571429,2.71414285714286,78.3571428571429,36.8228571428571,NA,704,190,329,91,154,1022,514,693
2018,7,91,"Trafik",41.4564,31.7987,13.8142857142857,7,2.48528571428571,84.6285714285714,25.7942857142857,NA,478,142,178,138,118,557,336,379
2018,8,91,"Trafik",41.4564,31.7987,15.1,6.1,7.05628571428571,93.8571428571429,25.5442857142857,NA,711,0,0,44,154,1321,711,1321
2018,9,91,"Trafik",41.4564,31.7987,20.6285714285714,6.82857142857143,9.18571428571429,80.9428571428572,27.5214285714286,NA,621,97,158,93,162,956,524,798
2018,10,91,"Trafik",41.4564,31.7987,16.1714285714286,11.0285714285714,3.92914285714286,77.9571428571429,35.5885714285714,NA,556,136,297,63,126,1330,420,1033
2018,11,91,"Trafik",41.4564,31.7987,20.6857142857143,15.3285714285714,2.71471428571429,55.3714285714286,28.69,NA,551,255,733,0,0,1426,296,693
2018,12,91,"Trafik",41.4564,31.7987,15.3857142857143,9.02857142857143,0.585714285714286,88.0142857142857,24.1685714285714,NA,425,0,0,30,89,1187,425,1187
2018,13,91,"Trafik",41.4564,31.7987,19.0428571428571,12.7142857142857,7.31357142857143,67.5,26.3214285714286,NA,356,164,158,108,185,428,192,270
2018,14,91,"Trafik",41.4564,31.7987,13.0857142857143,11.9285714285714,0.428571428571429,69.3571428571429,19.96,NA,407,115,82,180,316,486,292,404
2018,15,91,"Trafik",41.4564,31.7987,14.9428571428571,9.74285714285714,0.0857142857142857,94.5142857142857,NA,NA,374,0,0,258,375,450,374,450
2018,16,91,"Trafik",41.4564,31.7987,13.0428571428571,11.1571428571429,0.828714285714286,74.9,20.7666666666667,NA,411,60,47,199,402,648,351,601
2018,17,91,"Trafik",41.4564,31.7987,11.5,16.6571428571429,0,62.4428571428571,23.6128571428571,NA,419,122,153,0,0,652,297,499
2018,18,91,"Trafik",41.4564,31.7987,8.15714285714286,12.8142857142857,0.428714285714286,94.9,15.94,NA,303,0,0,190,299,474,303,474
2018,19,91,"Trafik",41.4564,31.7987,13.5571428571429,15.0428571428571,6.27128571428571,86.5,17.0328571428571,NA,275,0,0,76,83,467,275,467
2018,20,91,"Trafik",41.4564,31.7987,16.7285714285714,19.9571428571429,2.35685714285714,62.5857142857143,17.0171428571429,NA,204,87,180,80,108,306,117,126
2018,21,91,"Trafik",41.4564,31.7987,12.7428571428571,18.8285714285714,0.3,85.1857142857143,14.9371428571429,NA,252,0,0,112,146,281,252,281
2018,22,91,"Trafik",41.4564,31.7987,12.2714285714286,18.6142857142857,0.285857142857143,77.5285714285714,13.94,NA,249,0,0,93,188,427,249,427
2018,23,91,"Trafik",41.4564,31.7987,15.0285714285714,21.4142857142857,0,69.1571428571429,16.3957142857143,NA,267,0,0,42,109,812,267,812
2018,24,91,"Trafik",41.4564,31.7987,16.9857142857143,21.0714285714286,0.400142857142857,75.1142857142857,11.3128571428571,NA,267,17,5,45,39,448,250,443
2018,25,91,"Trafik",41.4564,31.7987,13.7714285714286,21.8285714285714,3.74485714285714,76.8428571428571,9.5175,NA,358,0,0,201,192,518,358,518
2018,26,91,"Trafik",41.4564,31.7987,15.8714285714286,22.5,0.442857142857143,76.6285714285714,NA,NA,355,0,0,240,437,587,355,587
2018,27,91,"Trafik",41.4564,31.7987,13,22.0857142857143,0,70.9428571428572,NA,NA,342,0,0,47,80,418,342,418
2018,28,91,"Trafik",41.4564,31.7987,14.3285714285714,24.1,1.857,75.1,NA,NA,286,0,0,101,187,585,286,585
2018,29,91,"Trafik",41.4564,31.7987,17.2428571428571,24.1285714285714,3.42814285714286,69.2142857142857,10.92,NA,260,5,13,2,1,756,255,743
2018,30,91,"Trafik",41.4564,31.7987,14.9,23.9428571428571,5.71328571428571,73.6428571428571,10.72,NA,265,5,21,0,0,822,260,801
2018,31,91,"Trafik",41.4564,31.7987,13.8142857142857,25.5428571428571,0,73.6142857142857,12.2042857142857,NA,267,0,0,14,17,499,267,499
2018,32,91,"Trafik",41.4564,31.7987,18.7428571428571,23.4714285714286,0.714142857142857,71.2714285714286,14.1242857142857,NA,297,27,72,35,22,403,270,331
2018,33,91,"Trafik",41.4564,31.7987,17.9714285714286,23.5714285714286,0,70.2857142857143,14.8814285714286,NA,216,2,10,7,20,332,214,322
2018,34,91,"Trafik",41.4564,31.7987,18.9285714285714,24.2428571428571,0,72.1571428571429,13.8771428571429,NA,144,0,0,0,0,227,144,227
2018,35,91,"Trafik",41.4564,31.7987,13.4428571428571,24.8285714285714,0.5,76.9285714285714,14.2442857142857,NA,201,0,0,32,60,314,201,314
2018,36,91,"Trafik",41.4564,31.7987,14.4571428571429,22.8428571428571,2.27285714285714,75.4571428571429,14.0185714285714,NA,341,62,66,28,23,370,279,304
2018,37,91,"Trafik",41.4564,31.7987,18.3142857142857,20.2571428571429,9.628,73.7285714285714,8.73571428571429,NA,241,35,65,0,0,419,206,354
2018,38,91,"Trafik",41.4564,31.7987,21.5,20.3428571428571,0.100142857142857,75.5285714285714,11.2628571428571,NA,189,0,0,1,0,344,189,344
2018,39,91,"Trafik",41.4564,31.7987,23.4714285714286,17.7571428571429,5.81314285714286,74.9714285714286,NA,NA,180,27,53,2,2,353,153,300
2018,40,91,"Trafik",41.4564,31.7987,14.9857142857143,17.5142857142857,2.61442857142857,75.4,NA,NA,191,51,89,0,0,341,140,252
2018,41,91,"Trafik",41.4564,31.7987,13.2571428571429,17.1,0.0285714285714286,82.6142857142857,222.42,NA,187,66,214,0,0,422,121,208
2018,42,91,"Trafik",41.4564,31.7987,8.2,17.6571428571429,3.32842857142857,87.3285714285714,334.103333333333,NA,168,48,185,76,159,381,120,196
2018,43,91,"Trafik",41.4564,31.7987,22.9857142857143,14.8142857142857,7.30042857142857,72.0428571428571,NA,NA,187,56,87,32,43,402,131,315
2018,44,91,"Trafik",41.4564,31.7987,12.3285714285714,15.9285714285714,0,69.4142857142857,NA,NA,196,147,192,0,0,264,49,72
2018,45,91,"Trafik",41.4564,31.7987,11.3857142857143,14,0.2,81.5285714285714,NA,NA,231,116,230,0,0,473,115,243
2018,46,91,"Trafik",41.4564,31.7987,17.4571428571429,9.75714285714286,5.65657142857143,78,NA,NA,230,103,208,0,0,465,127,257
2018,47,91,"Trafik",41.4564,31.7987,14.3142857142857,10.6,4.07114285714286,85.8,NA,NA,270,105,216,57,93,499,165,283
2018,48,91,"Trafik",41.4564,31.7987,17.1857142857143,9.85714285714286,13.8552857142857,82.2142857142857,NA,NA,245,96,60,0,0,201,149,141
2018,49,91,"Trafik",41.4564,31.7987,15.3285714285714,8.22857142857143,5.11371428571429,73.5857142857143,NA,NA,257,141,145,4,8,420,116,275
2018,50,91,"Trafik",41.4564,31.7987,17.7142857142857,8.1,10.8717142857143,77.4285714285714,NA,NA,256,128,146,20,3,305,128,159
2018,51,91,"Trafik",41.4564,31.7987,16.9571428571429,8.51428571428571,1.72885714285714,84.2428571428571,55.7325,NA,250,55,74,0,0,248,195,174
2018,52,91,"Trafik",41.4564,31.7987,19.0428571428571,4.7,10.7417142857143,81.1142857142857,44.5283333333333,39.7475,244,52,91,81,88,273,192,182
2019,1,91,"Trafik",41.4564,31.7987,20.6625,5.2375,6.799625,81.5125,51.0133333333333,42.865,343,152,498,84,212,784,191,286
2019,2,91,"Trafik",41.4564,31.7987,22.5428571428571,4.67142857142857,8.642,73.5571428571429,38.4566666666667,42.31,255,94,105,0,0,208,161,103
2019,3,91,"Trafik",41.4564,31.7987,18.0285714285714,6.6,4.75742857142857,68.4142857142857,NA,NA,192,62,95,54,45,198,130,103
2019,4,91,"Trafik",41.4564,31.7987,24.6857142857143,11.0428571428571,1.07142857142857,60.5285714285714,57.68,44.5025,308,154,180,48,43,314,154,134
2019,5,91,"Trafik",41.4564,31.7987,20.1428571428571,11.3,1.50014285714286,59.4428571428571,70.5628571428571,50.4871428571429,253,185,105,0,0,143,68,38
2019,6,91,"Trafik",41.4564,31.7987,13.2571428571429,7.48571428571429,3.67114285714286,86.2,55.6575,47.9975,276,97,23,17,17,127,179,104
2019,7,91,"Trafik",41.4564,31.7987,19.3,8.15714285714286,3.185,74.8857142857143,42.0885714285714,41.1042857142857,325,30,120,0,0,234,295,114
2019,8,91,"Trafik",41.4564,31.7987,13.3,6.07142857142857,5.456,81.8142857142857,52.9257142857143,49.39,305,45,10,78,98,219,260,209
2019,9,91,"Trafik",41.4564,31.7987,17.7571428571429,6.07142857142857,2.45714285714286,75.0285714285714,18.82,36.8425,331,0,0,48,3,310,331,310
2019,10,91,"Trafik",41.4564,31.7987,14.2857142857143,11.4285714285714,1.28571428571429,57.2,47.288,55.7457142857143,359,137,98,0,0,252,222,154
2019,11,91,"Trafik",41.4564,31.7987,19.9571428571429,10.0714285714286,2.90014285714286,71.5714285714286,NA,51.1333333333333,373,0,0,47,8,400,373,400
2019,12,91,"Trafik",41.4564,31.7987,12.2714285714286,9.15714285714286,0,67.1571428571429,21.2966666666667,NA,343,144,329,88,46,416,199,87
2019,13,91,"Trafik",41.4564,31.7987,20.5,6.74285714285714,0,67.7857142857143,27.8485714285714,33.06,256,0,0,24,9,194,256,194
2019,14,91,"Trafik",41.4564,31.7987,11.4571428571429,8.5,0.0285714285714286,86.9714285714286,29.76,45.1428571428571,365,0,0,242,150,208,365,208
2019,15,91,"Trafik",41.4564,31.7987,17.5571428571429,14.0857142857143,3.443,73.7142857142857,25.3314285714286,50.7585714285714,359,160,73,42,6,183,199,110
2019,16,91,"Trafik",41.4564,31.7987,13.2571428571429,8.41428571428571,5.87114285714286,85.3142857142857,12.7371428571429,37.53,318,0,0,270,189,208,318,208
2019,17,91,"Trafik",41.4564,31.7987,10.3714285714286,11.0571428571429,0,79.3714285714286,32.1528571428571,NA,412,0,0,263,224,313,412,313
2019,18,91,"Trafik",41.4564,31.7987,16.6428571428571,17.6285714285714,1.44271428571429,58.5142857142857,25.8214285714286,NA,523,183,169,0,0,353,340,184
2019,19,91,"Trafik",41.4564,31.7987,13.7714285714286,15.3,2.572,72.6285714285714,17.6571428571429,35.6383333333333,452,145,127,130,102,386,307,259
2019,20,91,"Trafik",41.4564,31.7987,16.9428571428571,17.0571428571429,7.885,83.3428571428571,17.6614285714286,35.8757142857143,454,0,0,209,190,389,454,389
2019,21,91,"Trafik",41.4564,31.7987,17.4428571428571,20.9,1.8,63.3428571428571,23.6028571428571,40.42,457,190,165,0,0,413,267,248
2019,22,91,"Trafik",41.4564,31.7987,18.4285714285714,22.1142857142857,0.228571428571429,65.1,33.2742857142857,43.18,453,98,68,0,0,323,355,255
2019,23,91,"Trafik",41.4564,31.7987,10.9428571428571,21.3428571428571,0,83.8857142857143,4.33166666666667,24.0757142857143,378,0,0,98,127,532,378,532
2019,24,91,"Trafik",41.4564,31.7987,13,23.0285714285714,0.0574285714285714,81.4571428571429,2.53428571428571,28.1142857142857,378,0,0,58,67,244,378,244
2019,25,91,"Trafik",41.4564,31.7987,13.6428571428571,22.8142857142857,8.77042857142857,86.8571428571429,3.895,36.2971428571429,306,0,0,93,79,325,306,325
2019,26,91,"Trafik",41.4564,31.7987,14.6285714285714,22.7285714285714,0.628857142857143,77.0142857142857,2.63,29.2114285714286,377,0,0,161,179,342,377,342
2019,27,91,"Trafik",41.4564,31.7987,13.2571428571429,22.2,0,78.1142857142857,5.99571428571429,25.8,456,0,0,85,25,222,456,222
2019,28,91,"Trafik",41.4564,31.7987,14.3,21.8428571428571,17.3687142857143,75.1142857142857,6.46,33.1514285714286,398,118,82,79,95,421,280,339
2019,29,91,"Trafik",41.4564,31.7987,20.2714285714286,22.0857142857143,6.32742857142857,78.1428571428571,11.5771428571429,31.48,453,0,0,0,0,203,453,203
2019,30,91,"Trafik",41.4564,31.7987,15.7,23.0857142857143,1.57114285714286,77.6857142857143,11.0485714285714,30.0714285714286,456,0,0,64,29,335,456,335
2019,31,91,"Trafik",41.4564,31.7987,12.7428571428571,23.4142857142857,1.88542857142857,83.4285714285714,15.0057142857143,32.9875,334,0,0,186,220,375,334,375
2019,32,91,"Trafik",41.4564,31.7987,15.3142857142857,21.2571428571429,0.685714285714286,75.8428571428571,12.9685714285714,35.0216666666667,346,0,0,56,48,395,346,395
2019,33,91,"Trafik",41.4564,31.7987,16.0285714285714,21.9571428571429,3.22814285714286,82.8142857142857,20.0742857142857,34.2628571428571,337,55,131,61,77,531,282,400
2019,34,91,"Trafik",41.4564,31.7987,19.7714285714286,22.7714285714286,14.4261428571429,85.3428571428571,23.2657142857143,35.8314285714286,299,0,0,0,0,345,299,345
2019,35,91,"Trafik",41.4564,31.7987,19.8,23.1714285714286,0,77.9571428571429,20.9114285714286,28.4685714285714,307,0,0,0,0,415,307,415
2019,36,91,"Trafik",41.4564,31.7987,18.4857142857143,22.1857142857143,0,75.1714285714286,23.4528571428571,31.8857142857143,171,9,1,0,0,67,162,66
2019,37,91,"Trafik",41.4564,31.7987,16.9428571428571,21.3714285714286,0,75.7142857142857,17.0714285714286,32.1514285714286,218,3,4,0,0,55,215,51
2019,38,91,"Trafik",41.4564,31.7987,17.2571428571429,18.8142857142857,3.98528571428571,68.3571428571429,24.9385714285714,36.7414285714286,266,191,70,0,0,91,75,21
2019,39,91,"Trafik",41.4564,31.7987,10.8142857142857,17.5285714285714,1.843,84.0714285714286,28.0342857142857,41.1742857142857,237,28,16,53,13,79,209,63
2019,40,91,"Trafik",41.4564,31.7987,13.0428571428571,18.3571428571429,12.4422857142857,79.1285714285714,33.4928571428571,48.0185714285714,241,0,0,35,27,111,241,111
2019,41,91,"Trafik",41.4564,31.7987,18.3285714285714,16.7571428571429,2.22842857142857,80.5,30.98,39.4842857142857,416,108,108,0,0,448,308,340
2019,42,91,"Trafik",41.4564,31.7987,9.65714285714286,17.7142857142857,0,87.7714285714286,56.7342857142857,43.9942857142857,356,206,260,1,1,408,150,148
2019,43,91,"Trafik",41.4564,31.7987,12.7428571428571,16.3714285714286,0,83.2428571428571,43.7985714285714,38.3771428571429,306,197,169,0,0,300,109,131
2019,44,91,"Trafik",41.4564,31.7987,13.0428571428571,13.8428571428571,0.285714285714286,79.6857142857143,46,42.4028571428571,350,286,198,0,0,250,64,52
2019,45,91,"Trafik",41.4564,31.7987,15.9571428571429,19,0,49.7285714285714,65.4542857142857,55.9371428571429,417,411,326,0,0,328,6,2
2019,46,91,"Trafik",41.4564,31.7987,9.58571428571429,17.3857142857143,0,60.5857142857143,75.2714285714286,53.618,401,356,293,0,0,337,45,44
2019,47,91,"Trafik",41.4564,31.7987,9.34285714285714,13.1,0,71.5,86.0785714285714,52.9842857142857,391,292,261,0,0,339,99,78
2019,48,91,"Trafik",41.4564,31.7987,18.4857142857143,13.9,8.32857142857143,70.7857142857143,65.2414285714286,45.7614285714286,320,155,84,48,34,251,165,167
2019,49,91,"Trafik",41.4564,31.7987,14.3285714285714,6.48571428571429,2.99985714285714,78.4,56.22,41.86,393,205,142,0,0,274,188,132
2019,50,91,"Trafik",41.4564,31.7987,14.3285714285714,9.37142857142857,1.42857142857143,77.0857142857143,86.705,47.8571428571429,218,147,65,0,0,119,71,54
2019,51,91,"Trafik",41.4564,31.7987,12.7857142857143,13.1285714285714,0,53.3285714285714,87.66,48.2928571428571,361,348,471,0,0,488,13,17
2019,52,91,"Trafik",41.4564,31.7987,20.1142857142857,9.37142857142857,17.4992857142857,79.8142857142857,29.775,34.7742857142857,279,47,64,87,41,281,232,217
2020,1,91,"Trafik",41.4564,31.7987,18.16,6.06,4.0008,75.48,34.88,35.534,160,54,48,39,21,126,106,78
2020,2,91,"Trafik",41.4564,31.7987,16.2142857142857,5.58571428571429,9.39828571428571,84.3571428571429,31.7575,40.22,240,142,130,49,11,173,98,43
2020,3,91,"Trafik",41.4564,31.7987,13.7,6,1.08571428571429,81.8,49.985,35.9685714285714,270,100,151,0,0,382,170,231
2020,4,91,"Trafik",41.4564,31.7987,19.7571428571429,5.82857142857143,2.71428571428571,67.1571428571429,41.3057142857143,38.9842857142857,358,4,0,153,109,295,354,295
2020,5,91,"Trafik",41.4564,31.7987,19.9571428571429,10.1714285714286,3.65714285714286,65.2285714285714,58.0771428571429,44.218,331,73,75,0,0,272,258,197
2020,6,91,"Trafik",41.4564,31.7987,23.0857142857143,8.12857142857143,7.64385714285714,69.8,54.9171428571429,29.9185714285714,343,55,69,99,91,267,288,198
2020,7,91,"Trafik",41.4564,31.7987,16.6857142857143,7.72857142857143,4.14314285714286,65.3714285714286,88.0914285714286,43.8414285714286,341,144,157,0,0,338,197,181
2020,8,91,"Trafik",41.4564,31.7987,12.0142857142857,6.45714285714286,3.74214285714286,83.6857142857143,91.114,44.1957142857143,283,42,20,50,23,187,241,167
2020,9,91,"Trafik",41.4564,31.7987,17.2,10.5714285714286,3.79971428571429,61.9857142857143,80.0928571428571,48.4175,393,46,15,97,99,528,347,513
2020,10,91,"Trafik",41.4564,31.7987,17.9857142857143,15.9428571428571,0,42.2857142857143,117.207142857143,51.986,205,169,164,4,1,210,36,46
2020,11,91,"Trafik",41.4564,31.7987,17.0428571428571,11.2571428571429,2.42828571428571,77,83.9671428571429,43.3028571428571,115,15,20,27,19,94,100,74
2020,12,91,"Trafik",41.4564,31.7987,20.5857142857143,5.72857142857143,3.99985714285714,77.2714285714286,85.87,34.69,117,0,0,16,12,118,117,118
2020,13,91,"Trafik",41.4564,31.7987,21.0285714285714,8.04285714285714,0.328571428571429,91.5142857142857,25.84,25.8083333333333,136,0,0,7,18,92,136,92
2020,14,91,"Trafik",41.4564,31.7987,28.4428571428571,9.21428571428571,3.17157142857143,87.6857142857143,42.1571428571429,NA,155,1,1,0,0,121,154,120
2020,15,91,"Trafik",41.4564,31.7987,27.4285714285714,8.75714285714286,0.614285714285714,76.1142857142857,68.87,22.7616666666667,133,0,0,24,11,118,133,118
2020,16,91,"Trafik",41.4564,31.7987,15.3714285714286,11.9142857142857,1.114,68.0857142857143,113.541428571429,26.5214285714286,141,26,10,0,0,106,115,96
2020,17,91,"Trafik",41.4564,31.7987,22.4142857142857,10.6285714285714,0.4,76.6,46.7442857142857,16.9757142857143,137,0,0,13,4,123,137,123
2020,18,91,"Trafik",41.4564,31.7987,16.4714285714286,14.4,0.0428571428571429,72.9,30.2957142857143,26.0685714285714,146,61,51,0,0,164,85,113
2020,19,91,"Trafik",41.4564,31.7987,17.2857142857143,13.5142857142857,2.74328571428571,80.4,26.0314285714286,25.05,137,25,58,34,28,157,112,99
2020,20,91,"Trafik",41.4564,31.7987,18.1428571428571,19.5857142857143,0,67.5714285714286,66.84,30.3071428571429,164,32,45,13,10,164,132,119
2020,21,91,"Trafik",41.4564,31.7987,21.9571428571429,16.0857142857143,3.59957142857143,79.6714285714286,31.26,24.4285714285714,146,5,0,14,22,96,141,96
2020,22,91,"Trafik",41.4564,31.7987,18.5285714285714,14.8857142857143,5.71442857142857,80.7142857142857,27.856,21.5357142857143,118,18,14,7,7,100,100,86
2020,23,91,"Trafik",41.4564,31.7987,13.6428571428571,19.3857142857143,5.02757142857143,67.1714285714286,38.4885714285714,40.788,112,29,16,22,5,70,83,54
2020,24,91,"Trafik",41.4564,31.7987,10.9428571428571,21.2857142857143,0.086,71.1571428571429,41.2657142857143,36.69,140,21,46,19,10,150,119,104
2020,25,91,"Trafik",41.4564,31.7987,12.7857142857143,22.1714285714286,4.08557142857143,75.8,37.0385714285714,31.6,137,42,38,6,23,108,95,70
2020,26,91,"Trafik",41.4564,31.7987,15.0285714285714,22.1142857142857,2.42814285714286,80.0714285714286,29.8728571428571,27.24,173,0,0,51,38,133,173,133
2020,27,91,"Trafik",41.4564,31.7987,9.98571428571429,23.7714285714286,0,79,35.6414285714286,31.1083333333333,113,12,8,7,6,113,101,105
2020,28,91,"Trafik",41.4564,31.7987,14.0714285714286,22.6857142857143,3.001,81.3,35.0257142857143,31.3357142857143,164,0,0,73,74,122,164,122
2020,29,91,"Trafik",41.4564,31.7987,14.1571428571429,21.5857142857143,0.100142857142857,81.0285714285714,30.6528571428571,27.3971428571429,186,0,0,52,31,111,186,111
2020,30,91,"Trafik",41.4564,31.7987,17.6857142857143,22.9714285714286,0.3,80.1142857142857,35.5728571428571,32.5616666666667,190,0,0,74,59,142,190,142
2020,31,91,"Trafik",41.4564,31.7987,14.6,23.5714285714286,0,79.9285714285714,31.0742857142857,28.7783333333333,150,0,0,65,58,127,150,127
2020,32,91,"Trafik",41.4564,31.7987,19.5714285714286,23.1,0,78.4571428571429,28.7314285714286,32.5942857142857,146,0,0,0,0,107,146,107
2020,33,91,"Trafik",41.4564,31.7987,18.3571428571429,23.1142857142857,0,74.0285714285714,24.9285714285714,27.38,183,0,0,8,8,83,183,83
2020,34,91,"Trafik",41.4564,31.7987,14.8285714285714,22.9714285714286,0.271428571428571,74.0142857142857,31.1885714285714,34.6685714285714,197,0,0,49,26,97,197,97
2020,35,91,"Trafik",41.4564,31.7987,11.9571428571429,23.6714285714286,0,74.7285714285714,46.2128571428571,31.528,164,0,0,53,54,157,164,157
2020,36,91,"Trafik",41.4564,31.7987,15.5285714285714,23.0857142857143,8.07157142857143,83.9285714285714,63.74,32.62,179,0,0,48,30,112,179,112
2020,37,91,"Trafik",41.4564,31.7987,15.6857142857143,22.6571428571429,0.285714285714286,81.5428571428571,60.9128571428571,31.6757142857143,193,0,0,0,0,91,193,91
2020,38,91,"Trafik",41.4564,31.7987,23.5142857142857,21.8,0.1,79.5,64.5728571428571,38.7466666666667,235,0,0,20,12,157,235,157
2020,39,91,"Trafik",41.4564,31.7987,15.9857142857143,21.0571428571429,0,74.2571428571429,64.3485714285714,42.49,220,42,14,0,0,129,178,115
2020,40,91,"Trafik",41.4564,31.7987,15.2857142857143,20.2,7.042,69.8571428571429,52.29,41.83,187,119,105,13,5,154,68,49
2020,41,91,"Trafik",41.4564,31.7987,14.8857142857143,22.2142857142857,11.984,64.8285714285714,79.0242857142857,45.84,182,107,80,0,0,127,75,47
2020,42,91,"Trafik",41.4564,31.7987,10.4285714285714,20.6142857142857,0.428714285714286,66.5285714285714,75.0171428571429,45.12,177,177,111,0,0,111,0,0
2020,43,91,"Trafik",41.4564,31.7987,12.2571428571429,17.2428571428571,5.60042857142857,84.3285714285714,80.3142857142857,40.2257142857143,194,154,132,0,0,161,40,29
2020,44,91,"Trafik",41.4564,31.7987,14.0285714285714,16.6857142857143,13.6148571428571,80.7571428571429,76.4714285714286,37.5628571428571,255,75,33,0,0,233,180,200
2020,45,91,"Trafik",41.4564,31.7987,13.9142857142857,13.5,3.07142857142857,81.4428571428571,67.66,37.216,156,116,86,0,0,103,40,17
2020,46,91,"Trafik",41.4564,31.7987,14.5857142857143,12.8285714285714,2.58528571428571,84.8857142857143,80.9771428571429,34.51,208,125,67,0,0,109,83,42
2020,47,91,"Trafik",41.4564,31.7987,17.0857142857143,10.5,0.842857142857143,76.5571428571429,75.1414285714286,36.2442857142857,173,125,49,0,0,83,48,34
2020,48,91,"Trafik",41.4564,31.7987,15.6857142857143,10.0142857142857,0.328571428571429,72.0571428571429,108.31,42.6957142857143,199,160,230,0,0,262,39,32
2020,49,91,"Trafik",41.4564,31.7987,11.7428571428571,11.6571428571429,1.714,78.3,118.417142857143,42.7325,207,90,40,0,0,116,117,76
2020,50,91,"Trafik",41.4564,31.7987,20.0428571428571,13.4428571428571,0.428571428571429,67.9714285714286,107.664285714286,40.5442857142857,181,110,76,0,0,98,71,22
2020,51,91,"Trafik",41.4564,31.7987,14.6142857142857,10.7428571428571,5.29985714285714,85.3857142857143,64.4614285714286,33.48,171,21,12,33,16,90,150,78
2020,52,91,"Trafik",41.4564,31.7987,18.2142857142857,10.3142857142857,2.157,69.0428571428571,98.8266666666667,42.1166666666667,203,110,71,0,0,113,93,42
2020,53,91,"Trafik",41.4564,31.7987,18.575,15.3,0,43.475,166.793333333333,55.9566666666667,122,117,102,0,0,111,5,9
